1,0,0,1,1,110,107,3
1,0,1,1,1,107,96,11
1,0,2,1,1,96,98,-2
1,0,3,1,1,98,111,-13
1,0,4,1,1,111,111,0
1,0,5,1,1,111,104,7
1,0,6,1,1,104,106,-2
1,0,7,1,1,106,104,2
1,0,8,1,1,104,103,1
1,0,9,1,1,103,102,1
1,0,10,1,1,102,102,0
1,0,11,1,1,102,102,0
1,0,12,1,1,102,103,-1
1,0,13,1,1,103,104,-1
1,0,14,1,1,104,105,-1
1,0,15,1,1,105,98,7
1,0,16,1,1,98,102,-4
1,0,17,1,1,102,110,-8
1,0,18,1,1,110,108,2
1,0,19,1,1,108,98,10
1,0,20,1,1,98,103,-5
1,0,21,1,1,103,109,-6
1,0,22,1,1,109,102,7
1,1,0,1,1,106,111,-5
1,1,1,1,1,111,107,4
1,1,2,1,1,107,106,1
1,1,3,1,1,106,112,-6
1,1,4,1,1,112,108,4
1,1,5,1,1,108,102,6
1,1,6,1,1,102,107,-5
1,1,7,1,1,107,108,-1
1,1,8,1,1,108,106,2
1,1,9,1,1,106,104,2
1,1,10,1,1,104,103,1
1,1,11,1,1,103,103,0
1,1,12,1,1,103,104,-1
1,1,13,1,1,104,105,-1
1,1,14,1,1,105,107,-2
1,1,15,1,1,107,115,-8
1,1,16,1,1,115,107,8
1,1,17,1,1,107,104,3
1,1,18,1,1,104,102,2
1,1,19,1,1,102,101,1
1,1,20,1,1,101,111,-10
1,1,21,1,1,111,114,-3
1,1,22,1,1,114,102,12
1,2,0,1,1,106,115,-9
1,2,1,1,1,115,112,3
1,2,2,1,1,112,107,5
1,2,3,1,1,107,110,-3
1,2,4,1,1,110,108,2
1,2,5,1,1,108,108,0
1,2,6,1,1,108,118,-10
1,2,7,1,1,118,115,3
1,2,8,1,1,115,113,2
1,2,9,1,1,113,109,4
1,2,10,1,1,109,107,2
1,2,11,1,1,107,106,1
1,2,12,1,1,106,108,-2
1,2,13,1,1,108,110,-2
1,2,14,1,1,110,111,-1
1,2,15,1,1,111,117,-6
1,2,16,1,1,117,109,8
1,2,17,1,1,109,109,0
1,2,18,1,1,109,107,2
1,2,19,1,1,107,103,4
1,2,20,1,1,103,110,-7
1,2,21,1,1,110,115,-5
1,2,22,1,1,115,106,9
1,3,0,1,1,112,117,-5
1,3,1,1,1,117,110,7
1,3,2,1,1,110,105,5
1,3,3,1,1,105,112,-7
1,3,4,1,1,112,115,-3
1,3,5,1,1,115,112,3
1,3,6,1,1,112,115,-3
1,3,7,1,1,115,72,43
1,3,8,1,1,72,69,3
1,3,9,1,1,69,66,3
1,3,10,1,1,66,63,3
1,3,11,1,1,63,62,1
1,3,12,1,1,62,63,-1
1,3,13,1,1,63,65,-2
1,3,14,1,1,65,67,-2
1,3,15,1,1,67,90,-23
1,3,16,1,1,90,99,-9
1,3,17,1,1,99,117,-18
1,3,18,1,1,117,121,-4
1,3,19,1,1,121,107,14
1,3,20,1,1,107,104,3
1,3,21,1,1,104,111,-7
1,3,22,1,1,111,111,0
1,4,0,1,1,114,119,-5
1,4,1,1,1,119,114,5
1,4,2,1,1,114,115,-1
1,4,3,1,1,115,126,-11
1,4,4,1,1,126,120,6
1,4,5,1,1,120,94,26
1,4,6,1,1,94,76,18
1,4,7,1,1,76,54,22
1,4,8,1,1,54,51,3
1,4,9,1,1,51,48,3
1,4,10,1,1,48,45,3
1,4,11,1,1,45,44,1
1,4,12,1,1,44,45,-1
1,4,13,1,1,45,47,-2
1,4,14,1,1,47,48,-1
1,4,15,1,1,48,59,-11
1,4,16,1,1,59,75,-16
1,4,17,1,1,75,106,-31
1,4,18,1,1,106,123,-17
1,4,19,1,1,123,115,8
1,4,20,1,1,115,110,5
1,4,21,1,1,110,113,-3
1,4,22,1,1,113,110,3
1,5,0,1,1,114,122,-8
1,5,1,1,1,122,120,2
1,5,2,1,1,120,119,1
1,5,3,1,1,119,125,-6
1,5,4,1,1,125,109,16
1,5,5,1,1,109,69,40
1,5,6,1,1,69,39,30
1,5,7,1,1,39,69,-30
1,5,8,1,1,69,68,1
1,5,9,1,1,68,67,1
1,5,10,1,1,67,65,2
1,5,11,1,1,65,65,0
1,5,12,1,1,65,65,0
1,5,13,1,1,65,65,0
1,5,14,1,1,65,66,-1
1,5,15,1,1,66,55,11
1,5,16,1,1,55,58,-3
1,5,17,1,1,58,81,-23
1,5,18,1,1,81,107,-26
1,5,19,1,1,107,116,-9
1,5,20,1,1,116,119,-3
1,5,21,1,1,119,118,1
1,5,22,1,1,118,108,10
1,6,0,1,1,120,124,-4
1,6,1,1,1,124,109,15
1,6,2,1,1,109,89,20
1,6,3,1,1,89,87,2
1,6,4,1,1,87,82,5
1,6,5,1,1,82,67,15
1,6,6,1,1,67,58,9
1,6,7,1,1,58,69,-11
1,6,8,1,1,69,69,0
1,6,9,1,1,69,69,0
1,6,10,1,1,69,69,0
1,6,11,1,1,69,69,0
1,6,12,1,1,69,69,0
1,6,13,1,1,69,68,1
1,6,14,1,1,68,68,0
1,6,15,1,1,68,77,-9
1,6,16,1,1,77,66,11
1,6,17,1,1,66,71,-5
1,6,18,1,1,71,87,-16
1,6,19,1,1,87,97,-10
1,6,20,1,1,97,107,-10
1,6,21,1,1,107,116,-9
1,6,22,1,1,116,115,1
1,7,0,1,1,130,125,5
1,7,1,1,1,125,90,35
1,7,2,1,1,90,49,41
1,7,3,1,1,49,40,9
1,7,4,1,1,40,57,-17
1,7,5,1,1,57,82,-25
1,7,6,1,1,82,105,-23
1,7,7,1,1,105,95,10
1,7,8,1,1,95,96,-1
1,7,9,1,1,96,97,-1
1,7,10,1,1,97,99,-2
1,7,11,1,1,99,99,0
1,7,12,1,1,99,98,1
1,7,13,1,1,98,97,1
1,7,14,1,1,97,96,1
1,7,15,1,1,96,99,-3
1,7,16,1,1,99,84,15
1,7,17,1,1,84,79,5
1,7,18,1,1,79,77,2
1,7,19,1,1,77,72,5
1,7,20,1,1,72,84,-12
1,7,21,1,1,84,110,-26
1,7,22,1,1,110,125,-15
1,8,0,1,1,126,141,-15
1,8,1,1,1,141,121,20
1,8,2,1,1,121,78,43
1,8,3,1,1,78,63,15
1,8,4,1,1,63,94,-31
1,8,5,1,1,94,135,-41
1,8,6,1,1,135,121,14
1,8,7,1,1,121,127,-6
1,8,8,1,1,127,135,-8
1,8,9,1,1,135,130,5
1,8,10,1,1,130,137,-7
1,8,11,1,1,137,146,-9
1,8,12,1,1,146,146,0
1,8,13,1,1,146,138,8
1,8,14,1,1,138,138,0
1,8,15,1,1,138,134,4
1,8,16,1,1,134,131,3
1,8,17,1,1,131,129,2
1,8,18,1,1,129,93,36
1,8,19,1,1,93,99,-6
1,8,20,1,1,99,128,-29
1,8,21,1,1,128,118,10
1,8,22,1,1,118,131,-13
1,9,0,1,1,106,69,37
1,9,1,1,1,69,69,0
1,9,2,1,1,69,43,26
1,9,3,1,1,43,41,2
1,9,4,1,1,41,55,-14
1,9,5,1,1,55,44,11
1,9,6,1,1,44,67,-23
1,9,7,1,1,67,64,3
1,9,8,1,1,64,41,23
1,9,9,1,1,41,29,12
1,9,10,1,1,29,36,-7
1,9,11,1,1,36,39,-3
1,9,12,1,1,39,28,11
1,9,13,1,1,28,27,1
1,9,14,1,1,27,53,-26
1,9,15,1,1,53,59,-6
1,9,16,1,1,59,66,-7
1,9,17,1,1,66,58,8
1,9,18,1,1,58,47,11
1,9,19,1,1,47,51,-4
1,9,20,1,1,51,60,-9
1,9,21,1,1,60,76,-16
1,9,22,1,1,76,103,-27
1,10,0,1,1,104,44,60
1,10,1,1,1,44,60,-16
1,10,2,1,1,60,76,-16
1,10,3,1,1,76,148,-72
1,10,4,1,1,148,118,30
1,10,5,1,1,118,123,-5
1,10,6,1,1,123,157,-34
1,10,7,1,1,157,142,15
1,10,8,1,1,142,128,14
1,10,9,1,1,128,132,-4
1,10,10,1,1,132,119,13
1,10,11,1,1,119,125,-6
1,10,12,1,1,125,132,-7
1,10,13,1,1,132,124,8
1,10,14,1,1,124,129,-5
1,10,15,1,1,129,145,-16
1,10,16,1,1,145,149,-4
1,10,17,1,1,149,112,37
1,10,18,1,1,112,120,-8
1,10,19,1,1,120,115,5
1,10,20,1,1,115,82,33
1,10,21,1,1,82,99,-17
1,10,22,1,1,99,106,-7
1,11,0,1,1,139,100,39
1,11,1,1,1,100,90,10
1,11,2,1,1,90,123,-33
1,11,3,1,1,123,253,-130
1,11,4,1,1,253,175,78
1,11,5,1,1,175,223,-48
1,11,6,1,1,223,230,-7
1,11,7,1,1,230,216,14
1,11,8,1,1,216,178,38
1,11,9,1,1,178,194,-16
1,11,10,1,1,194,178,16
1,11,11,1,1,178,191,-13
1,11,12,1,1,191,200,-9
1,11,13,1,1,200,184,16
1,11,14,1,1,184,189,-5
1,11,15,1,1,189,242,-53
1,11,16,1,1,242,236,6
1,11,17,1,1,236,184,52
1,11,18,1,1,184,211,-27
1,11,19,1,1,211,213,-2
1,11,20,1,1,213,169,44
1,11,21,1,1,169,173,-4
1,11,22,1,1,173,134,39
1,12,0,1,1,151,147,4
1,12,1,1,1,147,104,43
1,12,2,1,1,104,126,-22
1,12,3,1,1,126,237,-111
1,12,4,1,1,237,201,36
1,12,5,1,1,201,213,-12
1,12,6,1,1,213,224,-11
1,12,7,1,1,224,232,-8
1,12,8,1,1,232,111,121
1,12,9,1,1,111,114,-3
1,12,10,1,1,114,115,-1
1,12,11,1,1,115,131,-16
1,12,12,1,1,131,111,20
1,12,13,1,1,111,103,8
1,12,14,1,1,103,159,-56
1,12,15,1,1,159,251,-92
1,12,16,1,1,251,238,13
1,12,17,1,1,238,200,38
1,12,18,1,1,200,222,-22
1,12,19,1,1,222,218,4
1,12,20,1,1,218,197,21
1,12,21,1,1,197,199,-2
1,12,22,1,1,199,131,68
1,13,0,1,1,146,159,-13
1,13,1,1,1,159,110,49
1,13,2,1,1,110,123,-13
1,13,3,1,1,123,187,-64
1,13,4,1,1,187,253,-66
1,13,5,1,1,253,170,83
1,13,6,1,1,170,233,-63
1,13,7,1,1,233,249,-16
1,13,8,1,1,249,100,149
1,13,9,1,1,100,106,-6
1,13,10,1,1,106,93,13
1,13,11,1,1,93,110,-17
1,13,12,1,1,110,96,14
1,13,13,1,1,96,91,5
1,13,14,1,1,91,157,-66
1,13,15,1,1,157,249,-92
1,13,16,1,1,249,217,32
1,13,17,1,1,217,218,-1
1,13,18,1,1,218,213,5
1,13,19,1,1,213,177,36
1,13,20,1,1,177,188,-11
1,13,21,1,1,188,197,-9
1,13,22,1,1,197,134,63
1,14,0,1,1,152,169,-17
1,14,1,1,1,169,115,54
1,14,2,1,1,115,122,-7
1,14,3,1,1,122,176,-54
1,14,4,1,1,176,254,-78
1,14,5,1,1,254,143,111
1,14,6,1,1,143,231,-88
1,14,7,1,1,231,236,-5
1,14,8,1,1,236,100,136
1,14,9,1,1,100,127,-27
1,14,10,1,1,127,93,34
1,14,11,1,1,93,109,-16
1,14,12,1,1,109,112,-3
1,14,13,1,1,112,104,8
1,14,14,1,1,104,155,-51
1,14,15,1,1,155,241,-86
1,14,16,1,1,241,180,61
1,14,17,1,1,180,230,-50
1,14,18,1,1,230,213,17
1,14,19,1,1,213,153,60
1,14,20,1,1,153,195,-42
1,14,21,1,1,195,201,-6
1,14,22,1,1,201,154,47
1,15,0,1,1,146,169,-23
1,15,1,1,1,169,107,62
1,15,2,1,1,107,119,-12
1,15,3,1,1,119,207,-88
1,15,4,1,1,207,250,-43
1,15,5,1,1,250,164,86
1,15,6,1,1,164,237,-73
1,15,7,1,1,237,238,-1
1,15,8,1,1,238,83,155
1,15,9,1,1,83,118,-35
1,15,10,1,1,118,94,24
1,15,11,1,1,94,105,-11
1,15,12,1,1,105,92,13
1,15,13,1,1,92,86,6
1,15,14,1,1,86,160,-74
1,15,15,1,1,160,255,-95
1,15,16,1,1,255,171,84
1,15,17,1,1,171,247,-76
1,15,18,1,1,247,223,24
1,15,19,1,1,223,149,74
1,15,20,1,1,149,198,-49
1,15,21,1,1,198,186,12
1,15,22,1,1,186,141,45
1,16,0,1,1,108,114,-6
1,16,1,1,1,114,75,39
1,16,2,1,1,75,119,-44
1,16,3,1,1,119,219,-100
1,16,4,1,1,219,249,-30
1,16,5,1,1,249,130,119
1,16,6,1,1,130,248,-118
1,16,7,1,1,248,239,9
1,16,8,1,1,239,107,132
1,16,9,1,1,107,117,-10
1,16,10,1,1,117,94,23
1,16,11,1,1,94,127,-33
1,16,12,1,1,127,112,15
1,16,13,1,1,112,98,14
1,16,14,1,1,98,174,-76
1,16,15,1,1,174,254,-80
1,16,16,1,1,254,170,84
1,16,17,1,1,170,189,-19
1,16,18,1,1,189,217,-28
1,16,19,1,1,217,156,61
1,16,20,1,1,156,168,-12
1,16,21,1,1,168,117,51
1,16,22,1,1,117,140,-23
1,17,0,1,1,108,75,33
1,17,1,1,1,75,63,12
1,17,2,1,1,63,146,-83
1,17,3,1,1,146,207,-61
1,17,4,1,1,207,191,16
1,17,5,1,1,191,112,79
1,17,6,1,1,112,231,-119
1,17,7,1,1,231,196,35
1,17,8,1,1,196,71,125
1,17,9,1,1,71,110,-39
1,17,10,1,1,110,67,43
1,17,11,1,1,67,83,-16
1,17,12,1,1,83,83,0
1,17,13,1,1,83,61,22
1,17,14,1,1,61,140,-79
1,17,15,1,1,140,242,-102
1,17,16,1,1,242,161,81
1,17,17,1,1,161,75,86
1,17,18,1,1,75,160,-85
1,17,19,1,1,160,174,-14
1,17,20,1,1,174,166,8
1,17,21,1,1,166,93,73
1,17,22,1,1,93,155,-62
1,18,0,1,1,122,92,30
1,18,1,1,1,92,76,16
1,18,2,1,1,76,184,-108
1,18,3,1,1,184,238,-54
1,18,4,1,1,238,179,59
1,18,5,1,1,179,69,110
1,18,6,1,1,69,128,-59
1,18,7,1,1,128,112,16
1,18,8,1,1,112,73,39
1,18,9,1,1,73,75,-2
1,18,10,1,1,75,84,-9
1,18,11,1,1,84,107,-23
1,18,12,1,1,107,75,32
1,18,13,1,1,75,103,-28
1,18,14,1,1,103,82,21
1,18,15,1,1,82,67,15
1,18,16,1,1,67,158,-91
1,18,17,1,1,158,73,85
1,18,18,1,1,73,125,-52
1,18,19,1,1,125,200,-75
1,18,20,1,1,200,164,36
1,18,21,1,1,164,81,83
1,18,22,1,1,81,121,-40
1,19,0,1,1,190,90,100
1,19,1,1,1,90,104,-14
1,19,2,1,1,104,234,-130
1,19,3,1,1,234,130,104
1,19,4,1,1,130,80,50
1,19,5,1,1,80,72,8
1,19,6,1,1,72,99,-27
1,19,7,1,1,99,187,-88
1,19,8,1,1,187,123,64
1,19,9,1,1,123,158,-35
1,19,10,1,1,158,131,27
1,19,11,1,1,131,158,-27
1,19,12,1,1,158,157,1
1,19,13,1,1,157,110,47
1,19,14,1,1,110,65,45
1,19,15,1,1,65,188,-123
1,19,16,1,1,188,208,-20
1,19,17,1,1,208,69,139
1,19,18,1,1,69,63,6
1,19,19,1,1,63,177,-114
1,19,20,1,1,177,79,98
1,19,21,1,1,79,74,5
1,19,22,1,1,74,201,-127
1,20,0,1,1,190,76,114
1,20,1,1,1,76,68,8
1,20,2,1,1,68,230,-162
1,20,3,1,1,230,97,133
1,20,4,1,1,97,43,54
1,20,5,1,1,43,73,-30
1,20,6,1,1,73,179,-106
1,20,7,1,1,179,244,-65
1,20,8,1,1,244,132,112
1,20,9,1,1,132,153,-21
1,20,10,1,1,153,120,33
1,20,11,1,1,120,152,-32
1,20,12,1,1,152,146,6
1,20,13,1,1,146,84,62
1,20,14,1,1,84,75,9
1,20,15,1,1,75,138,-63
1,20,16,1,1,138,120,18
1,20,17,1,1,120,48,72
1,20,18,1,1,48,77,-29
1,20,19,1,1,77,163,-86
1,20,20,1,1,163,45,118
1,20,21,1,1,45,55,-10
1,20,22,1,1,55,211,-156
1,21,0,1,1,203,72,131
1,21,1,1,1,72,89,-17
1,21,2,1,1,89,235,-146
1,21,3,1,1,235,62,173
1,21,4,1,1,62,32,30
1,21,5,1,1,32,58,-26
1,21,6,1,1,58,84,-26
1,21,7,1,1,84,145,-61
1,21,8,1,1,145,41,104
1,21,9,1,1,41,26,15
1,21,10,1,1,26,44,-18
1,21,11,1,1,44,88,-44
1,21,12,1,1,88,36,52
1,21,13,1,1,36,24,12
1,21,14,1,1,24,55,-31
1,21,15,1,1,55,43,12
1,21,16,1,1,43,70,-27
1,21,17,1,1,70,55,15
1,21,18,1,1,55,84,-29
1,21,19,1,1,84,101,-17
1,21,20,1,1,101,89,12
1,21,21,1,1,89,96,-7
1,21,22,1,1,96,173,-77
1,22,0,1,1,97,74,23
1,22,1,1,1,74,76,-2
1,22,2,1,1,76,120,-44
1,22,3,1,1,120,40,80
1,22,4,1,1,40,37,3
1,22,5,1,1,37,45,-8
1,22,6,1,1,45,95,-50
1,22,7,1,1,95,151,-56
1,22,8,1,1,151,49,102
1,22,9,1,1,49,70,-21
1,22,10,1,1,70,61,9
1,22,11,1,1,61,116,-55
1,22,12,1,1,116,83,33
1,22,13,1,1,83,33,50
1,22,14,1,1,33,98,-65
1,22,15,1,1,98,112,-14
1,22,16,1,1,112,70,42
1,22,17,1,1,70,20,50
1,22,18,1,1,20,58,-38
1,22,19,1,1,58,48,10
1,22,20,1,1,48,54,-6
1,22,21,1,1,54,54,0
1,22,22,1,1,54,56,-2
1,23,0,1,1,111,69,42
1,23,1,1,1,69,54,15
1,23,2,1,1,54,69,-15
1,23,3,1,1,69,69,0
1,23,4,1,1,69,65,4
1,23,5,1,1,65,48,17
1,23,6,1,1,48,80,-32
1,23,7,1,1,80,126,-46
1,23,8,1,1,126,98,28
1,23,9,1,1,98,55,43
1,23,10,1,1,55,60,-5
1,23,11,1,1,60,132,-72
1,23,12,1,1,132,90,42
1,23,13,1,1,90,92,-2
1,23,14,1,1,92,94,-2
1,23,15,1,1,94,107,-13
1,23,16,1,1,107,67,40
1,23,17,1,1,67,42,25
1,23,18,1,1,42,70,-28
1,23,19,1,1,70,54,16
1,23,20,1,1,54,33,21
1,23,21,1,1,33,74,-41
1,23,22,1,1,74,47,27
1,0,0,2,1,216,218,-2
1,0,1,2,1,218,203,15
1,0,2,2,1,203,204,-1
1,0,3,2,1,204,223,-19
1,0,4,2,1,223,219,4
1,0,5,2,1,219,206,13
1,0,6,2,1,206,213,-7
1,0,7,2,1,213,212,1
1,0,8,2,1,212,209,3
1,0,9,2,1,209,206,3
1,0,10,2,1,206,205,1
1,0,11,2,1,205,205,0
1,0,12,2,1,205,207,-2
1,0,13,2,1,207,209,-2
1,0,14,2,1,209,212,-3
1,0,15,2,1,212,213,-1
1,0,16,2,1,213,209,4
1,0,17,2,1,209,214,-5
1,0,18,2,1,214,210,4
1,0,19,2,1,210,199,11
1,0,20,2,1,199,214,-15
1,0,21,2,1,214,223,-9
1,0,22,2,1,223,204,19
1,1,0,2,1,212,226,-14
1,1,1,2,1,226,219,7
1,1,2,2,1,219,213,6
1,1,3,2,1,213,222,-9
1,1,4,2,1,222,216,6
1,1,5,2,1,216,210,6
1,1,6,2,1,210,225,-15
1,1,7,2,1,225,223,2
1,1,8,2,1,223,219,4
1,1,9,2,1,219,213,6
1,1,10,2,1,213,210,3
1,1,11,2,1,210,209,1
1,1,12,2,1,209,212,-3
1,1,13,2,1,212,215,-3
1,1,14,2,1,215,218,-3
1,1,15,2,1,218,232,-14
1,1,16,2,1,232,216,16
1,1,17,2,1,216,213,3
1,1,18,2,1,213,209,4
1,1,19,2,1,209,204,5
1,1,20,2,1,204,221,-17
1,1,21,2,1,221,229,-8
1,1,22,2,1,229,208,21
1,2,0,2,1,218,232,-14
1,2,1,2,1,232,222,10
1,2,2,2,1,222,212,10
1,2,3,2,1,212,222,-10
1,2,4,2,1,222,223,-1
1,2,5,2,1,223,220,3
1,2,6,2,1,220,233,-13
1,2,7,2,1,233,187,46
1,2,8,2,1,187,182,5
1,2,9,2,1,182,175,7
1,2,10,2,1,175,170,5
1,2,11,2,1,170,168,2
1,2,12,2,1,168,171,-3
1,2,13,2,1,171,175,-4
1,2,14,2,1,175,178,-3
1,2,15,2,1,178,207,-29
1,2,16,2,1,207,208,-1
1,2,17,2,1,208,226,-18
1,2,18,2,1,226,228,-2
1,2,19,2,1,228,210,18
1,2,20,2,1,210,214,-4
1,2,21,2,1,214,226,-12
1,2,22,2,1,226,217,9
1,3,0,2,1,226,236,-10
1,3,1,2,1,236,224,12
1,3,2,2,1,224,220,4
1,3,3,2,1,220,238,-18
1,3,4,2,1,238,235,3
1,3,5,2,1,235,206,29
1,3,6,2,1,206,191,15
1,3,7,2,1,191,126,65
1,3,8,2,1,126,120,6
1,3,9,2,1,120,114,6
1,3,10,2,1,114,108,6
1,3,11,2,1,108,106,2
1,3,12,2,1,106,108,-2
1,3,13,2,1,108,112,-4
1,3,14,2,1,112,115,-3
1,3,15,2,1,115,149,-34
1,3,16,2,1,149,174,-25
1,3,17,2,1,174,223,-49
1,3,18,2,1,223,244,-21
1,3,19,2,1,244,222,22
1,3,20,2,1,222,214,8
1,3,21,2,1,214,224,-10
1,3,22,2,1,224,221,3
1,4,0,2,1,228,241,-13
1,4,1,2,1,241,234,7
1,4,2,2,1,234,234,0
1,4,3,2,1,234,251,-17
1,4,4,2,1,251,229,22
1,4,5,2,1,229,163,66
1,4,6,2,1,163,115,48
1,4,7,2,1,115,123,-8
1,4,8,2,1,123,119,4
1,4,9,2,1,119,115,4
1,4,10,2,1,115,110,5
1,4,11,2,1,110,109,1
1,4,12,2,1,109,110,-1
1,4,13,2,1,110,112,-2
1,4,14,2,1,112,114,-2
1,4,15,2,1,114,114,0
1,4,16,2,1,114,133,-19
1,4,17,2,1,133,187,-54
1,4,18,2,1,187,230,-43
1,4,19,2,1,230,231,-1
1,4,20,2,1,231,229,2
1,4,21,2,1,229,231,-2
1,4,22,2,1,231,218,13
1,5,0,2,1,234,246,-12
1,5,1,2,1,246,229,17
1,5,2,2,1,229,208,21
1,5,3,2,1,208,212,-4
1,5,4,2,1,212,191,21
1,5,5,2,1,191,136,55
1,5,6,2,1,136,97,39
1,5,7,2,1,97,138,-41
1,5,8,2,1,138,137,1
1,5,9,2,1,137,136,1
1,5,10,2,1,136,134,2
1,5,11,2,1,134,134,0
1,5,12,2,1,134,134,0
1,5,13,2,1,134,133,1
1,5,14,2,1,133,134,-1
1,5,15,2,1,134,132,2
1,5,16,2,1,132,124,8
1,5,17,2,1,124,152,-28
1,5,18,2,1,152,194,-42
1,5,19,2,1,194,213,-19
1,5,20,2,1,213,226,-13
1,5,21,2,1,226,234,-8
1,5,22,2,1,234,223,11
1,6,0,2,1,250,249,1
1,6,1,2,1,249,199,50
1,6,2,2,1,199,138,61
1,6,3,2,1,138,127,11
1,6,4,2,1,127,139,-12
1,6,5,2,1,139,149,-10
1,6,6,2,1,149,163,-14
1,6,7,2,1,163,164,-1
1,6,8,2,1,164,165,-1
1,6,9,2,1,165,166,-1
1,6,10,2,1,166,168,-2
1,6,11,2,1,168,168,0
1,6,12,2,1,168,167,1
1,6,13,2,1,167,165,2
1,6,14,2,1,165,164,1
1,6,15,2,1,164,176,-12
1,6,16,2,1,176,150,26
1,6,17,2,1,150,150,0
1,6,18,2,1,150,164,-14
1,6,19,2,1,164,169,-5
1,6,20,2,1,169,191,-22
1,6,21,2,1,191,226,-35
1,6,22,2,1,226,240,-14
1,7,0,2,1,256,266,-10
1,7,1,2,1,266,211,55
1,7,2,2,1,211,127,84
1,7,3,2,1,127,103,24
1,7,4,2,1,103,151,-48
1,7,5,2,1,151,217,-66
1,7,6,2,1,217,226,-9
1,7,7,2,1,226,222,4
1,7,8,2,1,222,231,-9
1,7,9,2,1,231,227,4
1,7,10,2,1,227,236,-9
1,7,11,2,1,236,245,-9
1,7,12,2,1,245,244,1
1,7,13,2,1,244,235,9
1,7,14,2,1,235,234,1
1,7,15,2,1,234,233,1
1,7,16,2,1,233,215,18
1,7,17,2,1,215,208,7
1,7,18,2,1,208,170,38
1,7,19,2,1,170,171,-1
1,7,20,2,1,171,212,-41
1,7,21,2,1,212,228,-16
1,7,22,2,1,228,256,-28
1,8,0,2,1,232,210,22
1,8,1,2,1,210,190,20
1,8,2,2,1,190,121,69
1,8,3,2,1,121,104,17
1,8,4,2,1,104,149,-45
1,8,5,2,1,149,179,-30
1,8,6,2,1,179,188,-9
1,8,7,2,1,188,191,-3
1,8,8,2,1,191,176,15
1,8,9,2,1,176,159,17
1,8,10,2,1,159,173,-14
1,8,11,2,1,173,185,-12
1,8,12,2,1,185,174,11
1,8,13,2,1,174,165,9
1,8,14,2,1,165,191,-26
1,8,15,2,1,191,193,-2
1,8,16,2,1,193,197,-4
1,8,17,2,1,197,187,10
1,8,18,2,1,187,140,47
1,8,19,2,1,140,150,-10
1,8,20,2,1,150,188,-38
1,8,21,2,1,188,194,-6
1,8,22,2,1,194,234,-40
1,9,0,2,1,210,113,97
1,9,1,2,1,113,129,-16
1,9,2,2,1,129,119,10
1,9,3,2,1,119,189,-70
1,9,4,2,1,189,173,16
1,9,5,2,1,173,167,6
1,9,6,2,1,167,224,-57
1,9,7,2,1,224,206,18
1,9,8,2,1,206,169,37
1,9,9,2,1,169,161,8
1,9,10,2,1,161,155,6
1,9,11,2,1,155,164,-9
1,9,12,2,1,164,160,4
1,9,13,2,1,160,151,9
1,9,14,2,1,151,182,-31
1,9,15,2,1,182,204,-22
1,9,16,2,1,204,215,-11
1,9,17,2,1,215,170,45
1,9,18,2,1,170,167,3
1,9,19,2,1,167,166,1
1,9,20,2,1,166,142,24
1,9,21,2,1,142,175,-33
1,9,22,2,1,175,209,-34
1,10,0,2,1,243,144,99
1,10,1,2,1,144,150,-6
1,10,2,2,1,150,199,-49
1,10,3,2,1,199,401,-202
1,10,4,2,1,401,293,108
1,10,5,2,1,293,346,-53
1,10,6,2,1,346,387,-41
1,10,7,2,1,387,358,29
1,10,8,2,1,358,306,52
1,10,9,2,1,306,326,-20
1,10,10,2,1,326,297,29
1,10,11,2,1,297,316,-19
1,10,12,2,1,316,332,-16
1,10,13,2,1,332,308,24
1,10,14,2,1,308,318,-10
1,10,15,2,1,318,387,-69
1,10,16,2,1,387,385,2
1,10,17,2,1,385,296,89
1,10,18,2,1,296,331,-35
1,10,19,2,1,331,328,3
1,10,20,2,1,328,251,77
1,10,21,2,1,251,272,-21
1,10,22,2,1,272,240,32
1,11,0,2,1,290,247,43
1,11,1,2,1,247,194,53
1,11,2,2,1,194,249,-55
1,11,3,2,1,249,490,-241
1,11,4,2,1,490,376,114
1,11,5,2,1,376,436,-60
1,11,6,2,1,436,454,-18
1,11,7,2,1,454,448,6
1,11,8,2,1,448,289,159
1,11,9,2,1,289,308,-19
1,11,10,2,1,308,293,15
1,11,11,2,1,293,322,-29
1,11,12,2,1,322,311,11
1,11,13,2,1,311,287,24
1,11,14,2,1,287,348,-61
1,11,15,2,1,348,493,-145
1,11,16,2,1,493,474,19
1,11,17,2,1,474,384,90
1,11,18,2,1,384,433,-49
1,11,19,2,1,433,431,2
1,11,20,2,1,431,366,65
1,11,21,2,1,366,372,-6
1,11,22,2,1,372,265,107
1,12,0,2,1,297,306,-9
1,12,1,2,1,306,214,92
1,12,2,2,1,214,249,-35
1,12,3,2,1,249,424,-175
1,12,4,2,1,424,454,-30
1,12,5,2,1,454,383,71
1,12,6,2,1,383,457,-74
1,12,7,2,1,457,481,-24
1,12,8,2,1,481,211,270
1,12,9,2,1,211,220,-9
1,12,10,2,1,220,208,12
1,12,11,2,1,208,241,-33
1,12,12,2,1,241,207,34
1,12,13,2,1,207,194,13
1,12,14,2,1,194,316,-122
1,12,15,2,1,316,500,-184
1,12,16,2,1,500,455,45
1,12,17,2,1,455,418,37
1,12,18,2,1,418,435,-17
1,12,19,2,1,435,395,40
1,12,20,2,1,395,385,10
1,12,21,2,1,385,396,-11
1,12,22,2,1,396,265,131
1,13,0,2,1,298,328,-30
1,13,1,2,1,328,225,103
1,13,2,2,1,225,245,-20
1,13,3,2,1,245,363,-118
1,13,4,2,1,363,507,-144
1,13,5,2,1,507,313,194
1,13,6,2,1,313,464,-151
1,13,7,2,1,464,485,-21
1,13,8,2,1,485,200,285
1,13,9,2,1,200,233,-33
1,13,10,2,1,233,186,47
1,13,11,2,1,186,219,-33
1,13,12,2,1,219,208,11
1,13,13,2,1,208,195,13
1,13,14,2,1,195,312,-117
1,13,15,2,1,312,490,-178
1,13,16,2,1,490,397,93
1,13,17,2,1,397,448,-51
1,13,18,2,1,448,426,22
1,13,19,2,1,426,330,96
1,13,20,2,1,330,383,-53
1,13,21,2,1,383,398,-15
1,13,22,2,1,398,288,110
1,14,0,2,1,298,338,-40
1,14,1,2,1,338,222,116
1,14,2,2,1,222,241,-19
1,14,3,2,1,241,383,-142
1,14,4,2,1,383,504,-121
1,14,5,2,1,504,307,197
1,14,6,2,1,307,468,-161
1,14,7,2,1,468,474,-6
1,14,8,2,1,474,183,291
1,14,9,2,1,183,245,-62
1,14,10,2,1,245,187,58
1,14,11,2,1,187,214,-27
1,14,12,2,1,214,204,10
1,14,13,2,1,204,190,14
1,14,14,2,1,190,315,-125
1,14,15,2,1,315,496,-181
1,14,16,2,1,496,351,145
1,14,17,2,1,351,477,-126
1,14,18,2,1,477,436,41
1,14,19,2,1,436,302,134
1,14,20,2,1,302,393,-91
1,14,21,2,1,393,387,6
1,14,22,2,1,387,295,92
1,15,0,2,1,254,283,-29
1,15,1,2,1,283,182,101
1,15,2,2,1,182,238,-56
1,15,3,2,1,238,426,-188
1,15,4,2,1,426,499,-73
1,15,5,2,1,499,294,205
1,15,6,2,1,294,485,-191
1,15,7,2,1,485,477,8
1,15,8,2,1,477,190,287
1,15,9,2,1,190,235,-45
1,15,10,2,1,235,188,47
1,15,11,2,1,188,232,-44
1,15,12,2,1,232,204,28
1,15,13,2,1,204,184,20
1,15,14,2,1,184,334,-150
1,15,15,2,1,334,509,-175
1,15,16,2,1,509,341,168
1,15,17,2,1,341,436,-95
1,15,18,2,1,436,440,-4
1,15,19,2,1,440,305,135
1,15,20,2,1,305,366,-61
1,15,21,2,1,366,303,63
1,15,22,2,1,303,281,22
1,16,0,2,1,216,189,27
1,16,1,2,1,189,138,51
1,16,2,2,1,138,265,-127
1,16,3,2,1,265,426,-161
1,16,4,2,1,426,440,-14
1,16,5,2,1,440,242,198
1,16,6,2,1,242,479,-237
1,16,7,2,1,479,435,44
1,16,8,2,1,435,178,257
1,16,9,2,1,178,227,-49
1,16,10,2,1,227,161,66
1,16,11,2,1,161,210,-49
1,16,12,2,1,210,195,15
1,16,13,2,1,195,159,36
1,16,14,2,1,159,314,-155
1,16,15,2,1,314,496,-182
1,16,16,2,1,496,331,165
1,16,17,2,1,331,264,67
1,16,18,2,1,264,377,-113
1,16,19,2,1,377,330,47
1,16,20,2,1,330,334,-4
1,16,21,2,1,334,210,124
1,16,22,2,1,210,295,-85
1,17,0,2,1,230,167,63
1,17,1,2,1,167,139,28
1,17,2,2,1,139,330,-191
1,17,3,2,1,330,445,-115
1,17,4,2,1,445,370,75
1,17,5,2,1,370,181,189
1,17,6,2,1,181,359,-178
1,17,7,2,1,359,308,51
1,17,8,2,1,308,144,164
1,17,9,2,1,144,185,-41
1,17,10,2,1,185,151,34
1,17,11,2,1,151,190,-39
1,17,12,2,1,190,158,32
1,17,13,2,1,158,164,-6
1,17,14,2,1,164,222,-58
1,17,15,2,1,222,309,-87
1,17,16,2,1,309,319,-10
1,17,17,2,1,319,148,171
1,17,18,2,1,148,285,-137
1,17,19,2,1,285,374,-89
1,17,20,2,1,374,330,44
1,17,21,2,1,330,174,156
1,17,22,2,1,174,276,-102
1,18,0,2,1,312,182,130
1,18,1,2,1,182,180,2
1,18,2,2,1,180,418,-238
1,18,3,2,1,418,368,50
1,18,4,2,1,368,259,109
1,18,5,2,1,259,141,118
1,18,6,2,1,141,227,-86
1,18,7,2,1,227,299,-72
1,18,8,2,1,299,196,103
1,18,9,2,1,196,233,-37
1,18,10,2,1,233,215,18
1,18,11,2,1,215,265,-50
1,18,12,2,1,265,232,33
1,18,13,2,1,232,213,19
1,18,14,2,1,213,147,66
1,18,15,2,1,147,255,-108
1,18,16,2,1,255,366,-111
1,18,17,2,1,366,142,224
1,18,18,2,1,142,188,-46
1,18,19,2,1,188,377,-189
1,18,20,2,1,377,243,134
1,18,21,2,1,243,155,88
1,18,22,2,1,155,322,-167
1,19,0,2,1,380,166,214
1,19,1,2,1,166,172,-6
1,19,2,2,1,172,464,-292
1,19,3,2,1,464,227,237
1,19,4,2,1,227,123,104
1,19,5,2,1,123,145,-22
1,19,6,2,1,145,278,-133
1,19,7,2,1,278,431,-153
1,19,8,2,1,431,255,176
1,19,9,2,1,255,311,-56
1,19,10,2,1,311,251,60
1,19,11,2,1,251,310,-59
1,19,12,2,1,310,303,7
1,19,13,2,1,303,194,109
1,19,14,2,1,194,140,54
1,19,15,2,1,140,326,-186
1,19,16,2,1,326,328,-2
1,19,17,2,1,328,117,211
1,19,18,2,1,117,140,-23
1,19,19,2,1,140,340,-200
1,19,20,2,1,340,124,216
1,19,21,2,1,124,129,-5
1,19,22,2,1,129,412,-283
1,20,0,2,1,393,148,245
1,20,1,2,1,148,157,-9
1,20,2,2,1,157,465,-308
1,20,3,2,1,465,159,306
1,20,4,2,1,159,75,84
1,20,5,2,1,75,131,-56
1,20,6,2,1,131,263,-132
1,20,7,2,1,263,389,-126
1,20,8,2,1,389,173,216
1,20,9,2,1,173,179,-6
1,20,10,2,1,179,164,15
1,20,11,2,1,164,240,-76
1,20,12,2,1,240,182,58
1,20,13,2,1,182,108,74
1,20,14,2,1,108,130,-22
1,20,15,2,1,130,181,-51
1,20,16,2,1,181,190,-9
1,20,17,2,1,190,103,87
1,20,18,2,1,103,161,-58
1,20,19,2,1,161,264,-103
1,20,20,2,1,264,134,130
1,20,21,2,1,134,151,-17
1,20,22,2,1,151,384,-233
1,21,0,2,1,300,146,154
1,21,1,2,1,146,165,-19
1,21,2,2,1,165,355,-190
1,21,3,2,1,355,102,253
1,21,4,2,1,102,69,33
1,21,5,2,1,69,103,-34
1,21,6,2,1,103,179,-76
1,21,7,2,1,179,296,-117
1,21,8,2,1,296,90,206
1,21,9,2,1,90,96,-6
1,21,10,2,1,96,105,-9
1,21,11,2,1,105,204,-99
1,21,12,2,1,204,119,85
1,21,13,2,1,119,57,62
1,21,14,2,1,57,153,-96
1,21,15,2,1,153,155,-2
1,21,16,2,1,155,140,15
1,21,17,2,1,140,75,65
1,21,18,2,1,75,142,-67
1,21,19,2,1,142,149,-7
1,21,20,2,1,149,143,6
1,21,21,2,1,143,150,-7
1,21,22,2,1,150,229,-79
1,22,0,2,1,208,143,65
1,22,1,2,1,143,130,13
1,22,2,2,1,130,189,-59
1,22,3,2,1,189,109,80
1,22,4,2,1,109,102,7
1,22,5,2,1,102,93,9
1,22,6,2,1,93,175,-82
1,22,7,2,1,175,277,-102
1,22,8,2,1,277,147,130
1,22,9,2,1,147,125,22
1,22,10,2,1,125,121,4
1,22,11,2,1,121,248,-127
1,22,12,2,1,248,173,75
1,22,13,2,1,173,125,48
1,22,14,2,1,125,192,-67
1,22,15,2,1,192,219,-27
1,22,16,2,1,219,137,82
1,22,17,2,1,137,62,75
1,22,18,2,1,62,128,-66
1,22,19,2,1,128,102,26
1,22,20,2,1,102,87,15
1,22,21,2,1,87,128,-41
1,22,22,2,1,128,103,25
1,0,0,3,1,322,333,-11
1,0,1,3,1,333,315,18
1,0,2,3,1,315,311,4
1,0,3,3,1,311,333,-22
1,0,4,3,1,333,327,6
1,0,5,3,1,327,314,13
1,0,6,3,1,314,331,-17
1,0,7,3,1,331,327,4
1,0,8,3,1,327,322,5
1,0,9,3,1,322,315,7
1,0,10,3,1,315,312,3
1,0,11,3,1,312,311,1
1,0,12,3,1,311,315,-4
1,0,13,3,1,315,319,-4
1,0,14,3,1,319,323,-4
1,0,15,3,1,323,330,-7
1,0,16,3,1,330,318,12
1,0,17,3,1,318,323,-5
1,0,18,3,1,323,317,6
1,0,19,3,1,317,302,15
1,0,20,3,1,302,324,-22
1,0,21,3,1,324,338,-14
1,0,22,3,1,338,310,28
1,1,0,3,1,324,343,-19
1,1,1,3,1,343,329,14
1,1,2,3,1,329,318,11
1,1,3,3,1,318,334,-16
1,1,4,3,1,334,331,3
1,1,5,3,1,331,322,9
1,1,6,3,1,322,340,-18
1,1,7,3,1,340,295,45
1,1,8,3,1,295,288,7
1,1,9,3,1,288,279,9
1,1,10,3,1,279,273,6
1,1,11,3,1,273,271,2
1,1,12,3,1,271,275,-4
1,1,13,3,1,275,280,-5
1,1,14,3,1,280,285,-5
1,1,15,3,1,285,322,-37
1,1,16,3,1,322,315,7
1,1,17,3,1,315,330,-15
1,1,18,3,1,330,330,0
1,1,19,3,1,330,311,19
1,1,20,3,1,311,325,-14
1,1,21,3,1,325,340,-15
1,1,22,3,1,340,319,21
1,2,0,3,1,332,351,-19
1,2,1,3,1,351,336,15
1,2,2,3,1,336,327,9
1,2,3,3,1,327,348,-21
1,2,4,3,1,348,343,5
1,2,5,3,1,343,314,29
1,2,6,3,1,314,309,5
1,2,7,3,1,309,241,68
1,2,8,3,1,241,233,8
1,2,9,3,1,233,223,10
1,2,10,3,1,223,215,8
1,2,11,3,1,215,212,3
1,2,12,3,1,212,216,-4
1,2,13,3,1,216,222,-6
1,2,14,3,1,222,226,-4
1,2,15,3,1,226,266,-40
1,2,16,3,1,266,283,-17
1,2,17,3,1,283,332,-49
1,2,18,3,1,332,351,-19
1,2,19,3,1,351,325,26
1,2,20,3,1,325,324,1
1,2,21,3,1,324,339,-15
1,2,22,3,1,339,327,12
1,3,0,3,1,340,358,-18
1,3,1,3,1,358,344,14
1,3,2,3,1,344,339,5
1,3,3,3,1,339,363,-24
1,3,4,3,1,363,344,19
1,3,5,3,1,344,275,69
1,3,6,3,1,275,230,45
1,3,7,3,1,230,195,35
1,3,8,3,1,195,188,7
1,3,9,3,1,188,181,7
1,3,10,3,1,181,173,8
1,3,11,3,1,173,171,2
1,3,12,3,1,171,173,-2
1,3,13,3,1,173,177,-4
1,3,14,3,1,177,181,-4
1,3,15,3,1,181,204,-23
1,3,16,3,1,204,232,-28
1,3,17,3,1,232,304,-72
1,3,18,3,1,304,351,-47
1,3,19,3,1,351,338,13
1,3,20,3,1,338,333,5
1,3,21,3,1,333,342,-9
1,3,22,3,1,342,329,13
1,4,0,3,1,348,365,-17
1,4,1,3,1,365,343,22
1,4,2,3,1,343,323,20
1,4,3,3,1,323,338,-15
1,4,4,3,1,338,311,27
1,4,5,3,1,311,230,81
1,4,6,3,1,230,173,57
1,4,7,3,1,173,192,-19
1,4,8,3,1,192,188,4
1,4,9,3,1,188,184,4
1,4,10,3,1,184,179,5
1,4,11,3,1,179,178,1
1,4,12,3,1,178,179,-1
1,4,13,3,1,179,180,-1
1,4,14,3,1,180,182,-2
1,4,15,3,1,182,191,-9
1,4,16,3,1,191,199,-8
1,4,17,3,1,199,258,-59
1,4,18,3,1,258,317,-59
1,4,19,3,1,317,328,-11
1,4,20,3,1,328,336,-8
1,4,21,3,1,336,347,-11
1,4,22,3,1,347,333,14
1,5,0,3,1,364,371,-7
1,5,1,3,1,371,319,52
1,5,2,3,1,319,257,62
1,5,3,3,1,257,252,5
1,5,4,3,1,252,248,4
1,5,5,3,1,248,218,30
1,5,6,3,1,218,202,16
1,5,7,3,1,202,233,-31
1,5,8,3,1,233,233,0
1,5,9,3,1,233,233,0
1,5,10,3,1,233,233,0
1,5,11,3,1,233,233,0
1,5,12,3,1,233,232,1
1,5,13,3,1,232,230,2
1,5,14,3,1,230,230,0
1,5,15,3,1,230,231,-1
1,5,16,3,1,231,208,23
1,5,17,3,1,208,231,-23
1,5,18,3,1,231,271,-40
1,5,19,3,1,271,285,-14
1,5,20,3,1,285,310,-25
1,5,21,3,1,310,344,-34
1,5,22,3,1,344,348,-4
1,6,0,3,1,376,390,-14
1,6,1,3,1,390,320,70
1,6,2,3,1,320,216,104
1,6,3,3,1,216,190,26
1,6,4,3,1,190,233,-43
1,6,5,3,1,233,284,-51
1,6,6,3,1,284,284,0
1,6,7,3,1,284,291,-7
1,6,8,3,1,291,300,-9
1,6,9,3,1,300,296,4
1,6,10,3,1,296,305,-9
1,6,11,3,1,305,314,-9
1,6,12,3,1,314,313,1
1,6,13,3,1,313,303,10
1,6,14,3,1,303,302,1
1,6,15,3,1,302,310,-8
1,6,16,3,1,310,281,29
1,6,17,3,1,281,279,2
1,6,18,3,1,279,257,22
1,6,19,3,1,257,268,-11
1,6,20,3,1,268,319,-51
1,6,21,3,1,319,344,-25
1,6,22,3,1,344,371,-27
1,7,0,3,1,362,335,27
1,7,1,3,1,335,280,55
1,7,2,3,1,280,170,110
1,7,3,3,1,170,144,26
1,7,4,3,1,144,206,-62
1,7,5,3,1,206,261,-55
1,7,6,3,1,261,293,-32
1,7,7,3,1,293,286,7
1,7,8,3,1,286,272,14
1,7,9,3,1,272,256,16
1,7,10,3,1,256,272,-16
1,7,11,3,1,272,284,-12
1,7,12,3,1,284,272,12
1,7,13,3,1,272,262,10
1,7,14,3,1,262,287,-25
1,7,15,3,1,287,292,-5
1,7,16,3,1,292,281,11
1,7,17,3,1,281,266,15
1,7,18,3,1,266,217,49
1,7,19,3,1,217,222,-5
1,7,20,3,1,222,272,-50
1,7,21,3,1,272,304,-32
1,7,22,3,1,304,359,-55
1,8,0,3,1,336,254,82
1,8,1,3,1,254,250,4
1,8,2,3,1,250,197,53
1,8,3,3,1,197,252,-55
1,8,4,3,1,252,267,-15
1,8,5,3,1,267,302,-35
1,8,6,3,1,302,345,-43
1,8,7,3,1,345,333,12
1,8,8,3,1,333,304,29
1,8,9,3,1,304,291,13
1,8,10,3,1,291,292,-1
1,8,11,3,1,292,310,-18
1,8,12,3,1,310,306,4
1,8,13,3,1,306,289,17
1,8,14,3,1,289,320,-31
1,8,15,3,1,320,338,-18
1,8,16,3,1,338,346,-8
1,8,17,3,1,346,299,47
1,8,18,3,1,299,260,39
1,8,19,3,1,260,265,-5
1,8,20,3,1,265,270,-5
1,8,21,3,1,270,293,-23
1,8,22,3,1,293,340,-47
1,9,0,3,1,349,213,136
1,9,1,3,1,213,219,-6
1,9,2,3,1,219,242,-23
1,9,3,3,1,242,442,-200
1,9,4,3,1,442,348,94
1,9,5,3,1,348,390,-42
1,9,6,3,1,390,454,-64
1,9,7,3,1,454,422,32
1,9,8,3,1,422,347,75
1,9,9,3,1,347,355,-8
1,9,10,3,1,355,333,22
1,9,11,3,1,333,355,-22
1,9,12,3,1,355,360,-5
1,9,13,3,1,360,335,25
1,9,14,3,1,335,371,-36
1,9,15,3,1,371,446,-75
1,9,16,3,1,446,451,-5
1,9,17,3,1,451,354,97
1,9,18,3,1,354,378,-24
1,9,19,3,1,378,379,-1
1,9,20,3,1,379,311,68
1,9,21,3,1,311,348,-37
1,9,22,3,1,348,343,5
1,10,0,3,1,394,291,103
1,10,1,3,1,291,254,37
1,10,2,3,1,254,325,-71
1,10,3,3,1,325,638,-313
1,10,4,3,1,638,494,144
1,10,5,3,1,494,559,-65
1,10,6,3,1,559,611,-52
1,10,7,3,1,611,590,21
1,10,8,3,1,590,417,173
1,10,9,3,1,417,440,-23
1,10,10,3,1,440,412,28
1,10,11,3,1,412,447,-35
1,10,12,3,1,447,443,4
1,10,13,3,1,443,411,32
1,10,14,3,1,411,477,-66
1,10,15,3,1,477,638,-161
1,10,16,3,1,638,623,15
1,10,17,3,1,623,496,127
1,10,18,3,1,496,553,-57
1,10,19,3,1,553,546,7
1,10,20,3,1,546,448,98
1,10,21,3,1,448,471,-23
1,10,22,3,1,471,371,100
1,11,0,3,1,436,406,30
1,11,1,3,1,406,304,102
1,11,2,3,1,304,372,-68
1,11,3,3,1,372,677,-305
1,11,4,3,1,677,629,48
1,11,5,3,1,629,606,23
1,11,6,3,1,606,687,-81
1,11,7,3,1,687,697,-10
1,11,8,3,1,697,389,308
1,11,9,3,1,389,414,-25
1,11,10,3,1,414,386,28
1,11,11,3,1,386,432,-46
1,11,12,3,1,432,407,25
1,11,13,3,1,407,378,29
1,11,14,3,1,378,505,-127
1,11,15,3,1,505,742,-237
1,11,16,3,1,742,691,51
1,11,17,3,1,691,602,89
1,11,18,3,1,602,646,-44
1,11,19,3,1,646,608,38
1,11,20,3,1,608,554,54
1,11,21,3,1,554,569,-15
1,11,22,3,1,569,399,170
1,12,0,3,1,449,475,-26
1,12,1,3,1,475,329,146
1,12,2,3,1,329,371,-42
1,12,3,3,1,371,600,-229
1,12,4,3,1,600,708,-108
1,12,5,3,1,708,526,182
1,12,6,3,1,526,688,-162
1,12,7,3,1,688,717,-29
1,12,8,3,1,717,311,406
1,12,9,3,1,311,347,-36
1,12,10,3,1,347,301,46
1,12,11,3,1,301,350,-49
1,12,12,3,1,350,319,31
1,12,13,3,1,319,298,21
1,12,14,3,1,298,471,-173
1,12,15,3,1,471,741,-270
1,12,16,3,1,741,635,106
1,12,17,3,1,635,648,-13
1,12,18,3,1,648,648,0
1,12,19,3,1,648,548,100
1,12,20,3,1,548,580,-32
1,12,21,3,1,580,597,-17
1,12,22,3,1,597,419,178
1,13,0,3,1,444,497,-53
1,13,1,3,1,497,332,165
1,13,2,3,1,332,364,-32
1,13,3,3,1,364,570,-206
1,13,4,3,1,570,757,-187
1,13,5,3,1,757,477,280
1,13,6,3,1,477,701,-224
1,13,7,3,1,701,723,-22
1,13,8,3,1,723,283,440
1,13,9,3,1,283,351,-68
1,13,10,3,1,351,280,71
1,13,11,3,1,280,324,-44
1,13,12,3,1,324,300,24
1,13,13,3,1,300,281,19
1,13,14,3,1,281,472,-191
1,13,15,3,1,472,745,-273
1,13,16,3,1,745,568,177
1,13,17,3,1,568,695,-127
1,13,18,3,1,695,649,46
1,13,19,3,1,649,479,170
1,13,20,3,1,479,581,-102
1,13,21,3,1,581,584,-3
1,13,22,3,1,584,429,155
1,14,0,3,1,406,452,-46
1,14,1,3,1,452,297,155
1,14,2,3,1,297,360,-63
1,14,3,3,1,360,602,-242
1,14,4,3,1,602,753,-151
1,14,5,3,1,753,437,316
1,14,6,3,1,437,716,-279
1,14,7,3,1,716,713,3
1,14,8,3,1,713,290,423
1,14,9,3,1,290,362,-72
1,14,10,3,1,362,281,81
1,14,11,3,1,281,341,-60
1,14,12,3,1,341,316,25
1,14,13,3,1,316,288,28
1,14,14,3,1,288,489,-201
1,14,15,3,1,489,750,-261
1,14,16,3,1,750,521,229
1,14,17,3,1,521,666,-145
1,14,18,3,1,666,653,13
1,14,19,3,1,653,458,195
1,14,20,3,1,458,561,-103
1,14,21,3,1,561,504,57
1,14,22,3,1,504,435,69
1,15,0,3,1,362,358,4
1,15,1,3,1,358,245,113
1,15,2,3,1,245,384,-139
1,15,3,3,1,384,633,-249
1,15,4,3,1,633,690,-57
1,15,5,3,1,690,406,284
1,15,6,3,1,406,716,-310
1,15,7,3,1,716,673,43
1,15,8,3,1,673,261,412
1,15,9,3,1,261,345,-84
1,15,10,3,1,345,255,90
1,15,11,3,1,255,315,-60
1,15,12,3,1,315,287,28
1,15,13,3,1,287,245,42
1,15,14,3,1,245,474,-229
1,15,15,3,1,474,751,-277
1,15,16,3,1,751,502,249
1,15,17,3,1,502,511,-9
1,15,18,3,1,511,600,-89
1,15,19,3,1,600,479,121
1,15,20,3,1,479,532,-53
1,15,21,3,1,532,396,136
1,15,22,3,1,396,436,-40
1,16,0,3,1,338,281,57
1,16,1,3,1,281,214,67
1,16,2,3,1,214,449,-235
1,16,3,3,1,449,664,-215
1,16,4,3,1,664,619,45
1,16,5,3,1,619,311,308
1,16,6,3,1,311,607,-296
1,16,7,3,1,607,547,60
1,16,8,3,1,547,251,296
1,16,9,3,1,251,302,-51
1,16,10,3,1,302,245,57
1,16,11,3,1,245,317,-72
1,16,12,3,1,317,270,47
1,16,13,3,1,270,262,8
1,16,14,3,1,262,396,-134
1,16,15,3,1,396,563,-167
1,16,16,3,1,563,489,74
1,16,17,3,1,489,337,152
1,16,18,3,1,337,502,-165
1,16,19,3,1,502,530,-28
1,16,20,3,1,530,498,32
1,16,21,3,1,498,291,207
1,16,22,3,1,291,416,-125
1,17,0,3,1,420,257,163
1,17,1,3,1,257,243,14
1,17,2,3,1,243,564,-321
1,17,3,3,1,564,575,-11
1,17,4,3,1,575,450,125
1,17,5,3,1,450,253,197
1,17,6,3,1,253,458,-205
1,17,7,3,1,458,495,-37
1,17,8,3,1,495,267,228
1,17,9,3,1,267,343,-76
1,17,10,3,1,343,282,61
1,17,11,3,1,282,348,-66
1,17,12,3,1,348,315,33
1,17,13,3,1,315,274,41
1,17,14,3,1,274,287,-13
1,17,15,3,1,287,497,-210
1,17,16,3,1,497,527,-30
1,17,17,3,1,527,217,310
1,17,18,3,1,217,348,-131
1,17,19,3,1,348,551,-203
1,17,20,3,1,551,409,142
1,17,21,3,1,409,248,161
1,17,22,3,1,248,477,-229
1,18,0,3,1,502,258,244
1,18,1,3,1,258,248,10
1,18,2,3,1,248,648,-400
1,18,3,3,1,648,465,183
1,18,4,3,1,465,302,163
1,18,5,3,1,302,214,88
1,18,6,3,1,214,406,-192
1,18,7,3,1,406,543,-137
1,18,8,3,1,543,328,215
1,18,9,3,1,328,386,-58
1,18,10,3,1,386,335,51
1,18,11,3,1,335,417,-82
1,18,12,3,1,417,378,39
1,18,13,3,1,378,297,81
1,18,14,3,1,297,222,75
1,18,15,3,1,222,393,-171
1,18,16,3,1,393,486,-93
1,18,17,3,1,486,190,296
1,18,18,3,1,190,265,-75
1,18,19,3,1,265,540,-275
1,18,20,3,1,540,288,252
1,18,21,3,1,288,210,78
1,18,22,3,1,210,533,-323
1,19,0,3,1,583,238,345
1,19,1,3,1,238,261,-23
1,19,2,3,1,261,699,-438
1,19,3,3,1,699,289,410
1,19,4,3,1,289,155,134
1,19,5,3,1,155,203,-48
1,19,6,3,1,203,362,-159
1,19,7,3,1,362,576,-214
1,19,8,3,1,576,296,280
1,19,9,3,1,296,337,-41
1,19,10,3,1,337,295,42
1,19,11,3,1,295,398,-103
1,19,12,3,1,398,339,59
1,19,13,3,1,339,218,121
1,19,14,3,1,218,195,23
1,19,15,3,1,195,369,-174
1,19,16,3,1,369,398,-29
1,19,17,3,1,398,172,226
1,19,18,3,1,172,224,-52
1,19,19,3,1,224,441,-217
1,19,20,3,1,441,213,228
1,19,21,3,1,213,225,-12
1,19,22,3,1,225,585,-360
1,20,0,3,1,490,222,268
1,20,1,3,1,222,233,-11
1,20,2,3,1,233,585,-352
1,20,3,3,1,585,199,386
1,20,4,3,1,199,112,87
1,20,5,3,1,112,176,-64
1,20,6,3,1,176,358,-182
1,20,7,3,1,358,540,-182
1,20,8,3,1,540,222,318
1,20,9,3,1,222,249,-27
1,20,10,3,1,249,225,24
1,20,11,3,1,225,356,-131
1,20,12,3,1,356,265,91
1,20,13,3,1,265,141,124
1,20,14,3,1,141,228,-87
1,20,15,3,1,228,293,-65
1,20,16,3,1,293,260,33
1,20,17,3,1,260,123,137
1,20,18,3,1,123,219,-96
1,20,19,3,1,219,312,-93
1,20,20,3,1,312,188,124
1,20,21,3,1,188,205,-17
1,20,22,3,1,205,440,-235
1,21,0,3,1,411,215,196
1,21,1,3,1,215,219,-4
1,21,2,3,1,219,424,-205
1,21,3,3,1,424,171,253
1,21,4,3,1,171,134,37
1,21,5,3,1,134,151,-17
1,21,6,3,1,151,259,-108
1,21,7,3,1,259,422,-163
1,21,8,3,1,422,188,234
1,21,9,3,1,188,151,37
1,21,10,3,1,151,165,-14
1,21,11,3,1,165,336,-171
1,21,12,3,1,336,209,127
1,21,13,3,1,209,149,60
1,21,14,3,1,149,247,-98
1,21,15,3,1,247,262,-15
1,21,16,3,1,262,207,55
1,21,17,3,1,207,117,90
1,21,18,3,1,117,212,-95
1,21,19,3,1,212,203,9
1,21,20,3,1,203,176,27
1,21,21,3,1,176,224,-48
1,21,22,3,1,224,276,-52
1,0,0,4,1,434,450,-16
1,0,1,4,1,450,425,25
1,0,2,4,1,425,416,9
1,0,3,4,1,416,445,-29
1,0,4,4,1,445,442,3
1,0,5,4,1,442,426,16
1,0,6,4,1,426,446,-20
1,0,7,4,1,446,399,47
1,0,8,4,1,399,391,8
1,0,9,4,1,391,381,10
1,0,10,4,1,381,375,6
1,0,11,4,1,375,373,2
1,0,12,4,1,373,378,-5
1,0,13,4,1,378,384,-6
1,0,14,4,1,384,390,-6
1,0,15,4,1,390,420,-30
1,0,16,4,1,420,417,3
1,0,17,4,1,417,440,-23
1,0,18,4,1,440,438,2
1,0,19,4,1,438,409,29
1,0,20,4,1,409,428,-19
1,0,21,4,1,428,449,-21
1,0,22,4,1,449,421,28
1,1,0,4,1,438,462,-24
1,1,1,4,1,462,443,19
1,1,2,4,1,443,433,10
1,1,3,4,1,433,460,-27
1,1,4,4,1,460,451,9
1,1,5,4,1,451,416,35
1,1,6,4,1,416,416,0
1,1,7,4,1,416,349,67
1,1,8,4,1,349,339,10
1,1,9,4,1,339,327,12
1,1,10,4,1,327,318,9
1,1,11,4,1,318,315,3
1,1,12,4,1,315,320,-5
1,1,13,4,1,320,327,-7
1,1,14,4,1,327,333,-6
1,1,15,4,1,333,381,-48
1,1,16,4,1,381,390,-9
1,1,17,4,1,390,436,-46
1,1,18,4,1,436,453,-17
1,1,19,4,1,453,426,27
1,1,20,4,1,426,435,-9
1,1,21,4,1,435,453,-18
1,1,22,4,1,453,429,24
1,2,0,4,1,446,473,-27
1,2,1,4,1,473,456,17
1,2,2,4,1,456,446,10
1,2,3,4,1,446,473,-27
1,2,4,4,1,473,452,21
1,2,5,4,1,452,383,69
1,2,6,4,1,383,348,35
1,2,7,4,1,348,310,38
1,2,8,4,1,310,301,9
1,2,9,4,1,301,290,11
1,2,10,4,1,290,280,10
1,2,11,4,1,280,277,3
1,2,12,4,1,277,281,-4
1,2,13,4,1,281,287,-6
1,2,14,4,1,287,292,-5
1,2,15,4,1,292,321,-29
1,2,16,4,1,321,341,-20
1,2,17,4,1,341,413,-72
1,2,18,4,1,413,458,-45
1,2,19,4,1,458,441,17
1,2,20,4,1,441,443,-2
1,2,21,4,1,443,457,-14
1,2,22,4,1,457,435,22
1,3,0,4,1,460,482,-22
1,3,1,4,1,482,453,29
1,3,2,4,1,453,428,25
1,3,3,4,1,428,450,-22
1,3,4,4,1,450,426,24
1,3,5,4,1,426,342,84
1,3,6,4,1,342,288,54
1,3,7,4,1,288,264,24
1,3,8,4,1,264,257,7
1,3,9,4,1,257,250,7
1,3,10,4,1,250,242,8
1,3,11,4,1,242,240,2
1,3,12,4,1,240,242,-2
1,3,13,4,1,242,245,-3
1,3,14,4,1,245,249,-4
1,3,15,4,1,249,281,-32
1,3,16,4,1,281,298,-17
1,3,17,4,1,298,375,-77
1,3,18,4,1,375,438,-63
1,3,19,4,1,438,435,3
1,3,20,4,1,435,440,-5
1,3,21,4,1,440,458,-18
1,3,22,4,1,458,444,14
1,4,0,4,1,478,490,-12
1,4,1,4,1,490,433,57
1,4,2,4,1,433,372,61
1,4,3,4,1,372,378,-6
1,4,4,4,1,378,368,10
1,4,5,4,1,368,312,56
1,4,6,4,1,312,278,34
1,4,7,4,1,278,287,-9
1,4,8,4,1,287,284,3
1,4,9,4,1,284,281,3
1,4,10,4,1,281,278,3
1,4,11,4,1,278,277,1
1,4,12,4,1,277,277,0
1,4,13,4,1,277,277,0
1,4,14,4,1,277,278,-1
1,4,15,4,1,278,290,-12
1,4,16,4,1,290,283,7
1,4,17,4,1,283,337,-54
1,4,18,4,1,337,394,-57
1,4,19,4,1,394,400,-6
1,4,20,4,1,400,420,-20
1,4,21,4,1,420,457,-37
1,4,22,4,1,457,458,-1
1,5,0,4,1,490,512,-22
1,5,1,4,1,512,440,72
1,5,2,4,1,440,335,105
1,5,3,4,1,335,315,20
1,5,4,4,1,315,342,-27
1,5,5,4,1,342,353,-11
1,5,6,4,1,353,323,30
1,5,7,4,1,323,360,-37
1,5,8,4,1,360,368,-8
1,5,9,4,1,368,363,5
1,5,10,4,1,363,370,-7
1,5,11,4,1,370,379,-9
1,5,12,4,1,379,378,1
1,5,13,4,1,378,368,10
1,5,14,4,1,368,368,0
1,5,15,4,1,368,365,3
1,5,16,4,1,365,339,26
1,5,17,4,1,339,360,-21
1,5,18,4,1,360,364,-4
1,5,19,4,1,364,384,-20
1,5,20,4,1,384,438,-54
1,5,21,4,1,438,462,-24
1,5,22,4,1,462,479,-17
1,6,0,4,1,482,459,23
1,6,1,4,1,459,389,70
1,6,2,4,1,389,259,130
1,6,3,4,1,259,231,28
1,6,4,4,1,231,288,-57
1,6,5,4,1,288,328,-40
1,6,6,4,1,328,351,-23
1,6,7,4,1,351,355,-4
1,6,8,4,1,355,341,14
1,6,9,4,1,341,325,16
1,6,10,4,1,325,341,-16
1,6,11,4,1,341,353,-12
1,6,12,4,1,353,341,12
1,6,13,4,1,341,330,11
1,6,14,4,1,330,355,-25
1,6,15,4,1,355,369,-14
1,6,16,4,1,369,347,22
1,6,17,4,1,347,337,10
1,6,18,4,1,337,304,33
1,6,19,4,1,304,319,-15
1,6,20,4,1,319,379,-60
1,6,21,4,1,379,420,-41
1,6,22,4,1,420,474,-54
1,7,0,4,1,466,379,87
1,7,1,4,1,379,340,39
1,7,2,4,1,340,246,94
1,7,3,4,1,246,292,-46
1,7,4,4,1,292,324,-32
1,7,5,4,1,324,384,-60
1,7,6,4,1,384,450,-66
1,7,7,4,1,450,428,22
1,7,8,4,1,428,400,28
1,7,9,4,1,400,388,12
1,7,10,4,1,388,391,-3
1,7,11,4,1,391,409,-18
1,7,12,4,1,409,404,5
1,7,13,4,1,404,386,18
1,7,14,4,1,386,416,-30
1,7,15,4,1,416,437,-21
1,7,16,4,1,437,430,7
1,7,17,4,1,430,378,52
1,7,18,4,1,378,337,41
1,7,19,4,1,337,337,0
1,7,20,4,1,337,354,-17
1,7,21,4,1,354,403,-49
1,7,22,4,1,403,465,-62
1,8,0,4,1,475,354,121
1,8,1,4,1,354,340,14
1,8,2,4,1,340,320,20
1,8,3,4,1,320,505,-185
1,8,4,4,1,505,442,63
1,8,5,4,1,442,525,-83
1,8,6,4,1,525,575,-50
1,8,7,4,1,575,549,26
1,8,8,4,1,549,482,67
1,8,9,4,1,482,485,-3
1,8,10,4,1,485,470,15
1,8,11,4,1,470,501,-31
1,8,12,4,1,501,506,-5
1,8,13,4,1,506,473,33
1,8,14,4,1,473,509,-36
1,8,15,4,1,509,580,-71
1,8,16,4,1,580,582,-2
1,8,17,4,1,582,483,99
1,8,18,4,1,483,471,12
1,8,19,4,1,471,478,-7
1,8,20,4,1,478,439,39
1,8,21,4,1,439,466,-27
1,8,22,4,1,466,474,-8
1,9,0,4,1,500,360,140
1,9,1,4,1,360,323,37
1,9,2,4,1,323,368,-45
1,9,3,4,1,368,679,-311
1,9,4,4,1,679,549,130
1,9,5,4,1,549,603,-54
1,9,6,4,1,603,678,-75
1,9,7,4,1,678,654,24
1,9,8,4,1,654,458,196
1,9,9,4,1,458,469,-11
1,9,10,4,1,469,448,21
1,9,11,4,1,448,486,-38
1,9,12,4,1,486,471,15
1,9,13,4,1,471,438,33
1,9,14,4,1,438,530,-92
1,9,15,4,1,530,697,-167
1,9,16,4,1,697,689,8
1,9,17,4,1,689,554,135
1,9,18,4,1,554,600,-46
1,9,19,4,1,600,597,3
1,9,20,4,1,597,508,89
1,9,21,4,1,508,547,-39
1,9,22,4,1,547,474,73
1,10,0,4,1,540,450,90
1,10,1,4,1,450,364,86
1,10,2,4,1,364,448,-84
1,10,3,4,1,448,825,-377
1,10,4,4,1,825,747,78
1,10,5,4,1,747,729,18
1,10,6,4,1,729,844,-115
1,10,7,4,1,844,839,5
1,10,8,4,1,839,517,322
1,10,9,4,1,517,546,-29
1,10,10,4,1,546,505,41
1,10,11,4,1,505,557,-52
1,10,12,4,1,557,539,18
1,10,13,4,1,539,502,37
1,10,14,4,1,502,634,-132
1,10,15,4,1,634,887,-253
1,10,16,4,1,887,840,47
1,10,17,4,1,840,714,126
1,10,18,4,1,714,766,-52
1,10,19,4,1,766,723,43
1,10,20,4,1,723,636,87
1,10,21,4,1,636,668,-32
1,10,22,4,1,668,505,163
1,11,0,4,1,588,575,13
1,11,1,4,1,575,419,156
1,11,2,4,1,419,494,-75
1,11,3,4,1,494,853,-359
1,11,4,4,1,853,883,-30
1,11,5,4,1,883,749,134
1,11,6,4,1,749,918,-169
1,11,7,4,1,918,933,-15
1,11,8,4,1,933,489,444
1,11,9,4,1,489,541,-52
1,11,10,4,1,541,479,62
1,11,11,4,1,479,541,-62
1,11,12,4,1,541,519,22
1,11,13,4,1,519,482,37
1,11,14,4,1,482,660,-178
1,11,15,4,1,660,983,-323
1,11,16,4,1,983,871,112
1,11,17,4,1,871,832,39
1,11,18,4,1,832,859,-27
1,11,19,4,1,859,761,98
1,11,20,4,1,761,749,12
1,11,21,4,1,749,770,-21
1,11,22,4,1,770,553,217
1,12,0,4,1,595,644,-49
1,12,1,4,1,644,436,208
1,12,2,4,1,436,490,-54
1,12,3,4,1,490,807,-317
1,12,4,4,1,807,958,-151
1,12,5,4,1,958,690,268
1,12,6,4,1,690,925,-235
1,12,7,4,1,925,955,-30
1,12,8,4,1,955,394,561
1,12,9,4,1,394,465,-71
1,12,10,4,1,465,395,70
1,12,11,4,1,395,455,-60
1,12,12,4,1,455,411,44
1,12,13,4,1,411,384,27
1,12,14,4,1,384,631,-247
1,12,15,4,1,631,996,-365
1,12,16,4,1,996,806,190
1,12,17,4,1,806,895,-89
1,12,18,4,1,895,871,24
1,12,19,4,1,871,697,174
1,12,20,4,1,697,778,-81
1,12,21,4,1,778,783,-5
1,12,22,4,1,783,560,223
1,13,0,4,1,552,611,-59
1,13,1,4,1,611,407,204
1,13,2,4,1,407,483,-76
1,13,3,4,1,483,789,-306
1,13,4,4,1,789,1006,-217
1,13,5,4,1,1006,607,399
1,13,6,4,1,607,949,-342
1,13,7,4,1,949,962,-13
1,13,8,4,1,962,390,572
1,13,9,4,1,390,468,-78
1,13,10,4,1,468,374,94
1,13,11,4,1,374,451,-77
1,13,12,4,1,451,412,39
1,13,13,4,1,412,379,33
1,13,14,4,1,379,646,-267
1,13,15,4,1,646,999,-353
1,13,16,4,1,999,738,261
1,13,17,4,1,738,884,-146
1,13,18,4,1,884,866,18
1,13,19,4,1,866,635,231
1,13,20,4,1,635,749,-114
1,13,21,4,1,749,701,48
1,13,22,4,1,701,569,132
1,14,0,4,1,514,527,-13
1,14,1,4,1,527,360,167
1,14,2,4,1,360,506,-146
1,14,3,4,1,506,809,-303
1,14,4,4,1,809,944,-135
1,14,5,4,1,944,549,395
1,14,6,4,1,549,947,-398
1,14,7,4,1,947,909,38
1,14,8,4,1,909,361,548
1,14,9,4,1,361,472,-111
1,14,10,4,1,472,348,124
1,14,11,4,1,348,424,-76
1,14,12,4,1,424,399,25
1,14,13,4,1,399,349,50
1,14,14,4,1,349,629,-280
1,14,15,4,1,629,992,-363
1,14,16,4,1,992,682,310
1,14,17,4,1,682,741,-59
1,14,18,4,1,741,813,-72
1,14,19,4,1,813,632,181
1,14,20,4,1,632,727,-95
1,14,21,4,1,727,597,130
1,14,22,4,1,597,590,7
1,15,0,4,1,484,450,34
1,15,1,4,1,450,321,129
1,15,2,4,1,321,568,-247
1,15,3,4,1,568,871,-303
1,15,4,4,1,871,869,2
1,15,5,4,1,869,475,394
1,15,6,4,1,475,844,-369
1,15,7,4,1,844,785,59
1,15,8,4,1,785,334,451
1,15,9,4,1,334,420,-86
1,15,10,4,1,420,339,81
1,15,11,4,1,339,422,-83
1,15,12,4,1,422,362,60
1,15,13,4,1,362,348,14
1,15,14,4,1,348,556,-208
1,15,15,4,1,556,818,-262
1,15,16,4,1,818,660,158
1,15,17,4,1,660,584,76
1,15,18,4,1,584,725,-141
1,15,19,4,1,725,679,46
1,15,20,4,1,679,696,-17
1,15,21,4,1,696,477,219
1,15,22,4,1,477,557,-80
1,16,0,4,1,528,371,157
1,16,1,4,1,371,318,53
1,16,2,4,1,318,683,-365
1,16,3,4,1,683,794,-111
1,16,4,4,1,794,699,95
1,16,5,4,1,699,383,316
1,16,6,4,1,383,706,-323
1,16,7,4,1,706,734,-28
1,16,8,4,1,734,374,360
1,16,9,4,1,374,460,-86
1,16,10,4,1,460,376,84
1,16,11,4,1,376,475,-99
1,16,12,4,1,475,427,48
1,16,13,4,1,427,372,55
1,16,14,4,1,372,461,-89
1,16,15,4,1,461,751,-290
1,16,16,4,1,751,697,54
1,16,17,4,1,697,406,291
1,16,18,4,1,406,565,-159
1,16,19,4,1,565,707,-142
1,16,20,4,1,707,577,130
1,16,21,4,1,577,365,212
1,16,22,4,1,365,617,-252
1,17,0,4,1,610,333,277
1,17,1,4,1,333,311,22
1,17,2,4,1,311,794,-483
1,17,3,4,1,794,672,122
1,17,4,4,1,672,493,179
1,17,5,4,1,493,326,167
1,17,6,4,1,326,637,-311
1,17,7,4,1,637,739,-102
1,17,8,4,1,739,399,340
1,17,9,4,1,399,496,-97
1,17,10,4,1,496,402,94
1,17,11,4,1,402,500,-98
1,17,12,4,1,500,461,39
1,17,13,4,1,461,358,103
1,17,14,4,1,358,362,-4
1,17,15,4,1,362,635,-273
1,17,16,4,1,635,647,-12
1,17,17,4,1,647,265,382
1,17,18,4,1,265,425,-160
1,17,19,4,1,425,714,-289
1,17,20,4,1,714,454,260
1,17,21,4,1,454,303,151
1,17,22,4,1,303,688,-385
1,18,0,4,1,705,330,375
1,18,1,4,1,330,337,-7
1,18,2,4,1,337,883,-546
1,18,3,4,1,883,527,356
1,18,4,4,1,527,334,193
1,18,5,4,1,334,272,62
1,18,6,4,1,272,490,-218
1,18,7,4,1,490,688,-198
1,18,8,4,1,688,369,319
1,18,9,4,1,369,412,-43
1,18,10,4,1,412,379,33
1,18,11,4,1,379,505,-126
1,18,12,4,1,505,414,91
1,18,13,4,1,414,321,93
1,18,14,4,1,321,277,44
1,18,15,4,1,277,436,-159
1,18,16,4,1,436,556,-120
1,18,17,4,1,556,245,311
1,18,18,4,1,245,349,-104
1,18,19,4,1,349,641,-292
1,18,20,4,1,641,377,264
1,18,21,4,1,377,306,71
1,18,22,4,1,306,706,-400
1,19,0,4,1,680,312,368
1,19,1,4,1,312,337,-25
1,19,2,4,1,337,819,-482
1,19,3,4,1,819,329,490
1,19,4,4,1,329,192,137
1,19,5,4,1,192,248,-56
1,19,6,4,1,248,457,-209
1,19,7,4,1,457,727,-270
1,19,8,4,1,727,345,382
1,19,9,4,1,345,407,-62
1,19,10,4,1,407,356,51
1,19,11,4,1,356,514,-158
1,19,12,4,1,514,422,92
1,19,13,4,1,422,251,171
1,19,14,4,1,251,293,-42
1,19,15,4,1,293,481,-188
1,19,16,4,1,481,468,13
1,19,17,4,1,468,192,276
1,19,18,4,1,192,282,-90
1,19,19,4,1,282,489,-207
1,19,20,4,1,489,267,222
1,19,21,4,1,267,279,-12
1,19,22,4,1,279,641,-362
1,20,0,4,1,601,291,310
1,20,1,4,1,291,287,4
1,20,2,4,1,287,654,-367
1,20,3,4,1,654,268,386
1,20,4,4,1,268,177,91
1,20,5,4,1,177,224,-47
1,20,6,4,1,224,438,-214
1,20,7,4,1,438,666,-228
1,20,8,4,1,666,320,346
1,20,9,4,1,320,304,16
1,20,10,4,1,304,285,19
1,20,11,4,1,285,488,-203
1,20,12,4,1,488,355,133
1,20,13,4,1,355,233,122
1,20,14,4,1,233,322,-89
1,20,15,4,1,322,400,-78
1,20,16,4,1,400,327,73
1,20,17,4,1,327,165,162
1,20,18,4,1,165,289,-124
1,20,19,4,1,289,366,-77
1,20,20,4,1,366,221,145
1,20,21,4,1,221,279,-58
1,20,22,4,1,279,487,-208
1,0,0,5,1,548,569,-21
1,0,1,5,1,569,539,30
1,0,2,5,1,539,531,8
1,0,3,5,1,531,571,-40
1,0,4,5,1,571,562,9
1,0,5,5,1,562,520,42
1,0,6,5,1,520,522,-2
1,0,7,5,1,522,453,69
1,0,8,5,1,453,442,11
1,0,9,5,1,442,429,13
1,0,10,5,1,429,420,9
1,0,11,5,1,420,417,3
1,0,12,5,1,417,423,-6
1,0,13,5,1,423,431,-8
1,0,14,5,1,431,438,-7
1,0,15,5,1,438,479,-41
1,0,16,5,1,479,492,-13
1,0,17,5,1,492,546,-54
1,0,18,5,1,546,561,-15
1,0,19,5,1,561,524,37
1,0,20,5,1,524,538,-14
1,0,21,5,1,538,562,-24
1,0,22,5,1,562,531,31
1,1,0,5,1,552,584,-32
1,1,1,5,1,584,563,21
1,1,2,5,1,563,552,11
1,1,3,5,1,552,585,-33
1,1,4,5,1,585,560,25
1,1,5,5,1,560,485,75
1,1,6,5,1,485,455,30
1,1,7,5,1,455,418,37
1,1,8,5,1,418,407,11
1,1,9,5,1,407,394,13
1,1,10,5,1,394,383,11
1,1,11,5,1,383,380,3
1,1,12,5,1,380,385,-5
1,1,13,5,1,385,392,-7
1,1,14,5,1,392,399,-7
1,1,15,5,1,399,436,-37
1,1,16,5,1,436,448,-12
1,1,17,5,1,448,517,-69
1,1,18,5,1,517,560,-43
1,1,19,5,1,560,542,18
1,1,20,5,1,542,554,-12
1,1,21,5,1,554,571,-17
1,1,22,5,1,571,537,34
1,2,0,5,1,566,597,-31
1,2,1,5,1,597,565,32
1,2,2,5,1,565,535,30
1,2,3,5,1,535,560,-25
1,2,4,5,1,560,534,26
1,2,5,5,1,534,450,84
1,2,6,5,1,450,406,44
1,2,7,5,1,406,379,27
1,2,8,5,1,379,370,9
1,2,9,5,1,370,359,11
1,2,10,5,1,359,349,10
1,2,11,5,1,349,346,3
1,2,12,5,1,346,350,-4
1,2,13,5,1,350,355,-5
1,2,14,5,1,355,360,-5
1,2,15,5,1,360,398,-38
1,2,16,5,1,398,407,-9
1,2,17,5,1,407,484,-77
1,2,18,5,1,484,545,-61
1,2,19,5,1,545,538,7
1,2,20,5,1,538,550,-12
1,2,21,5,1,550,573,-23
1,2,22,5,1,573,550,23
1,3,0,5,1,590,607,-17
1,3,1,5,1,607,543,64
1,3,2,5,1,543,477,66
1,3,3,5,1,477,490,-13
1,3,4,5,1,490,483,7
1,3,5,5,1,483,424,59
1,3,6,5,1,424,393,31
1,3,7,5,1,393,359,34
1,3,8,5,1,359,353,6
1,3,9,5,1,353,347,6
1,3,10,5,1,347,341,6
1,3,11,5,1,341,339,2
1,3,12,5,1,339,340,-1
1,3,13,5,1,340,342,-2
1,3,14,5,1,342,345,-3
1,3,15,5,1,345,380,-35
1,3,16,5,1,380,382,-2
1,3,17,5,1,382,454,-72
1,3,18,5,1,454,515,-61
1,3,19,5,1,515,507,8
1,3,20,5,1,507,524,-17
1,3,21,5,1,524,568,-44
1,3,22,5,1,568,569,-1
1,4,0,5,1,604,631,-27
1,4,1,5,1,631,554,77
1,4,2,5,1,554,450,104
1,4,3,5,1,450,441,9
1,4,4,5,1,441,462,-21
1,4,5,5,1,462,447,15
1,4,6,5,1,447,399,48
1,4,7,5,1,399,414,-15
1,4,8,5,1,414,419,-5
1,4,9,5,1,419,411,8
1,4,10,5,1,411,415,-4
1,4,11,5,1,415,423,-8
1,4,12,5,1,423,423,0
1,4,13,5,1,423,415,8
1,4,14,5,1,415,416,-1
1,4,15,5,1,416,424,-8
1,4,16,5,1,424,414,10
1,4,17,5,1,414,466,-52
1,4,18,5,1,466,487,-21
1,4,19,5,1,487,499,-12
1,4,20,5,1,499,548,-49
1,4,21,5,1,548,575,-27
1,4,22,5,1,575,589,-14
1,5,0,5,1,596,581,15
1,5,1,5,1,581,509,72
1,5,2,5,1,509,378,131
1,5,3,5,1,378,356,22
1,5,4,5,1,356,397,-41
1,5,5,5,1,397,397,0
1,5,6,5,1,397,390,7
1,5,7,5,1,390,424,-34
1,5,8,5,1,424,409,15
1,5,9,5,1,409,392,17
1,5,10,5,1,392,406,-14
1,5,11,5,1,406,418,-12
1,5,12,5,1,418,406,12
1,5,13,5,1,406,395,11
1,5,14,5,1,395,421,-26
1,5,15,5,1,421,424,-3
1,5,16,5,1,424,405,19
1,5,17,5,1,405,418,-13
1,5,18,5,1,418,411,7
1,5,19,5,1,411,435,-24
1,5,20,5,1,435,498,-63
1,5,21,5,1,498,538,-40
1,5,22,5,1,538,582,-44
1,6,0,5,1,586,503,83
1,6,1,5,1,503,449,54
1,6,2,5,1,449,335,114
1,6,3,5,1,335,379,-44
1,6,4,5,1,379,406,-27
1,6,5,5,1,406,451,-45
1,6,6,5,1,451,508,-57
1,6,7,5,1,508,497,11
1,6,8,5,1,497,469,28
1,6,9,5,1,469,457,12
1,6,10,5,1,457,460,-3
1,6,11,5,1,460,478,-18
1,6,12,5,1,478,473,5
1,6,13,5,1,473,454,19
1,6,14,5,1,454,484,-30
1,6,15,5,1,484,514,-30
1,6,16,5,1,514,496,18
1,6,17,5,1,496,449,47
1,6,18,5,1,449,424,25
1,6,19,5,1,424,434,-10
1,6,20,5,1,434,461,-27
1,6,21,5,1,461,519,-58
1,6,22,5,1,519,580,-61
1,7,0,5,1,605,479,126
1,7,1,5,1,479,430,49
1,7,2,5,1,430,369,61
1,7,3,5,1,369,545,-176
1,7,4,5,1,545,499,46
1,7,5,5,1,499,607,-108
1,7,6,5,1,607,680,-73
1,7,7,5,1,680,644,36
1,7,8,5,1,644,578,66
1,7,9,5,1,578,582,-4
1,7,10,5,1,582,569,13
1,7,11,5,1,569,600,-31
1,7,12,5,1,600,604,-4
1,7,13,5,1,604,570,34
1,7,14,5,1,570,605,-35
1,7,15,5,1,605,679,-74
1,7,16,5,1,679,666,13
1,7,17,5,1,666,562,104
1,7,18,5,1,562,548,14
1,7,19,5,1,548,550,-2
1,7,20,5,1,550,523,27
1,7,21,5,1,523,576,-53
1,7,22,5,1,576,599,-23
1,8,0,5,1,626,501,125
1,8,1,5,1,501,444,57
1,8,2,5,1,444,446,-2
1,8,3,5,1,446,742,-296
1,8,4,5,1,742,643,99
1,8,5,5,1,643,738,-95
1,8,6,5,1,738,799,-61
1,8,7,5,1,799,781,18
1,8,8,5,1,781,593,188
1,8,9,5,1,593,599,-6
1,8,10,5,1,599,585,14
1,8,11,5,1,585,632,-47
1,8,12,5,1,632,617,15
1,8,13,5,1,617,576,41
1,8,14,5,1,576,668,-92
1,8,15,5,1,668,831,-163
1,8,16,5,1,831,820,11
1,8,17,5,1,820,683,137
1,8,18,5,1,683,693,-10
1,8,19,5,1,693,696,-3
1,8,20,5,1,696,636,60
1,8,21,5,1,636,665,-29
1,8,22,5,1,665,605,60
1,9,0,5,1,646,519,127
1,9,1,5,1,519,433,86
1,9,2,5,1,433,491,-58
1,9,3,5,1,491,866,-375
1,9,4,5,1,866,802,64
1,9,5,5,1,802,773,29
1,9,6,5,1,773,911,-138
1,9,7,5,1,911,903,8
1,9,8,5,1,903,558,345
1,9,9,5,1,558,575,-17
1,9,10,5,1,575,541,34
1,9,11,5,1,541,596,-55
1,9,12,5,1,596,567,29
1,9,13,5,1,567,529,38
1,9,14,5,1,529,687,-158
1,9,15,5,1,687,946,-259
1,9,16,5,1,946,906,40
1,9,17,5,1,906,772,134
1,9,18,5,1,772,813,-41
1,9,19,5,1,813,774,39
1,9,20,5,1,774,696,78
1,9,21,5,1,696,744,-48
1,9,22,5,1,744,608,136
1,10,0,5,1,692,619,73
1,10,1,5,1,619,479,140
1,10,2,5,1,479,570,-91
1,10,3,5,1,570,1001,-431
1,10,4,5,1,1001,1001,0
1,10,5,5,1,1001,872,129
1,10,6,5,1,872,1075,-203
1,10,7,5,1,1075,1075,0
1,10,8,5,1,1075,617,458
1,10,9,5,1,617,673,-56
1,10,10,5,1,673,598,75
1,10,11,5,1,598,666,-68
1,10,12,5,1,666,651,15
1,10,13,5,1,651,606,45
1,10,14,5,1,606,789,-183
1,10,15,5,1,789,1128,-339
1,10,16,5,1,1128,1020,108
1,10,17,5,1,1020,944,76
1,10,18,5,1,944,979,-35
1,10,19,5,1,979,876,103
1,10,20,5,1,876,831,45
1,10,21,5,1,831,869,-38
1,10,22,5,1,869,659,210
1,11,0,5,1,734,744,-10
1,11,1,5,1,744,526,218
1,11,2,5,1,526,613,-87
1,11,3,5,1,613,1060,-447
1,11,4,5,1,1060,1133,-73
1,11,5,5,1,1133,913,220
1,11,6,5,1,913,1155,-242
1,11,7,5,1,1155,1171,-16
1,11,8,5,1,1171,572,599
1,11,9,5,1,572,659,-87
1,11,10,5,1,659,573,86
1,11,11,5,1,573,646,-73
1,11,12,5,1,646,611,35
1,11,13,5,1,611,568,43
1,11,14,5,1,568,820,-252
1,11,15,5,1,820,1238,-418
1,11,16,5,1,1238,1042,196
1,11,17,5,1,1042,1079,-37
1,11,18,5,1,1079,1082,-3
1,11,19,5,1,1082,910,172
1,11,20,5,1,910,947,-37
1,11,21,5,1,947,956,-9
1,11,22,5,1,956,694,262
1,12,0,5,1,703,758,-55
1,12,1,5,1,758,511,247
1,12,2,5,1,511,609,-98
1,12,3,5,1,609,1026,-417
1,12,4,5,1,1026,1207,-181
1,12,5,5,1,1207,820,387
1,12,6,5,1,820,1173,-353
1,12,7,5,1,1173,1194,-21
1,12,8,5,1,1194,501,693
1,12,9,5,1,501,582,-81
1,12,10,5,1,582,489,93
1,12,11,5,1,489,582,-93
1,12,12,5,1,582,523,59
1,12,13,5,1,523,482,41
1,12,14,5,1,482,805,-323
1,12,15,5,1,805,1250,-445
1,12,16,5,1,1250,976,274
1,12,17,5,1,976,1084,-108
1,12,18,5,1,1084,1088,-4
1,12,19,5,1,1088,853,235
1,12,20,5,1,853,946,-93
1,12,21,5,1,946,900,46
1,12,22,5,1,900,700,200
1,13,0,5,1,660,686,-26
1,13,1,5,1,686,470,216
1,13,2,5,1,470,629,-159
1,13,3,5,1,629,996,-367
1,13,4,5,1,996,1197,-201
1,13,5,5,1,1197,719,478
1,13,6,5,1,719,1180,-461
1,13,7,5,1,1180,1158,22
1,13,8,5,1,1158,461,697
1,13,9,5,1,461,578,-117
1,13,10,5,1,578,441,137
1,13,11,5,1,441,534,-93
1,13,12,5,1,534,495,39
1,13,13,5,1,495,440,55
1,13,14,5,1,440,786,-346
1,13,15,5,1,786,1241,-455
1,13,16,5,1,1241,899,342
1,13,17,5,1,899,959,-60
1,13,18,5,1,959,1026,-67
1,13,19,5,1,1026,809,217
1,13,20,5,1,809,915,-106
1,13,21,5,1,915,794,121
1,13,22,5,1,794,724,70
1,14,0,5,1,636,619,17
1,14,1,5,1,619,436,183
1,14,2,5,1,436,690,-254
1,14,3,5,1,690,1047,-357
1,14,4,5,1,1047,1123,-76
1,14,5,5,1,1123,618,505
1,14,6,5,1,618,1075,-457
1,14,7,5,1,1075,1021,54
1,14,8,5,1,1021,434,587
1,14,9,5,1,434,547,-113
1,14,10,5,1,547,432,115
1,14,11,5,1,432,531,-99
1,14,12,5,1,531,474,57
1,14,13,5,1,474,452,22
1,14,14,5,1,452,711,-259
1,14,15,5,1,711,1059,-348
1,14,16,5,1,1059,840,219
1,14,17,5,1,840,814,26
1,14,18,5,1,814,938,-124
1,14,19,5,1,938,832,106
1,14,20,5,1,832,891,-59
1,14,21,5,1,891,678,213
1,14,22,5,1,678,711,-33
1,15,0,5,1,674,540,134
1,15,1,5,1,540,425,115
1,15,2,5,1,425,802,-377
1,15,3,5,1,802,1001,-199
1,15,4,5,1,1001,949,52
1,15,5,5,1,949,547,402
1,15,6,5,1,547,943,-396
1,15,7,5,1,943,972,-29
1,15,8,5,1,972,457,515
1,15,9,5,1,457,578,-121
1,15,10,5,1,578,470,108
1,15,11,5,1,470,580,-110
1,15,12,5,1,580,519,61
1,15,13,5,1,519,458,61
1,15,14,5,1,458,621,-163
1,15,15,5,1,621,1006,-385
1,15,16,5,1,1006,868,138
1,15,17,5,1,868,653,215
1,15,18,5,1,653,788,-135
1,15,19,5,1,788,856,-68
1,15,20,5,1,856,775,81
1,15,21,5,1,775,551,224
1,15,22,5,1,551,758,-207
1,16,0,5,1,718,447,271
1,16,1,5,1,447,386,61
1,16,2,5,1,386,913,-527
1,16,3,5,1,913,891,22
1,16,4,5,1,891,742,149
1,16,5,5,1,742,456,286
1,16,6,5,1,456,885,-429
1,16,7,5,1,885,978,-93
1,16,8,5,1,978,506,472
1,16,9,5,1,506,613,-107
1,16,10,5,1,613,496,117
1,16,11,5,1,496,627,-131
1,16,12,5,1,627,573,54
1,16,13,5,1,573,456,117
1,16,14,5,1,456,536,-80
1,16,15,5,1,536,889,-353
1,16,16,5,1,889,817,72
1,16,17,5,1,817,454,363
1,16,18,5,1,454,642,-188
1,16,19,5,1,642,870,-228
1,16,20,5,1,870,622,248
1,16,21,5,1,622,420,202
1,16,22,5,1,420,828,-408
1,17,0,5,1,813,405,408
1,17,1,5,1,405,400,5
1,17,2,5,1,400,1029,-629
1,17,3,5,1,1029,734,295
1,17,4,5,1,734,525,209
1,17,5,5,1,525,384,141
1,17,6,5,1,384,721,-337
1,17,7,5,1,721,884,-163
1,17,8,5,1,884,440,444
1,17,9,5,1,440,522,-82
1,17,10,5,1,522,446,76
1,17,11,5,1,446,588,-142
1,17,12,5,1,588,497,91
1,17,13,5,1,497,382,115
1,17,14,5,1,382,417,-35
1,17,15,5,1,417,678,-261
1,17,16,5,1,678,717,-39
1,17,17,5,1,717,320,397
1,17,18,5,1,320,509,-189
1,17,19,5,1,509,815,-306
1,17,20,5,1,815,543,272
1,17,21,5,1,543,399,144
1,17,22,5,1,399,861,-462
1,18,0,5,1,802,404,398
1,18,1,5,1,404,413,-9
1,18,2,5,1,413,1003,-590
1,18,3,5,1,1003,567,436
1,18,4,5,1,567,371,196
1,18,5,5,1,371,317,54
1,18,6,5,1,317,585,-268
1,18,7,5,1,585,839,-254
1,18,8,5,1,839,418,421
1,18,9,5,1,418,482,-64
1,18,10,5,1,482,440,42
1,18,11,5,1,440,621,-181
1,18,12,5,1,621,497,124
1,18,13,5,1,497,354,143
1,18,14,5,1,354,375,-21
1,18,15,5,1,375,548,-173
1,18,16,5,1,548,626,-78
1,18,17,5,1,626,265,361
1,18,18,5,1,265,407,-142
1,18,19,5,1,407,689,-282
1,18,20,5,1,689,431,258
1,18,21,5,1,431,360,71
1,18,22,5,1,360,762,-402
1,19,0,5,1,791,381,410
1,19,1,5,1,381,391,-10
1,19,2,5,1,391,888,-497
1,19,3,5,1,888,398,490
1,19,4,5,1,398,257,141
1,19,5,5,1,257,296,-39
1,19,6,5,1,296,537,-241
1,19,7,5,1,537,853,-316
1,19,8,5,1,853,443,410
1,19,9,5,1,443,462,-19
1,19,10,5,1,462,416,46
1,19,11,5,1,416,646,-230
1,19,12,5,1,646,512,134
1,19,13,5,1,512,343,169
1,19,14,5,1,343,387,-44
1,19,15,5,1,387,588,-201
1,19,16,5,1,588,535,53
1,19,17,5,1,535,234,301
1,19,18,5,1,234,352,-118
1,19,19,5,1,352,543,-191
1,19,20,5,1,543,300,243
1,19,21,5,1,300,353,-53
1,19,22,5,1,353,688,-335
1,0,0,6,1,662,691,-29
1,0,1,6,1,691,659,32
1,0,2,6,1,659,650,9
1,0,3,6,1,650,696,-46
1,0,4,6,1,696,671,25
1,0,5,6,1,671,589,82
1,0,6,6,1,589,561,28
1,0,7,6,1,561,522,39
1,0,8,6,1,522,510,12
1,0,9,6,1,510,496,14
1,0,10,6,1,496,485,11
1,0,11,6,1,485,482,3
1,0,12,6,1,482,488,-6
1,0,13,6,1,488,496,-8
1,0,14,6,1,496,504,-8
1,0,15,6,1,504,534,-30
1,0,16,6,1,534,550,-16
1,0,17,6,1,550,627,-77
1,0,18,6,1,627,668,-41
1,0,19,6,1,668,640,28
1,0,20,6,1,640,657,-17
1,0,21,6,1,657,680,-23
1,0,22,6,1,680,639,41
1,1,0,6,1,672,708,-36
1,1,1,6,1,708,672,36
1,1,2,6,1,672,641,31
1,1,3,6,1,641,672,-31
1,1,4,6,1,672,642,30
1,1,5,6,1,642,552,90
1,1,6,6,1,552,513,39
1,1,7,6,1,513,487,26
1,1,8,6,1,487,476,11
1,1,9,6,1,476,463,13
1,1,10,6,1,463,452,11
1,1,11,6,1,452,449,3
1,1,12,6,1,449,454,-5
1,1,13,6,1,454,460,-6
1,1,14,6,1,460,467,-7
1,1,15,6,1,467,513,-46
1,1,16,6,1,513,514,-1
1,1,17,6,1,514,588,-74
1,1,18,6,1,588,647,-59
1,1,19,6,1,647,639,8
1,1,20,6,1,639,661,-22
1,1,21,6,1,661,687,-26
1,1,22,6,1,687,652,35
1,2,0,6,1,696,722,-26
1,2,1,6,1,722,655,67
1,2,2,6,1,655,584,71
1,2,3,6,1,584,600,-16
1,2,4,6,1,600,591,9
1,2,5,6,1,591,532,59
1,2,6,6,1,532,511,21
1,2,7,6,1,511,474,37
1,2,8,6,1,474,466,8
1,2,9,6,1,466,456,10
1,2,10,6,1,456,448,8
1,2,11,6,1,448,445,3
1,2,12,6,1,445,448,-3
1,2,13,6,1,448,452,-4
1,2,14,6,1,452,456,-4
1,2,15,6,1,456,497,-41
1,2,16,6,1,497,491,6
1,2,17,6,1,491,563,-72
1,2,18,6,1,563,622,-59
1,2,19,6,1,622,610,12
1,2,20,6,1,610,634,-24
1,2,21,6,1,634,683,-49
1,2,22,6,1,683,675,8
1,3,0,6,1,716,748,-32
1,3,1,6,1,748,664,84
1,3,2,6,1,664,555,109
1,3,3,6,1,555,553,2
1,3,4,6,1,553,577,-24
1,3,5,6,1,577,559,18
1,3,6,6,1,559,514,45
1,3,7,6,1,514,486,28
1,3,8,6,1,486,488,-2
1,3,9,6,1,488,477,11
1,3,10,6,1,477,478,-1
1,3,11,6,1,478,485,-7
1,3,12,6,1,485,486,-1
1,3,13,6,1,486,480,6
1,3,14,6,1,480,483,-3
1,3,15,6,1,483,514,-31
1,3,16,6,1,514,513,1
1,3,17,6,1,513,583,-70
1,3,18,6,1,583,608,-25
1,3,19,6,1,608,606,2
1,3,20,6,1,606,652,-46
1,3,21,6,1,652,686,-34
1,3,22,6,1,686,700,-14
1,4,0,6,1,710,700,10
1,4,1,6,1,700,623,77
1,4,2,6,1,623,493,130
1,4,3,6,1,493,482,11
1,4,4,6,1,482,517,-35
1,4,5,6,1,517,491,26
1,4,6,6,1,491,466,25
1,4,7,6,1,466,478,-12
1,4,8,6,1,478,460,18
1,4,9,6,1,460,440,20
1,4,10,6,1,440,451,-11
1,4,11,6,1,451,462,-11
1,4,12,6,1,462,451,11
1,4,13,6,1,451,442,9
1,4,14,6,1,442,469,-27
1,4,15,6,1,469,483,-14
1,4,16,6,1,483,480,3
1,4,17,6,1,480,524,-44
1,4,18,6,1,524,534,-10
1,4,19,6,1,534,550,-16
1,4,20,6,1,550,608,-58
1,4,21,6,1,608,651,-43
1,4,22,6,1,651,692,-41
1,5,0,6,1,700,625,75
1,5,1,6,1,625,569,56
1,5,2,6,1,569,454,115
1,5,3,6,1,454,504,-50
1,5,4,6,1,504,515,-11
1,5,5,6,1,515,520,-5
1,5,6,6,1,520,547,-27
1,5,7,6,1,547,566,-19
1,5,8,6,1,566,537,29
1,5,9,6,1,537,524,13
1,5,10,6,1,524,525,-1
1,5,11,6,1,525,543,-18
1,5,12,6,1,543,538,5
1,5,13,6,1,538,519,19
1,5,14,6,1,519,550,-31
1,5,15,6,1,550,569,-19
1,5,16,6,1,569,554,15
1,5,17,6,1,554,530,24
1,5,18,6,1,530,531,-1
1,5,19,6,1,531,550,-19
1,5,20,6,1,550,580,-30
1,5,21,6,1,580,637,-57
1,5,22,6,1,637,688,-51
1,6,0,6,1,725,603,122
1,6,1,6,1,603,539,64
1,6,2,6,1,539,458,81
1,6,3,6,1,458,632,-174
1,6,4,6,1,632,581,51
1,6,5,6,1,581,674,-93
1,6,6,6,1,674,738,-64
1,6,7,6,1,738,713,25
1,6,8,6,1,713,647,66
1,6,9,6,1,647,651,-4
1,6,10,6,1,651,638,13
1,6,11,6,1,638,669,-31
1,6,12,6,1,669,673,-4
1,6,13,6,1,673,638,35
1,6,14,6,1,638,673,-35
1,6,15,6,1,673,756,-83
1,6,16,6,1,756,732,24
1,6,17,6,1,732,633,99
1,6,18,6,1,633,635,-2
1,6,19,6,1,635,647,-12
1,6,20,6,1,647,630,17
1,6,21,6,1,630,692,-62
1,6,22,6,1,692,714,-22
1,7,0,6,1,756,626,130
1,7,1,6,1,626,534,92
1,7,2,6,1,534,495,39
1,7,3,6,1,495,782,-287
1,7,4,6,1,782,700,82
1,7,5,6,1,700,820,-120
1,7,6,6,1,820,904,-84
1,7,7,6,1,904,876,28
1,7,8,6,1,876,689,187
1,7,9,6,1,689,696,-7
1,7,10,6,1,696,684,12
1,7,11,6,1,684,731,-47
1,7,12,6,1,731,715,16
1,7,13,6,1,715,673,42
1,7,14,6,1,673,764,-91
1,7,15,6,1,764,930,-166
1,7,16,6,1,930,904,26
1,7,17,6,1,904,762,142
1,7,18,6,1,762,770,-8
1,7,19,6,1,770,768,2
1,7,20,6,1,768,720,48
1,7,21,6,1,720,775,-55
1,7,22,6,1,775,730,45
1,8,0,6,1,772,660,112
1,8,1,6,1,660,554,106
1,8,2,6,1,554,569,-15
1,8,3,6,1,569,929,-360
1,8,4,6,1,929,896,33
1,8,5,6,1,896,908,-12
1,8,6,6,1,908,1032,-124
1,8,7,6,1,1032,1030,2
1,8,8,6,1,1030,693,337
1,8,9,6,1,693,705,-12
1,8,10,6,1,705,678,27
1,8,11,6,1,678,742,-64
1,8,12,6,1,742,713,29
1,8,13,6,1,713,667,46
1,8,14,6,1,667,825,-158
1,8,15,6,1,825,1080,-255
1,8,16,6,1,1080,1037,43
1,8,17,6,1,1037,901,136
1,8,18,6,1,901,906,-5
1,8,19,6,1,906,873,33
1,8,20,6,1,873,824,49
1,8,21,6,1,824,862,-38
1,8,22,6,1,862,739,123
1,9,0,6,1,798,688,110
1,9,1,6,1,688,548,140
1,9,2,6,1,548,613,-65
1,9,3,6,1,613,1042,-429
1,9,4,6,1,1042,1056,-14
1,9,5,6,1,1056,916,140
1,9,6,6,1,916,1142,-226
1,9,7,6,1,1142,1139,3
1,9,8,6,1,1139,658,481
1,9,9,6,1,658,702,-44
1,9,10,6,1,702,634,68
1,9,11,6,1,634,705,-71
1,9,12,6,1,705,679,26
1,9,13,6,1,679,633,46
1,9,14,6,1,633,842,-209
1,9,15,6,1,842,1187,-345
1,9,16,6,1,1187,1086,101
1,9,17,6,1,1086,1002,84
1,9,18,6,1,1002,1026,-24
1,9,19,6,1,1026,927,99
1,9,20,6,1,927,891,36
1,9,21,6,1,891,945,-54
1,9,22,6,1,945,762,183
1,10,0,6,1,838,788,50
1,10,1,6,1,788,586,202
1,10,2,6,1,586,689,-103
1,10,3,6,1,689,1208,-519
1,10,4,6,1,1208,1251,-43
1,10,5,6,1,1251,1036,215
1,10,6,6,1,1036,1312,-276
1,10,7,6,1,1312,1313,-1
1,10,8,6,1,1313,700,613
1,10,9,6,1,700,791,-91
1,10,10,6,1,791,692,99
1,10,11,6,1,692,771,-79
1,10,12,6,1,771,743,28
1,10,13,6,1,743,692,51
1,10,14,6,1,692,949,-257
1,10,15,6,1,949,1383,-434
1,10,16,6,1,1383,1191,192
1,10,17,6,1,1191,1191,0
1,10,18,6,1,1191,1202,-11
1,10,19,6,1,1202,1025,177
1,10,20,6,1,1025,1029,-4
1,10,21,6,1,1029,1055,-26
1,10,22,6,1,1055,800,255
1,11,0,6,1,842,858,-16
1,11,1,6,1,858,601,257
1,11,2,6,1,601,732,-131
1,11,3,6,1,732,1279,-547
1,11,4,6,1,1279,1382,-103
1,11,5,6,1,1382,1043,339
1,11,6,6,1,1043,1403,-360
1,11,7,6,1,1403,1410,-7
1,11,8,6,1,1410,679,731
1,11,9,6,1,679,776,-97
1,11,10,6,1,776,667,109
1,11,11,6,1,667,773,-106
1,11,12,6,1,773,723,50
1,11,13,6,1,723,666,57
1,11,14,6,1,666,994,-328
1,11,15,6,1,994,1492,-498
1,11,16,6,1,1492,1212,280
1,11,17,6,1,1212,1268,-56
1,11,18,6,1,1268,1299,-31
1,11,19,6,1,1299,1066,233
1,11,20,6,1,1066,1115,-49
1,11,21,6,1,1115,1073,42
1,11,22,6,1,1073,834,239
1,12,0,6,1,811,833,-22
1,12,1,6,1,833,574,259
1,12,2,6,1,574,755,-181
1,12,3,6,1,755,1233,-478
1,12,4,6,1,1233,1398,-165
1,12,5,6,1,1398,932,466
1,12,6,6,1,932,1404,-472
1,12,7,6,1,1404,1390,14
1,12,8,6,1,1390,572,818
1,12,9,6,1,572,692,-120
1,12,10,6,1,692,556,136
1,12,11,6,1,556,665,-109
1,12,12,6,1,665,606,59
1,12,13,6,1,606,543,63
1,12,14,6,1,543,945,-402
1,12,15,6,1,945,1492,-547
1,12,16,6,1,1492,1137,355
1,12,17,6,1,1137,1159,-22
1,12,18,6,1,1159,1248,-89
1,12,19,6,1,1248,1027,221
1,12,20,6,1,1027,1112,-85
1,12,21,6,1,1112,993,119
1,12,22,6,1,993,855,138
1,13,0,6,1,782,778,4
1,13,1,6,1,778,546,232
1,13,2,6,1,546,813,-267
1,13,3,6,1,813,1234,-421
1,13,4,6,1,1234,1376,-142
1,13,5,6,1,1376,788,588
1,13,6,6,1,788,1308,-520
1,13,7,6,1,1308,1270,38
1,13,8,6,1,1270,534,736
1,13,9,6,1,534,653,-119
1,13,10,6,1,653,525,128
1,13,11,6,1,525,641,-116
1,13,12,6,1,641,570,71
1,13,13,6,1,570,543,27
1,13,14,6,1,543,868,-325
1,13,15,6,1,868,1308,-440
1,13,16,6,1,1308,1057,251
1,13,17,6,1,1057,1032,25
1,13,18,6,1,1032,1151,-119
1,13,19,6,1,1151,1009,142
1,13,20,6,1,1009,1079,-70
1,13,21,6,1,1079,875,204
1,13,22,6,1,875,845,30
1,14,0,6,1,826,709,117
1,14,1,6,1,709,540,169
1,14,2,6,1,540,924,-384
1,14,3,6,1,924,1177,-253
1,14,4,6,1,1177,1203,-26
1,14,5,6,1,1203,690,513
1,14,6,6,1,690,1174,-484
1,14,7,6,1,1174,1208,-34
1,14,8,6,1,1208,557,651
1,14,9,6,1,557,705,-148
1,14,10,6,1,705,563,142
1,14,11,6,1,563,689,-126
1,14,12,6,1,689,631,58
1,14,13,6,1,631,562,69
1,14,14,6,1,562,776,-214
1,14,15,6,1,776,1247,-471
1,14,16,6,1,1247,1048,199
1,14,17,6,1,1048,883,165
1,14,18,6,1,883,1001,-118
1,14,19,6,1,1001,1009,-8
1,14,20,6,1,1009,970,39
1,14,21,6,1,970,752,218
1,14,22,6,1,752,912,-160
1,15,0,6,1,864,616,248
1,15,1,6,1,616,493,123
1,15,2,6,1,493,1032,-539
1,15,3,6,1,1032,1098,-66
1,15,4,6,1,1098,992,106
1,15,5,6,1,992,620,372
1,15,6,6,1,620,1122,-502
1,15,7,6,1,1122,1216,-94
1,15,8,6,1,1216,589,627
1,15,9,6,1,589,731,-142
1,15,10,6,1,731,590,141
1,15,11,6,1,590,732,-142
1,15,12,6,1,732,665,67
1,15,13,6,1,665,542,123
1,15,14,6,1,542,696,-154
1,15,15,6,1,696,1144,-448
1,15,16,6,1,1144,988,156
1,15,17,6,1,988,701,287
1,15,18,6,1,701,865,-164
1,15,19,6,1,865,1019,-154
1,15,20,6,1,1019,820,199
1,15,21,6,1,820,606,214
1,15,22,6,1,606,969,-363
1,16,0,6,1,921,519,402
1,16,1,6,1,519,475,44
1,16,2,6,1,475,1148,-673
1,16,3,6,1,1148,953,195
1,16,4,6,1,953,774,179
1,16,5,6,1,774,514,260
1,16,6,6,1,514,969,-455
1,16,7,6,1,969,1123,-154
1,16,8,6,1,1123,547,576
1,16,9,6,1,547,639,-92
1,16,10,6,1,639,540,99
1,16,11,6,1,540,715,-175
1,16,12,6,1,715,609,106
1,16,13,6,1,609,480,129
1,16,14,6,1,480,591,-111
1,16,15,6,1,591,932,-341
1,16,16,6,1,932,887,45
1,16,17,6,1,887,509,378
1,16,18,6,1,509,726,-217
1,16,19,6,1,726,971,-245
1,16,20,6,1,971,711,260
1,16,21,6,1,711,516,195
1,16,22,6,1,516,1001,-485
1,17,0,6,1,910,479,431
1,17,1,6,1,479,476,3
1,17,2,6,1,476,1149,-673
1,17,3,6,1,1149,774,375
1,17,4,6,1,774,562,212
1,17,5,6,1,562,429,133
1,17,6,6,1,429,816,-387
1,17,7,6,1,816,1035,-219
1,17,8,6,1,1035,489,546
1,17,9,6,1,489,592,-103
1,17,10,6,1,592,507,85
1,17,11,6,1,507,704,-197
1,17,12,6,1,704,580,124
1,17,13,6,1,580,415,165
1,17,14,6,1,415,515,-100
1,17,15,6,1,515,790,-275
1,17,16,6,1,790,787,3
1,17,17,6,1,787,340,447
1,17,18,6,1,340,567,-227
1,17,19,6,1,567,863,-296
1,17,20,6,1,863,597,266
1,17,21,6,1,597,453,144
1,17,22,6,1,453,917,-464
1,18,0,6,1,913,473,440
1,18,1,6,1,473,467,6
1,18,2,6,1,467,1072,-605
1,18,3,6,1,1072,636,436
1,18,4,6,1,636,436,200
1,18,5,6,1,436,365,71
1,18,6,6,1,365,665,-300
1,18,7,6,1,665,965,-300
1,18,8,6,1,965,516,449
1,18,9,6,1,516,537,-21
1,18,10,6,1,537,500,37
1,18,11,6,1,500,753,-253
1,18,12,6,1,753,587,166
1,18,13,6,1,587,446,141
1,18,14,6,1,446,469,-23
1,18,15,6,1,469,655,-186
1,18,16,6,1,655,693,-38
1,18,17,6,1,693,307,386
1,18,18,6,1,307,477,-170
1,18,19,6,1,477,743,-266
1,18,20,6,1,743,464,279
1,18,21,6,1,464,434,30
1,18,22,6,1,434,809,-375
1,0,0,7,1,782,815,-33
1,0,1,7,1,815,768,47
1,0,2,7,1,768,739,29
1,0,3,7,1,739,783,-44
1,0,4,7,1,783,753,30
1,0,5,7,1,753,656,97
1,0,6,7,1,656,619,37
1,0,7,7,1,619,591,28
1,0,8,7,1,591,579,12
1,0,9,7,1,579,565,14
1,0,10,7,1,565,554,11
1,0,11,7,1,554,551,3
1,0,12,7,1,551,557,-6
1,0,13,7,1,557,564,-7
1,0,14,7,1,564,572,-8
1,0,15,7,1,572,611,-39
1,0,16,7,1,611,616,-5
1,0,17,7,1,616,698,-82
1,0,18,7,1,698,755,-57
1,0,19,7,1,755,737,18
1,0,20,7,1,737,764,-27
1,0,21,7,1,764,796,-32
1,0,22,7,1,796,754,42
1,1,0,7,1,802,833,-31
1,1,1,7,1,833,762,71
1,1,2,7,1,762,690,72
1,1,3,7,1,690,712,-22
1,1,4,7,1,712,699,13
1,1,5,7,1,699,634,65
1,1,6,7,1,634,618,16
1,1,7,7,1,618,582,36
1,1,8,7,1,582,572,10
1,1,9,7,1,572,560,12
1,1,10,7,1,560,551,9
1,1,11,7,1,551,548,3
1,1,12,7,1,548,552,-4
1,1,13,7,1,552,557,-5
1,1,14,7,1,557,563,-6
1,1,15,7,1,563,612,-49
1,1,16,7,1,612,598,14
1,1,17,7,1,598,667,-69
1,1,18,7,1,667,724,-57
1,1,19,7,1,724,711,13
1,1,20,7,1,711,745,-34
1,1,21,7,1,745,797,-52
1,1,22,7,1,797,777,20
1,2,0,7,1,822,863,-41
1,2,1,7,1,863,776,87
1,2,2,7,1,776,662,114
1,2,3,7,1,662,663,-1
1,2,4,7,1,663,685,-22
1,2,5,7,1,685,667,18
1,2,6,7,1,667,632,35
1,2,7,7,1,632,601,31
1,2,8,7,1,601,601,0
1,2,9,7,1,601,586,15
1,2,10,7,1,586,585,1
1,2,11,7,1,585,591,-6
1,2,12,7,1,591,594,-3
1,2,13,7,1,594,590,4
1,2,14,7,1,590,594,-4
1,2,15,7,1,594,631,-37
1,2,16,7,1,631,622,9
1,2,17,7,1,622,692,-70
1,2,18,7,1,692,715,-23
1,2,19,7,1,715,709,6
1,2,20,7,1,709,762,-53
1,2,21,7,1,762,801,-39
1,2,22,7,1,801,806,-5
1,3,0,7,1,822,817,5
1,3,1,7,1,817,733,84
1,3,2,7,1,733,598,135
1,3,3,7,1,598,594,4
1,3,4,7,1,594,632,-38
1,3,5,7,1,632,603,29
1,3,6,7,1,603,581,22
1,3,7,7,1,581,550,31
1,3,8,7,1,550,529,21
1,3,9,7,1,529,506,23
1,3,10,7,1,506,514,-8
1,3,11,7,1,514,524,-10
1,3,12,7,1,524,514,10
1,3,13,7,1,514,507,7
1,3,14,7,1,507,536,-29
1,3,15,7,1,536,573,-37
1,3,16,7,1,573,579,-6
1,3,17,7,1,579,641,-62
1,3,18,7,1,641,655,-14
1,3,19,7,1,655,657,-2
1,3,20,7,1,657,712,-55
1,3,21,7,1,712,762,-50
1,3,22,7,1,762,803,-41
1,4,0,7,1,814,744,70
1,4,1,7,1,744,683,61
1,4,2,7,1,683,569,114
1,4,3,7,1,569,630,-61
1,4,4,7,1,630,635,-5
1,4,5,7,1,635,614,21
1,4,6,7,1,614,623,-9
1,4,7,7,1,623,620,3
1,4,8,7,1,620,588,32
1,4,9,7,1,588,572,16
1,4,10,7,1,572,570,2
1,4,11,7,1,570,587,-17
1,4,12,7,1,587,583,4
1,4,13,7,1,583,566,17
1,4,14,7,1,566,598,-32
1,4,15,7,1,598,628,-30
1,4,16,7,1,628,629,-1
1,4,17,7,1,629,636,-7
1,4,18,7,1,636,654,-18
1,4,19,7,1,654,665,-11
1,4,20,7,1,665,690,-25
1,4,21,7,1,690,750,-60
1,4,22,7,1,750,798,-48
1,5,0,7,1,839,725,114
1,5,1,7,1,725,659,66
1,5,2,7,1,659,577,82
1,5,3,7,1,577,757,-180
1,5,4,7,1,757,690,67
1,5,5,7,1,690,743,-53
1,5,6,7,1,743,777,-34
1,5,7,7,1,777,782,-5
1,5,8,7,1,782,715,67
1,5,9,7,1,715,718,-3
1,5,10,7,1,718,703,15
1,5,11,7,1,703,734,-31
1,5,12,7,1,734,738,-4
1,5,13,7,1,738,703,35
1,5,14,7,1,703,739,-36
1,5,15,7,1,739,811,-72
1,5,16,7,1,811,790,21
1,5,17,7,1,790,714,76
1,5,18,7,1,714,742,-28
1,5,19,7,1,742,763,-21
1,5,20,7,1,763,749,14
1,5,21,7,1,749,810,-61
1,5,22,7,1,810,822,-12
1,6,0,7,1,876,750,126
1,6,1,7,1,750,643,107
1,6,2,7,1,643,584,59
1,6,3,7,1,584,869,-285
1,6,4,7,1,869,782,87
1,6,5,7,1,782,887,-105
1,6,6,7,1,887,962,-75
1,6,7,7,1,962,945,17
1,6,8,7,1,945,758,187
1,6,9,7,1,758,765,-7
1,6,10,7,1,765,753,12
1,6,11,7,1,753,800,-47
1,6,12,7,1,800,784,16
1,6,13,7,1,784,741,43
1,6,14,7,1,741,832,-91
1,6,15,7,1,832,1007,-175
1,6,16,7,1,1007,970,37
1,6,17,7,1,970,833,137
1,6,18,7,1,833,857,-24
1,6,19,7,1,857,865,-8
1,6,20,7,1,865,827,38
1,6,21,7,1,827,891,-64
1,6,22,7,1,891,845,46
1,7,0,7,1,902,785,117
1,7,1,7,1,785,644,141
1,7,2,7,1,644,618,26
1,7,3,7,1,618,969,-351
1,7,4,7,1,969,953,16
1,7,5,7,1,953,990,-37
1,7,6,7,1,990,1137,-147
1,7,7,7,1,1137,1125,12
1,7,8,7,1,1125,789,336
1,7,9,7,1,789,802,-13
1,7,10,7,1,802,777,25
1,7,11,7,1,777,841,-64
1,7,12,7,1,841,811,30
1,7,13,7,1,811,764,47
1,7,14,7,1,764,921,-157
1,7,15,7,1,921,1179,-258
1,7,16,7,1,1179,1121,58
1,7,17,7,1,1121,980,141
1,7,18,7,1,980,983,-3
1,7,19,7,1,983,945,38
1,7,20,7,1,945,908,37
1,7,21,7,1,908,972,-64
1,7,22,7,1,972,864,108
1,8,0,7,1,924,829,95
1,8,1,7,1,829,669,160
1,8,2,7,1,669,691,-22
1,8,3,7,1,691,1105,-414
1,8,4,7,1,1105,1150,-45
1,8,5,7,1,1150,1051,99
1,8,6,7,1,1051,1263,-212
1,8,7,7,1,1263,1266,-3
1,8,8,7,1,1266,793,473
1,8,9,7,1,793,832,-39
1,8,10,7,1,832,771,61
1,8,11,7,1,771,851,-80
1,8,12,7,1,851,825,26
1,8,13,7,1,825,771,54
1,8,14,7,1,771,980,-209
1,8,15,7,1,980,1321,-341
1,8,16,7,1,1321,1217,104
1,8,17,7,1,1217,1131,86
1,8,18,7,1,1131,1119,12
1,8,19,7,1,1119,1026,93
1,8,20,7,1,1026,1019,7
1,8,21,7,1,1019,1063,-44
1,8,22,7,1,1063,893,170
1,9,0,7,1,944,857,87
1,9,1,7,1,857,655,202
1,9,2,7,1,655,732,-77
1,9,3,7,1,732,1249,-517
1,9,4,7,1,1249,1306,-57
1,9,5,7,1,1306,1080,226
1,9,6,7,1,1080,1379,-299
1,9,7,7,1,1379,1377,2
1,9,8,7,1,1377,741,636
1,9,9,7,1,741,820,-79
1,9,10,7,1,820,728,92
1,9,11,7,1,728,810,-82
1,9,12,7,1,810,771,39
1,9,13,7,1,771,719,52
1,9,14,7,1,719,1002,-283
1,9,15,7,1,1002,1442,-440
1,9,16,7,1,1442,1257,185
1,9,17,7,1,1257,1249,8
1,9,18,7,1,1249,1249,0
1,9,19,7,1,1249,1076,173
1,9,20,7,1,1076,1089,-13
1,9,21,7,1,1089,1131,-42
1,9,22,7,1,1131,903,228
1,10,0,7,1,946,902,44
1,10,1,7,1,902,661,241
1,10,2,7,1,661,808,-147
1,10,3,7,1,808,1427,-619
1,10,4,7,1,1427,1500,-73
1,10,5,7,1,1500,1166,334
1,10,6,7,1,1166,1560,-394
1,10,7,7,1,1560,1552,8
1,10,8,7,1,1552,807,745
1,10,9,7,1,807,908,-101
1,10,10,7,1,908,786,122
1,10,11,7,1,786,898,-112
1,10,12,7,1,898,855,43
1,10,13,7,1,855,790,65
1,10,14,7,1,790,1123,-333
1,10,15,7,1,1123,1637,-514
1,10,16,7,1,1637,1361,276
1,10,17,7,1,1361,1380,-19
1,10,18,7,1,1380,1419,-39
1,10,19,7,1,1419,1181,238
1,10,20,7,1,1181,1197,-16
1,10,21,7,1,1197,1172,25
1,10,22,7,1,1172,940,232
1,11,0,7,1,950,933,17
1,11,1,7,1,933,664,269
1,11,2,7,1,664,878,-214
1,11,3,7,1,878,1486,-608
1,11,4,7,1,1486,1573,-87
1,11,5,7,1,1573,1155,418
1,11,6,7,1,1155,1634,-479
1,11,7,7,1,1634,1606,28
1,11,8,7,1,1606,750,856
1,11,9,7,1,750,886,-136
1,11,10,7,1,886,734,152
1,11,11,7,1,734,856,-122
1,11,12,7,1,856,806,50
1,11,13,7,1,806,727,79
1,11,14,7,1,727,1134,-407
1,11,15,7,1,1134,1734,-600
1,11,16,7,1,1734,1373,361
1,11,17,7,1,1373,1343,30
1,11,18,7,1,1343,1459,-116
1,11,19,7,1,1459,1240,219
1,11,20,7,1,1240,1281,-41
1,11,21,7,1,1281,1166,115
1,11,22,7,1,1166,989,177
1,12,0,7,1,933,925,8
1,12,1,7,1,925,650,275
1,12,2,7,1,650,939,-289
1,12,3,7,1,939,1471,-532
1,12,4,7,1,1471,1577,-106
1,12,5,7,1,1577,1001,576
1,12,6,7,1,1001,1532,-531
1,12,7,7,1,1532,1502,30
1,12,8,7,1,1502,645,857
1,12,9,7,1,645,767,-122
1,12,10,7,1,767,640,127
1,12,11,7,1,640,772,-132
1,12,12,7,1,772,681,91
1,12,13,7,1,681,646,35
1,12,14,7,1,646,1027,-381
1,12,15,7,1,1027,1559,-532
1,12,16,7,1,1559,1295,264
1,12,17,7,1,1295,1232,63
1,12,18,7,1,1232,1373,-141
1,12,19,7,1,1373,1227,146
1,12,20,7,1,1227,1276,-49
1,12,21,7,1,1276,1074,202
1,12,22,7,1,1074,976,98
1,13,0,7,1,972,868,104
1,13,1,7,1,868,650,218
1,13,2,7,1,650,1047,-397
1,13,3,7,1,1047,1364,-317
1,13,4,7,1,1364,1456,-92
1,13,5,7,1,1456,860,596
1,13,6,7,1,860,1407,-547
1,13,7,7,1,1407,1457,-50
1,13,8,7,1,1457,657,800
1,13,9,7,1,657,811,-154
1,13,10,7,1,811,656,155
1,13,11,7,1,656,799,-143
1,13,12,7,1,799,727,72
1,13,13,7,1,727,653,74
1,13,14,7,1,653,933,-280
1,13,15,7,1,933,1496,-563
1,13,16,7,1,1496,1265,231
1,13,17,7,1,1265,1101,164
1,13,18,7,1,1101,1214,-113
1,13,19,7,1,1214,1186,28
1,13,20,7,1,1186,1158,28
1,13,21,7,1,1158,949,209
1,13,22,7,1,949,1046,-97
1,14,0,7,1,1016,785,231
1,14,1,7,1,785,608,177
1,14,2,7,1,608,1154,-546
1,14,3,7,1,1154,1274,-120
1,14,4,7,1,1274,1246,28
1,14,5,7,1,1246,763,483
1,14,6,7,1,763,1353,-590
1,14,7,7,1,1353,1452,-99
1,14,8,7,1,1452,689,763
1,14,9,7,1,689,858,-169
1,14,10,7,1,858,683,175
1,14,11,7,1,683,841,-158
1,14,12,7,1,841,777,64
1,14,13,7,1,777,646,131
1,14,14,7,1,646,851,-205
1,14,15,7,1,851,1385,-534
1,14,16,7,1,1385,1168,217
1,14,17,7,1,1168,931,237
1,14,18,7,1,931,1078,-147
1,14,19,7,1,1078,1172,-94
1,14,20,7,1,1172,1015,157
1,14,21,7,1,1015,807,208
1,14,22,7,1,807,1123,-316
1,15,0,7,1,1067,688,379
1,15,1,7,1,688,582,106
1,15,2,7,1,582,1267,-685
1,15,3,7,1,1267,1160,107
1,15,4,7,1,1160,1024,136
1,15,5,7,1,1024,678,346
1,15,6,7,1,678,1206,-528
1,15,7,7,1,1206,1361,-155
1,15,8,7,1,1361,630,731
1,15,9,7,1,630,757,-127
1,15,10,7,1,757,634,123
1,15,11,7,1,634,820,-186
1,15,12,7,1,820,701,119
1,15,13,7,1,701,566,135
1,15,14,7,1,566,751,-185
1,15,15,7,1,751,1187,-436
1,15,16,7,1,1187,1058,129
1,15,17,7,1,1058,756,302
1,15,18,7,1,756,949,-193
1,15,19,7,1,949,1120,-171
1,15,20,7,1,1120,909,211
1,15,21,7,1,909,702,207
1,15,22,7,1,702,1142,-440
1,16,0,7,1,1018,593,425
1,16,1,7,1,593,551,42
1,16,2,7,1,551,1268,-717
1,16,3,7,1,1268,993,275
1,16,4,7,1,993,811,182
1,16,5,7,1,811,559,252
1,16,6,7,1,559,1064,-505
1,16,7,7,1,1064,1274,-210
1,16,8,7,1,1274,596,678
1,16,9,7,1,596,709,-113
1,16,10,7,1,709,601,108
1,16,11,7,1,601,831,-230
1,16,12,7,1,831,692,139
1,16,13,7,1,692,513,179
1,16,14,7,1,513,689,-176
1,16,15,7,1,689,1044,-355
1,16,16,7,1,1044,957,87
1,16,17,7,1,957,529,428
1,16,18,7,1,529,784,-255
1,16,19,7,1,784,1019,-235
1,16,20,7,1,1019,765,254
1,16,21,7,1,765,570,195
1,16,22,7,1,570,1057,-487
1,17,0,7,1,1021,548,473
1,17,1,7,1,548,530,18
1,17,2,7,1,530,1218,-688
1,17,3,7,1,1218,843,375
1,17,4,7,1,843,627,216
1,17,5,7,1,627,477,150
1,17,6,7,1,477,896,-419
1,17,7,7,1,896,1161,-265
1,17,8,7,1,1161,587,574
1,17,9,7,1,587,647,-60
1,17,10,7,1,647,567,80
1,17,11,7,1,567,836,-269
1,17,12,7,1,836,670,166
1,17,13,7,1,670,507,163
1,17,14,7,1,507,609,-102
1,17,15,7,1,609,897,-288
1,17,16,7,1,897,854,43
1,17,17,7,1,854,382,472
1,17,18,7,1,382,637,-255
1,17,19,7,1,637,917,-280
1,17,20,7,1,917,630,287
1,17,21,7,1,630,527,103
1,17,22,7,1,527,964,-437
1,0,0,8,1,912,940,-28
1,0,1,8,1,940,858,82
1,0,2,8,1,858,788,70
1,0,3,8,1,788,823,-35
1,0,4,8,1,823,810,13
1,0,5,8,1,810,738,72
1,0,6,8,1,738,724,14
1,0,7,8,1,724,686,38
1,0,8,8,1,686,675,11
1,0,9,8,1,675,662,13
1,0,10,8,1,662,653,9
1,0,11,8,1,653,650,3
1,0,12,8,1,650,655,-5
1,0,13,8,1,655,661,-6
1,0,14,8,1,661,668,-7
1,0,15,8,1,668,710,-42
1,0,16,8,1,710,700,10
1,0,17,8,1,700,777,-77
1,0,18,8,1,777,832,-55
1,0,19,8,1,832,809,23
1,0,20,8,1,809,848,-39
1,0,21,8,1,848,906,-58
1,0,22,8,1,906,879,27
1,1,0,8,1,928,974,-46
1,1,1,8,1,974,883,91
1,1,2,8,1,883,768,115
1,1,3,8,1,768,775,-7
1,1,4,8,1,775,793,-18
1,1,5,8,1,793,769,24
1,1,6,8,1,769,739,30
1,1,7,8,1,739,709,30
1,1,8,8,1,709,707,2
1,1,9,8,1,707,690,17
1,1,10,8,1,690,688,2
1,1,11,8,1,688,694,-6
1,1,12,8,1,694,698,-4
1,1,13,8,1,698,695,3
1,1,14,8,1,695,701,-6
1,1,15,8,1,701,746,-45
1,1,16,8,1,746,729,17
1,1,17,8,1,729,796,-67
1,1,18,8,1,796,817,-21
1,1,19,8,1,817,810,7
1,1,20,8,1,810,873,-63
1,1,21,8,1,873,915,-42
1,1,22,8,1,915,908,7
1,2,0,8,1,928,932,-4
1,2,1,8,1,932,845,87
1,2,2,8,1,845,705,140
1,2,3,8,1,705,704,1
1,2,4,8,1,704,740,-36
1,2,5,8,1,740,711,29
1,2,6,8,1,711,699,12
1,2,7,8,1,699,665,34
1,2,8,8,1,665,642,23
1,2,9,8,1,642,615,27
1,2,10,8,1,615,621,-6
1,2,11,8,1,621,630,-9
1,2,12,8,1,630,622,8
1,2,13,8,1,622,617,5
1,2,14,8,1,617,647,-30
1,2,15,8,1,647,690,-43
1,2,16,8,1,690,688,2
1,2,17,8,1,688,750,-62
1,2,18,8,1,750,762,-12
1,2,19,8,1,762,760,2
1,2,20,8,1,760,822,-62
1,2,21,8,1,822,877,-55
1,2,22,8,1,877,909,-32
1,3,0,8,1,926,861,65
1,3,1,8,1,861,793,68
1,3,2,8,1,793,674,119
1,3,3,8,1,674,742,-68
1,3,4,8,1,742,750,-8
1,3,5,8,1,750,726,24
1,3,6,8,1,726,738,-12
1,3,7,8,1,738,692,46
1,3,8,8,1,692,657,35
1,3,9,8,1,657,638,19
1,3,10,8,1,638,633,5
1,3,11,8,1,633,649,-16
1,3,12,8,1,649,646,3
1,3,13,8,1,646,631,15
1,3,14,8,1,631,665,-34
1,3,15,8,1,665,718,-53
1,3,16,8,1,718,728,-10
1,3,17,8,1,728,753,-25
1,3,18,8,1,753,775,-22
1,3,19,8,1,775,772,3
1,3,20,8,1,772,794,-22
1,3,21,8,1,794,861,-67
1,3,22,8,1,861,909,-48
1,4,0,8,1,953,844,109
1,4,1,8,1,844,773,71
1,4,2,8,1,773,692,81
1,4,3,8,1,692,883,-191
1,4,4,8,1,883,810,73
1,4,5,8,1,810,837,-27
1,4,6,8,1,837,853,-16
1,4,7,8,1,853,836,17
1,4,8,8,1,836,766,70
1,4,9,8,1,766,766,0
1,4,10,8,1,766,748,18
1,4,11,8,1,748,778,-30
1,4,12,8,1,778,783,-5
1,4,13,8,1,783,750,33
1,4,14,8,1,750,787,-37
1,4,15,8,1,787,870,-83
1,4,16,8,1,870,865,5
1,4,17,8,1,865,820,45
1,4,18,8,1,820,865,-45
1,4,19,8,1,865,878,-13
1,4,20,8,1,878,859,19
1,4,21,8,1,859,923,-64
1,4,22,8,1,923,932,-9
1,5,0,8,1,990,872,118
1,5,1,8,1,872,763,109
1,5,2,8,1,763,703,60
1,5,3,8,1,703,994,-291
1,5,4,8,1,994,891,103
1,5,5,8,1,891,956,-65
1,5,6,8,1,956,1001,-45
1,5,7,8,1,1001,1014,-13
1,5,8,8,1,1014,826,188
1,5,9,8,1,826,832,-6
1,5,10,8,1,832,818,14
1,5,11,8,1,818,865,-47
1,5,12,8,1,865,849,16
1,5,13,8,1,849,806,43
1,5,14,8,1,806,898,-92
1,5,15,8,1,898,1062,-164
1,5,16,8,1,1062,1028,34
1,5,17,8,1,1028,914,114
1,5,18,8,1,914,964,-50
1,5,19,8,1,964,981,-17
1,5,20,8,1,981,946,35
1,5,21,8,1,946,1009,-63
1,5,22,8,1,1009,953,56
1,6,0,8,1,1022,909,113
1,6,1,8,1,909,753,156
1,6,2,8,1,753,707,46
1,6,3,8,1,707,1056,-349
1,6,4,8,1,1056,1035,21
1,6,5,8,1,1035,1057,-22
1,6,6,8,1,1057,1195,-138
1,6,7,8,1,1195,1194,1
1,6,8,8,1,1194,858,336
1,6,9,8,1,858,871,-13
1,6,10,8,1,871,846,25
1,6,11,8,1,846,910,-64
1,6,12,8,1,910,880,30
1,6,13,8,1,880,832,48
1,6,14,8,1,832,989,-157
1,6,15,8,1,989,1256,-267
1,6,16,8,1,1256,1187,69
1,6,17,8,1,1187,1051,136
1,6,18,8,1,1051,1070,-19
1,6,19,8,1,1070,1042,28
1,6,20,8,1,1042,1015,27
1,6,21,8,1,1015,1088,-73
1,6,22,8,1,1088,979,109
1,7,0,8,1,1054,954,100
1,7,1,8,1,954,759,195
1,7,2,8,1,759,740,19
1,7,3,8,1,740,1145,-405
1,7,4,8,1,1145,1207,-62
1,7,5,8,1,1207,1133,74
1,7,6,8,1,1133,1368,-235
1,7,7,8,1,1368,1361,7
1,7,8,8,1,1361,889,472
1,7,9,8,1,889,929,-40
1,7,10,8,1,929,870,59
1,7,11,8,1,870,950,-80
1,7,12,8,1,950,923,27
1,7,13,8,1,923,868,55
1,7,14,8,1,868,1076,-208
1,7,15,8,1,1076,1420,-344
1,7,16,8,1,1420,1301,119
1,7,17,8,1,1301,1210,91
1,7,18,8,1,1210,1196,14
1,7,19,8,1,1196,1098,98
1,7,20,8,1,1098,1103,-5
1,7,21,8,1,1103,1173,-70
1,7,22,8,1,1173,1018,155
1,8,0,8,1,1070,998,72
1,8,1,8,1,998,776,222
1,8,2,8,1,776,810,-34
1,8,3,8,1,810,1312,-502
1,8,4,8,1,1312,1400,-88
1,8,5,8,1,1400,1215,185
1,8,6,8,1,1215,1500,-285
1,8,7,8,1,1500,1504,-4
1,8,8,8,1,1504,876,628
1,8,9,8,1,876,950,-74
1,8,10,8,1,950,865,85
1,8,11,8,1,865,956,-91
1,8,12,8,1,956,917,39
1,8,13,8,1,917,857,60
1,8,14,8,1,857,1140,-283
1,8,15,8,1,1140,1576,-436
1,8,16,8,1,1576,1388,188
1,8,17,8,1,1388,1378,10
1,8,18,8,1,1378,1342,36
1,8,19,8,1,1342,1175,167
1,8,20,8,1,1175,1217,-42
1,8,21,8,1,1217,1249,-32
1,8,22,8,1,1249,1034,215
1,9,0,8,1,1052,971,81
1,9,1,8,1,971,730,241
1,9,2,8,1,730,851,-121
1,9,3,8,1,851,1468,-617
1,9,4,8,1,1468,1555,-87
1,9,5,8,1,1555,1210,345
1,9,6,8,1,1210,1627,-417
1,9,7,8,1,1627,1616,11
1,9,8,8,1,1616,848,768
1,9,9,8,1,848,937,-89
1,9,10,8,1,937,822,115
1,9,11,8,1,822,937,-115
1,9,12,8,1,937,883,54
1,9,13,8,1,883,817,66
1,9,14,8,1,817,1176,-359
1,9,15,8,1,1176,1696,-520
1,9,16,8,1,1696,1427,269
1,9,17,8,1,1427,1438,-11
1,9,18,8,1,1438,1466,-28
1,9,19,8,1,1466,1232,234
1,9,20,8,1,1232,1257,-25
1,9,21,8,1,1257,1248,9
1,9,22,8,1,1248,1043,205
1,10,0,8,1,1054,977,77
1,10,1,8,1,977,724,253
1,10,2,8,1,724,954,-230
1,10,3,8,1,954,1634,-680
1,10,4,8,1,1634,1691,-57
1,10,5,8,1,1691,1278,413
1,10,6,8,1,1278,1791,-513
1,10,7,8,1,1791,1748,43
1,10,8,8,1,1748,878,870
1,10,9,8,1,878,1018,-140
1,10,10,8,1,1018,853,165
1,10,11,8,1,853,981,-128
1,10,12,8,1,981,938,43
1,10,13,8,1,938,851,87
1,10,14,8,1,851,1263,-412
1,10,15,8,1,1263,1879,-616
1,10,16,8,1,1879,1522,357
1,10,17,8,1,1522,1455,67
1,10,18,8,1,1455,1579,-124
1,10,19,8,1,1579,1355,224
1,10,20,8,1,1355,1363,-8
1,10,21,8,1,1363,1265,98
1,10,22,8,1,1265,1095,170
1,11,0,8,1,1072,1025,47
1,11,1,8,1,1025,740,285
1,11,2,8,1,740,1062,-322
1,11,3,8,1,1062,1724,-662
1,11,4,8,1,1724,1752,-28
1,11,5,8,1,1752,1224,528
1,11,6,8,1,1224,1762,-538
1,11,7,8,1,1762,1718,44
1,11,8,8,1,1718,823,895
1,11,9,8,1,823,961,-138
1,11,10,8,1,961,818,143
1,11,11,8,1,818,963,-145
1,11,12,8,1,963,881,82
1,11,13,8,1,881,830,51
1,11,14,8,1,830,1216,-386
1,11,15,8,1,1216,1801,-585
1,11,16,8,1,1801,1531,270
1,11,17,8,1,1531,1416,115
1,11,18,8,1,1416,1584,-168
1,11,19,8,1,1584,1440,144
1,11,20,8,1,1440,1445,-5
1,11,21,8,1,1445,1247,198
1,11,22,8,1,1247,1110,137
1,12,0,8,1,1123,1015,108
1,12,1,8,1,1015,754,261
1,12,2,8,1,754,1173,-419
1,12,3,8,1,1173,1601,-428
1,12,4,8,1,1601,1657,-56
1,12,5,8,1,1657,1073,584
1,12,6,8,1,1073,1631,-558
1,12,7,8,1,1631,1689,-58
1,12,8,8,1,1689,768,921
1,12,9,8,1,768,925,-157
1,12,10,8,1,925,771,154
1,12,11,8,1,771,930,-159
1,12,12,8,1,930,838,92
1,12,13,8,1,838,756,82
1,12,14,8,1,756,1092,-336
1,12,15,8,1,1092,1747,-655
1,12,16,8,1,1747,1503,244
1,12,17,8,1,1503,1301,202
1,12,18,8,1,1301,1436,-135
1,12,19,8,1,1436,1404,32
1,12,20,8,1,1404,1355,49
1,12,21,8,1,1355,1148,207
1,12,22,8,1,1148,1177,-29
1,13,0,8,1,1162,944,218
1,13,1,8,1,944,718,226
1,13,2,8,1,718,1277,-559
1,13,3,8,1,1277,1461,-184
1,13,4,8,1,1461,1499,-38
1,13,5,8,1,1499,933,566
1,13,6,8,1,933,1586,-653
1,13,7,8,1,1586,1701,-115
1,13,8,8,1,1701,789,912
1,13,9,8,1,789,964,-175
1,13,10,8,1,964,776,188
1,13,11,8,1,776,951,-175
1,13,12,8,1,951,873,78
1,13,13,8,1,873,737,136
1,13,14,8,1,737,1008,-271
1,13,15,8,1,1008,1634,-626
1,13,16,8,1,1634,1385,249
1,13,17,8,1,1385,1149,236
1,13,18,8,1,1149,1291,-142
1,13,19,8,1,1291,1349,-58
1,13,20,8,1,1349,1203,146
1,13,21,8,1,1203,1004,199
1,13,22,8,1,1004,1257,-253
1,14,0,8,1,1219,857,362
1,14,1,8,1,857,697,160
1,14,2,8,1,697,1389,-692
1,14,3,8,1,1389,1336,53
1,14,4,8,1,1336,1278,58
1,14,5,8,1,1278,821,457
1,14,6,8,1,821,1437,-616
1,14,7,8,1,1437,1597,-160
1,14,8,8,1,1597,730,867
1,14,9,8,1,730,884,-154
1,14,10,8,1,884,727,157
1,14,11,8,1,727,929,-202
1,14,12,8,1,929,813,116
1,14,13,8,1,813,670,143
1,14,14,8,1,670,906,-236
1,14,15,8,1,906,1428,-522
1,14,16,8,1,1428,1238,190
1,14,17,8,1,1238,986,252
1,14,18,8,1,986,1162,-176
1,14,19,8,1,1162,1273,-111
1,14,20,8,1,1273,1104,169
1,14,21,8,1,1104,903,201
1,14,22,8,1,903,1296,-393
1,15,0,8,1,1164,762,402
1,15,1,8,1,762,658,104
1,15,2,8,1,658,1387,-729
1,15,3,8,1,1387,1200,187
1,15,4,8,1,1200,1061,139
1,15,5,8,1,1061,723,338
1,15,6,8,1,723,1301,-578
1,15,7,8,1,1301,1512,-211
1,15,8,8,1,1512,679,833
1,15,9,8,1,679,827,-148
1,15,10,8,1,827,695,132
1,15,11,8,1,695,936,-241
1,15,12,8,1,936,784,152
1,15,13,8,1,784,599,185
1,15,14,8,1,599,849,-250
1,15,15,8,1,849,1299,-450
1,15,16,8,1,1299,1128,171
1,15,17,8,1,1128,776,352
1,15,18,8,1,776,1007,-231
1,15,19,8,1,1007,1168,-161
1,15,20,8,1,1168,963,205
1,15,21,8,1,963,756,207
1,15,22,8,1,756,1198,-442
1,16,0,8,1,1129,662,467
1,16,1,8,1,662,605,57
1,16,2,8,1,605,1337,-732
1,16,3,8,1,1337,1062,275
1,16,4,8,1,1062,876,186
1,16,5,8,1,876,607,269
1,16,6,8,1,607,1144,-537
1,16,7,8,1,1144,1400,-256
1,16,8,8,1,1400,694,706
1,16,9,8,1,694,764,-70
1,16,10,8,1,764,661,103
1,16,11,8,1,661,963,-302
1,16,12,8,1,963,782,181
1,16,13,8,1,782,605,177
1,16,14,8,1,605,783,-178
1,16,15,8,1,783,1151,-368
1,16,16,8,1,1151,1024,127
1,16,17,8,1,1024,571,453
1,16,18,8,1,571,854,-283
1,16,19,8,1,854,1073,-219
1,16,20,8,1,1073,798,275
1,16,21,8,1,798,644,154
1,16,22,8,1,644,1104,-460
1,0,0,9,1,1038,1081,-43
1,0,1,9,1,1081,979,102
1,0,2,9,1,979,866,113
1,0,3,9,1,866,886,-20
1,0,4,9,1,886,904,-18
1,0,5,9,1,904,873,31
1,0,6,9,1,873,845,28
1,0,7,9,1,845,813,32
1,0,8,9,1,813,810,3
1,0,9,9,1,810,792,18
1,0,10,9,1,792,790,2
1,0,11,9,1,790,796,-6
1,0,12,9,1,796,801,-5
1,0,13,9,1,801,799,2
1,0,14,9,1,799,806,-7
1,0,15,9,1,806,844,-38
1,0,16,9,1,844,831,13
1,0,17,9,1,831,906,-75
1,0,18,9,1,906,925,-19
1,0,19,9,1,925,908,17
1,0,20,9,1,908,976,-68
1,0,21,9,1,976,1024,-48
1,0,22,9,1,1024,1010,14
1,1,0,9,1,1034,1043,-9
1,1,1,9,1,1043,952,91
1,1,2,9,1,952,811,141
1,1,3,9,1,811,816,-5
1,1,4,9,1,816,848,-32
1,1,5,9,1,848,813,35
1,1,6,9,1,813,806,7
1,1,7,9,1,806,773,33
1,1,8,9,1,773,748,25
1,1,9,9,1,748,719,29
1,1,10,9,1,719,724,-5
1,1,11,9,1,724,733,-9
1,1,12,9,1,733,726,7
1,1,13,9,1,726,722,4
1,1,14,9,1,722,754,-32
1,1,15,9,1,754,805,-51
1,1,16,9,1,805,795,10
1,1,17,9,1,795,854,-59
1,1,18,9,1,854,864,-10
1,1,19,9,1,864,861,3
1,1,20,9,1,861,933,-72
1,1,21,9,1,933,991,-58
1,1,22,9,1,991,1011,-20
1,2,0,9,1,1032,976,56
1,2,1,9,1,976,905,71
1,2,2,9,1,905,781,124
1,2,3,9,1,781,852,-71
1,2,4,9,1,852,858,-6
1,2,5,9,1,858,834,24
1,2,6,9,1,834,856,-22
1,2,7,9,1,856,807,49
1,2,8,9,1,807,770,37
1,2,9,9,1,770,747,23
1,2,10,9,1,747,740,7
1,2,11,9,1,740,755,-15
1,2,12,9,1,755,754,1
1,2,13,9,1,754,741,13
1,2,14,9,1,741,776,-35
1,2,15,9,1,776,835,-59
1,2,16,9,1,835,837,-2
1,2,17,9,1,837,862,-25
1,2,18,9,1,862,882,-20
1,2,19,9,1,882,875,7
1,2,20,9,1,875,904,-29
1,2,21,9,1,904,976,-72
1,2,22,9,1,976,1015,-39
1,3,0,9,1,1065,961,104
1,3,1,9,1,961,883,78
1,3,2,9,1,883,797,86
1,3,3,9,1,797,995,-198
1,3,4,9,1,995,925,70
1,3,5,9,1,925,949,-24
1,3,6,9,1,949,968,-19
1,3,7,9,1,968,908,60
1,3,8,9,1,908,835,73
1,3,9,9,1,835,832,3
1,3,10,9,1,832,811,21
1,3,11,9,1,811,840,-29
1,3,12,9,1,840,846,-6
1,3,13,9,1,846,815,31
1,3,14,9,1,815,854,-39
1,3,15,9,1,854,960,-106
1,3,16,9,1,960,964,-4
1,3,17,9,1,964,937,27
1,3,18,9,1,937,986,-49
1,3,19,9,1,986,985,1
1,3,20,9,1,985,963,22
1,3,21,9,1,963,1034,-71
1,3,22,9,1,1034,1043,-9
1,4,0,9,1,1104,991,113
1,4,1,9,1,991,877,114
1,4,2,9,1,877,818,59
1,4,3,9,1,818,1120,-302
1,4,4,9,1,1120,1011,109
1,4,5,9,1,1011,1050,-39
1,4,6,9,1,1050,1077,-27
1,4,7,9,1,1077,1068,9
1,4,8,9,1,1068,877,191
1,4,9,9,1,877,880,-3
1,4,10,9,1,880,863,17
1,4,11,9,1,863,909,-46
1,4,12,9,1,909,894,15
1,4,13,9,1,894,853,41
1,4,14,9,1,853,946,-93
1,4,15,9,1,946,1121,-175
1,4,16,9,1,1121,1103,18
1,4,17,9,1,1103,1020,83
1,4,18,9,1,1020,1087,-67
1,4,19,9,1,1087,1096,-9
1,4,20,9,1,1096,1056,40
1,4,21,9,1,1056,1122,-66
1,4,22,9,1,1122,1063,59
1,5,0,9,1,1136,1031,105
1,5,1,9,1,1031,873,158
1,5,2,9,1,873,826,47
1,5,3,9,1,826,1181,-355
1,5,4,9,1,1181,1144,37
1,5,5,9,1,1144,1126,18
1,5,6,9,1,1126,1234,-108
1,5,7,9,1,1234,1263,-29
1,5,8,9,1,1263,926,337
1,5,9,9,1,926,938,-12
1,5,10,9,1,938,911,27
1,5,11,9,1,911,975,-64
1,5,12,9,1,975,945,30
1,5,13,9,1,945,897,48
1,5,14,9,1,897,1055,-158
1,5,15,9,1,1055,1311,-256
1,5,16,9,1,1311,1245,66
1,5,17,9,1,1245,1132,113
1,5,18,9,1,1132,1177,-45
1,5,19,9,1,1177,1158,19
1,5,20,9,1,1158,1134,24
1,5,21,9,1,1134,1206,-72
1,5,22,9,1,1206,1087,119
1,6,0,9,1,1174,1078,96
1,6,1,9,1,1078,868,210
1,6,2,9,1,868,829,39
1,6,3,9,1,829,1232,-403
1,6,4,9,1,1232,1289,-57
1,6,5,9,1,1289,1200,89
1,6,6,9,1,1200,1426,-226
1,6,7,9,1,1426,1430,-4
1,6,8,9,1,1430,958,472
1,6,9,9,1,958,998,-40
1,6,10,9,1,998,939,59
1,6,11,9,1,939,1019,-80
1,6,12,9,1,1019,992,27
1,6,13,9,1,992,936,56
1,6,14,9,1,936,1144,-208
1,6,15,9,1,1144,1497,-353
1,6,16,9,1,1497,1367,130
1,6,17,9,1,1367,1281,86
1,6,18,9,1,1281,1283,-2
1,6,19,9,1,1283,1195,88
1,6,20,9,1,1195,1210,-15
1,6,21,9,1,1210,1289,-79
1,6,22,9,1,1289,1133,156
1,7,0,9,1,1200,1123,77
1,7,1,9,1,1123,866,257
1,7,2,9,1,866,859,7
1,7,3,9,1,859,1352,-493
1,7,4,9,1,1352,1457,-105
1,7,5,9,1,1457,1297,160
1,7,6,9,1,1297,1605,-308
1,7,7,9,1,1605,1599,6
1,7,8,9,1,1599,972,627
1,7,9,9,1,972,1047,-75
1,7,10,9,1,1047,964,83
1,7,11,9,1,964,1055,-91
1,7,12,9,1,1055,1015,40
1,7,13,9,1,1015,954,61
1,7,14,9,1,954,1236,-282
1,7,15,9,1,1236,1675,-439
1,7,16,9,1,1675,1472,203
1,7,17,9,1,1472,1457,15
1,7,18,9,1,1457,1419,38
1,7,19,9,1,1419,1247,172
1,7,20,9,1,1247,1301,-54
1,7,21,9,1,1301,1359,-58
1,7,22,9,1,1359,1159,200
1,8,0,9,1,1178,1112,66
1,8,1,9,1,1112,851,261
1,8,2,9,1,851,929,-78
1,8,3,9,1,929,1531,-602
1,8,4,9,1,1531,1649,-118
1,8,5,9,1,1649,1345,304
1,8,6,9,1,1345,1748,-403
1,8,7,9,1,1748,1743,5
1,8,8,9,1,1743,983,760
1,8,9,9,1,983,1067,-84
1,8,10,9,1,1067,959,108
1,8,11,9,1,959,1083,-124
1,8,12,9,1,1083,1029,54
1,8,13,9,1,1029,955,74
1,8,14,9,1,955,1314,-359
1,8,15,9,1,1314,1830,-516
1,8,16,9,1,1830,1558,272
1,8,17,9,1,1558,1567,-9
1,8,18,9,1,1567,1559,8
1,8,19,9,1,1559,1331,228
1,8,20,9,1,1331,1385,-54
1,8,21,9,1,1385,1366,19
1,8,22,9,1,1366,1174,192
1,9,0,9,1,1160,1046,114
1,9,1,9,1,1046,793,253
1,9,2,9,1,793,997,-204
1,9,3,9,1,997,1675,-678
1,9,4,9,1,1675,1746,-71
1,9,5,9,1,1746,1322,424
1,9,6,9,1,1322,1858,-536
1,9,7,9,1,1858,1812,46
1,9,8,9,1,1812,919,893
1,9,9,9,1,919,1047,-128
1,9,10,9,1,1047,889,158
1,9,11,9,1,889,1020,-131
1,9,12,9,1,1020,966,54
1,9,13,9,1,966,878,88
1,9,14,9,1,878,1316,-438
1,9,15,9,1,1316,1938,-622
1,9,16,9,1,1938,1588,350
1,9,17,9,1,1588,1513,75
1,9,18,9,1,1513,1626,-113
1,9,19,9,1,1626,1406,220
1,9,20,9,1,1406,1423,-17
1,9,21,9,1,1423,1341,82
1,9,22,9,1,1341,1198,143
1,10,0,9,1,1176,1069,107
1,10,1,9,1,1069,800,269
1,10,2,9,1,800,1138,-338
1,10,3,9,1,1138,1872,-734
1,10,4,9,1,1872,1870,2
1,10,5,9,1,1870,1347,523
1,10,6,9,1,1347,1919,-572
1,10,7,9,1,1919,1860,59
1,10,8,9,1,1860,951,909
1,10,9,9,1,951,1093,-142
1,10,10,9,1,1093,937,156
1,10,11,9,1,937,1088,-151
1,10,12,9,1,1088,1013,75
1,10,13,9,1,1013,954,59
1,10,14,9,1,954,1345,-391
1,10,15,9,1,1345,1946,-601
1,10,16,9,1,1946,1680,266
1,10,17,9,1,1680,1528,152
1,10,18,9,1,1528,1704,-176
1,10,19,9,1,1704,1555,149
1,10,20,9,1,1555,1527,28
1,10,21,9,1,1527,1346,181
1,10,22,9,1,1346,1216,130
1,11,0,9,1,1262,1115,147
1,11,1,9,1,1115,844,271
1,11,2,9,1,844,1296,-452
1,11,3,9,1,1296,1854,-558
1,11,4,9,1,1854,1832,22
1,11,5,9,1,1832,1296,536
1,11,6,9,1,1296,1861,-565
1,11,7,9,1,1861,1905,-44
1,11,8,9,1,1905,946,959
1,11,9,9,1,946,1119,-173
1,11,10,9,1,1119,949,170
1,11,11,9,1,949,1121,-172
1,11,12,9,1,1121,1038,83
1,11,13,9,1,1038,940,98
1,11,14,9,1,940,1281,-341
1,11,15,9,1,1281,1989,-708
1,11,16,9,1,1989,1739,250
1,11,17,9,1,1739,1485,254
1,11,18,9,1,1485,1647,-162
1,11,19,9,1,1647,1617,30
1,11,20,9,1,1617,1524,93
1,11,21,9,1,1524,1321,203
1,11,22,9,1,1321,1311,10
1,12,0,9,1,1313,1091,222
1,12,1,9,1,1091,822,269
1,12,2,9,1,822,1403,-581
1,12,3,9,1,1403,1698,-295
1,12,4,9,1,1698,1700,-2
1,12,5,9,1,1700,1146,554
1,12,6,9,1,1146,1810,-664
1,12,7,9,1,1810,1933,-123
1,12,8,9,1,1933,900,1033
1,12,9,9,1,900,1078,-178
1,12,10,9,1,1078,891,187
1,12,11,9,1,891,1082,-191
1,12,12,9,1,1082,984,98
1,12,13,9,1,984,840,144
1,12,14,9,1,840,1167,-327
1,12,15,9,1,1167,1885,-718
1,12,16,9,1,1885,1623,262
1,12,17,9,1,1623,1349,274
1,12,18,9,1,1349,1513,-164
1,12,19,9,1,1513,1567,-54
1,12,20,9,1,1567,1400,167
1,12,21,9,1,1400,1203,197
1,12,22,9,1,1203,1388,-185
1,13,0,9,1,1365,1016,349
1,13,1,9,1,1016,807,209
1,13,2,9,1,807,1512,-705
1,13,3,9,1,1512,1523,-11
1,13,4,9,1,1523,1531,-8
1,13,5,9,1,1531,991,540
1,13,6,9,1,991,1670,-679
1,13,7,9,1,1670,1846,-176
1,13,8,9,1,1846,830,1016
1,13,9,9,1,830,990,-160
1,13,10,9,1,990,820,170
1,13,11,9,1,820,1039,-219
1,13,12,9,1,1039,909,130
1,13,13,9,1,909,761,148
1,13,14,9,1,761,1063,-302
1,13,15,9,1,1063,1677,-614
1,13,16,9,1,1677,1455,222
1,13,17,9,1,1455,1204,251
1,13,18,9,1,1204,1375,-171
1,13,19,9,1,1375,1450,-75
1,13,20,9,1,1450,1292,158
1,13,21,9,1,1292,1100,192
1,13,22,9,1,1100,1430,-330
1,14,0,9,1,1316,931,385
1,14,1,9,1,931,773,158
1,14,2,9,1,773,1509,-736
1,14,3,9,1,1509,1376,133
1,14,4,9,1,1376,1315,61
1,14,5,9,1,1315,866,449
1,14,6,9,1,866,1532,-666
1,14,7,9,1,1532,1748,-216
1,14,8,9,1,1748,779,969
1,14,9,9,1,779,954,-175
1,14,10,9,1,954,788,166
1,14,11,9,1,788,1045,-257
1,14,12,9,1,1045,896,149
1,14,13,9,1,896,703,193
1,14,14,9,1,703,1004,-301
1,14,15,9,1,1004,1540,-536
1,14,16,9,1,1540,1308,232
1,14,17,9,1,1308,1006,302
1,14,18,9,1,1006,1220,-214
1,14,19,9,1,1220,1321,-101
1,14,20,9,1,1321,1158,163
1,14,21,9,1,1158,957,201
1,14,22,9,1,957,1352,-395
1,15,0,9,1,1275,831,444
1,15,1,9,1,831,712,119
1,15,2,9,1,712,1456,-744
1,15,3,9,1,1456,1269,187
1,15,4,9,1,1269,1126,143
1,15,5,9,1,1126,771,355
1,15,6,9,1,771,1381,-610
1,15,7,9,1,1381,1638,-257
1,15,8,9,1,1638,777,861
1,15,9,9,1,777,882,-105
1,15,10,9,1,882,755,127
1,15,11,9,1,755,1068,-313
1,15,12,9,1,1068,874,194
1,15,13,9,1,874,691,183
1,15,14,9,1,691,943,-252
1,15,15,9,1,943,1406,-463
1,15,16,9,1,1406,1195,211
1,15,17,9,1,1195,818,377
1,15,18,9,1,818,1077,-259
1,15,19,9,1,1077,1222,-145
1,15,20,9,1,1222,996,226
1,15,21,9,1,996,830,166
1,15,22,9,1,830,1245,-415
1,0,0,10,1,1144,1150,-6
1,0,1,10,1,1150,1048,102
1,0,2,10,1,1048,909,139
1,0,3,10,1,909,927,-18
1,0,4,10,1,927,959,-32
1,0,5,10,1,959,917,42
1,0,6,10,1,917,912,5
1,0,7,10,1,912,877,35
1,0,8,10,1,877,851,26
1,0,9,10,1,851,821,30
1,0,10,10,1,821,826,-5
1,0,11,10,1,826,835,-9
1,0,12,10,1,835,829,6
1,0,13,10,1,829,826,3
1,0,14,10,1,826,859,-33
1,0,15,10,1,859,903,-44
1,0,16,10,1,903,897,6
1,0,17,10,1,897,964,-67
1,0,18,10,1,964,972,-8
1,0,19,10,1,972,959,13
1,0,20,10,1,959,1036,-77
1,0,21,10,1,1036,1100,-64
1,0,22,10,1,1100,1113,-13
1,1,0,10,1,1138,1087,51
1,1,1,10,1,1087,1012,75
1,1,2,10,1,1012,887,125
1,1,3,10,1,887,964,-77
1,1,4,10,1,964,966,-2
1,1,5,10,1,966,936,30
1,1,6,10,1,936,963,-27
1,1,7,10,1,963,915,48
1,1,8,10,1,915,876,39
1,1,9,10,1,876,851,25
1,1,10,10,1,851,843,8
1,1,11,10,1,843,858,-15
1,1,12,10,1,858,858,0
1,1,13,10,1,858,846,12
1,1,14,10,1,846,883,-37
1,1,15,10,1,883,950,-67
1,1,16,10,1,950,944,6
1,1,17,10,1,944,966,-22
1,1,18,10,1,966,984,-18
1,1,19,10,1,984,976,8
1,1,20,10,1,976,1015,-39
1,1,21,10,1,1015,1090,-75
1,1,22,10,1,1090,1117,-27
1,2,0,10,1,1171,1076,95
1,2,1,10,1,1076,995,81
1,2,2,10,1,995,904,91
1,2,3,10,1,904,1105,-201
1,2,4,10,1,1105,1033,72
1,2,5,10,1,1033,1057,-24
1,2,6,10,1,1057,1086,-29
1,2,7,10,1,1086,1023,63
1,2,8,10,1,1023,948,75
1,2,9,10,1,948,941,7
1,2,10,10,1,941,918,23
1,2,11,10,1,918,946,-28
1,2,12,10,1,946,954,-8
1,2,13,10,1,954,925,29
1,2,14,10,1,925,965,-40
1,2,15,10,1,965,1077,-112
1,2,16,10,1,1077,1073,4
1,2,17,10,1,1073,1046,27
1,2,18,10,1,1046,1093,-47
1,2,19,10,1,1093,1088,5
1,2,20,10,1,1088,1073,15
1,2,21,10,1,1073,1149,-76
1,2,22,10,1,1149,1149,0
1,3,0,10,1,1216,1108,108
1,3,1,10,1,1108,987,121
1,3,2,10,1,987,923,64
1,3,3,10,1,923,1232,-309
1,3,4,10,1,1232,1126,106
1,3,5,10,1,1126,1162,-36
1,3,6,10,1,1162,1192,-30
1,3,7,10,1,1192,1140,52
1,3,8,10,1,1140,946,194
1,3,9,10,1,946,946,0
1,3,10,10,1,946,926,20
1,3,11,10,1,926,971,-45
1,3,12,10,1,971,957,14
1,3,13,10,1,957,918,39
1,3,14,10,1,918,1013,-95
1,3,15,10,1,1013,1211,-198
1,3,16,10,1,1211,1202,9
1,3,17,10,1,1202,1137,65
1,3,18,10,1,1137,1208,-71
1,3,19,10,1,1208,1203,5
1,3,20,10,1,1203,1160,43
1,3,21,10,1,1160,1233,-73
1,3,22,10,1,1233,1174,59
1,4,0,10,1,1250,1150,100
1,4,1,10,1,1150,987,163
1,4,2,10,1,987,941,46
1,4,3,10,1,941,1307,-366
1,4,4,10,1,1307,1264,43
1,4,5,10,1,1264,1220,44
1,4,6,10,1,1220,1310,-90
1,4,7,10,1,1310,1317,-7
1,4,8,10,1,1317,977,340
1,4,9,10,1,977,986,-9
1,4,10,10,1,986,956,30
1,4,11,10,1,956,1019,-63
1,4,12,10,1,1019,990,29
1,4,13,10,1,990,944,46
1,4,14,10,1,944,1103,-159
1,4,15,10,1,1103,1370,-267
1,4,16,10,1,1370,1320,50
1,4,17,10,1,1320,1238,82
1,4,18,10,1,1238,1300,-62
1,4,19,10,1,1300,1273,27
1,4,20,10,1,1273,1244,29
1,4,21,10,1,1244,1319,-75
1,4,22,10,1,1319,1197,122
1,5,0,10,1,1288,1200,88
1,5,1,10,1,1200,988,212
1,5,2,10,1,988,948,40
1,5,3,10,1,948,1357,-409
1,5,4,10,1,1357,1398,-41
1,5,5,10,1,1398,1269,129
1,5,6,10,1,1269,1465,-196
1,5,7,10,1,1465,1499,-34
1,5,8,10,1,1499,1026,473
1,5,9,10,1,1026,1065,-39
1,5,10,10,1,1065,1004,61
1,5,11,10,1,1004,1084,-80
1,5,12,10,1,1084,1057,27
1,5,13,10,1,1057,1001,56
1,5,14,10,1,1001,1210,-209
1,5,15,10,1,1210,1552,-342
1,5,16,10,1,1552,1425,127
1,5,17,10,1,1425,1362,63
1,5,18,10,1,1362,1390,-28
1,5,19,10,1,1390,1311,79
1,5,20,10,1,1311,1329,-18
1,5,21,10,1,1329,1407,-78
1,5,22,10,1,1407,1241,166
1,6,0,10,1,1320,1247,73
1,6,1,10,1,1247,975,272
1,6,2,10,1,975,948,27
1,6,3,10,1,948,1439,-491
1,6,4,10,1,1439,1539,-100
1,6,5,10,1,1539,1364,175
1,6,6,10,1,1364,1663,-299
1,6,7,10,1,1663,1668,-5
1,6,8,10,1,1668,1041,627
1,6,9,10,1,1041,1116,-75
1,6,10,10,1,1116,1033,83
1,6,11,10,1,1033,1124,-91
1,6,12,10,1,1124,1084,40
1,6,13,10,1,1084,1022,62
1,6,14,10,1,1022,1304,-282
1,6,15,10,1,1304,1752,-448
1,6,16,10,1,1752,1538,214
1,6,17,10,1,1538,1528,10
1,6,18,10,1,1528,1506,22
1,6,19,10,1,1506,1344,162
1,6,20,10,1,1344,1408,-64
1,6,21,10,1,1408,1475,-67
1,6,22,10,1,1475,1274,201
1,7,0,10,1,1308,1237,71
1,7,1,10,1,1237,941,296
1,7,2,10,1,941,978,-37
1,7,3,10,1,978,1571,-593
1,7,4,10,1,1571,1706,-135
1,7,5,10,1,1706,1427,279
1,7,6,10,1,1427,1853,-426
1,7,7,10,1,1853,1838,15
1,7,8,10,1,1838,1079,759
1,7,9,10,1,1079,1164,-85
1,7,10,10,1,1164,1058,106
1,7,11,10,1,1058,1182,-124
1,7,12,10,1,1182,1127,55
1,7,13,10,1,1127,1052,75
1,7,14,10,1,1052,1410,-358
1,7,15,10,1,1410,1929,-519
1,7,16,10,1,1929,1642,287
1,7,17,10,1,1642,1646,-4
1,7,18,10,1,1646,1636,10
1,7,19,10,1,1636,1403,233
1,7,20,10,1,1403,1469,-66
1,7,21,10,1,1469,1476,-7
1,7,22,10,1,1476,1299,177
1,8,0,10,1,1286,1187,99
1,8,1,10,1,1187,914,273
1,8,2,10,1,914,1075,-161
1,8,3,10,1,1075,1738,-663
1,8,4,10,1,1738,1840,-102
1,8,5,10,1,1840,1457,383
1,8,6,10,1,1457,1979,-522
1,8,7,10,1,1979,1939,40
1,8,8,10,1,1939,1054,885
1,8,9,10,1,1054,1177,-123
1,8,10,10,1,1177,1026,151
1,8,11,10,1,1026,1166,-140
1,8,12,10,1,1166,1112,54
1,8,13,10,1,1112,1016,96
1,8,14,10,1,1016,1454,-438
1,8,15,10,1,1454,2072,-618
1,8,16,10,1,2072,1719,353
1,8,17,10,1,1719,1642,77
1,8,18,10,1,1642,1719,-77
1,8,19,10,1,1719,1505,214
1,8,20,10,1,1505,1551,-46
1,8,21,10,1,1551,1459,92
1,8,22,10,1,1459,1329,130
1,9,0,10,1,1282,1138,144
1,9,1,10,1,1138,869,269
1,9,2,10,1,869,1181,-312
1,9,3,10,1,1181,1913,-732
1,9,4,10,1,1913,1925,-12
1,9,5,10,1,1925,1391,534
1,9,6,10,1,1391,1986,-595
1,9,7,10,1,1986,1924,62
1,9,8,10,1,1924,992,932
1,9,9,10,1,992,1122,-130
1,9,10,10,1,1122,973,149
1,9,11,10,1,973,1127,-154
1,9,12,10,1,1127,1041,86
1,9,13,10,1,1041,981,60
1,9,14,10,1,981,1398,-417
1,9,15,10,1,1398,2005,-607
1,9,16,10,1,2005,1746,259
1,9,17,10,1,1746,1586,160
1,9,18,10,1,1586,1751,-165
1,9,19,10,1,1751,1606,145
1,9,20,10,1,1606,1587,19
1,9,21,10,1,1587,1422,165
1,9,22,10,1,1422,1319,103
1,10,0,10,1,1366,1159,207
1,10,1,10,1,1159,904,255
1,10,2,10,1,904,1372,-468
1,10,3,10,1,1372,2002,-630
1,10,4,10,1,2002,1950,52
1,10,5,10,1,1950,1419,531
1,10,6,10,1,1419,2018,-599
1,10,7,10,1,2018,2047,-29
1,10,8,10,1,2047,1074,973
1,10,9,10,1,1074,1251,-177
1,10,10,10,1,1251,1068,183
1,10,11,10,1,1068,1246,-178
1,10,12,10,1,1246,1170,76
1,10,13,10,1,1170,1064,106
1,10,14,10,1,1064,1410,-346
1,10,15,10,1,1410,2134,-724
1,10,16,10,1,2134,1888,246
1,10,17,10,1,1888,1597,291
1,10,18,10,1,1597,1767,-170
1,10,19,10,1,1767,1732,35
1,10,20,10,1,1732,1606,126
1,10,21,10,1,1606,1420,186
1,10,22,10,1,1420,1417,3
1,11,0,10,1,1452,1191,261
1,11,1,10,1,1191,912,279
1,11,2,10,1,912,1526,-614
1,11,3,10,1,1526,1951,-425
1,11,4,10,1,1951,1875,76
1,11,5,10,1,1875,1369,506
1,11,6,10,1,1369,2040,-671
1,11,7,10,1,2040,2149,-109
1,11,8,10,1,2149,1078,1071
1,11,9,10,1,1078,1272,-194
1,11,10,10,1,1272,1069,203
1,11,11,10,1,1069,1273,-204
1,11,12,10,1,1273,1184,89
1,11,13,10,1,1184,1024,160
1,11,14,10,1,1024,1356,-332
1,11,15,10,1,1356,2127,-771
1,11,16,10,1,2127,1859,268
1,11,17,10,1,1859,1533,326
1,11,18,10,1,1533,1724,-191
1,11,19,10,1,1724,1780,-56
1,11,20,10,1,1780,1569,211
1,11,21,10,1,1569,1376,193
1,11,22,10,1,1376,1522,-146
1,12,0,10,1,1516,1163,353
1,12,1,10,1,1163,911,252
1,12,2,10,1,911,1638,-727
1,12,3,10,1,1638,1760,-122
1,12,4,10,1,1760,1732,28
1,12,5,10,1,1732,1204,528
1,12,6,10,1,1204,1894,-690
1,12,7,10,1,1894,2078,-184
1,12,8,10,1,2078,941,1137
1,12,9,10,1,941,1104,-163
1,12,10,10,1,1104,935,169
1,12,11,10,1,935,1170,-235
1,12,12,10,1,1170,1020,150
1,12,13,10,1,1020,864,156
1,12,14,10,1,864,1222,-358
1,12,15,10,1,1222,1928,-706
1,12,16,10,1,1928,1693,235
1,12,17,10,1,1693,1404,289
1,12,18,10,1,1404,1597,-193
1,12,19,10,1,1597,1668,-71
1,12,20,10,1,1668,1489,179
1,12,21,10,1,1489,1299,190
1,12,22,10,1,1299,1561,-262
1,13,0,10,1,1462,1090,372
1,13,1,10,1,1090,883,207
1,13,2,10,1,883,1632,-749
1,13,3,10,1,1632,1563,69
1,13,4,10,1,1563,1568,-5
1,13,5,10,1,1568,1036,532
1,13,6,10,1,1036,1765,-729
1,13,7,10,1,1765,1997,-232
1,13,8,10,1,1997,879,1118
1,13,9,10,1,879,1060,-181
1,13,10,10,1,1060,881,179
1,13,11,10,1,881,1155,-274
1,13,12,10,1,1155,992,163
1,13,13,10,1,992,794,198
1,13,14,10,1,794,1161,-367
1,13,15,10,1,1161,1789,-628
1,13,16,10,1,1789,1525,264
1,13,17,10,1,1525,1224,301
1,13,18,10,1,1224,1433,-209
1,13,19,10,1,1433,1498,-65
1,13,20,10,1,1498,1346,152
1,13,21,10,1,1346,1154,192
1,13,22,10,1,1154,1486,-332
1,14,0,10,1,1427,1000,427
1,14,1,10,1,1000,827,173
1,14,2,10,1,827,1578,-751
1,14,3,10,1,1578,1445,133
1,14,4,10,1,1445,1380,65
1,14,5,10,1,1380,914,466
1,14,6,10,1,914,1612,-698
1,14,7,10,1,1612,1874,-262
1,14,8,10,1,1874,877,997
1,14,9,10,1,877,1009,-132
1,14,10,10,1,1009,848,161
1,14,11,10,1,848,1177,-329
1,14,12,10,1,1177,986,191
1,14,13,10,1,986,795,191
1,14,14,10,1,795,1098,-303
1,14,15,10,1,1098,1647,-549
1,14,16,10,1,1647,1375,272
1,14,17,10,1,1375,1048,327
1,14,18,10,1,1048,1290,-242
1,14,19,10,1,1290,1375,-85
1,14,20,10,1,1375,1191,184
1,14,21,10,1,1191,1031,160
1,14,22,10,1,1031,1399,-368
1,0,0,11,1,1248,1194,54
1,0,1,11,1,1194,1108,86
1,0,2,11,1,1108,985,123
1,0,3,11,1,985,1075,-90
1,0,4,11,1,1075,1077,-2
1,0,5,11,1,1077,1040,37
1,0,6,11,1,1040,1069,-29
1,0,7,11,1,1069,1019,50
1,0,8,11,1,1019,979,40
1,0,9,11,1,979,953,26
1,0,10,11,1,953,945,8
1,0,11,11,1,945,960,-15
1,0,12,11,1,960,961,-1
1,0,13,11,1,961,950,11
1,0,14,11,1,950,988,-38
1,0,15,11,1,988,1048,-60
1,0,16,11,1,1048,1046,2
1,0,17,11,1,1046,1076,-30
1,0,18,11,1,1076,1092,-16
1,0,19,11,1,1092,1074,18
1,0,20,11,1,1074,1118,-44
1,0,21,11,1,1118,1199,-81
1,0,22,11,1,1199,1219,-20
1,1,0,11,1,1277,1187,90
1,1,1,11,1,1187,1102,85
1,1,2,11,1,1102,1010,92
1,1,3,11,1,1010,1217,-207
1,1,4,11,1,1217,1141,76
1,1,5,11,1,1141,1159,-18
1,1,6,11,1,1159,1193,-34
1,1,7,11,1,1193,1131,62
1,1,8,11,1,1131,1054,77
1,1,9,11,1,1054,1045,9
1,1,10,11,1,1045,1021,24
1,1,11,11,1,1021,1049,-28
1,1,12,11,1,1049,1058,-9
1,1,13,11,1,1058,1030,28
1,1,14,11,1,1030,1072,-42
1,1,15,11,1,1072,1192,-120
1,1,16,11,1,1192,1180,12
1,1,17,11,1,1180,1150,30
1,1,18,11,1,1150,1195,-45
1,1,19,11,1,1195,1189,6
1,1,20,11,1,1189,1184,5
1,1,21,11,1,1184,1263,-79
1,1,22,11,1,1263,1251,12
1,2,0,11,1,1322,1223,99
1,2,1,11,1,1223,1099,124
1,2,2,11,1,1099,1030,69
1,2,3,11,1,1030,1342,-312
1,2,4,11,1,1342,1234,108
1,2,5,11,1,1234,1270,-36
1,2,6,11,1,1270,1310,-40
1,2,7,11,1,1310,1255,55
1,2,8,11,1,1255,1059,196
1,2,9,11,1,1059,1055,4
1,2,10,11,1,1055,1033,22
1,2,11,11,1,1033,1077,-44
1,2,12,11,1,1077,1065,12
1,2,13,11,1,1065,1028,37
1,2,14,11,1,1028,1124,-96
1,2,15,11,1,1124,1328,-204
1,2,16,11,1,1328,1311,17
1,2,17,11,1,1311,1246,65
1,2,18,11,1,1246,1315,-69
1,2,19,11,1,1315,1306,9
1,2,20,11,1,1306,1270,36
1,2,21,11,1,1270,1348,-78
1,2,22,11,1,1348,1280,68
1,3,0,11,1,1362,1267,95
1,3,1,11,1,1267,1097,170
1,3,2,11,1,1097,1046,51
1,3,3,11,1,1046,1419,-373
1,3,4,11,1,1419,1379,40
1,3,5,11,1,1379,1332,47
1,3,6,11,1,1332,1425,-93
1,3,7,11,1,1425,1389,36
1,3,8,11,1,1389,1046,343
1,3,9,11,1,1046,1052,-6
1,3,10,11,1,1052,1019,33
1,3,11,11,1,1019,1081,-62
1,3,12,11,1,1081,1053,28
1,3,13,11,1,1053,1009,44
1,3,14,11,1,1009,1170,-161
1,3,15,11,1,1170,1460,-290
1,3,16,11,1,1460,1419,41
1,3,17,11,1,1419,1355,64
1,3,18,11,1,1355,1421,-66
1,3,19,11,1,1421,1380,41
1,3,20,11,1,1380,1348,32
1,3,21,11,1,1348,1430,-82
1,3,22,11,1,1430,1308,122
1,4,0,11,1,1402,1319,83
1,4,1,11,1,1319,1102,217
1,4,2,11,1,1102,1063,39
1,4,3,11,1,1063,1483,-420
1,4,4,11,1,1483,1518,-35
1,4,5,11,1,1518,1363,155
1,4,6,11,1,1363,1541,-178
1,4,7,11,1,1541,1553,-12
1,4,8,11,1,1553,1077,476
1,4,9,11,1,1077,1113,-36
1,4,10,11,1,1113,1049,64
1,4,11,11,1,1049,1128,-79
1,4,12,11,1,1128,1102,26
1,4,13,11,1,1102,1048,54
1,4,14,11,1,1048,1258,-210
1,4,15,11,1,1258,1611,-353
1,4,16,11,1,1611,1500,111
1,4,17,11,1,1500,1468,32
1,4,18,11,1,1468,1513,-45
1,4,19,11,1,1513,1426,87
1,4,20,11,1,1426,1439,-13
1,4,21,11,1,1439,1520,-81
1,4,22,11,1,1520,1351,169
1,5,0,11,1,1434,1369,65
1,5,1,11,1,1369,1095,274
1,5,2,11,1,1095,1067,28
1,5,3,11,1,1067,1564,-497
1,5,4,11,1,1564,1648,-84
1,5,5,11,1,1648,1433,215
1,5,6,11,1,1433,1702,-269
1,5,7,11,1,1702,1737,-35
1,5,8,11,1,1737,1109,628
1,5,9,11,1,1109,1183,-74
1,5,10,11,1,1183,1098,85
1,5,11,11,1,1098,1189,-91
1,5,12,11,1,1189,1149,40
1,5,13,11,1,1149,1087,62
1,5,14,11,1,1087,1370,-283
1,5,15,11,1,1370,1807,-437
1,5,16,11,1,1807,1596,211
1,5,17,11,1,1596,1609,-13
1,5,18,11,1,1609,1613,-4
1,5,19,11,1,1613,1460,153
1,5,20,11,1,1460,1527,-67
1,5,21,11,1,1527,1593,-66
1,5,22,11,1,1593,1382,211
1,6,0,11,1,1428,1361,67
1,6,1,11,1,1361,1050,311
1,6,2,11,1,1050,1067,-17
1,6,3,11,1,1067,1658,-591
1,6,4,11,1,1658,1788,-130
1,6,5,11,1,1788,1494,294
1,6,6,11,1,1494,1911,-417
1,6,7,11,1,1911,1907,4
1,6,8,11,1,1907,1148,759
1,6,9,11,1,1148,1233,-85
1,6,10,11,1,1233,1127,106
1,6,11,11,1,1127,1251,-124
1,6,12,11,1,1251,1196,55
1,6,13,11,1,1196,1120,76
1,6,14,11,1,1120,1478,-358
1,6,15,11,1,1478,2006,-528
1,6,16,11,1,2006,1708,298
1,6,17,11,1,1708,1717,-9
1,6,18,11,1,1717,1723,-6
1,6,19,11,1,1723,1500,223
1,6,20,11,1,1500,1576,-76
1,6,21,11,1,1576,1592,-16
1,6,22,11,1,1592,1414,178
1,7,0,11,1,1416,1312,104
1,7,1,11,1,1312,1004,308
1,7,2,11,1,1004,1124,-120
1,7,3,11,1,1124,1778,-654
1,7,4,11,1,1778,1897,-119
1,7,5,11,1,1897,1539,358
1,7,6,11,1,1539,2084,-545
1,7,7,11,1,2084,2034,50
1,7,8,11,1,2034,1150,884
1,7,9,11,1,1150,1274,-124
1,7,10,11,1,1274,1125,149
1,7,11,11,1,1125,1265,-140
1,7,12,11,1,1265,1210,55
1,7,13,11,1,1210,1113,97
1,7,14,11,1,1113,1550,-437
1,7,15,11,1,1550,2171,-621
1,7,16,11,1,2171,1803,368
1,7,17,11,1,1803,1721,82
1,7,18,11,1,1721,1796,-75
1,7,19,11,1,1796,1577,219
1,7,20,11,1,1577,1635,-58
1,7,21,11,1,1635,1569,66
1,7,22,11,1,1569,1454,115
1,8,0,11,1,1408,1279,129
1,8,1,11,1,1279,990,289
1,8,2,11,1,990,1259,-269
1,8,3,11,1,1259,1976,-717
1,8,4,11,1,1976,2019,-43
1,8,5,11,1,2019,1526,493
1,8,6,11,1,1526,2107,-581
1,8,7,11,1,2107,2051,56
1,8,8,11,1,2051,1127,924
1,8,9,11,1,1127,1252,-125
1,8,10,11,1,1252,1110,142
1,8,11,11,1,1110,1273,-163
1,8,12,11,1,1273,1187,86
1,8,13,11,1,1187,1119,68
1,8,14,11,1,1119,1536,-417
1,8,15,11,1,1536,2139,-603
1,8,16,11,1,2139,1877,262
1,8,17,11,1,1877,1715,162
1,8,18,11,1,1715,1844,-129
1,8,19,11,1,1844,1705,139
1,8,20,11,1,1705,1715,-10
1,8,21,11,1,1715,1540,175
1,8,22,11,1,1540,1450,90
1,9,0,11,1,1472,1228,244
1,9,1,11,1,1228,973,255
1,9,2,11,1,973,1415,-442
1,9,3,11,1,1415,2043,-628
1,9,4,11,1,2043,2005,38
1,9,5,11,1,2005,1463,542
1,9,6,11,1,1463,2085,-622
1,9,7,11,1,2085,2111,-26
1,9,8,11,1,2111,1115,996
1,9,9,11,1,1115,1280,-165
1,9,10,11,1,1280,1104,176
1,9,11,11,1,1104,1285,-181
1,9,12,11,1,1285,1198,87
1,9,13,11,1,1198,1091,107
1,9,14,11,1,1091,1463,-372
1,9,15,11,1,1463,2193,-730
1,9,16,11,1,2193,1954,239
1,9,17,11,1,1954,1655,299
1,9,18,11,1,1655,1814,-159
1,9,19,11,1,1814,1783,31
1,9,20,11,1,1783,1666,117
1,9,21,11,1,1666,1496,170
1,9,22,11,1,1496,1520,-24
1,10,0,11,1,1556,1235,321
1,10,1,11,1,1235,972,263
1,10,2,11,1,972,1602,-630
1,10,3,11,1,1602,2099,-497
1,10,4,11,1,2099,1993,106
1,10,5,11,1,1993,1492,501
1,10,6,11,1,1492,2197,-705
1,10,7,11,1,2197,2291,-94
1,10,8,11,1,2291,1206,1085
1,10,9,11,1,1206,1404,-198
1,10,10,11,1,1404,1188,216
1,10,11,11,1,1188,1398,-210
1,10,12,11,1,1398,1316,82
1,10,13,11,1,1316,1148,168
1,10,14,11,1,1148,1485,-337
1,10,15,11,1,1485,2272,-787
1,10,16,11,1,2272,2008,264
1,10,17,11,1,2008,1645,363
1,10,18,11,1,1645,1844,-199
1,10,19,11,1,1844,1895,-51
1,10,20,11,1,1895,1651,244
1,10,21,11,1,1651,1475,176
1,10,22,11,1,1475,1628,-153
1,11,0,11,1,1655,1263,392
1,11,1,11,1,1263,1001,262
1,11,2,11,1,1001,1761,-760
1,11,3,11,1,1761,2013,-252
1,11,4,11,1,2013,1907,106
1,11,5,11,1,1907,1427,480
1,11,6,11,1,1427,2124,-697
1,11,7,11,1,2124,2294,-170
1,11,8,11,1,2294,1119,1175
1,11,9,11,1,1119,1298,-179
1,11,10,11,1,1298,1113,185
1,11,11,11,1,1113,1361,-248
1,11,12,11,1,1361,1220,141
1,11,13,11,1,1220,1048,172
1,11,14,11,1,1048,1411,-363
1,11,15,11,1,1411,2170,-759
1,11,16,11,1,2170,1929,241
1,11,17,11,1,1929,1588,341
1,11,18,11,1,1588,1808,-220
1,11,19,11,1,1808,1881,-73
1,11,20,11,1,1881,1658,223
1,11,21,11,1,1658,1472,186
1,11,22,11,1,1472,1695,-223
1,12,0,11,1,1613,1237,376
1,12,1,11,1,1237,987,250
1,12,2,11,1,987,1758,-771
1,12,3,11,1,1758,1800,-42
1,12,4,11,1,1800,1769,31
1,12,5,11,1,1769,1249,520
1,12,6,11,1,1249,1989,-740
1,12,7,11,1,1989,2229,-240
1,12,8,11,1,2229,990,1239
1,12,9,11,1,990,1174,-184
1,12,10,11,1,1174,996,178
1,12,11,11,1,996,1286,-290
1,12,12,11,1,1286,1103,183
1,12,13,11,1,1103,897,206
1,12,14,11,1,897,1320,-423
1,12,15,11,1,1320,2040,-720
1,12,16,11,1,2040,1763,277
1,12,17,11,1,1763,1424,339
1,12,18,11,1,1424,1655,-231
1,12,19,11,1,1655,1716,-61
1,12,20,11,1,1716,1543,173
1,12,21,11,1,1543,1353,190
1,12,22,11,1,1353,1617,-264
1,13,0,11,1,1573,1159,414
1,13,1,11,1,1159,937,222
1,13,2,11,1,937,1701,-764
1,13,3,11,1,1701,1632,69
1,13,4,11,1,1632,1633,-1
1,13,5,11,1,1633,1084,549
1,13,6,11,1,1084,1845,-761
1,13,7,11,1,1845,2123,-278
1,13,8,11,1,2123,977,1146
1,13,9,11,1,977,1115,-138
1,13,10,11,1,1115,941,174
1,13,11,11,1,941,1287,-346
1,13,12,11,1,1287,1082,205
1,13,13,11,1,1082,886,196
1,13,14,11,1,886,1255,-369
1,13,15,11,1,1255,1896,-641
1,13,16,11,1,1896,1592,304
1,13,17,11,1,1592,1266,326
1,13,18,11,1,1266,1503,-237
1,13,19,11,1,1503,1552,-49
1,13,20,11,1,1552,1379,173
1,13,21,11,1,1379,1228,151
1,13,22,11,1,1228,1533,-305
1,0,0,12,1,1387,1294,93
1,0,1,12,1,1294,1198,96
1,0,2,12,1,1198,1108,90
1,0,3,12,1,1108,1328,-220
1,0,4,12,1,1328,1252,76
1,0,5,12,1,1252,1263,-11
1,0,6,12,1,1263,1299,-36
1,0,7,12,1,1299,1235,64
1,0,8,12,1,1235,1157,78
1,0,9,12,1,1157,1147,10
1,0,10,12,1,1147,1123,24
1,0,11,12,1,1123,1151,-28
1,0,12,12,1,1151,1161,-10
1,0,13,12,1,1161,1134,27
1,0,14,12,1,1134,1177,-43
1,0,15,12,1,1177,1290,-113
1,0,16,12,1,1290,1282,8
1,0,17,12,1,1282,1260,22
1,0,18,12,1,1260,1303,-43
1,0,19,12,1,1303,1287,16
1,0,20,12,1,1287,1287,0
1,0,21,12,1,1287,1372,-85
1,0,22,12,1,1372,1353,19
1,1,0,12,1,1428,1334,94
1,1,1,12,1,1334,1206,128
1,1,2,12,1,1206,1136,70
1,1,3,12,1,1136,1454,-318
1,1,4,12,1,1454,1342,112
1,1,5,12,1,1342,1372,-30
1,1,6,12,1,1372,1417,-45
1,1,7,12,1,1417,1363,54
1,1,8,12,1,1363,1165,198
1,1,9,12,1,1165,1159,6
1,1,10,12,1,1159,1136,23
1,1,11,12,1,1136,1180,-44
1,1,12,12,1,1180,1169,11
1,1,13,12,1,1169,1133,36
1,1,14,12,1,1133,1231,-98
1,1,15,12,1,1231,1443,-212
1,1,16,12,1,1443,1418,25
1,1,17,12,1,1418,1350,68
1,1,18,12,1,1350,1417,-67
1,1,19,12,1,1417,1407,10
1,1,20,12,1,1407,1381,26
1,1,21,12,1,1381,1462,-81
1,1,22,12,1,1462,1382,80
1,2,0,12,1,1468,1382,86
1,2,1,12,1,1382,1209,173
1,2,2,12,1,1209,1153,56
1,2,3,12,1,1153,1529,-376
1,2,4,12,1,1529,1487,42
1,2,5,12,1,1487,1440,47
1,2,6,12,1,1440,1543,-103
1,2,7,12,1,1543,1504,39
1,2,8,12,1,1504,1159,345
1,2,9,12,1,1159,1161,-2
1,2,10,12,1,1161,1126,35
1,2,11,12,1,1126,1187,-61
1,2,12,12,1,1187,1161,26
1,2,13,12,1,1161,1119,42
1,2,14,12,1,1119,1281,-162
1,2,15,12,1,1281,1577,-296
1,2,16,12,1,1577,1528,49
1,2,17,12,1,1528,1464,64
1,2,18,12,1,1464,1528,-64
1,2,19,12,1,1528,1483,45
1,2,20,12,1,1483,1458,25
1,2,21,12,1,1458,1545,-87
1,2,22,12,1,1545,1414,131
1,3,0,12,1,1514,1436,78
1,3,1,12,1,1436,1212,224
1,3,2,12,1,1212,1168,44
1,3,3,12,1,1168,1595,-427
1,3,4,12,1,1595,1633,-38
1,3,5,12,1,1633,1475,158
1,3,6,12,1,1475,1656,-181
1,3,7,12,1,1656,1625,31
1,3,8,12,1,1625,1146,479
1,3,9,12,1,1146,1179,-33
1,3,10,12,1,1179,1112,67
1,3,11,12,1,1112,1190,-78
1,3,12,12,1,1190,1165,25
1,3,13,12,1,1165,1113,52
1,3,14,12,1,1113,1325,-212
1,3,15,12,1,1325,1701,-376
1,3,16,12,1,1701,1599,102
1,3,17,12,1,1599,1585,14
1,3,18,12,1,1585,1634,-49
1,3,19,12,1,1634,1533,101
1,3,20,12,1,1533,1543,-10
1,3,21,12,1,1543,1631,-88
1,3,22,12,1,1631,1462,169
1,4,0,12,1,1548,1488,60
1,4,1,12,1,1488,1209,279
1,4,2,12,1,1209,1182,27
1,4,3,12,1,1182,1690,-508
1,4,4,12,1,1690,1768,-78
1,4,5,12,1,1768,1527,241
1,4,6,12,1,1527,1778,-251
1,4,7,12,1,1778,1791,-13
1,4,8,12,1,1791,1160,631
1,4,9,12,1,1160,1231,-71
1,4,10,12,1,1231,1143,88
1,4,11,12,1,1143,1233,-90
1,4,12,12,1,1233,1194,39
1,4,13,12,1,1194,1134,60
1,4,14,12,1,1134,1418,-284
1,4,15,12,1,1418,1866,-448
1,4,16,12,1,1866,1671,195
1,4,17,12,1,1671,1715,-44
1,4,18,12,1,1715,1736,-21
1,4,19,12,1,1736,1575,161
1,4,20,12,1,1575,1637,-62
1,4,21,12,1,1637,1706,-69
1,4,22,12,1,1706,1492,214
1,5,0,12,1,1542,1483,59
1,5,1,12,1,1483,1170,313
1,5,2,12,1,1170,1186,-16
1,5,3,12,1,1186,1783,-597
1,5,4,12,1,1783,1897,-114
1,5,5,12,1,1897,1563,334
1,5,6,12,1,1563,1950,-387
1,5,7,12,1,1950,1976,-26
1,5,8,12,1,1976,1216,760
1,5,9,12,1,1216,1300,-84
1,5,10,12,1,1300,1192,108
1,5,11,12,1,1192,1316,-124
1,5,12,12,1,1316,1261,55
1,5,13,12,1,1261,1185,76
1,5,14,12,1,1185,1544,-359
1,5,15,12,1,1544,2061,-517
1,5,16,12,1,2061,1766,295
1,5,17,12,1,1766,1798,-32
1,5,18,12,1,1798,1830,-32
1,5,19,12,1,1830,1616,214
1,5,20,12,1,1616,1695,-79
1,5,21,12,1,1695,1710,-15
1,5,22,12,1,1710,1522,188
1,6,0,12,1,1536,1436,100
1,6,1,12,1,1436,1113,323
1,6,2,12,1,1113,1213,-100
1,6,3,12,1,1213,1865,-652
1,6,4,12,1,1865,1979,-114
1,6,5,12,1,1979,1606,373
1,6,6,12,1,1606,2142,-536
1,6,7,12,1,2142,2103,39
1,6,8,12,1,2103,1219,884
1,6,9,12,1,1219,1343,-124
1,6,10,12,1,1343,1194,149
1,6,11,12,1,1194,1334,-140
1,6,12,12,1,1334,1279,55
1,6,13,12,1,1279,1181,98
1,6,14,12,1,1181,1618,-437
1,6,15,12,1,1618,2248,-630
1,6,16,12,1,2248,1869,379
1,6,17,12,1,1869,1792,77
1,6,18,12,1,1792,1883,-91
1,6,19,12,1,1883,1674,209
1,6,20,12,1,1674,1742,-68
1,6,21,12,1,1742,1685,57
1,6,22,12,1,1685,1569,116
1,7,0,12,1,1538,1404,134
1,7,1,12,1,1404,1080,324
1,7,2,12,1,1080,1308,-228
1,7,3,12,1,1308,2016,-708
1,7,4,12,1,2016,2076,-60
1,7,5,12,1,2076,1608,468
1,7,6,12,1,1608,2212,-604
1,7,7,12,1,2212,2146,66
1,7,8,12,1,2146,1223,923
1,7,9,12,1,1223,1349,-126
1,7,10,12,1,1349,1209,140
1,7,11,12,1,1209,1372,-163
1,7,12,12,1,1372,1285,87
1,7,13,12,1,1285,1216,69
1,7,14,12,1,1216,1632,-416
1,7,15,12,1,1632,2238,-606
1,7,16,12,1,2238,1961,277
1,7,17,12,1,1961,1794,167
1,7,18,12,1,1794,1921,-127
1,7,19,12,1,1921,1777,144
1,7,20,12,1,1777,1799,-22
1,7,21,12,1,1799,1650,149
1,7,22,12,1,1650,1575,75
1,8,0,12,1,1598,1369,229
1,8,1,12,1,1369,1094,275
1,8,2,12,1,1094,1493,-399
1,8,3,12,1,1493,2106,-613
1,8,4,12,1,2106,2099,7
1,8,5,12,1,2099,1598,501
1,8,6,12,1,1598,2206,-608
1,8,7,12,1,2206,2238,-32
1,8,8,12,1,2238,1250,988
1,8,9,12,1,1250,1410,-160
1,8,10,12,1,1410,1241,169
1,8,11,12,1,1241,1431,-190
1,8,12,12,1,1431,1344,87
1,8,13,12,1,1344,1229,115
1,8,14,12,1,1229,1601,-372
1,8,15,12,1,1601,2327,-726
1,8,16,12,1,2327,2085,242
1,8,17,12,1,2085,1784,301
1,8,18,12,1,1784,1907,-123
1,8,19,12,1,1907,1882,25
1,8,20,12,1,1882,1794,88
1,8,21,12,1,1794,1614,180
1,8,22,12,1,1614,1651,-37
1,9,0,12,1,1662,1304,358
1,9,1,12,1,1304,1041,263
1,9,2,12,1,1041,1645,-604
1,9,3,12,1,1645,2140,-495
1,9,4,12,1,2140,2048,92
1,9,5,12,1,2048,1536,512
1,9,6,12,1,1536,2264,-728
1,9,7,12,1,2264,2355,-91
1,9,8,12,1,2355,1247,1108
1,9,9,12,1,1247,1433,-186
1,9,10,12,1,1433,1224,209
1,9,11,12,1,1224,1437,-213
1,9,12,12,1,1437,1344,93
1,9,13,12,1,1344,1175,169
1,9,14,12,1,1175,1538,-363
1,9,15,12,1,1538,2331,-793
1,9,16,12,1,2331,2074,257
1,9,17,12,1,2074,1703,371
1,9,18,12,1,1703,1891,-188
1,9,19,12,1,1891,1946,-55
1,9,20,12,1,1946,1711,235
1,9,21,12,1,1711,1551,160
1,9,22,12,1,1551,1731,-180
1,10,0,12,1,1759,1307,452
1,10,1,12,1,1307,1061,246
1,10,2,12,1,1061,1837,-776
1,10,3,12,1,1837,2161,-324
1,10,4,12,1,2161,2025,136
1,10,5,12,1,2025,1550,475
1,10,6,12,1,1550,2281,-731
1,10,7,12,1,2281,2436,-155
1,10,8,12,1,2436,1247,1189
1,10,9,12,1,1247,1430,-183
1,10,10,12,1,1430,1232,198
1,10,11,12,1,1232,1486,-254
1,10,12,12,1,1486,1352,134
1,10,13,12,1,1352,1172,180
1,10,14,12,1,1172,1540,-368
1,10,15,12,1,1540,2315,-775
1,10,16,12,1,2315,2078,237
1,10,17,12,1,2078,1700,378
1,10,18,12,1,1700,1928,-228
1,10,19,12,1,1928,1996,-68
1,10,20,12,1,1996,1740,256
1,10,21,12,1,1740,1571,169
1,10,22,12,1,1571,1801,-230
1,11,0,12,1,1752,1337,415
1,11,1,12,1,1337,1077,260
1,11,2,12,1,1077,1881,-804
1,11,3,12,1,1881,2053,-172
1,11,4,12,1,2053,1944,109
1,11,5,12,1,1944,1472,472
1,11,6,12,1,1472,2219,-747
1,11,7,12,1,2219,2445,-226
1,11,8,12,1,2445,1168,1277
1,11,9,12,1,1168,1368,-200
1,11,10,12,1,1368,1174,194
1,11,11,12,1,1174,1477,-303
1,11,12,12,1,1477,1303,174
1,11,13,12,1,1303,1081,222
1,11,14,12,1,1081,1509,-428
1,11,15,12,1,1509,2282,-773
1,11,16,12,1,2282,1999,283
1,11,17,12,1,1999,1608,391
1,11,18,12,1,1608,1866,-258
1,11,19,12,1,1866,1929,-63
1,11,20,12,1,1929,1712,217
1,11,21,12,1,1712,1526,186
1,11,22,12,1,1526,1751,-225
1,12,0,12,1,1724,1306,418
1,12,1,12,1,1306,1041,265
1,12,2,12,1,1041,1827,-786
1,12,3,12,1,1827,1869,-42
1,12,4,12,1,1869,1834,35
1,12,5,12,1,1834,1297,537
1,12,6,12,1,1297,2069,-772
1,12,7,12,1,2069,2355,-286
1,12,8,12,1,2355,1088,1267
1,12,9,12,1,1088,1229,-141
1,12,10,12,1,1229,1056,173
1,12,11,12,1,1056,1418,-362
1,12,12,12,1,1418,1193,225
1,12,13,12,1,1193,989,204
1,12,14,12,1,989,1414,-425
1,12,15,12,1,1414,2147,-733
1,12,16,12,1,2147,1830,317
1,12,17,12,1,1830,1466,364
1,12,18,12,1,1466,1725,-259
1,12,19,12,1,1725,1770,-45
1,12,20,12,1,1770,1576,194
1,12,21,12,1,1576,1427,149
1,12,22,12,1,1427,1664,-237
1,0,0,13,1,1538,1441,97
1,0,1,13,1,1441,1302,139
1,0,2,13,1,1302,1234,68
1,0,3,13,1,1234,1565,-331
1,0,4,13,1,1565,1453,112
1,0,5,13,1,1453,1476,-23
1,0,6,13,1,1476,1523,-47
1,0,7,13,1,1523,1467,56
1,0,8,13,1,1467,1268,199
1,0,9,13,1,1268,1261,7
1,0,10,13,1,1261,1238,23
1,0,11,13,1,1238,1282,-44
1,0,12,13,1,1282,1272,10
1,0,13,13,1,1272,1237,35
1,0,14,13,1,1237,1336,-99
1,0,15,13,1,1336,1541,-205
1,0,16,13,1,1541,1520,21
1,0,17,13,1,1520,1460,60
1,0,18,13,1,1460,1525,-65
1,0,19,13,1,1525,1505,20
1,0,20,13,1,1505,1484,21
1,0,21,13,1,1484,1571,-87
1,0,22,13,1,1571,1484,87
1,1,0,13,1,1574,1493,81
1,1,1,13,1,1493,1316,177
1,1,2,13,1,1316,1259,57
1,1,3,13,1,1259,1641,-382
1,1,4,13,1,1641,1595,46
1,1,5,13,1,1595,1542,53
1,1,6,13,1,1542,1650,-108
1,1,7,13,1,1650,1612,38
1,1,8,13,1,1612,1265,347
1,1,9,13,1,1265,1265,0
1,1,10,13,1,1265,1229,36
1,1,11,13,1,1229,1290,-61
1,1,12,13,1,1290,1265,25
1,1,13,13,1,1265,1224,41
1,1,14,13,1,1224,1388,-164
1,1,15,13,1,1388,1692,-304
1,1,16,13,1,1692,1635,57
1,1,17,13,1,1635,1568,67
1,1,18,13,1,1568,1630,-62
1,1,19,13,1,1630,1584,46
1,1,20,13,1,1584,1569,15
1,1,21,13,1,1569,1659,-90
1,1,22,13,1,1659,1516,143
1,2,0,13,1,1620,1551,69
1,2,1,13,1,1551,1324,227
1,2,2,13,1,1324,1275,49
1,2,3,13,1,1275,1705,-430
1,2,4,13,1,1705,1741,-36
1,2,5,13,1,1741,1583,158
1,2,6,13,1,1583,1774,-191
1,2,7,13,1,1774,1740,34
1,2,8,13,1,1740,1259,481
1,2,9,13,1,1259,1288,-29
1,2,10,13,1,1288,1219,69
1,2,11,13,1,1219,1296,-77
1,2,12,13,1,1296,1273,23
1,2,13,13,1,1273,1223,50
1,2,14,13,1,1223,1436,-213
1,2,15,13,1,1436,1818,-382
1,2,16,13,1,1818,1708,110
1,2,17,13,1,1708,1694,14
1,2,18,13,1,1694,1741,-47
1,2,19,13,1,1741,1636,105
1,2,20,13,1,1636,1653,-17
1,2,21,13,1,1653,1746,-93
1,2,22,13,1,1746,1568,178
1,3,0,13,1,1660,1605,55
1,3,1,13,1,1605,1319,286
1,3,2,13,1,1319,1287,32
1,3,3,13,1,1287,1802,-515
1,3,4,13,1,1802,1883,-81
1,3,5,13,1,1883,1639,244
1,3,6,13,1,1639,1893,-254
1,3,7,13,1,1893,1863,30
1,3,8,13,1,1863,1229,634
1,3,9,13,1,1229,1297,-68
1,3,10,13,1,1297,1206,91
1,3,11,13,1,1206,1295,-89
1,3,12,13,1,1295,1257,38
1,3,13,13,1,1257,1199,58
1,3,14,13,1,1199,1485,-286
1,3,15,13,1,1485,1956,-471
1,3,16,13,1,1956,1770,186
1,3,17,13,1,1770,1832,-62
1,3,18,13,1,1832,1857,-25
1,3,19,13,1,1857,1682,175
1,3,20,13,1,1682,1741,-59
1,3,21,13,1,1741,1817,-76
1,3,22,13,1,1817,1603,214
1,4,0,13,1,1656,1602,54
1,4,1,13,1,1602,1284,318
1,4,2,13,1,1284,1301,-17
1,4,3,13,1,1301,1909,-608
1,4,4,13,1,1909,2017,-108
1,4,5,13,1,2017,1657,360
1,4,6,13,1,1657,2026,-369
1,4,7,13,1,2026,2030,-4
1,4,8,13,1,2030,1267,763
1,4,9,13,1,1267,1348,-81
1,4,10,13,1,1348,1237,111
1,4,11,13,1,1237,1360,-123
1,4,12,13,1,1360,1306,54
1,4,13,13,1,1306,1232,74
1,4,14,13,1,1232,1592,-360
1,4,15,13,1,1592,2120,-528
1,4,16,13,1,2120,1841,279
1,4,17,13,1,1841,1904,-63
1,4,18,13,1,1904,1953,-49
1,4,19,13,1,1953,1731,222
1,4,20,13,1,1731,1805,-74
1,4,21,13,1,1805,1823,-18
1,4,22,13,1,1823,1632,191
1,5,0,13,1,1650,1558,92
1,5,1,13,1,1558,1233,325
1,5,2,13,1,1233,1332,-99
1,5,3,13,1,1332,1990,-658
1,5,4,13,1,1990,2088,-98
1,5,5,13,1,2088,1675,413
1,5,6,13,1,1675,2181,-506
1,5,7,13,1,2181,2172,9
1,5,8,13,1,2172,1287,885
1,5,9,13,1,1287,1410,-123
1,5,10,13,1,1410,1259,151
1,5,11,13,1,1259,1399,-140
1,5,12,13,1,1399,1344,55
1,5,13,13,1,1344,1246,98
1,5,14,13,1,1246,1684,-438
1,5,15,13,1,1684,2303,-619
1,5,16,13,1,2303,1927,376
1,5,17,13,1,1927,1873,54
1,5,18,13,1,1873,1990,-117
1,5,19,13,1,1990,1790,200
1,5,20,13,1,1790,1861,-71
1,5,21,13,1,1861,1803,58
1,5,22,13,1,1803,1677,126
1,6,0,13,1,1658,1528,130
1,6,1,13,1,1528,1189,339
1,6,2,13,1,1189,1397,-208
1,6,3,13,1,1397,2103,-706
1,6,4,13,1,2103,2158,-55
1,6,5,13,1,2158,1675,483
1,6,6,13,1,1675,2270,-595
1,6,7,13,1,2270,2215,55
1,6,8,13,1,2215,1292,923
1,6,9,13,1,1292,1418,-126
1,6,10,13,1,1418,1278,140
1,6,11,13,1,1278,1441,-163
1,6,12,13,1,1441,1354,87
1,6,13,13,1,1354,1284,70
1,6,14,13,1,1284,1700,-416
1,6,15,13,1,1700,2315,-615
1,6,16,13,1,2315,2027,288
1,6,17,13,1,2027,1865,162
1,6,18,13,1,1865,2008,-143
1,6,19,13,1,2008,1874,134
1,6,20,13,1,1874,1906,-32
1,6,21,13,1,1906,1766,140
1,6,22,13,1,1766,1690,76
1,7,0,13,1,1728,1494,234
1,7,1,13,1,1494,1184,310
1,7,2,13,1,1184,1542,-358
1,7,3,13,1,1542,2146,-604
1,7,4,13,1,2146,2156,-10
1,7,5,13,1,2156,1680,476
1,7,6,13,1,1680,2311,-631
1,7,7,13,1,2311,2333,-22
1,7,8,13,1,2333,1346,987
1,7,9,13,1,1346,1507,-161
1,7,10,13,1,1507,1340,167
1,7,11,13,1,1340,1530,-190
1,7,12,13,1,1530,1442,88
1,7,13,13,1,1442,1326,116
1,7,14,13,1,1326,1697,-371
1,7,15,13,1,1697,2426,-729
1,7,16,13,1,2426,2169,257
1,7,17,13,1,2169,1863,306
1,7,18,13,1,1863,1984,-121
1,7,19,13,1,1984,1954,30
1,7,20,13,1,1954,1878,76
1,7,21,13,1,1878,1724,154
1,7,22,13,1,1724,1776,-52
1,8,0,13,1,1788,1445,343
1,8,1,13,1,1445,1162,283
1,8,2,13,1,1162,1723,-561
1,8,3,13,1,1723,2203,-480
1,8,4,13,1,2203,2142,61
1,8,5,13,1,2142,1671,471
1,8,6,13,1,1671,2385,-714
1,8,7,13,1,2385,2482,-97
1,8,8,13,1,2482,1382,1100
1,8,9,13,1,1382,1563,-181
1,8,10,13,1,1563,1361,202
1,8,11,13,1,1361,1583,-222
1,8,12,13,1,1583,1490,93
1,8,13,13,1,1490,1313,177
1,8,14,13,1,1313,1676,-363
1,8,15,13,1,1676,2465,-789
1,8,16,13,1,2465,2205,260
1,8,17,13,1,2205,1832,373
1,8,18,13,1,1832,1984,-152
1,8,19,13,1,1984,2045,-61
1,8,20,13,1,2045,1839,206
1,8,21,13,1,1839,1669,170
1,8,22,13,1,1669,1862,-193
1,9,0,13,1,1865,1376,489
1,9,1,13,1,1376,1130,246
1,9,2,13,1,1130,1880,-750
1,9,3,13,1,1880,2202,-322
1,9,4,13,1,2202,2080,122
1,9,5,13,1,2080,1594,486
1,9,6,13,1,1594,2348,-754
1,9,7,13,1,2348,2500,-152
1,9,8,13,1,2500,1288,1212
1,9,9,13,1,1288,1459,-171
1,9,10,13,1,1459,1268,191
1,9,11,13,1,1268,1525,-257
1,9,12,13,1,1525,1380,145
1,9,13,13,1,1380,1199,181
1,9,14,13,1,1199,1593,-394
1,9,15,13,1,1593,2374,-781
1,9,16,13,1,2374,2144,230
1,9,17,13,1,2144,1758,386
1,9,18,13,1,1758,1975,-217
1,9,19,13,1,1975,2047,-72
1,9,20,13,1,2047,1800,247
1,9,21,13,1,1800,1647,153
1,9,22,13,1,1647,1904,-257
1,10,0,13,1,1856,1381,475
1,10,1,13,1,1381,1137,244
1,10,2,13,1,1137,1957,-820
1,10,3,13,1,1957,2201,-244
1,10,4,13,1,2201,2062,139
1,10,5,13,1,2062,1595,467
1,10,6,13,1,1595,2376,-781
1,10,7,13,1,2376,2587,-211
1,10,8,13,1,2587,1296,1291
1,10,9,13,1,1296,1500,-204
1,10,10,13,1,1500,1293,207
1,10,11,13,1,1293,1602,-309
1,10,12,13,1,1602,1435,167
1,10,13,13,1,1435,1205,230
1,10,14,13,1,1205,1638,-433
1,10,15,13,1,1638,2427,-789
1,10,16,13,1,2427,2148,279
1,10,17,13,1,2148,1720,428
1,10,18,13,1,1720,1986,-266
1,10,19,13,1,1986,2044,-58
1,10,20,13,1,2044,1794,250
1,10,21,13,1,1794,1625,169
1,10,22,13,1,1625,1857,-232
1,11,0,13,1,1863,1406,457
1,11,1,13,1,1406,1131,275
1,11,2,13,1,1131,1950,-819
1,11,3,13,1,1950,2122,-172
1,11,4,13,1,2122,2009,113
1,11,5,13,1,2009,1520,489
1,11,6,13,1,1520,2299,-779
1,11,7,13,1,2299,2571,-272
1,11,8,13,1,2571,1266,1305
1,11,9,13,1,1266,1423,-157
1,11,10,13,1,1423,1234,189
1,11,11,13,1,1234,1609,-375
1,11,12,13,1,1609,1393,216
1,11,13,13,1,1393,1173,220
1,11,14,13,1,1173,1603,-430
1,11,15,13,1,1603,2389,-786
1,11,16,13,1,2389,2066,323
1,11,17,13,1,2066,1650,416
1,11,18,13,1,1650,1936,-286
1,11,19,13,1,1936,1983,-47
1,11,20,13,1,1983,1745,238
1,11,21,13,1,1745,1600,145
1,11,22,13,1,1600,1798,-198
1,0,0,14,1,1684,1600,84
1,0,1,14,1,1600,1412,188
1,0,2,14,1,1412,1357,55
1,0,3,14,1,1357,1752,-395
1,0,4,14,1,1752,1706,46
1,0,5,14,1,1706,1646,60
1,0,6,14,1,1646,1756,-110
1,0,7,14,1,1756,1716,40
1,0,8,14,1,1716,1368,348
1,0,9,14,1,1368,1367,1
1,0,10,14,1,1367,1331,36
1,0,11,14,1,1331,1392,-61
1,0,12,14,1,1392,1368,24
1,0,13,14,1,1368,1328,40
1,0,14,14,1,1328,1493,-165
1,0,15,14,1,1493,1790,-297
1,0,16,14,1,1790,1737,53
1,0,17,14,1,1737,1678,59
1,0,18,14,1,1678,1738,-60
1,0,19,14,1,1738,1682,56
1,0,20,14,1,1682,1672,10
1,0,21,14,1,1672,1768,-96
1,0,22,14,1,1768,1618,150
1,1,0,14,1,1726,1662,64
1,1,1,14,1,1662,1431,231
1,1,2,14,1,1431,1381,50
1,1,3,14,1,1381,1817,-436
1,1,4,14,1,1817,1849,-32
1,1,5,14,1,1849,1685,164
1,1,6,14,1,1685,1881,-196
1,1,7,14,1,1881,1848,33
1,1,8,14,1,1848,1365,483
1,1,9,14,1,1365,1392,-27
1,1,10,14,1,1392,1322,70
1,1,11,14,1,1322,1399,-77
1,1,12,14,1,1399,1377,22
1,1,13,14,1,1377,1328,49
1,1,14,14,1,1328,1543,-215
1,1,15,14,1,1543,1933,-390
1,1,16,14,1,1933,1815,118
1,1,17,14,1,1815,1798,17
1,1,18,14,1,1798,1843,-45
1,1,19,14,1,1843,1737,106
1,1,20,14,1,1737,1764,-27
1,1,21,14,1,1764,1860,-96
1,1,22,14,1,1860,1670,190
1,2,0,14,1,1766,1720,46
1,2,1,14,1,1720,1431,289
1,2,2,14,1,1431,1394,37
1,2,3,14,1,1394,1912,-518
1,2,4,14,1,1912,1991,-79
1,2,5,14,1,1991,1747,244
1,2,6,14,1,1747,2011,-264
1,2,7,14,1,2011,1978,33
1,2,8,14,1,1978,1342,636
1,2,9,14,1,1342,1406,-64
1,2,10,14,1,1406,1313,93
1,2,11,14,1,1313,1401,-88
1,2,12,14,1,1401,1365,36
1,2,13,14,1,1365,1309,56
1,2,14,14,1,1309,1596,-287
1,2,15,14,1,1596,2073,-477
1,2,16,14,1,2073,1879,194
1,2,17,14,1,1879,1941,-62
1,2,18,14,1,1941,1964,-23
1,2,19,14,1,1964,1785,179
1,2,20,14,1,1785,1851,-66
1,2,21,14,1,1851,1932,-81
1,2,22,14,1,1932,1709,223
1,3,0,14,1,1768,1719,49
1,3,1,14,1,1719,1394,325
1,3,2,14,1,1394,1406,-12
1,3,3,14,1,1406,2021,-615
1,3,4,14,1,2021,2132,-111
1,3,5,14,1,2132,1769,363
1,3,6,14,1,1769,2141,-372
1,3,7,14,1,2141,2102,39
1,3,8,14,1,2102,1336,766
1,3,9,14,1,1336,1414,-78
1,3,10,14,1,1414,1300,114
1,3,11,14,1,1300,1422,-122
1,3,12,14,1,1422,1369,53
1,3,13,14,1,1369,1297,72
1,3,14,14,1,1297,1659,-362
1,3,15,14,1,1659,2210,-551
1,3,16,14,1,2210,1940,270
1,3,17,14,1,1940,2021,-81
1,3,18,14,1,2021,2074,-53
1,3,19,14,1,2074,1838,236
1,3,20,14,1,1838,1909,-71
1,3,21,14,1,1909,1934,-25
1,3,22,14,1,1934,1743,191
1,4,0,14,1,1764,1677,87
1,4,1,14,1,1677,1347,330
1,4,2,14,1,1347,1447,-100
1,4,3,14,1,1447,2116,-669
1,4,4,14,1,2116,2208,-92
1,4,5,14,1,2208,1769,439
1,4,6,14,1,1769,2257,-488
1,4,7,14,1,2257,2226,31
1,4,8,14,1,2226,1338,888
1,4,9,14,1,1338,1458,-120
1,4,10,14,1,1458,1304,154
1,4,11,14,1,1304,1443,-139
1,4,12,14,1,1443,1389,54
1,4,13,14,1,1389,1293,96
1,4,14,14,1,1293,1732,-439
1,4,15,14,1,1732,2362,-630
1,4,16,14,1,2362,2002,360
1,4,17,14,1,2002,1979,23
1,4,18,14,1,1979,2113,-134
1,4,19,14,1,2113,1905,208
1,4,20,14,1,1905,1971,-66
1,4,21,14,1,1971,1916,55
1,4,22,14,1,1916,1787,129
1,5,0,14,1,1772,1650,122
1,5,1,14,1,1650,1309,341
1,5,2,14,1,1309,1516,-207
1,5,3,14,1,1516,2228,-712
1,5,4,14,1,2228,2267,-39
1,5,5,14,1,2267,1744,523
1,5,6,14,1,1744,2309,-565
1,5,7,14,1,2309,2284,25
1,5,8,14,1,2284,1360,924
1,5,9,14,1,1360,1485,-125
1,5,10,14,1,1485,1343,142
1,5,11,14,1,1343,1506,-163
1,5,12,14,1,1506,1419,87
1,5,13,14,1,1419,1349,70
1,5,14,14,1,1349,1766,-417
1,5,15,14,1,1766,2370,-604
1,5,16,14,1,2370,2085,285
1,5,17,14,1,2085,1946,139
1,5,18,14,1,1946,2115,-169
1,5,19,14,1,2115,1990,125
1,5,20,14,1,1990,2025,-35
1,5,21,14,1,2025,1884,141
1,5,22,14,1,1884,1798,86
1,6,0,14,1,1848,1618,230
1,6,1,14,1,1618,1293,325
1,6,2,14,1,1293,1631,-338
1,6,3,14,1,1631,2233,-602
1,6,4,14,1,2233,2238,-5
1,6,5,14,1,2238,1747,491
1,6,6,14,1,1747,2369,-622
1,6,7,14,1,2369,2402,-33
1,6,8,14,1,2402,1415,987
1,6,9,14,1,1415,1576,-161
1,6,10,14,1,1576,1409,167
1,6,11,14,1,1409,1599,-190
1,6,12,14,1,1599,1511,88
1,6,13,14,1,1511,1394,117
1,6,14,14,1,1394,1765,-371
1,6,15,14,1,1765,2503,-738
1,6,16,14,1,2503,2235,268
1,6,17,14,1,2235,1934,301
1,6,18,14,1,1934,2071,-137
1,6,19,14,1,2071,2051,20
1,6,20,14,1,2051,1985,66
1,6,21,14,1,1985,1840,145
1,6,22,14,1,1840,1891,-51
1,7,0,14,1,1918,1570,348
1,7,1,14,1,1570,1252,318
1,7,2,14,1,1252,1772,-520
1,7,3,14,1,1772,2243,-471
1,7,4,14,1,2243,2199,44
1,7,5,14,1,2199,1753,446
1,7,6,14,1,1753,2490,-737
1,7,7,14,1,2490,2577,-87
1,7,8,14,1,2577,1478,1099
1,7,9,14,1,1478,1660,-182
1,7,10,14,1,1660,1460,200
1,7,11,14,1,1460,1682,-222
1,7,12,14,1,1682,1588,94
1,7,13,14,1,1588,1410,178
1,7,14,14,1,1410,1772,-362
1,7,15,14,1,1772,2564,-792
1,7,16,14,1,2564,2289,275
1,7,17,14,1,2289,1911,378
1,7,18,14,1,1911,2061,-150
1,7,19,14,1,2061,2117,-56
1,7,20,14,1,2117,1923,194
1,7,21,14,1,1923,1779,144
1,7,22,14,1,1779,1987,-208
1,8,0,14,1,1991,1517,474
1,8,1,14,1,1517,1251,266
1,8,2,14,1,1251,1958,-707
1,8,3,14,1,1958,2265,-307
1,8,4,14,1,2265,2174,91
1,8,5,14,1,2174,1729,445
1,8,6,14,1,1729,2469,-740
1,8,7,14,1,2469,2627,-158
1,8,8,14,1,2627,1423,1204
1,8,9,14,1,1423,1589,-166
1,8,10,14,1,1589,1405,184
1,8,11,14,1,1405,1671,-266
1,8,12,14,1,1671,1526,145
1,8,13,14,1,1526,1337,189
1,8,14,14,1,1337,1731,-394
1,8,15,14,1,1731,2508,-777
1,8,16,14,1,2508,2275,233
1,8,17,14,1,2275,1887,388
1,8,18,14,1,1887,2068,-181
1,8,19,14,1,2068,2146,-78
1,8,20,14,1,2146,1928,218
1,8,21,14,1,1928,1765,163
1,8,22,14,1,1765,2035,-270
1,9,0,14,1,1962,1450,512
1,9,1,14,1,1450,1206,244
1,9,2,14,1,1206,2000,-794
1,9,3,14,1,2000,2242,-242
1,9,4,14,1,2242,2117,125
1,9,5,14,1,2117,1639,478
1,9,6,14,1,1639,2443,-804
1,9,7,14,1,2443,2651,-208
1,9,8,14,1,2651,1337,1314
1,9,9,14,1,1337,1529,-192
1,9,10,14,1,1529,1329,200
1,9,11,14,1,1329,1641,-312
1,9,12,14,1,1641,1463,178
1,9,13,14,1,1463,1232,231
1,9,14,14,1,1232,1691,-459
1,9,15,14,1,1691,2486,-795
1,9,16,14,1,2486,2214,272
1,9,17,14,1,2214,1778,436
1,9,18,14,1,1778,2033,-255
1,9,19,14,1,2033,2095,-62
1,9,20,14,1,2095,1854,241
1,9,21,14,1,1854,1701,153
1,9,22,14,1,1701,1960,-259
1,10,0,14,1,1967,1450,517
1,10,1,14,1,1450,1191,259
1,10,2,14,1,1191,2026,-835
1,10,3,14,1,2026,2270,-244
1,10,4,14,1,2270,2127,143
1,10,5,14,1,2127,1643,484
1,10,6,14,1,1643,2456,-813
1,10,7,14,1,2456,2713,-257
1,10,8,14,1,2713,1394,1319
1,10,9,14,1,1394,1555,-161
1,10,10,14,1,1555,1353,202
1,10,11,14,1,1353,1734,-381
1,10,12,14,1,1734,1525,209
1,10,13,14,1,1525,1297,228
1,10,14,14,1,1297,1732,-435
1,10,15,14,1,1732,2534,-802
1,10,16,14,1,2534,2215,319
1,10,17,14,1,2215,1762,453
1,10,18,14,1,1762,2056,-294
1,10,19,14,1,2056,2098,-42
1,10,20,14,1,2098,1827,271
1,10,21,14,1,1827,1699,128
1,10,22,14,1,1699,1904,-205
1,0,0,15,1,1836,1769,67
1,0,1,15,1,1769,1527,242
1,0,2,15,1,1527,1479,48
1,0,3,15,1,1479,1928,-449
1,0,4,15,1,1928,1960,-32
1,0,5,15,1,1960,1789,171
1,0,6,15,1,1789,1987,-198
1,0,7,15,1,1987,1952,35
1,0,8,15,1,1952,1468,484
1,0,9,15,1,1468,1494,-26
1,0,10,15,1,1494,1424,70
1,0,11,15,1,1424,1501,-77
1,0,12,15,1,1501,1480,21
1,0,13,15,1,1480,1432,48
1,0,14,15,1,1432,1648,-216
1,0,15,15,1,1648,2031,-383
1,0,16,15,1,2031,1917,114
1,0,17,15,1,1917,1908,9
1,0,18,15,1,1908,1951,-43
1,0,19,15,1,1951,1835,116
1,0,20,15,1,1835,1867,-32
1,0,21,15,1,1867,1969,-102
1,0,22,15,1,1969,1772,197
1,1,0,15,1,1872,1831,41
1,1,1,15,1,1831,1538,293
1,1,2,15,1,1538,1500,38
1,1,3,15,1,1500,2024,-524
1,1,4,15,1,2024,2099,-75
1,1,5,15,1,2099,1849,250
1,1,6,15,1,1849,2118,-269
1,1,7,15,1,2118,2086,32
1,1,8,15,1,2086,1448,638
1,1,9,15,1,1448,1510,-62
1,1,10,15,1,1510,1416,94
1,1,11,15,1,1416,1504,-88
1,1,12,15,1,1504,1469,35
1,1,13,15,1,1469,1414,55
1,1,14,15,1,1414,1703,-289
1,1,15,15,1,1703,2188,-485
1,1,16,15,1,2188,1986,202
1,1,17,15,1,1986,2045,-59
1,1,18,15,1,2045,2066,-21
1,1,19,15,1,2066,1886,180
1,1,20,15,1,1886,1962,-76
1,1,21,15,1,1962,2046,-84
1,1,22,15,1,2046,1811,235
1,2,0,15,1,1874,1834,40
1,2,1,15,1,1834,1506,328
1,2,2,15,1,1506,1513,-7
1,2,3,15,1,1513,2131,-618
1,2,4,15,1,2131,2240,-109
1,2,5,15,1,2240,1877,363
1,2,6,15,1,1877,2259,-382
1,2,7,15,1,2259,2217,42
1,2,8,15,1,2217,1449,768
1,2,9,15,1,1449,1523,-74
1,2,10,15,1,1523,1407,116
1,2,11,15,1,1407,1528,-121
1,2,12,15,1,1528,1477,51
1,2,13,15,1,1477,1407,70
1,2,14,15,1,1407,1770,-363
1,2,15,15,1,1770,2327,-557
1,2,16,15,1,2327,2049,278
1,2,17,15,1,2049,2130,-81
1,2,18,15,1,2130,2181,-51
1,2,19,15,1,2181,1941,240
1,2,20,15,1,1941,2019,-78
1,2,21,15,1,2019,2049,-30
1,2,22,15,1,2049,1849,200
1,3,0,15,1,1876,1794,82
1,3,1,15,1,1794,1457,337
1,3,2,15,1,1457,1552,-95
1,3,3,15,1,1552,2228,-676
1,3,4,15,1,2228,2323,-95
1,3,5,15,1,2323,1881,442
1,3,6,15,1,1881,2372,-491
1,3,7,15,1,2372,2298,74
1,3,8,15,1,2298,1407,891
1,3,9,15,1,1407,1524,-117
1,3,10,15,1,1524,1367,157
1,3,11,15,1,1367,1505,-138
1,3,12,15,1,1505,1452,53
1,3,13,15,1,1452,1358,94
1,3,14,15,1,1358,1799,-441
1,3,15,15,1,1799,2452,-653
1,3,16,15,1,2452,2101,351
1,3,17,15,1,2101,2096,5
1,3,18,15,1,2096,2234,-138
1,3,19,15,1,2234,2012,222
1,3,20,15,1,2012,2075,-63
1,3,21,15,1,2075,2027,48
1,3,22,15,1,2027,1898,129
1,4,0,15,1,1886,1769,117
1,4,1,15,1,1769,1423,346
1,4,2,15,1,1423,1631,-208
1,4,3,15,1,1631,2354,-723
1,4,4,15,1,2354,2387,-33
1,4,5,15,1,2387,1838,549
1,4,6,15,1,1838,2385,-547
1,4,7,15,1,2385,2338,47
1,4,8,15,1,2338,1411,927
1,4,9,15,1,1411,1533,-122
1,4,10,15,1,1533,1388,145
1,4,11,15,1,1388,1550,-162
1,4,12,15,1,1550,1464,86
1,4,13,15,1,1464,1396,68
1,4,14,15,1,1396,1814,-418
1,4,15,15,1,1814,2429,-615
1,4,16,15,1,2429,2160,269
1,4,17,15,1,2160,2052,108
1,4,18,15,1,2052,2238,-186
1,4,19,15,1,2238,2105,133
1,4,20,15,1,2105,2135,-30
1,4,21,15,1,2135,1997,138
1,4,22,15,1,1997,1908,89
1,5,0,15,1,1962,1740,222
1,5,1,15,1,1740,1413,327
1,5,2,15,1,1413,1750,-337
1,5,3,15,1,1750,2358,-608
1,5,4,15,1,2358,2347,11
1,5,5,15,1,2347,1816,531
1,5,6,15,1,1816,2408,-592
1,5,7,15,1,2408,2471,-63
1,5,8,15,1,2471,1483,988
1,5,9,15,1,1483,1643,-160
1,5,10,15,1,1643,1474,169
1,5,11,15,1,1474,1664,-190
1,5,12,15,1,1664,1576,88
1,5,13,15,1,1576,1459,117
1,5,14,15,1,1459,1831,-372
1,5,15,15,1,1831,2558,-727
1,5,16,15,1,2558,2293,265
1,5,17,15,1,2293,2015,278
1,5,18,15,1,2015,2178,-163
1,5,19,15,1,2178,2167,11
1,5,20,15,1,2167,2104,63
1,5,21,15,1,2104,1958,146
1,5,22,15,1,1958,1999,-41
1,6,0,15,1,2038,1694,344
1,6,1,15,1,1694,1361,333
1,6,2,15,1,1361,1861,-500
1,6,3,15,1,1861,2330,-469
1,6,4,15,1,2330,2281,49
1,6,5,15,1,2281,1820,461
1,6,6,15,1,1820,2548,-728
1,6,7,15,1,2548,2646,-98
1,6,8,15,1,2646,1547,1099
1,6,9,15,1,1547,1729,-182
1,6,10,15,1,1729,1529,200
1,6,11,15,1,1529,1751,-222
1,6,12,15,1,1751,1657,94
1,6,13,15,1,1657,1478,179
1,6,14,15,1,1478,1840,-362
1,6,15,15,1,1840,2641,-801
1,6,16,15,1,2641,2355,286
1,6,17,15,1,2355,1982,373
1,6,18,15,1,1982,2148,-166
1,6,19,15,1,2148,2214,-66
1,6,20,15,1,2214,2030,184
1,6,21,15,1,2030,1895,135
1,6,22,15,1,1895,2102,-207
1,7,0,15,1,2121,1642,479
1,7,1,15,1,1642,1341,301
1,7,2,15,1,1341,2007,-666
1,7,3,15,1,2007,2305,-298
1,7,4,15,1,2305,2231,74
1,7,5,15,1,2231,1811,420
1,7,6,15,1,1811,2574,-763
1,7,7,15,1,2574,2722,-148
1,7,8,15,1,2722,1519,1203
1,7,9,15,1,1519,1686,-167
1,7,10,15,1,1686,1504,182
1,7,11,15,1,1504,1770,-266
1,7,12,15,1,1770,1624,146
1,7,13,15,1,1624,1434,190
1,7,14,15,1,1434,1827,-393
1,7,15,15,1,1827,2607,-780
1,7,16,15,1,2607,2359,248
1,7,17,15,1,2359,1966,393
1,7,18,15,1,1966,2145,-179
1,7,19,15,1,2145,2218,-73
1,7,20,15,1,2218,2012,206
1,7,21,15,1,2012,1875,137
1,7,22,15,1,1875,2160,-285
1,8,0,15,1,2088,1591,497
1,8,1,15,1,1591,1327,264
1,8,2,15,1,1327,2078,-751
1,8,3,15,1,2078,2305,-227
1,8,4,15,1,2305,2211,94
1,8,5,15,1,2211,1774,437
1,8,6,15,1,1774,2564,-790
1,8,7,15,1,2564,2778,-214
1,8,8,15,1,2778,1472,1306
1,8,9,15,1,1472,1659,-187
1,8,10,15,1,1659,1466,193
1,8,11,15,1,1466,1787,-321
1,8,12,15,1,1787,1609,178
1,8,13,15,1,1609,1370,239
1,8,14,15,1,1370,1829,-459
1,8,15,15,1,1829,2620,-791
1,8,16,15,1,2620,2345,275
1,8,17,15,1,2345,1907,438
1,8,18,15,1,1907,2126,-219
1,8,19,15,1,2126,2194,-68
1,8,20,15,1,2194,1982,212
1,8,21,15,1,1982,1819,163
1,8,22,15,1,1819,2091,-272
1,9,0,15,1,2073,1519,554
1,9,1,15,1,1519,1260,259
1,9,2,15,1,1260,2069,-809
1,9,3,15,1,2069,2311,-242
1,9,4,15,1,2311,2182,129
1,9,5,15,1,2182,1687,495
1,9,6,15,1,1687,2523,-836
1,9,7,15,1,2523,2777,-254
1,9,8,15,1,2777,1435,1342
1,9,9,15,1,1435,1584,-149
1,9,10,15,1,1584,1389,195
1,9,11,15,1,1389,1773,-384
1,9,12,15,1,1773,1553,220
1,9,13,15,1,1553,1324,229
1,9,14,15,1,1324,1785,-461
1,9,15,15,1,1785,2593,-808
1,9,16,15,1,2593,2281,312
1,9,17,15,1,2281,1820,461
1,9,18,15,1,1820,2103,-283
1,9,19,15,1,2103,2149,-46
1,9,20,15,1,2149,1887,262
1,9,21,15,1,1887,1775,112
1,9,22,15,1,1775,2007,-232
1,0,0,16,1,1982,1938,44
1,0,1,16,1,1938,1634,304
1,0,2,16,1,1634,1598,36
1,0,3,16,1,1598,2135,-537
1,0,4,16,1,2135,2210,-75
1,0,5,16,1,2210,1953,257
1,0,6,16,1,1953,2224,-271
1,0,7,16,1,2224,2190,34
1,0,8,16,1,2190,1551,639
1,0,9,16,1,1551,1612,-61
1,0,10,16,1,1612,1518,94
1,0,11,16,1,1518,1606,-88
1,0,12,16,1,1606,1572,34
1,0,13,16,1,1572,1518,54
1,0,14,16,1,1518,1808,-290
1,0,15,16,1,1808,2286,-478
1,0,16,16,1,2286,2088,198
1,0,17,16,1,2088,2155,-67
1,0,18,16,1,2155,2174,-19
1,0,19,16,1,2174,1984,190
1,0,20,16,1,1984,2065,-81
1,0,21,16,1,2065,2155,-90
1,0,22,16,1,2155,1913,242
1,1,0,16,1,1980,1945,35
1,1,1,16,1,1945,1613,332
1,1,2,16,1,1613,1619,-6
1,1,3,16,1,1619,2243,-624
1,1,4,16,1,2243,2348,-105
1,1,5,16,1,2348,1979,369
1,1,6,16,1,1979,2366,-387
1,1,7,16,1,2366,2325,41
1,1,8,16,1,2325,1555,770
1,1,9,16,1,1555,1627,-72
1,1,10,16,1,1627,1510,117
1,1,11,16,1,1510,1631,-121
1,1,12,16,1,1631,1581,50
1,1,13,16,1,1581,1512,69
1,1,14,16,1,1512,1877,-365
1,1,15,16,1,1877,2442,-565
1,1,16,16,1,2442,2156,286
1,1,17,16,1,2156,2234,-78
1,1,18,16,1,2234,2283,-49
1,1,19,16,1,2283,2042,241
1,1,20,16,1,2042,2130,-88
1,1,21,16,1,2130,2163,-33
1,1,22,16,1,2163,1951,212
1,2,0,16,1,1982,1909,73
1,2,1,16,1,1909,1569,340
1,2,2,16,1,1569,1659,-90
1,2,3,16,1,1659,2338,-679
1,2,4,16,1,2338,2431,-93
1,2,5,16,1,2431,1989,442
1,2,6,16,1,1989,2490,-501
1,2,7,16,1,2490,2413,77
1,2,8,16,1,2413,1520,893
1,2,9,16,1,1520,1633,-113
1,2,10,16,1,1633,1474,159
1,2,11,16,1,1474,1611,-137
1,2,12,16,1,1611,1560,51
1,2,13,16,1,1560,1468,92
1,2,14,16,1,1468,1910,-442
1,2,15,16,1,1910,2569,-659
1,2,16,16,1,2569,2210,359
1,2,17,16,1,2210,2205,5
1,2,18,16,1,2205,2341,-136
1,2,19,16,1,2341,2115,226
1,2,20,16,1,2115,2185,-70
1,2,21,16,1,2185,2142,43
1,2,22,16,1,2142,2004,138
1,3,0,16,1,1998,1886,112
1,3,1,16,1,1886,1533,353
1,3,2,16,1,1533,1736,-203
1,3,3,16,1,1736,2466,-730
1,3,4,16,1,2466,2502,-36
1,3,5,16,1,2502,1950,552
1,3,6,16,1,1950,2500,-550
1,3,7,16,1,2500,2410,90
1,3,8,16,1,2410,1480,930
1,3,9,16,1,1480,1599,-119
1,3,10,16,1,1599,1451,148
1,3,11,16,1,1451,1612,-161
1,3,12,16,1,1612,1527,85
1,3,13,16,1,1527,1461,66
1,3,14,16,1,1461,1881,-420
1,3,15,16,1,1881,2519,-638
1,3,16,16,1,2519,2259,260
1,3,17,16,1,2259,2169,90
1,3,18,16,1,2169,2359,-190
1,3,19,16,1,2359,2212,147
1,3,20,16,1,2212,2239,-27
1,3,21,16,1,2239,2108,131
1,3,22,16,1,2108,2019,89
1,4,0,16,1,2076,1859,217
1,4,1,16,1,1859,1527,332
1,4,2,16,1,1527,1865,-338
1,4,3,16,1,1865,2484,-619
1,4,4,16,1,2484,2467,17
1,4,5,16,1,2467,1910,557
1,4,6,16,1,1910,2484,-574
1,4,7,16,1,2484,2525,-41
1,4,8,16,1,2525,1534,991
1,4,9,16,1,1534,1691,-157
1,4,10,16,1,1691,1519,172
1,4,11,16,1,1519,1708,-189
1,4,12,16,1,1708,1621,87
1,4,13,16,1,1621,1506,115
1,4,14,16,1,1506,1879,-373
1,4,15,16,1,1879,2617,-738
1,4,16,16,1,2617,2368,249
1,4,17,16,1,2368,2121,247
1,4,18,16,1,2121,2301,-180
1,4,19,16,1,2301,2282,19
1,4,20,16,1,2282,2214,68
1,4,21,16,1,2214,2071,143
1,4,22,16,1,2071,2109,-38
1,5,0,16,1,2152,1816,336
1,5,1,16,1,1816,1481,335
1,5,2,16,1,1481,1980,-499
1,5,3,16,1,1980,2455,-475
1,5,4,16,1,2455,2390,65
1,5,5,16,1,2390,1889,501
1,5,6,16,1,1889,2587,-698
1,5,7,16,1,2587,2715,-128
1,5,8,16,1,2715,1615,1100
1,5,9,16,1,1615,1796,-181
1,5,10,16,1,1796,1594,202
1,5,11,16,1,1594,1816,-222
1,5,12,16,1,1816,1722,94
1,5,13,16,1,1722,1543,179
1,5,14,16,1,1543,1906,-363
1,5,15,16,1,1906,2696,-790
1,5,16,16,1,2696,2413,283
1,5,17,16,1,2413,2063,350
1,5,18,16,1,2063,2255,-192
1,5,19,16,1,2255,2330,-75
1,5,20,16,1,2330,2149,181
1,5,21,16,1,2149,2013,136
1,5,22,16,1,2013,2210,-197
1,6,0,16,1,2241,1766,475
1,6,1,16,1,1766,1450,316
1,6,2,16,1,1450,2096,-646
1,6,3,16,1,2096,2392,-296
1,6,4,16,1,2392,2313,79
1,6,5,16,1,2313,1878,435
1,6,6,16,1,1878,2632,-754
1,6,7,16,1,2632,2791,-159
1,6,8,16,1,2791,1588,1203
1,6,9,16,1,1588,1755,-167
1,6,10,16,1,1755,1573,182
1,6,11,16,1,1573,1839,-266
1,6,12,16,1,1839,1693,146
1,6,13,16,1,1693,1502,191
1,6,14,16,1,1502,1895,-393
1,6,15,16,1,1895,2684,-789
1,6,16,16,1,2684,2425,259
1,6,17,16,1,2425,2037,388
1,6,18,16,1,2037,2232,-195
1,6,19,16,1,2232,2315,-83
1,6,20,16,1,2315,2119,196
1,6,21,16,1,2119,1991,128
1,6,22,16,1,1991,2275,-284
1,7,0,16,1,2218,1716,502
1,7,1,16,1,1716,1417,299
1,7,2,16,1,1417,2127,-710
1,7,3,16,1,2127,2345,-218
1,7,4,16,1,2345,2268,77
1,7,5,16,1,2268,1856,412
1,7,6,16,1,1856,2669,-813
1,7,7,16,1,2669,2873,-204
1,7,8,16,1,2873,1568,1305
1,7,9,16,1,1568,1756,-188
1,7,10,16,1,1756,1565,191
1,7,11,16,1,1565,1886,-321
1,7,12,16,1,1886,1707,179
1,7,13,16,1,1707,1467,240
1,7,14,16,1,1467,1925,-458
1,7,15,16,1,1925,2719,-794
1,7,16,16,1,2719,2429,290
1,7,17,16,1,2429,1986,443
1,7,18,16,1,1986,2203,-217
1,7,19,16,1,2203,2266,-63
1,7,20,16,1,2266,2066,200
1,7,21,16,1,2066,1929,137
1,7,22,16,1,1929,2216,-287
1,8,0,16,1,2199,1660,539
1,8,1,16,1,1660,1381,279
1,8,2,16,1,1381,2147,-766
1,8,3,16,1,2147,2374,-227
1,8,4,16,1,2374,2276,98
1,8,5,16,1,2276,1822,454
1,8,6,16,1,1822,2644,-822
1,8,7,16,1,2644,2904,-260
1,8,8,16,1,2904,1570,1334
1,8,9,16,1,1570,1714,-144
1,8,10,16,1,1714,1526,188
1,8,11,16,1,1526,1919,-393
1,8,12,16,1,1919,1699,220
1,8,13,16,1,1699,1462,237
1,8,14,16,1,1462,1923,-461
1,8,15,16,1,1923,2727,-804
1,8,16,16,1,2727,2412,315
1,8,17,16,1,2412,1949,463
1,8,18,16,1,1949,2196,-247
1,8,19,16,1,2196,2248,-52
1,8,20,16,1,2248,2015,233
1,8,21,16,1,2015,1893,122
1,8,22,16,1,1893,2138,-245
1,0,0,17,1,2090,2052,38
1,0,1,17,1,2052,1709,343
1,0,2,17,1,1709,1717,-8
1,0,3,17,1,1717,2354,-637
1,0,4,17,1,2354,2459,-105
1,0,5,17,1,2459,2083,376
1,0,6,17,1,2083,2472,-389
1,0,7,17,1,2472,2429,43
1,0,8,17,1,2429,1658,771
1,0,9,17,1,1658,1729,-71
1,0,10,17,1,1729,1612,117
1,0,11,17,1,1612,1733,-121
1,0,12,17,1,1733,1684,49
1,0,13,17,1,1684,1616,68
1,0,14,17,1,1616,1982,-366
1,0,15,17,1,1982,2540,-558
1,0,16,17,1,2540,2258,282
1,0,17,17,1,2258,2344,-86
1,0,18,17,1,2344,2391,-47
1,0,19,17,1,2391,2140,251
1,0,20,17,1,2140,2233,-93
1,0,21,17,1,2233,2272,-39
1,0,22,17,1,2272,2053,219
1,1,0,17,1,2088,2020,68
1,1,1,17,1,2020,1676,344
1,1,2,17,1,1676,1765,-89
1,1,3,17,1,1765,2450,-685
1,1,4,17,1,2450,2539,-89
1,1,5,17,1,2539,2091,448
1,1,6,17,1,2091,2597,-506
1,1,7,17,1,2597,2521,76
1,1,8,17,1,2521,1626,895
1,1,9,17,1,1626,1737,-111
1,1,10,17,1,1737,1577,160
1,1,11,17,1,1577,1714,-137
1,1,12,17,1,1714,1664,50
1,1,13,17,1,1664,1573,91
1,1,14,17,1,1573,2017,-444
1,1,15,17,1,2017,2684,-667
1,1,16,17,1,2684,2317,367
1,1,17,17,1,2317,2309,8
1,1,18,17,1,2309,2443,-134
1,1,19,17,1,2443,2216,227
1,1,20,17,1,2216,2296,-80
1,1,21,17,1,2296,2256,40
1,1,22,17,1,2256,2106,150
1,2,0,17,1,2104,2001,103
1,2,1,17,1,2001,1645,356
1,2,2,17,1,1645,1843,-198
1,2,3,17,1,1843,2576,-733
1,2,4,17,1,2576,2610,-34
1,2,5,17,1,2610,2058,552
1,2,6,17,1,2058,2618,-560
1,2,7,17,1,2618,2525,93
1,2,8,17,1,2525,1593,932
1,2,9,17,1,1593,1708,-115
1,2,10,17,1,1708,1558,150
1,2,11,17,1,1558,1718,-160
1,2,12,17,1,1718,1635,83
1,2,13,17,1,1635,1571,64
1,2,14,17,1,1571,1992,-421
1,2,15,17,1,1992,2636,-644
1,2,16,17,1,2636,2368,268
1,2,17,17,1,2368,2278,90
1,2,18,17,1,2278,2466,-188
1,2,19,17,1,2466,2315,151
1,2,20,17,1,2315,2349,-34
1,2,21,17,1,2349,2223,126
1,2,22,17,1,2223,2125,98
1,3,0,17,1,2188,1976,212
1,3,1,17,1,1976,1637,339
1,3,2,17,1,1637,1970,-333
1,3,3,17,1,1970,2596,-626
1,3,4,17,1,2596,2582,14
1,3,5,17,1,2582,2022,560
1,3,6,17,1,2022,2599,-577
1,3,7,17,1,2599,2597,2
1,3,8,17,1,2597,1603,994
1,3,9,17,1,1603,1757,-154
1,3,10,17,1,1757,1582,175
1,3,11,17,1,1582,1770,-188
1,3,12,17,1,1770,1684,86
1,3,13,17,1,1684,1571,113
1,3,14,17,1,1571,1946,-375
1,3,15,17,1,1946,2707,-761
1,3,16,17,1,2707,2467,240
1,3,17,17,1,2467,2238,229
1,3,18,17,1,2238,2422,-184
1,3,19,17,1,2422,2389,33
1,3,20,17,1,2389,2318,71
1,3,21,17,1,2318,2182,136
1,3,22,17,1,2182,2220,-38
1,4,0,17,1,2266,1935,331
1,4,1,17,1,1935,1595,340
1,4,2,17,1,1595,2095,-500
1,4,3,17,1,2095,2581,-486
1,4,4,17,1,2581,2510,71
1,4,5,17,1,2510,1983,527
1,4,6,17,1,1983,2663,-680
1,4,7,17,1,2663,2769,-106
1,4,8,17,1,2769,1666,1103
1,4,9,17,1,1666,1844,-178
1,4,10,17,1,1844,1639,205
1,4,11,17,1,1639,1860,-221
1,4,12,17,1,1860,1767,93
1,4,13,17,1,1767,1590,177
1,4,14,17,1,1590,1954,-364
1,4,15,17,1,1954,2755,-801
1,4,16,17,1,2755,2488,267
1,4,17,17,1,2488,2169,319
1,4,18,17,1,2169,2378,-209
1,4,19,17,1,2378,2445,-67
1,4,20,17,1,2445,2259,186
1,4,21,17,1,2259,2126,133
1,4,22,17,1,2126,2320,-194
1,5,0,17,1,2355,1888,467
1,5,1,17,1,1888,1570,318
1,5,2,17,1,1570,2215,-645
1,5,3,17,1,2215,2517,-302
1,5,4,17,1,2517,2422,95
1,5,5,17,1,2422,1947,475
1,5,6,17,1,1947,2671,-724
1,5,7,17,1,2671,2860,-189
1,5,8,17,1,2860,1656,1204
1,5,9,17,1,1656,1822,-166
1,5,10,17,1,1822,1638,184
1,5,11,17,1,1638,1904,-266
1,5,12,17,1,1904,1758,146
1,5,13,17,1,1758,1567,191
1,5,14,17,1,1567,1961,-394
1,5,15,17,1,1961,2739,-778
1,5,16,17,1,2739,2483,256
1,5,17,17,1,2483,2118,365
1,5,18,17,1,2118,2339,-221
1,5,19,17,1,2339,2431,-92
1,5,20,17,1,2431,2238,193
1,5,21,17,1,2238,2109,129
1,5,22,17,1,2109,2383,-274
1,6,0,17,1,2338,1840,498
1,6,1,17,1,1840,1526,314
1,6,2,17,1,1526,2216,-690
1,6,3,17,1,2216,2432,-216
1,6,4,17,1,2432,2350,82
1,6,5,17,1,2350,1923,427
1,6,6,17,1,1923,2727,-804
1,6,7,17,1,2727,2942,-215
1,6,8,17,1,2942,1637,1305
1,6,9,17,1,1637,1825,-188
1,6,10,17,1,1825,1634,191
1,6,11,17,1,1634,1955,-321
1,6,12,17,1,1955,1776,179
1,6,13,17,1,1776,1535,241
1,6,14,17,1,1535,1993,-458
1,6,15,17,1,1993,2796,-803
1,6,16,17,1,2796,2495,301
1,6,17,17,1,2495,2057,438
1,6,18,17,1,2057,2290,-233
1,6,19,17,1,2290,2363,-73
1,6,20,17,1,2363,2173,190
1,6,21,17,1,2173,2045,128
1,6,22,17,1,2045,2331,-286
1,7,0,17,1,2329,1785,544
1,7,1,17,1,1785,1471,314
1,7,2,17,1,1471,2196,-725
1,7,3,17,1,2196,2414,-218
1,7,4,17,1,2414,2333,81
1,7,5,17,1,2333,1904,429
1,7,6,17,1,1904,2749,-845
1,7,7,17,1,2749,2999,-250
1,7,8,17,1,2999,1666,1333
1,7,9,17,1,1666,1811,-145
1,7,10,17,1,1811,1625,186
1,7,11,17,1,1625,2018,-393
1,7,12,17,1,2018,1797,221
1,7,13,17,1,1797,1559,238
1,7,14,17,1,1559,2019,-460
1,7,15,17,1,2019,2826,-807
1,7,16,17,1,2826,2496,330
1,7,17,17,1,2496,2028,468
1,7,18,17,1,2028,2273,-245
1,7,19,17,1,2273,2320,-47
1,7,20,17,1,2320,2099,221
1,7,21,17,1,2099,2003,96
1,7,22,17,1,2003,2263,-260
1,0,0,18,1,2198,2127,71
1,0,1,18,1,2127,1772,355
1,0,2,18,1,1772,1863,-91
1,0,3,18,1,1863,2561,-698
1,0,4,18,1,2561,2650,-89
1,0,5,18,1,2650,2195,455
1,0,6,18,1,2195,2703,-508
1,0,7,18,1,2703,2625,78
1,0,8,18,1,2625,1729,896
1,0,9,18,1,1729,1839,-110
1,0,10,18,1,1839,1679,160
1,0,11,18,1,1679,1816,-137
1,0,12,18,1,1816,1767,49
1,0,13,18,1,1767,1677,90
1,0,14,18,1,1677,2122,-445
1,0,15,18,1,2122,2782,-660
1,0,16,18,1,2782,2419,363
1,0,17,18,1,2419,2419,0
1,0,18,18,1,2419,2551,-132
1,0,19,18,1,2551,2314,237
1,0,20,18,1,2314,2399,-85
1,0,21,18,1,2399,2365,34
1,0,22,18,1,2365,2208,157
1,1,0,18,1,2210,2112,98
1,1,1,18,1,2112,1752,360
1,1,2,18,1,1752,1949,-197
1,1,3,18,1,1949,2688,-739
1,1,4,18,1,2688,2718,-30
1,1,5,18,1,2718,2160,558
1,1,6,18,1,2160,2725,-565
1,1,7,18,1,2725,2633,92
1,1,8,18,1,2633,1699,934
1,1,9,18,1,1699,1812,-113
1,1,10,18,1,1812,1661,151
1,1,11,18,1,1661,1821,-160
1,1,12,18,1,1821,1739,82
1,1,13,18,1,1739,1676,63
1,1,14,18,1,1676,2099,-423
1,1,15,18,1,2099,2751,-652
1,1,16,18,1,2751,2475,276
1,1,17,18,1,2475,2382,93
1,1,18,18,1,2382,2568,-186
1,1,19,18,1,2568,2416,152
1,1,20,18,1,2416,2460,-44
1,1,21,18,1,2460,2337,123
1,1,22,18,1,2337,2227,110
1,2,0,18,1,2294,2091,203
1,2,1,18,1,2091,1749,342
1,2,2,18,1,1749,2077,-328
1,2,3,18,1,2077,2706,-629
1,2,4,18,1,2706,2690,16
1,2,5,18,1,2690,2130,560
1,2,6,18,1,2130,2717,-587
1,2,7,18,1,2717,2712,5
1,2,8,18,1,2712,1716,996
1,2,9,18,1,1716,1866,-150
1,2,10,18,1,1866,1689,177
1,2,11,18,1,1689,1876,-187
1,2,12,18,1,1876,1792,84
1,2,13,18,1,1792,1681,111
1,2,14,18,1,1681,2057,-376
1,2,15,18,1,2057,2824,-767
1,2,16,18,1,2824,2576,248
1,2,17,18,1,2576,2347,229
1,2,18,18,1,2347,2529,-182
1,2,19,18,1,2529,2492,37
1,2,20,18,1,2492,2428,64
1,2,21,18,1,2428,2297,131
1,2,22,18,1,2297,2326,-29
1,3,0,18,1,2378,2052,326
1,3,1,18,1,2052,1705,347
1,3,2,18,1,1705,2200,-495
1,3,3,18,1,2200,2693,-493
1,3,4,18,1,2693,2625,68
1,3,5,18,1,2625,2095,530
1,3,6,18,1,2095,2778,-683
1,3,7,18,1,2778,2841,-63
1,3,8,18,1,2841,1735,1106
1,3,9,18,1,1735,1910,-175
1,3,10,18,1,1910,1702,208
1,3,11,18,1,1702,1922,-220
1,3,12,18,1,1922,1830,92
1,3,13,18,1,1830,1655,175
1,3,14,18,1,1655,2021,-366
1,3,15,18,1,2021,2845,-824
1,3,16,18,1,2845,2587,258
1,3,17,18,1,2587,2286,301
1,3,18,18,1,2286,2499,-213
1,3,19,18,1,2499,2552,-53
1,3,20,18,1,2552,2363,189
1,3,21,18,1,2363,2237,126
1,3,22,18,1,2237,2431,-194
1,4,0,18,1,2469,2007,462
1,4,1,18,1,2007,1684,323
1,4,2,18,1,1684,2330,-646
1,4,3,18,1,2330,2643,-313
1,4,4,18,1,2643,2542,101
1,4,5,18,1,2542,2041,501
1,4,6,18,1,2041,2747,-706
1,4,7,18,1,2747,2914,-167
1,4,8,18,1,2914,1707,1207
1,4,9,18,1,1707,1870,-163
1,4,10,18,1,1870,1683,187
1,4,11,18,1,1683,1948,-265
1,4,12,18,1,1948,1803,145
1,4,13,18,1,1803,1614,189
1,4,14,18,1,1614,2009,-395
1,4,15,18,1,2009,2798,-789
1,4,16,18,1,2798,2558,240
1,4,17,18,1,2558,2224,334
1,4,18,18,1,2224,2462,-238
1,4,19,18,1,2462,2546,-84
1,4,20,18,1,2546,2348,198
1,4,21,18,1,2348,2222,126
1,4,22,18,1,2222,2493,-271
1,5,0,18,1,2452,1962,490
1,5,1,18,1,1962,1646,316
1,5,2,18,1,1646,2335,-689
1,5,3,18,1,2335,2557,-222
1,5,4,18,1,2557,2459,98
1,5,5,18,1,2459,1992,467
1,5,6,18,1,1992,2766,-774
1,5,7,18,1,2766,3011,-245
1,5,8,18,1,3011,1705,1306
1,5,9,18,1,1705,1892,-187
1,5,10,18,1,1892,1699,193
1,5,11,18,1,1699,2020,-321
1,5,12,18,1,2020,1841,179
1,5,13,18,1,1841,1600,241
1,5,14,18,1,1600,2059,-459
1,5,15,18,1,2059,2851,-792
1,5,16,18,1,2851,2553,298
1,5,17,18,1,2553,2138,415
1,5,18,18,1,2138,2397,-259
1,5,19,18,1,2397,2479,-82
1,5,20,18,1,2479,2292,187
1,5,21,18,1,2292,2163,129
1,5,22,18,1,2163,2439,-276
1,6,0,18,1,2449,1909,540
1,6,1,18,1,1909,1580,329
1,6,2,18,1,1580,2285,-705
1,6,3,18,1,2285,2501,-216
1,6,4,18,1,2501,2415,86
1,6,5,18,1,2415,1971,444
1,6,6,18,1,1971,2807,-836
1,6,7,18,1,2807,3068,-261
1,6,8,18,1,3068,1735,1333
1,6,9,18,1,1735,1880,-145
1,6,10,18,1,1880,1694,186
1,6,11,18,1,1694,2087,-393
1,6,12,18,1,2087,1866,221
1,6,13,18,1,1866,1627,239
1,6,14,18,1,1627,2087,-460
1,6,15,18,1,2087,2903,-816
1,6,16,18,1,2903,2562,341
1,6,17,18,1,2562,2099,463
1,6,18,18,1,2099,2360,-261
1,6,19,18,1,2360,2417,-57
1,6,20,18,1,2417,2206,211
1,6,21,18,1,2206,2119,87
1,6,22,18,1,2119,2378,-259
1,0,0,19,1,2320,2219,101
1,0,1,19,1,2219,1848,371
1,0,2,19,1,1848,2047,-199
1,0,3,19,1,2047,2799,-752
1,0,4,19,1,2799,2829,-30
1,0,5,19,1,2829,2264,565
1,0,6,19,1,2264,2831,-567
1,0,7,19,1,2831,2737,94
1,0,8,19,1,2737,1802,935
1,0,9,19,1,1802,1914,-112
1,0,10,19,1,1914,1763,151
1,0,11,19,1,1763,1923,-160
1,0,12,19,1,1923,1842,81
1,0,13,19,1,1842,1780,62
1,0,14,19,1,1780,2204,-424
1,0,15,19,1,2204,2849,-645
1,0,16,19,1,2849,2577,272
1,0,17,19,1,2577,2492,85
1,0,18,19,1,2492,2676,-184
1,0,19,19,1,2676,2514,162
1,0,20,19,1,2514,2563,-49
1,0,21,19,1,2563,2446,117
1,0,22,19,1,2446,2329,117
1,1,0,19,1,2400,2202,198
1,1,1,19,1,2202,1856,346
1,1,2,19,1,1856,2183,-327
1,1,3,19,1,2183,2818,-635
1,1,4,19,1,2818,2798,20
1,1,5,19,1,2798,2232,566
1,1,6,19,1,2232,2824,-592
1,1,7,19,1,2824,2820,4
1,1,8,19,1,2820,1822,998
1,1,9,19,1,1822,1970,-148
1,1,10,19,1,1970,1792,178
1,1,11,19,1,1792,1979,-187
1,1,12,19,1,1979,1896,83
1,1,13,19,1,1896,1786,110
1,1,14,19,1,1786,2164,-378
1,1,15,19,1,2164,2939,-775
1,1,16,19,1,2939,2683,256
1,1,17,19,1,2683,2451,232
1,1,18,19,1,2451,2631,-180
1,1,19,19,1,2631,2593,38
1,1,20,19,1,2593,2539,54
1,1,21,19,1,2539,2411,128
1,1,22,19,1,2411,2428,-17
1,2,0,19,1,2484,2167,317
1,2,1,19,1,2167,1817,350
1,2,2,19,1,1817,2307,-490
1,2,3,19,1,2307,2803,-496
1,2,4,19,1,2803,2733,70
1,2,5,19,1,2733,2203,530
1,2,6,19,1,2203,2896,-693
1,2,7,19,1,2896,2956,-60
1,2,8,19,1,2956,1848,1108
1,2,9,19,1,1848,2019,-171
1,2,10,19,1,2019,1809,210
1,2,11,19,1,1809,2028,-219
1,2,12,19,1,2028,1938,90
1,2,13,19,1,1938,1765,173
1,2,14,19,1,1765,2132,-367
1,2,15,19,1,2132,2962,-830
1,2,16,19,1,2962,2696,266
1,2,17,19,1,2696,2395,301
1,2,18,19,1,2395,2606,-211
1,2,19,19,1,2606,2655,-49
1,2,20,19,1,2655,2473,182
1,2,21,19,1,2473,2352,121
1,2,22,19,1,2352,2537,-185
1,3,0,19,1,2581,2124,457
1,3,1,19,1,2124,1794,330
1,3,2,19,1,1794,2435,-641
1,3,3,19,1,2435,2755,-320
1,3,4,19,1,2755,2657,98
1,3,5,19,1,2657,2153,504
1,3,6,19,1,2153,2862,-709
1,3,7,19,1,2862,2986,-124
1,3,8,19,1,2986,1776,1210
1,3,9,19,1,1776,1936,-160
1,3,10,19,1,1936,1746,190
1,3,11,19,1,1746,2010,-264
1,3,12,19,1,2010,1866,144
1,3,13,19,1,1866,1679,187
1,3,14,19,1,1679,2076,-397
1,3,15,19,1,2076,2888,-812
1,3,16,19,1,2888,2657,231
1,3,17,19,1,2657,2341,316
1,3,18,19,1,2341,2583,-242
1,3,19,19,1,2583,2653,-70
1,3,20,19,1,2653,2452,201
1,3,21,19,1,2452,2333,119
1,3,22,19,1,2333,2604,-271
1,4,0,19,1,2566,2081,485
1,4,1,19,1,2081,1760,321
1,4,2,19,1,1760,2450,-690
1,4,3,19,1,2450,2683,-233
1,4,4,19,1,2683,2579,104
1,4,5,19,1,2579,2086,493
1,4,6,19,1,2086,2842,-756
1,4,7,19,1,2842,3065,-223
1,4,8,19,1,3065,1756,1309
1,4,9,19,1,1756,1940,-184
1,4,10,19,1,1940,1744,196
1,4,11,19,1,1744,2064,-320
1,4,12,19,1,2064,1886,178
1,4,13,19,1,1886,1647,239
1,4,14,19,1,1647,2107,-460
1,4,15,19,1,2107,2910,-803
1,4,16,19,1,2910,2628,282
1,4,17,19,1,2628,2244,384
1,4,18,19,1,2244,2520,-276
1,4,19,19,1,2520,2594,-74
1,4,20,19,1,2594,2402,192
1,4,21,19,1,2402,2276,126
1,4,22,19,1,2276,2549,-273
1,5,0,19,1,2563,2031,532
1,5,1,19,1,2031,1700,331
1,5,2,19,1,1700,2404,-704
1,5,3,19,1,2404,2626,-222
1,5,4,19,1,2626,2524,102
1,5,5,19,1,2524,2040,484
1,5,6,19,1,2040,2846,-806
1,5,7,19,1,2846,3137,-291
1,5,8,19,1,3137,1803,1334
1,5,9,19,1,1803,1947,-144
1,5,10,19,1,1947,1759,188
1,5,11,19,1,1759,2152,-393
1,5,12,19,1,2152,1931,221
1,5,13,19,1,1931,1692,239
1,5,14,19,1,1692,2153,-461
1,5,15,19,1,2153,2958,-805
1,5,16,19,1,2958,2620,338
1,5,17,19,1,2620,2180,440
1,5,18,19,1,2180,2467,-287
1,5,19,19,1,2467,2533,-66
1,5,20,19,1,2533,2325,208
1,5,21,19,1,2325,2237,88
1,5,22,19,1,2237,2486,-249
1,0,0,20,1,2510,2309,201
1,0,1,20,1,2309,1952,357
1,0,2,20,1,1952,2281,-329
1,0,3,20,1,2281,2929,-648
1,0,4,20,1,2929,2909,20
1,0,5,20,1,2909,2336,573
1,0,6,20,1,2336,2930,-594
1,0,7,20,1,2930,2924,6
1,0,8,20,1,2924,1925,999
1,0,9,20,1,1925,2072,-147
1,0,10,20,1,2072,1894,178
1,0,11,20,1,1894,2081,-187
1,0,12,20,1,2081,1999,82
1,0,13,20,1,1999,1890,109
1,0,14,20,1,1890,2269,-379
1,0,15,20,1,2269,3037,-768
1,0,16,20,1,3037,2785,252
1,0,17,20,1,2785,2561,224
1,0,18,20,1,2561,2739,-178
1,0,19,20,1,2739,2691,48
1,0,20,20,1,2691,2642,49
1,0,21,20,1,2642,2520,122
1,0,22,20,1,2520,2530,-10
1,1,0,20,1,2590,2278,312
1,1,1,20,1,2278,1924,354
1,1,2,20,1,1924,2413,-489
1,1,3,20,1,2413,2915,-502
1,1,4,20,1,2915,2841,74
1,1,5,20,1,2841,2305,536
1,1,6,20,1,2305,3003,-698
1,1,7,20,1,3003,3064,-61
1,1,8,20,1,3064,1954,1110
1,1,9,20,1,1954,2123,-169
1,1,10,20,1,2123,1912,211
1,1,11,20,1,1912,2131,-219
1,1,12,20,1,2131,2042,89
1,1,13,20,1,2042,1870,172
1,1,14,20,1,1870,2239,-369
1,1,15,20,1,2239,3077,-838
1,1,16,20,1,3077,2803,274
1,1,17,20,1,2803,2499,304
1,1,18,20,1,2499,2708,-209
1,1,19,20,1,2708,2756,-48
1,1,20,20,1,2756,2584,172
1,1,21,20,1,2584,2466,118
1,1,22,20,1,2466,2639,-173
1,2,0,20,1,2687,2239,448
1,2,1,20,1,2239,1906,333
1,2,2,20,1,1906,2542,-636
1,2,3,20,1,2542,2865,-323
1,2,4,20,1,2865,2765,100
1,2,5,20,1,2765,2261,504
1,2,6,20,1,2261,2980,-719
1,2,7,20,1,2980,3101,-121
1,2,8,20,1,3101,1889,1212
1,2,9,20,1,1889,2045,-156
1,2,10,20,1,2045,1853,192
1,2,11,20,1,1853,2116,-263
1,2,12,20,1,2116,1974,142
1,2,13,20,1,1974,1789,185
1,2,14,20,1,1789,2187,-398
1,2,15,20,1,2187,3005,-818
1,2,16,20,1,3005,2766,239
1,2,17,20,1,2766,2450,316
1,2,18,20,1,2450,2690,-240
1,2,19,20,1,2690,2756,-66
1,2,20,20,1,2756,2562,194
1,2,21,20,1,2562,2448,114
1,2,22,20,1,2448,2710,-262
1,3,0,20,1,2678,2198,480
1,3,1,20,1,2198,1870,328
1,3,2,20,1,1870,2555,-685
1,3,3,20,1,2555,2795,-240
1,3,4,20,1,2795,2694,101
1,3,5,20,1,2694,2198,496
1,3,6,20,1,2198,2957,-759
1,3,7,20,1,2957,3137,-180
1,3,8,20,1,3137,1825,1312
1,3,9,20,1,1825,2006,-181
1,3,10,20,1,2006,1807,199
1,3,11,20,1,1807,2126,-319
1,3,12,20,1,2126,1949,177
1,3,13,20,1,1949,1712,237
1,3,14,20,1,1712,2174,-462
1,3,15,20,1,2174,3000,-826
1,3,16,20,1,3000,2727,273
1,3,17,20,1,2727,2361,366
1,3,18,20,1,2361,2641,-280
1,3,19,20,1,2641,2701,-60
1,3,20,20,1,2701,2506,195
1,3,21,20,1,2506,2387,119
1,3,22,20,1,2387,2660,-273
1,4,0,20,1,2677,2150,527
1,4,1,20,1,2150,1814,336
1,4,2,20,1,1814,2519,-705
1,4,3,20,1,2519,2752,-233
1,4,4,20,1,2752,2644,108
1,4,5,20,1,2644,2134,510
1,4,6,20,1,2134,2922,-788
1,4,7,20,1,2922,3191,-269
1,4,8,20,1,3191,1854,1337
1,4,9,20,1,1854,1995,-141
1,4,10,20,1,1995,1804,191
1,4,11,20,1,1804,2196,-392
1,4,12,20,1,2196,1976,220
1,4,13,20,1,1976,1739,237
1,4,14,20,1,1739,2201,-462
1,4,15,20,1,2201,3017,-816
1,4,16,20,1,3017,2695,322
1,4,17,20,1,2695,2286,409
1,4,18,20,1,2286,2590,-304
1,4,19,20,1,2590,2648,-58
1,4,20,20,1,2648,2435,213
1,4,21,20,1,2435,2350,85
1,4,22,20,1,2350,2596,-246
1,0,0,21,1,2700,2385,315
1,0,1,21,1,2385,2020,365
1,0,2,21,1,2020,2511,-491
1,0,3,21,1,2511,3026,-515
1,0,4,21,1,3026,2952,74
1,0,5,21,1,2952,2409,543
1,0,6,21,1,2409,3109,-700
1,0,7,21,1,3109,3168,-59
1,0,8,21,1,3168,2057,1111
1,0,9,21,1,2057,2225,-168
1,0,10,21,1,2225,2014,211
1,0,11,21,1,2014,2233,-219
1,0,12,21,1,2233,2145,88
1,0,13,21,1,2145,1974,171
1,0,14,21,1,1974,2344,-370
1,0,15,21,1,2344,3175,-831
1,0,16,21,1,3175,2905,270
1,0,17,21,1,2905,2609,296
1,0,18,21,1,2609,2816,-207
1,0,19,21,1,2816,2854,-38
1,0,20,21,1,2854,2687,167
1,0,21,21,1,2687,2575,112
1,0,22,21,1,2575,2741,-166
1,1,0,21,1,2793,2350,443
1,1,1,21,1,2350,2013,337
1,1,2,21,1,2013,2648,-635
1,1,3,21,1,2648,2977,-329
1,1,4,21,1,2977,2873,104
1,1,5,21,1,2873,2363,510
1,1,6,21,1,2363,3087,-724
1,1,7,21,1,3087,3209,-122
1,1,8,21,1,3209,1995,1214
1,1,9,21,1,1995,2149,-154
1,1,10,21,1,2149,1956,193
1,1,11,21,1,1956,2219,-263
1,1,12,21,1,2219,2078,141
1,1,13,21,1,2078,1894,184
1,1,14,21,1,1894,2294,-400
1,1,15,21,1,2294,3120,-826
1,1,16,21,1,3120,2873,247
1,1,17,21,1,2873,2554,319
1,1,18,21,1,2554,2792,-238
1,1,19,21,1,2792,2857,-65
1,1,20,21,1,2857,2673,184
1,1,21,21,1,2673,2562,111
1,1,22,21,1,2562,2812,-250
1,2,0,21,1,2784,2313,471
1,2,1,21,1,2313,1982,331
1,2,2,21,1,1982,2662,-680
1,2,3,21,1,2662,2905,-243
1,2,4,21,1,2905,2802,103
1,2,5,21,1,2802,2306,496
1,2,6,21,1,2306,3075,-769
1,2,7,21,1,3075,3252,-177
1,2,8,21,1,3252,1938,1314
1,2,9,21,1,1938,2115,-177
1,2,10,21,1,2115,1914,201
1,2,11,21,1,1914,2232,-318
1,2,12,21,1,2232,2057,175
1,2,13,21,1,2057,1822,235
1,2,14,21,1,1822,2285,-463
1,2,15,21,1,2285,3117,-832
1,2,16,21,1,3117,2836,281
1,2,17,21,1,2836,2470,366
1,2,18,21,1,2470,2748,-278
1,2,19,21,1,2748,2804,-56
1,2,20,21,1,2804,2616,188
1,2,21,21,1,2616,2502,114
1,2,22,21,1,2502,2766,-264
1,3,0,21,1,2789,2267,522
1,3,1,21,1,2267,1924,343
1,3,2,21,1,1924,2624,-700
1,3,3,21,1,2624,2864,-240
1,3,4,21,1,2864,2759,105
1,3,5,21,1,2759,2246,513
1,3,6,21,1,2246,3037,-791
1,3,7,21,1,3037,3263,-226
1,3,8,21,1,3263,1923,1340
1,3,9,21,1,1923,2061,-138
1,3,10,21,1,2061,1867,194
1,3,11,21,1,1867,2258,-391
1,3,12,21,1,2258,2039,219
1,3,13,21,1,2039,1804,235
1,3,14,21,1,1804,2268,-464
1,3,15,21,1,2268,3107,-839
1,3,16,21,1,3107,2794,313
1,3,17,21,1,2794,2403,391
1,3,18,21,1,2403,2711,-308
1,3,19,21,1,2711,2755,-44
1,3,20,21,1,2755,2539,216
1,3,21,21,1,2539,2461,78
1,3,22,21,1,2461,2707,-246
1,0,0,22,1,2903,2457,446
1,0,1,22,1,2457,2109,348
1,0,2,22,1,2109,2746,-637
1,0,3,22,1,2746,3088,-342
1,0,4,22,1,3088,2984,104
1,0,5,22,1,2984,2467,517
1,0,6,22,1,2467,3193,-726
1,0,7,22,1,3193,3313,-120
1,0,8,22,1,3313,2098,1215
1,0,9,22,1,2098,2251,-153
1,0,10,22,1,2251,2058,193
1,0,11,22,1,2058,2321,-263
1,0,12,22,1,2321,2181,140
1,0,13,22,1,2181,1998,183
1,0,14,22,1,1998,2399,-401
1,0,15,22,1,2399,3218,-819
1,0,16,22,1,3218,2975,243
1,0,17,22,1,2975,2664,311
1,0,18,22,1,2664,2900,-236
1,0,19,22,1,2900,2955,-55
1,0,20,22,1,2955,2776,179
1,0,21,22,1,2776,2671,105
1,0,22,22,1,2671,2914,-243
1,1,0,22,1,2890,2424,466
1,1,1,22,1,2424,2089,335
1,1,2,22,1,2089,2768,-679
1,1,3,22,1,2768,3017,-249
1,1,4,22,1,3017,2910,107
1,1,5,22,1,2910,2408,502
1,1,6,22,1,2408,3182,-774
1,1,7,22,1,3182,3360,-178
1,1,8,22,1,3360,2044,1316
1,1,9,22,1,2044,2219,-175
1,1,10,22,1,2219,2017,202
1,1,11,22,1,2017,2335,-318
1,1,12,22,1,2335,2161,174
1,1,13,22,1,2161,1927,234
1,1,14,22,1,1927,2392,-465
1,1,15,22,1,2392,3232,-840
1,1,16,22,1,3232,2943,289
1,1,17,22,1,2943,2574,369
1,1,18,22,1,2574,2850,-276
1,1,19,22,1,2850,2905,-55
1,1,20,22,1,2905,2727,178
1,1,21,22,1,2727,2616,111
1,1,22,22,1,2616,2868,-252
1,2,0,22,1,2895,2382,513
1,2,1,22,1,2382,2036,346
1,2,2,22,1,2036,2731,-695
1,2,3,22,1,2731,2974,-243
1,2,4,22,1,2974,2867,107
1,2,5,22,1,2867,2354,513
1,2,6,22,1,2354,3155,-801
1,2,7,22,1,3155,3378,-223
1,2,8,22,1,3378,2036,1342
1,2,9,22,1,2036,2170,-134
1,2,10,22,1,2170,1974,196
1,2,11,22,1,1974,2364,-390
1,2,12,22,1,2364,2147,217
1,2,13,22,1,2147,1914,233
1,2,14,22,1,1914,2379,-465
1,2,15,22,1,2379,3224,-845
1,2,16,22,1,3224,2903,321
1,2,17,22,1,2903,2512,391
1,2,18,22,1,2512,2818,-306
1,2,19,22,1,2818,2858,-40
1,2,20,22,1,2858,2649,209
1,2,21,22,1,2649,2576,73
1,2,22,22,1,2576,2813,-237
1,0,0,23,1,3000,2531,469
1,0,1,23,1,2531,2185,346
1,0,2,23,1,2185,2866,-681
1,0,3,23,1,2866,3128,-262
1,0,4,23,1,3128,3021,107
1,0,5,23,1,3021,2512,509
1,0,6,23,1,2512,3288,-776
1,0,7,23,1,3288,3464,-176
1,0,8,23,1,3464,2147,1317
1,0,9,23,1,2147,2321,-174
1,0,10,23,1,2321,2119,202
1,0,11,23,1,2119,2437,-318
1,0,12,23,1,2437,2264,173
1,0,13,23,1,2264,2031,233
1,0,14,23,1,2031,2497,-466
1,0,15,23,1,2497,3330,-833
1,0,16,23,1,3330,3045,285
1,0,17,23,1,3045,2684,361
1,0,18,23,1,2684,2958,-274
1,0,19,23,1,2958,3003,-45
1,0,20,23,1,3003,2830,173
1,0,21,23,1,2830,2725,105
1,0,22,23,1,2725,2970,-245
1,1,0,23,1,3001,2493,508
1,1,1,23,1,2493,2143,350
1,1,2,23,1,2143,2837,-694
1,1,3,23,1,2837,3086,-249
1,1,4,23,1,3086,2975,111
1,1,5,23,1,2975,2456,519
1,1,6,23,1,2456,3262,-806
1,1,7,23,1,3262,3486,-224
1,1,8,23,1,3486,2142,1344
1,1,9,23,1,2142,2274,-132
1,1,10,23,1,2274,2077,197
1,1,11,23,1,2077,2467,-390
1,1,12,23,1,2467,2251,216
1,1,13,23,1,2251,2019,232
1,1,14,23,1,2019,2486,-467
1,1,15,23,1,2486,3339,-853
1,1,16,23,1,3339,3010,329
1,1,17,23,1,3010,2616,394
1,1,18,23,1,2616,2920,-304
1,1,19,23,1,2920,2959,-39
1,1,20,23,1,2959,2760,199
1,1,21,23,1,2760,2690,70
1,1,22,23,1,2690,2915,-225
1,0,0,24,1,3111,2600,511
1,0,1,24,1,2600,2239,361
1,0,2,24,1,2239,2935,-696
1,0,3,24,1,2935,3197,-262
1,0,4,24,1,3197,3086,111
1,0,5,24,1,3086,2560,526
1,0,6,24,1,2560,3368,-808
1,0,7,24,1,3368,3590,-222
1,0,8,24,1,3590,2245,1345
1,0,9,24,1,2245,2376,-131
1,0,10,24,1,2376,2179,197
1,0,11,24,1,2179,2569,-390
1,0,12,24,1,2569,2354,215
1,0,13,24,1,2354,2123,231
1,0,14,24,1,2123,2591,-468
1,0,15,24,1,2591,3437,-846
1,0,16,24,1,3437,3112,325
1,0,17,24,1,3112,2726,386
1,0,18,24,1,2726,3028,-302
1,0,19,24,1,3028,3057,-29
1,0,20,24,1,3057,2863,194
1,0,21,24,1,2863,2799,64
1,0,22,24,1,2799,3017,-218
1,0,0,1,2,217,194,23
1,0,1,1,2,203,209,-6
1,0,2,1,2,194,222,-28
1,0,3,1,2,209,215,-6
1,0,4,1,2,222,210,12
1,0,5,1,2,215,210,5
1,0,6,1,2,210,207,3
1,0,7,1,2,210,205,5
1,0,8,1,2,207,204,3
1,0,9,1,2,205,204,1
1,0,10,1,2,204,205,-1
1,0,11,1,2,204,207,-3
1,0,12,1,2,205,209,-4
1,0,13,1,2,207,203,4
1,0,14,1,2,209,200,9
1,0,15,1,2,203,212,-9
1,0,16,1,2,200,218,-18
1,0,17,1,2,212,206,6
1,0,18,1,2,218,201,17
1,0,19,1,2,206,212,-6
1,0,20,1,2,201,211,-10
1,1,0,1,2,217,213,4
1,1,1,1,2,218,218,0
1,1,2,1,2,213,220,-7
1,1,3,1,2,218,210,8
1,1,4,1,2,220,209,11
1,1,5,1,2,210,215,-5
1,1,6,1,2,209,214,-5
1,1,7,1,2,215,210,5
1,1,8,1,2,214,207,7
1,1,9,1,2,210,206,4
1,1,10,1,2,207,207,0
1,1,11,1,2,206,209,-3
1,1,12,1,2,207,212,-5
1,1,13,1,2,209,222,-13
1,1,14,1,2,212,222,-10
1,1,15,1,2,222,211,11
1,1,16,1,2,222,206,16
1,1,17,1,2,211,203,8
1,1,18,1,2,206,212,-6
1,1,19,1,2,203,225,-22
1,1,20,1,2,212,216,-4
1,2,0,1,2,221,219,2
1,2,1,1,2,227,217,10
1,2,2,1,2,219,218,1
1,2,3,1,2,217,216,1
1,2,4,1,2,218,226,-8
1,2,5,1,2,216,233,-17
1,2,6,1,2,226,228,-2
1,2,7,1,2,233,222,11
1,2,8,1,2,228,216,12
1,2,9,1,2,222,213,9
1,2,10,1,2,216,214,2
1,2,11,1,2,213,218,-5
1,2,12,1,2,214,221,-7
1,2,13,1,2,218,228,-10
1,2,14,1,2,221,226,-5
1,2,15,1,2,228,218,10
1,2,16,1,2,226,216,10
1,2,17,1,2,218,210,8
1,2,18,1,2,216,213,3
1,2,19,1,2,210,225,-15
1,2,20,1,2,213,221,-8
1,3,0,1,2,229,215,14
1,3,1,1,2,227,217,10
1,3,2,1,2,215,227,-12
1,3,3,1,2,217,227,-10
1,3,4,1,2,227,227,0
1,3,5,1,2,227,187,40
1,3,6,1,2,227,141,86
1,3,7,1,2,187,135,52
1,3,8,1,2,141,129,12
1,3,9,1,2,135,125,10
1,3,10,1,2,129,125,4
1,3,11,1,2,125,128,-3
1,3,12,1,2,125,132,-7
1,3,13,1,2,128,157,-29
1,3,14,1,2,132,189,-57
1,3,15,1,2,157,216,-59
1,3,16,1,2,189,238,-49
1,3,17,1,2,216,228,-12
1,3,18,1,2,238,211,27
1,3,19,1,2,228,215,13
1,3,20,1,2,211,222,-11
1,4,0,1,2,233,229,4
1,4,1,1,2,233,241,-8
1,4,2,1,2,229,246,-17
1,4,3,1,2,241,214,27
1,4,4,1,2,246,170,76
1,4,5,1,2,214,130,84
1,4,6,1,2,170,105,65
1,4,7,1,2,130,99,31
1,4,8,1,2,105,93,12
1,4,9,1,2,99,89,10
1,4,10,1,2,93,89,4
1,4,11,1,2,89,92,-3
1,4,12,1,2,89,95,-6
1,4,13,1,2,92,107,-15
1,4,14,1,2,95,134,-39
1,4,15,1,2,107,181,-74
1,4,16,1,2,134,229,-95
1,4,17,1,2,181,238,-57
1,4,18,1,2,229,225,4
1,4,19,1,2,238,223,15
1,4,20,1,2,225,223,2
1,5,0,1,2,236,239,-3
1,5,1,1,2,242,244,-2
1,5,2,1,2,239,234,5
1,5,3,1,2,244,178,66
1,5,4,1,2,234,108,126
1,5,5,1,2,178,108,70
1,5,6,1,2,108,137,-29
1,5,7,1,2,108,135,-27
1,5,8,1,2,137,132,5
1,5,9,1,2,135,130,5
1,5,10,1,2,132,130,2
1,5,11,1,2,130,130,0
1,5,12,1,2,130,131,-1
1,5,13,1,2,130,121,9
1,5,14,1,2,131,113,18
1,5,15,1,2,121,139,-18
1,5,16,1,2,113,188,-75
1,5,17,1,2,139,223,-84
1,5,18,1,2,188,235,-47
1,5,19,1,2,223,237,-14
1,5,20,1,2,235,226,9
1,6,0,1,2,244,198,46
1,6,1,1,2,233,176,57
1,6,2,1,2,198,169,29
1,6,3,1,2,176,149,27
1,6,4,1,2,169,125,44
1,6,5,1,2,149,127,22
1,6,6,1,2,125,138,-13
1,6,7,1,2,127,138,-11
1,6,8,1,2,138,138,0
1,6,9,1,2,138,138,0
1,6,10,1,2,138,138,0
1,6,11,1,2,138,137,1
1,6,12,1,2,138,136,2
1,6,13,1,2,137,145,-8
1,6,14,1,2,136,143,-7
1,6,15,1,2,145,137,8
1,6,16,1,2,143,158,-15
1,6,17,1,2,137,184,-47
1,6,18,1,2,158,204,-46
1,6,19,1,2,184,223,-39
1,6,20,1,2,204,231,-27
1,7,0,1,2,255,139,116
1,7,1,1,2,215,89,126
1,7,2,1,2,139,97,42
1,7,3,1,2,89,139,-50
1,7,4,1,2,97,187,-90
1,7,5,1,2,139,200,-61
1,7,6,1,2,187,191,-4
1,7,7,1,2,200,193,7
1,7,8,1,2,191,196,-5
1,7,9,1,2,193,198,-5
1,7,10,1,2,196,197,-1
1,7,11,1,2,198,195,3
1,7,12,1,2,197,193,4
1,7,13,1,2,195,195,0
1,7,14,1,2,193,183,10
1,7,15,1,2,195,163,32
1,7,16,1,2,183,156,27
1,7,17,1,2,163,149,14
1,7,18,1,2,156,156,0
1,7,19,1,2,149,194,-45
1,7,20,1,2,156,235,-79
1,8,0,1,2,267,199,68
1,8,1,1,2,262,141,121
1,8,2,1,2,199,157,42
1,8,3,1,2,141,229,-88
1,8,4,1,2,157,256,-99
1,8,5,1,2,229,248,-19
1,8,6,1,2,256,262,-6
1,8,7,1,2,248,265,-17
1,8,8,1,2,262,267,-5
1,8,9,1,2,265,283,-18
1,8,10,1,2,267,292,-25
1,8,11,1,2,283,284,-1
1,8,12,1,2,292,276,16
1,8,13,1,2,284,272,12
1,8,14,1,2,276,265,11
1,8,15,1,2,272,260,12
1,8,16,1,2,265,222,43
1,8,17,1,2,260,192,68
1,8,18,1,2,222,227,-5
1,8,19,1,2,192,246,-54
1,8,20,1,2,227,249,-22
1,9,0,1,2,175,112,63
1,9,1,1,2,138,84,54
1,9,2,1,2,112,96,16
1,9,3,1,2,84,99,-15
1,9,4,1,2,96,111,-15
1,9,5,1,2,99,131,-32
1,9,6,1,2,111,105,6
1,9,7,1,2,131,70,61
1,9,8,1,2,105,65,40
1,9,9,1,2,70,75,-5
1,9,10,1,2,65,67,-2
1,9,11,1,2,75,55,20
1,9,12,1,2,67,80,-13
1,9,13,1,2,55,112,-57
1,9,14,1,2,80,125,-45
1,9,15,1,2,112,124,-12
1,9,16,1,2,125,105,20
1,9,17,1,2,124,98,26
1,9,18,1,2,105,111,-6
1,9,19,1,2,98,136,-38
1,9,20,1,2,111,179,-68
1,10,0,1,2,148,136,12
1,10,1,1,2,104,224,-120
1,10,2,1,2,136,266,-130
1,10,3,1,2,224,241,-17
1,10,4,1,2,266,280,-14
1,10,5,1,2,241,299,-58
1,10,6,1,2,280,270,10
1,10,7,1,2,299,260,39
1,10,8,1,2,270,251,19
1,10,9,1,2,260,244,16
1,10,10,1,2,251,257,-6
1,10,11,1,2,244,256,-12
1,10,12,1,2,257,253,4
1,10,13,1,2,256,274,-18
1,10,14,1,2,253,294,-41
1,10,15,1,2,274,261,13
1,10,16,1,2,294,232,62
1,10,17,1,2,261,235,26
1,10,18,1,2,232,197,35
1,10,19,1,2,235,181,54
1,10,20,1,2,197,205,-8
1,11,0,1,2,239,213,26
1,11,1,1,2,190,376,-186
1,11,2,1,2,213,428,-215
1,11,3,1,2,376,398,-22
1,11,4,1,2,428,453,-25
1,11,5,1,2,398,446,-48
1,11,6,1,2,453,394,59
1,11,7,1,2,446,372,74
1,11,8,1,2,394,372,22
1,11,9,1,2,372,369,3
1,11,10,1,2,372,391,-19
1,11,11,1,2,369,384,-15
1,11,12,1,2,391,373,18
1,11,13,1,2,384,431,-47
1,11,14,1,2,373,478,-105
1,11,15,1,2,431,420,11
1,11,16,1,2,478,395,83
1,11,17,1,2,420,424,-4
1,11,18,1,2,395,382,13
1,11,19,1,2,424,342,82
1,11,20,1,2,382,307,75
1,12,0,1,2,298,230,68
1,12,1,1,2,251,363,-112
1,12,2,1,2,230,438,-208
1,12,3,1,2,363,414,-51
1,12,4,1,2,438,437,1
1,12,5,1,2,414,456,-42
1,12,6,1,2,437,343,94
1,12,7,1,2,456,225,231
1,12,8,1,2,343,229,114
1,12,9,1,2,225,246,-21
1,12,10,1,2,229,242,-13
1,12,11,1,2,246,214,32
1,12,12,1,2,242,262,-20
1,12,13,1,2,214,410,-196
1,12,14,1,2,262,489,-227
1,12,15,1,2,410,438,-28
1,12,16,1,2,489,422,67
1,12,17,1,2,438,440,-2
1,12,18,1,2,422,415,7
1,12,19,1,2,440,396,44
1,12,20,1,2,415,330,85
1,13,0,1,2,305,233,72
1,13,1,1,2,269,310,-41
1,13,2,1,2,233,440,-207
1,13,3,1,2,310,423,-113
1,13,4,1,2,440,403,37
1,13,5,1,2,423,482,-59
1,13,6,1,2,403,349,54
1,13,7,1,2,482,206,276
1,13,8,1,2,349,199,150
1,13,9,1,2,206,203,3
1,13,10,1,2,199,206,-7
1,13,11,1,2,203,187,16
1,13,12,1,2,206,248,-42
1,13,13,1,2,187,406,-219
1,13,14,1,2,248,466,-218
1,13,15,1,2,406,435,-29
1,13,16,1,2,466,431,35
1,13,17,1,2,435,390,45
1,13,18,1,2,431,365,66
1,13,19,1,2,390,385,5
1,13,20,1,2,365,331,34
1,14,0,1,2,321,237,84
1,14,1,1,2,284,298,-14
1,14,2,1,2,237,430,-193
1,14,3,1,2,298,397,-99
1,14,4,1,2,430,374,56
1,14,5,1,2,397,467,-70
1,14,6,1,2,374,336,38
1,14,7,1,2,467,227,240
1,14,8,1,2,336,220,116
1,14,9,1,2,227,202,25
1,14,10,1,2,220,221,-1
1,14,11,1,2,202,216,-14
1,14,12,1,2,221,259,-38
1,14,13,1,2,216,396,-180
1,14,14,1,2,259,421,-162
1,14,15,1,2,396,410,-14
1,14,16,1,2,421,443,-22
1,14,17,1,2,410,366,44
1,14,18,1,2,443,348,95
1,14,19,1,2,366,396,-30
1,14,20,1,2,348,355,-7
1,15,0,1,2,315,226,89
1,15,1,1,2,276,326,-50
1,15,2,1,2,226,457,-231
1,15,3,1,2,326,414,-88
1,15,4,1,2,457,401,56
1,15,5,1,2,414,475,-61
1,15,6,1,2,401,321,80
1,15,7,1,2,475,201,274
1,15,8,1,2,321,212,109
1,15,9,1,2,201,199,2
1,15,10,1,2,212,197,15
1,15,11,1,2,199,178,21
1,15,12,1,2,197,246,-49
1,15,13,1,2,178,415,-237
1,15,14,1,2,246,426,-180
1,15,15,1,2,415,418,-3
1,15,16,1,2,426,470,-44
1,15,17,1,2,418,372,46
1,15,18,1,2,470,347,123
1,15,19,1,2,372,384,-12
1,15,20,1,2,347,327,20
1,16,0,1,2,222,194,28
1,16,1,1,2,189,338,-149
1,16,2,1,2,194,468,-274
1,16,3,1,2,338,379,-41
1,16,4,1,2,468,378,90
1,16,5,1,2,379,487,-108
1,16,6,1,2,378,346,32
1,16,7,1,2,487,224,263
1,16,8,1,2,346,211,135
1,16,9,1,2,224,221,3
1,16,10,1,2,211,239,-28
1,16,11,1,2,221,210,11
1,16,12,1,2,239,272,-33
1,16,13,1,2,210,428,-218
1,16,14,1,2,272,424,-152
1,16,15,1,2,428,359,69
1,16,16,1,2,424,406,18
1,16,17,1,2,359,373,-14
1,16,18,1,2,406,324,82
1,16,19,1,2,373,285,88
1,16,20,1,2,324,257,67
1,17,0,1,2,183,209,-26
1,17,1,1,2,138,353,-215
1,17,2,1,2,209,398,-189
1,17,3,1,2,353,303,50
1,17,4,1,2,398,343,55
1,17,5,1,2,303,427,-124
1,17,6,1,2,343,267,76
1,17,7,1,2,427,181,246
1,17,8,1,2,267,177,90
1,17,9,1,2,181,150,31
1,17,10,1,2,177,166,11
1,17,11,1,2,150,144,6
1,17,12,1,2,166,201,-35
1,17,13,1,2,144,382,-238
1,17,14,1,2,201,403,-202
1,17,15,1,2,382,236,146
1,17,16,1,2,403,235,168
1,17,17,1,2,236,334,-98
1,17,18,1,2,235,340,-105
1,17,19,1,2,334,259,75
1,17,20,1,2,340,248,92
1,18,0,1,2,214,260,-46
1,18,1,1,2,168,422,-254
1,18,2,1,2,260,417,-157
1,18,3,1,2,422,248,174
1,18,4,1,2,417,197,220
1,18,5,1,2,248,240,8
1,18,6,1,2,197,185,12
1,18,7,1,2,240,148,92
1,18,8,1,2,185,159,26
1,18,9,1,2,148,191,-43
1,18,10,1,2,159,182,-23
1,18,11,1,2,191,178,13
1,18,12,1,2,182,185,-3
1,18,13,1,2,178,149,29
1,18,14,1,2,185,225,-40
1,18,15,1,2,149,231,-82
1,18,16,1,2,225,198,27
1,18,17,1,2,231,325,-94
1,18,18,1,2,198,364,-166
1,18,19,1,2,325,245,80
1,18,20,1,2,364,202,162
1,19,0,1,2,280,338,-58
1,19,1,1,2,194,364,-170
1,19,2,1,2,338,210,128
1,19,3,1,2,364,152,212
1,19,4,1,2,210,171,39
1,19,5,1,2,152,286,-134
1,19,6,1,2,171,310,-139
1,19,7,1,2,286,281,5
1,19,8,1,2,310,289,21
1,19,9,1,2,281,289,-8
1,19,10,1,2,289,315,-26
1,19,11,1,2,289,267,22
1,19,12,1,2,315,175,140
1,19,13,1,2,267,253,14
1,19,14,1,2,175,396,-221
1,19,15,1,2,253,277,-24
1,19,16,1,2,396,132,264
1,19,17,1,2,277,240,37
1,19,18,1,2,132,256,-124
1,19,19,1,2,240,153,87
1,19,20,1,2,256,275,-19
1,20,0,1,2,266,298,-32
1,20,1,1,2,144,327,-183
1,20,2,1,2,298,140,158
1,20,3,1,2,327,116,211
1,20,4,1,2,140,252,-112
1,20,5,1,2,116,423,-307
1,20,6,1,2,252,376,-124
1,20,7,1,2,423,285,138
1,20,8,1,2,376,273,103
1,20,9,1,2,285,272,13
1,20,10,1,2,273,298,-25
1,20,11,1,2,272,230,42
1,20,12,1,2,298,159,139
1,20,13,1,2,230,213,17
1,20,14,1,2,159,258,-99
1,20,15,1,2,213,168,45
1,20,16,1,2,258,125,133
1,20,17,1,2,168,240,-72
1,20,18,1,2,125,208,-83
1,20,19,1,2,240,100,140
1,20,20,1,2,208,266,-58
1,21,0,1,2,275,324,-49
1,21,1,1,2,161,297,-136
1,21,2,1,2,324,94,230
1,21,3,1,2,297,90,207
1,21,4,1,2,94,142,-48
1,21,5,1,2,90,229,-139
1,21,6,1,2,142,186,-44
1,21,7,1,2,229,67,162
1,21,8,1,2,186,70,116
1,21,9,1,2,67,132,-65
1,21,10,1,2,70,124,-54
1,21,11,1,2,132,60,72
1,21,12,1,2,124,79,45
1,21,13,1,2,60,98,-38
1,21,14,1,2,79,113,-34
1,21,15,1,2,98,125,-27
1,21,16,1,2,113,139,-26
1,21,17,1,2,125,185,-60
1,21,18,1,2,139,190,-51
1,21,19,1,2,185,185,0
1,21,20,1,2,190,269,-79
1,22,0,1,2,171,196,-25
1,22,1,1,2,150,160,-10
1,22,2,1,2,196,77,119
1,22,3,1,2,160,82,78
1,22,4,1,2,77,140,-63
1,22,5,1,2,82,246,-164
1,22,6,1,2,140,200,-60
1,22,7,1,2,246,119,127
1,22,8,1,2,200,131,69
1,22,9,1,2,119,177,-58
1,22,10,1,2,131,199,-68
1,22,11,1,2,177,116,61
1,22,12,1,2,199,131,68
1,22,13,1,2,116,210,-94
1,22,14,1,2,131,182,-51
1,22,15,1,2,210,90,120
1,22,16,1,2,182,78,104
1,22,17,1,2,90,106,-16
1,22,18,1,2,78,102,-24
1,22,19,1,2,106,108,-2
1,22,20,1,2,102,110,-8
1,23,0,1,2,180,123,57
1,23,1,1,2,123,138,-15
1,23,2,1,2,123,134,-11
1,23,3,1,2,138,113,25
1,23,4,1,2,134,128,6
1,23,5,1,2,113,206,-93
1,23,6,1,2,128,224,-96
1,23,7,1,2,206,153,53
1,23,8,1,2,224,115,109
1,23,9,1,2,153,192,-39
1,23,10,1,2,115,222,-107
1,23,11,1,2,192,182,10
1,23,12,1,2,222,186,36
1,23,13,1,2,182,201,-19
1,23,14,1,2,186,174,12
1,23,15,1,2,201,109,92
1,23,16,1,2,174,112,62
1,23,17,1,2,109,124,-15
1,23,18,1,2,112,87,25
1,23,19,1,2,124,107,17
1,23,20,1,2,87,121,-34
1,0,0,2,2,434,407,27
1,0,1,2,2,421,427,-6
1,0,2,2,2,407,442,-35
1,0,3,2,2,427,425,2
1,0,4,2,2,442,419,23
1,0,5,2,2,425,425,0
1,0,6,2,2,419,421,-2
1,0,7,2,2,425,415,10
1,0,8,2,2,421,411,10
1,0,9,2,2,415,410,5
1,0,10,2,2,411,412,-1
1,0,11,2,2,410,416,-6
1,0,12,2,2,412,421,-9
1,0,13,2,2,416,425,-9
1,0,14,2,2,421,422,-1
1,0,15,2,2,425,423,2
1,0,16,2,2,422,424,-2
1,0,17,2,2,423,409,14
1,0,18,2,2,424,413,11
1,0,19,2,2,409,437,-28
1,0,20,2,2,413,427,-14
1,1,0,2,2,438,432,6
1,1,1,2,2,445,435,10
1,1,2,2,2,432,438,-6
1,1,3,2,2,435,426,9
1,1,4,2,2,438,435,3
1,1,5,2,2,426,448,-22
1,1,6,2,2,435,442,-7
1,1,7,2,2,448,432,16
1,1,8,2,2,442,423,19
1,1,9,2,2,432,419,13
1,1,10,2,2,423,421,2
1,1,11,2,2,419,427,-8
1,1,12,2,2,421,433,-12
1,1,13,2,2,427,450,-23
1,1,14,2,2,433,448,-15
1,1,15,2,2,450,429,21
1,1,16,2,2,448,422,26
1,1,17,2,2,429,413,16
1,1,18,2,2,422,425,-3
1,1,19,2,2,413,450,-37
1,1,20,2,2,425,437,-12
1,2,0,2,2,450,434,16
1,2,1,2,2,454,434,20
1,2,2,2,2,434,445,-11
1,2,3,2,2,434,443,-9
1,2,4,2,2,445,453,-8
1,2,5,2,2,443,420,23
1,2,6,2,2,453,369,84
1,2,7,2,2,420,357,63
1,2,8,2,2,369,345,24
1,2,9,2,2,357,338,19
1,2,10,2,2,345,339,6
1,2,11,2,2,338,346,-8
1,2,12,2,2,339,353,-14
1,2,13,2,2,346,385,-39
1,2,14,2,2,353,415,-62
1,2,15,2,2,385,434,-49
1,2,16,2,2,415,454,-39
1,2,17,2,2,434,438,-4
1,2,18,2,2,454,424,30
1,2,19,2,2,438,440,-2
1,2,20,2,2,424,443,-19
1,3,0,2,2,462,444,18
1,3,1,2,2,460,458,2
1,3,2,2,2,444,473,-29
1,3,3,2,2,458,441,17
1,3,4,2,2,473,397,76
1,3,5,2,2,441,317,124
1,3,6,2,2,397,246,151
1,3,7,2,2,317,234,83
1,3,8,2,2,246,222,24
1,3,9,2,2,234,214,20
1,3,10,2,2,222,214,8
1,3,11,2,2,214,220,-6
1,3,12,2,2,214,227,-13
1,3,13,2,2,220,264,-44
1,3,14,2,2,227,323,-96
1,3,15,2,2,264,397,-133
1,3,16,2,2,323,467,-144
1,3,17,2,2,397,466,-69
1,3,18,2,2,467,436,31
1,3,19,2,2,466,438,28
1,3,20,2,2,436,445,-9
1,4,0,2,2,469,468,1
1,4,1,2,2,475,485,-10
1,4,2,2,2,468,480,-12
1,4,3,2,2,485,392,93
1,4,4,2,2,480,278,202
1,4,5,2,2,392,238,154
1,4,6,2,2,278,242,36
1,4,7,2,2,238,234,4
1,4,8,2,2,242,225,17
1,4,9,2,2,234,219,15
1,4,10,2,2,225,219,6
1,4,11,2,2,219,222,-3
1,4,12,2,2,219,226,-7
1,4,13,2,2,222,228,-6
1,4,14,2,2,226,247,-21
1,4,15,2,2,228,320,-92
1,4,16,2,2,247,417,-170
1,4,17,2,2,320,461,-141
1,4,18,2,2,417,460,-43
1,4,19,2,2,461,460,1
1,4,20,2,2,460,449,11
1,5,0,2,2,480,437,43
1,5,1,2,2,475,420,55
1,5,2,2,2,437,403,34
1,5,3,2,2,420,327,93
1,5,4,2,2,403,233,170
1,5,5,2,2,327,235,92
1,5,6,2,2,233,275,-42
1,5,7,2,2,235,273,-38
1,5,8,2,2,275,270,5
1,5,9,2,2,273,268,5
1,5,10,2,2,270,268,2
1,5,11,2,2,268,267,1
1,5,12,2,2,268,267,1
1,5,13,2,2,267,266,1
1,5,14,2,2,267,256,11
1,5,15,2,2,266,276,-10
1,5,16,2,2,256,346,-90
1,5,17,2,2,276,407,-131
1,5,18,2,2,346,439,-93
1,5,19,2,2,407,460,-53
1,5,20,2,2,439,457,-18
1,6,0,2,2,499,337,162
1,6,1,2,2,448,265,183
1,6,2,2,2,337,266,71
1,6,3,2,2,265,288,-23
1,6,4,2,2,266,312,-46
1,6,5,2,2,288,327,-39
1,6,6,2,2,312,329,-17
1,6,7,2,2,327,331,-4
1,6,8,2,2,329,334,-5
1,6,9,2,2,331,336,-5
1,6,10,2,2,334,335,-1
1,6,11,2,2,336,332,4
1,6,12,2,2,335,329,6
1,6,13,2,2,332,340,-8
1,6,14,2,2,329,326,3
1,6,15,2,2,340,300,40
1,6,16,2,2,326,314,12
1,6,17,2,2,300,333,-33
1,6,18,2,2,314,360,-46
1,6,19,2,2,333,417,-84
1,6,20,2,2,360,466,-106
1,7,0,2,2,522,338,184
1,7,1,2,2,477,230,247
1,7,2,2,2,338,254,84
1,7,3,2,2,230,368,-138
1,7,4,2,2,254,443,-189
1,7,5,2,2,368,448,-80
1,7,6,2,2,443,453,-10
1,7,7,2,2,448,458,-10
1,7,8,2,2,453,463,-10
1,7,9,2,2,458,481,-23
1,7,10,2,2,463,489,-26
1,7,11,2,2,481,479,2
1,7,12,2,2,489,469,20
1,7,13,2,2,479,467,12
1,7,14,2,2,469,448,21
1,7,15,2,2,467,423,44
1,7,16,2,2,448,378,70
1,7,17,2,2,423,341,82
1,7,18,2,2,378,383,-5
1,7,19,2,2,341,440,-99
1,7,20,2,2,383,484,-101
1,8,0,2,2,442,311,131
1,8,1,2,2,400,225,175
1,8,2,2,2,311,253,58
1,8,3,2,2,225,328,-103
1,8,4,2,2,253,367,-114
1,8,5,2,2,328,379,-51
1,8,6,2,2,367,367,0
1,8,7,2,2,379,335,44
1,8,8,2,2,367,332,35
1,8,9,2,2,335,358,-23
1,8,10,2,2,332,359,-27
1,8,11,2,2,358,339,19
1,8,12,2,2,359,356,3
1,8,13,2,2,339,384,-45
1,8,14,2,2,356,390,-34
1,8,15,2,2,384,384,0
1,8,16,2,2,390,327,63
1,8,17,2,2,384,290,94
1,8,18,2,2,327,338,-11
1,8,19,2,2,290,382,-92
1,8,20,2,2,338,428,-90
1,9,0,2,2,323,248,75
1,9,1,2,2,242,308,-66
1,9,2,2,2,248,362,-114
1,9,3,2,2,308,340,-32
1,9,4,2,2,362,391,-29
1,9,5,2,2,340,430,-90
1,9,6,2,2,391,375,16
1,9,7,2,2,430,330,100
1,9,8,2,2,375,316,59
1,9,9,2,2,330,319,11
1,9,10,2,2,316,324,-8
1,9,11,2,2,319,311,8
1,9,12,2,2,324,333,-9
1,9,13,2,2,311,386,-75
1,9,14,2,2,333,419,-86
1,9,15,2,2,386,385,1
1,9,16,2,2,419,337,82
1,9,17,2,2,385,333,52
1,9,18,2,2,337,308,29
1,9,19,2,2,333,317,16
1,9,20,2,2,308,384,-76
1,10,0,2,2,387,349,38
1,10,1,2,2,294,600,-306
1,10,2,2,2,349,694,-345
1,10,3,2,2,600,639,-39
1,10,4,2,2,694,733,-39
1,10,5,2,2,639,745,-106
1,10,6,2,2,733,664,69
1,10,7,2,2,745,632,113
1,10,8,2,2,664,623,41
1,10,9,2,2,632,613,19
1,10,10,2,2,623,648,-25
1,10,11,2,2,613,640,-27
1,10,12,2,2,648,626,22
1,10,13,2,2,640,705,-65
1,10,14,2,2,626,772,-146
1,10,15,2,2,705,681,24
1,10,16,2,2,772,627,145
1,10,17,2,2,681,659,22
1,10,18,2,2,627,579,48
1,10,19,2,2,659,523,136
1,10,20,2,2,579,512,67
1,11,0,2,2,537,443,94
1,11,1,2,2,441,739,-298
1,11,2,2,2,443,866,-423
1,11,3,2,2,739,812,-73
1,11,4,2,2,866,890,-24
1,11,5,2,2,812,902,-90
1,11,6,2,2,890,737,153
1,11,7,2,2,902,597,305
1,11,8,2,2,737,601,136
1,11,9,2,2,597,615,-18
1,11,10,2,2,601,633,-32
1,11,11,2,2,615,598,17
1,11,12,2,2,633,635,-2
1,11,13,2,2,598,841,-243
1,11,14,2,2,635,967,-332
1,11,15,2,2,841,858,-17
1,11,16,2,2,967,817,150
1,11,17,2,2,858,864,-6
1,11,18,2,2,817,797,20
1,11,19,2,2,864,738,126
1,11,20,2,2,797,637,160
1,12,0,2,2,603,463,140
1,12,1,2,2,520,673,-153
1,12,2,2,2,463,878,-415
1,12,3,2,2,673,837,-164
1,12,4,2,2,878,840,38
1,12,5,2,2,837,938,-101
1,12,6,2,2,840,692,148
1,12,7,2,2,938,431,507
1,12,8,2,2,692,428,264
1,12,9,2,2,431,449,-18
1,12,10,2,2,428,448,-20
1,12,11,2,2,449,401,48
1,12,12,2,2,448,510,-62
1,12,13,2,2,401,816,-415
1,12,14,2,2,510,955,-445
1,12,15,2,2,816,873,-57
1,12,16,2,2,955,853,102
1,12,17,2,2,873,830,43
1,12,18,2,2,853,780,73
1,12,19,2,2,830,781,49
1,12,20,2,2,780,661,119
1,13,0,2,2,626,470,156
1,13,1,2,2,553,608,-55
1,13,2,2,2,470,870,-400
1,13,3,2,2,608,820,-212
1,13,4,2,2,870,777,93
1,13,5,2,2,820,949,-129
1,13,6,2,2,777,685,92
1,13,7,2,2,949,433,516
1,13,8,2,2,685,419,266
1,13,9,2,2,433,405,28
1,13,10,2,2,419,427,-8
1,13,11,2,2,405,403,2
1,13,12,2,2,427,507,-80
1,13,13,2,2,403,802,-399
1,13,14,2,2,507,887,-380
1,13,15,2,2,802,845,-43
1,13,16,2,2,887,874,13
1,13,17,2,2,845,756,89
1,13,18,2,2,874,713,161
1,13,19,2,2,756,781,-25
1,13,20,2,2,713,686,27
1,14,0,2,2,636,463,173
1,14,1,2,2,560,624,-64
1,14,2,2,2,463,887,-424
1,14,3,2,2,624,811,-187
1,14,4,2,2,887,775,112
1,14,5,2,2,811,942,-131
1,14,6,2,2,775,657,118
1,14,7,2,2,942,428,514
1,14,8,2,2,657,432,225
1,14,9,2,2,428,401,27
1,14,10,2,2,432,418,14
1,14,11,2,2,401,394,7
1,14,12,2,2,418,505,-87
1,14,13,2,2,394,811,-417
1,14,14,2,2,505,847,-342
1,14,15,2,2,811,828,-17
1,14,16,2,2,847,913,-66
1,14,17,2,2,828,738,90
1,14,18,2,2,913,695,218
1,14,19,2,2,738,780,-42
1,14,20,2,2,695,682,13
1,15,0,2,2,537,420,117
1,15,1,2,2,465,664,-199
1,15,2,2,2,420,925,-505
1,15,3,2,2,664,793,-129
1,15,4,2,2,925,779,146
1,15,5,2,2,793,962,-169
1,15,6,2,2,779,667,112
1,15,7,2,2,962,425,537
1,15,8,2,2,667,423,244
1,15,9,2,2,425,420,5
1,15,10,2,2,423,436,-13
1,15,11,2,2,420,388,32
1,15,12,2,2,436,518,-82
1,15,13,2,2,388,843,-455
1,15,14,2,2,518,850,-332
1,15,15,2,2,843,777,66
1,15,16,2,2,850,876,-26
1,15,17,2,2,777,745,32
1,15,18,2,2,876,671,205
1,15,19,2,2,745,669,76
1,15,20,2,2,671,584,87
1,16,0,2,2,405,403,2
1,16,1,2,2,327,691,-364
1,16,2,2,2,403,866,-463
1,16,3,2,2,691,682,9
1,16,4,2,2,866,721,145
1,16,5,2,2,682,914,-232
1,16,6,2,2,721,613,108
1,16,7,2,2,914,405,509
1,16,8,2,2,613,388,225
1,16,9,2,2,405,371,34
1,16,10,2,2,388,405,-17
1,16,11,2,2,371,354,17
1,16,12,2,2,405,473,-68
1,16,13,2,2,354,810,-456
1,16,14,2,2,473,827,-354
1,16,15,2,2,810,595,215
1,16,16,2,2,827,641,186
1,16,17,2,2,595,707,-112
1,16,18,2,2,641,664,-23
1,16,19,2,2,707,544,163
1,16,20,2,2,664,505,159
1,17,0,2,2,397,469,-72
1,17,1,2,2,306,775,-469
1,17,2,2,2,469,815,-346
1,17,3,2,2,775,551,224
1,17,4,2,2,815,540,275
1,17,5,2,2,551,667,-116
1,17,6,2,2,540,452,88
1,17,7,2,2,667,329,338
1,17,8,2,2,452,336,116
1,17,9,2,2,329,341,-12
1,17,10,2,2,336,348,-12
1,17,11,2,2,341,322,19
1,17,12,2,2,348,386,-38
1,17,13,2,2,322,531,-209
1,17,14,2,2,386,628,-242
1,17,15,2,2,531,467,64
1,17,16,2,2,628,433,195
1,17,17,2,2,467,659,-192
1,17,18,2,2,433,704,-271
1,17,19,2,2,659,504,155
1,17,20,2,2,704,450,254
1,18,0,2,2,494,598,-104
1,18,1,2,2,362,786,-424
1,18,2,2,2,598,627,-29
1,18,3,2,2,786,400,386
1,18,4,2,2,627,368,259
1,18,5,2,2,400,526,-126
1,18,6,2,2,368,495,-127
1,18,7,2,2,526,429,97
1,18,8,2,2,495,448,47
1,18,9,2,2,429,480,-51
1,18,10,2,2,448,497,-49
1,18,11,2,2,480,445,35
1,18,12,2,2,497,360,137
1,18,13,2,2,445,402,43
1,18,14,2,2,360,621,-261
1,18,15,2,2,402,508,-106
1,18,16,2,2,621,330,291
1,18,17,2,2,508,565,-57
1,18,18,2,2,330,620,-290
1,18,19,2,2,565,398,167
1,18,20,2,2,620,477,143
1,19,0,2,2,546,636,-90
1,19,1,2,2,338,691,-353
1,19,2,2,2,636,350,286
1,19,3,2,2,691,268,423
1,19,4,2,2,350,423,-73
1,19,5,2,2,268,709,-441
1,19,6,2,2,423,686,-263
1,19,7,2,2,709,566,143
1,19,8,2,2,686,562,124
1,19,9,2,2,566,561,5
1,19,10,2,2,562,613,-51
1,19,11,2,2,561,497,64
1,19,12,2,2,613,334,279
1,19,13,2,2,497,466,31
1,19,14,2,2,334,654,-320
1,19,15,2,2,466,445,21
1,19,16,2,2,654,257,397
1,19,17,2,2,445,480,-35
1,19,18,2,2,257,464,-207
1,19,19,2,2,480,253,227
1,19,20,2,2,464,541,-77
1,20,0,2,2,541,622,-81
1,20,1,2,2,305,624,-319
1,20,2,2,2,622,234,388
1,20,3,2,2,624,206,418
1,20,4,2,2,234,394,-160
1,20,5,2,2,206,652,-446
1,20,6,2,2,394,562,-168
1,20,7,2,2,652,352,300
1,20,8,2,2,562,343,219
1,20,9,2,2,352,404,-52
1,20,10,2,2,343,422,-79
1,20,11,2,2,404,290,114
1,20,12,2,2,422,238,184
1,20,13,2,2,290,311,-21
1,20,14,2,2,238,371,-133
1,20,15,2,2,311,293,18
1,20,16,2,2,371,264,107
1,20,17,2,2,293,425,-132
1,20,18,2,2,264,398,-134
1,20,19,2,2,425,285,140
1,20,20,2,2,398,535,-137
1,21,0,2,2,446,520,-74
1,21,1,2,2,311,457,-146
1,21,2,2,2,520,171,349
1,21,3,2,2,457,172,285
1,21,4,2,2,171,282,-111
1,21,5,2,2,172,475,-303
1,21,6,2,2,282,386,-104
1,21,7,2,2,475,186,289
1,21,8,2,2,386,201,185
1,21,9,2,2,186,309,-123
1,21,10,2,2,201,323,-122
1,21,11,2,2,309,176,133
1,21,12,2,2,323,210,113
1,21,13,2,2,176,308,-132
1,21,14,2,2,210,295,-85
1,21,15,2,2,308,215,93
1,21,16,2,2,295,217,78
1,21,17,2,2,215,291,-76
1,21,18,2,2,217,292,-75
1,21,19,2,2,291,293,-2
1,21,20,2,2,292,379,-87
1,22,0,2,2,351,319,32
1,22,1,2,2,273,298,-25
1,22,2,2,2,319,211,108
1,22,3,2,2,298,195,103
1,22,4,2,2,211,268,-57
1,22,5,2,2,195,452,-257
1,22,6,2,2,268,424,-156
1,22,7,2,2,452,272,180
1,22,8,2,2,424,246,178
1,22,9,2,2,272,369,-97
1,22,10,2,2,246,421,-175
1,22,11,2,2,369,298,71
1,22,12,2,2,421,317,104
1,22,13,2,2,298,411,-113
1,22,14,2,2,317,356,-39
1,22,15,2,2,411,199,212
1,22,16,2,2,356,190,166
1,22,17,2,2,199,230,-31
1,22,18,2,2,190,189,1
1,22,19,2,2,230,215,15
1,22,20,2,2,189,231,-42
1,0,0,3,2,655,626,29
1,0,1,3,2,648,644,4
1,0,2,3,2,626,660,-34
1,0,3,3,2,644,641,3
1,0,4,3,2,660,645,15
1,0,5,3,2,641,658,-17
1,0,6,3,2,645,649,-4
1,0,7,3,2,658,637,21
1,0,8,3,2,649,627,22
1,0,9,3,2,637,623,14
1,0,10,3,2,627,626,1
1,0,11,3,2,623,634,-11
1,0,12,3,2,626,642,-16
1,0,13,3,2,634,653,-19
1,0,14,3,2,642,648,-6
1,0,15,3,2,653,641,12
1,0,16,3,2,648,640,8
1,0,17,3,2,641,619,22
1,0,18,3,2,640,626,14
1,0,19,3,2,619,662,-43
1,0,20,3,2,626,648,-22
1,1,0,3,2,667,647,20
1,1,1,3,2,672,652,20
1,1,2,3,2,647,665,-18
1,1,3,3,2,652,653,-1
1,1,4,3,2,665,662,3
1,1,5,3,2,653,635,18
1,1,6,3,2,662,583,79
1,1,7,3,2,635,567,68
1,1,8,3,2,583,552,31
1,1,9,3,2,567,544,23
1,1,10,3,2,552,546,6
1,1,11,3,2,544,555,-11
1,1,12,3,2,546,565,-19
1,1,13,3,2,555,607,-52
1,1,14,3,2,565,637,-72
1,1,15,3,2,607,645,-38
1,1,16,3,2,637,660,-23
1,1,17,3,2,645,641,4
1,1,18,3,2,660,636,24
1,1,19,3,2,641,665,-24
1,1,20,3,2,636,659,-23
1,2,0,3,2,683,663,20
1,2,1,3,2,687,675,12
1,2,2,3,2,663,691,-28
1,2,3,3,2,675,657,18
1,2,4,3,2,691,623,68
1,2,5,3,2,657,550,107
1,2,6,3,2,623,474,149
1,2,7,3,2,550,456,94
1,2,8,3,2,474,438,36
1,2,9,3,2,456,427,29
1,2,10,3,2,438,428,10
1,2,11,3,2,427,438,-11
1,2,12,3,2,428,448,-20
1,2,13,3,2,438,492,-54
1,2,14,3,2,448,549,-101
1,2,15,3,2,492,615,-123
1,2,16,3,2,549,683,-134
1,2,17,3,2,615,676,-61
1,2,18,3,2,683,649,34
1,2,19,3,2,676,663,13
1,2,20,3,2,649,666,-17
1,3,0,3,2,698,683,15
1,3,1,3,2,702,702,0
1,3,2,3,2,683,707,-24
1,3,3,3,2,702,619,83
1,3,4,3,2,707,505,202
1,3,5,3,2,619,425,194
1,3,6,3,2,505,383,122
1,3,7,3,2,425,369,56
1,3,8,3,2,383,354,29
1,3,9,3,2,369,344,25
1,3,10,3,2,354,344,10
1,3,11,3,2,344,350,-6
1,3,12,3,2,344,358,-14
1,3,13,3,2,350,385,-35
1,3,14,3,2,358,436,-78
1,3,15,3,2,385,536,-151
1,3,16,3,2,436,655,-219
1,3,17,3,2,536,689,-153
1,3,18,3,2,655,671,-16
1,3,19,3,2,689,675,14
1,3,20,3,2,671,671,0
1,4,0,3,2,713,666,47
1,4,1,3,2,708,661,47
1,4,2,3,2,666,649,17
1,4,3,3,2,661,541,120
1,4,4,3,2,649,403,246
1,4,5,3,2,541,365,176
1,4,6,3,2,403,380,23
1,4,7,3,2,365,372,-7
1,4,8,3,2,380,363,17
1,4,9,3,2,372,357,15
1,4,10,3,2,363,357,6
1,4,11,3,2,357,359,-2
1,4,12,3,2,357,362,-5
1,4,13,3,2,359,373,-14
1,4,14,3,2,362,390,-28
1,4,15,3,2,373,457,-84
1,4,16,3,2,390,575,-185
1,4,17,3,2,457,645,-188
1,4,18,3,2,575,664,-89
1,4,19,3,2,645,683,-38
1,4,20,3,2,664,680,-16
1,5,0,3,2,735,576,159
1,5,1,3,2,690,509,181
1,5,2,3,2,576,500,76
1,5,3,3,2,509,466,43
1,5,4,3,2,500,420,80
1,5,5,3,2,466,435,31
1,5,6,3,2,420,466,-46
1,5,7,3,2,435,466,-31
1,5,8,3,2,466,466,0
1,5,9,3,2,466,466,0
1,5,10,3,2,466,465,1
1,5,11,3,2,466,462,4
1,5,12,3,2,465,460,5
1,5,13,3,2,462,461,1
1,5,14,3,2,460,439,21
1,5,15,3,2,461,439,22
1,5,16,3,2,439,502,-63
1,5,17,3,2,439,556,-117
1,5,18,3,2,502,595,-93
1,5,19,3,2,556,654,-98
1,5,20,3,2,595,692,-97
1,6,0,3,2,766,536,230
1,6,1,3,2,710,406,304
1,6,2,3,2,536,423,113
1,6,3,3,2,406,517,-111
1,6,4,3,2,423,568,-145
1,6,5,3,2,517,575,-58
1,6,6,3,2,568,591,-23
1,6,7,3,2,575,596,-21
1,6,8,3,2,591,601,-10
1,6,9,3,2,596,619,-23
1,6,10,3,2,601,627,-26
1,6,11,3,2,619,616,3
1,6,12,3,2,627,605,22
1,6,13,3,2,616,612,4
1,6,14,3,2,605,591,14
1,6,15,3,2,612,560,52
1,6,16,3,2,591,536,55
1,6,17,3,2,560,525,35
1,6,18,3,2,536,587,-51
1,6,19,3,2,525,663,-138
1,6,20,3,2,587,715,-128
1,7,0,3,2,697,450,247
1,7,1,3,2,615,314,301
1,7,2,3,2,450,350,100
1,7,3,3,2,314,467,-153
1,7,4,3,2,350,554,-204
1,7,5,3,2,467,579,-112
1,7,6,3,2,554,558,-4
1,7,7,3,2,579,528,51
1,7,8,3,2,558,528,30
1,7,9,3,2,528,556,-28
1,7,10,3,2,528,556,-28
1,7,11,3,2,556,534,22
1,7,12,3,2,556,549,7
1,7,13,3,2,534,579,-45
1,7,14,3,2,549,573,-24
1,7,15,3,2,579,547,32
1,7,16,3,2,573,483,90
1,7,17,3,2,547,439,108
1,7,18,3,2,483,494,-11
1,7,19,3,2,439,576,-137
1,7,20,3,2,494,663,-169
1,8,0,3,2,590,447,143
1,8,1,3,2,504,449,55
1,8,2,3,2,447,519,-72
1,8,3,3,2,449,569,-120
1,8,4,3,2,519,647,-128
1,8,5,3,2,569,678,-109
1,8,6,3,2,647,637,10
1,8,7,3,2,678,595,83
1,8,8,3,2,637,583,54
1,8,9,3,2,595,602,-7
1,8,10,3,2,583,616,-33
1,8,11,3,2,602,595,7
1,8,12,3,2,616,609,7
1,8,13,3,2,595,658,-63
1,8,14,3,2,609,684,-75
1,8,15,3,2,658,645,13
1,8,16,3,2,684,559,125
1,8,17,3,2,645,525,120
1,8,18,3,2,559,535,24
1,8,19,3,2,525,563,-38
1,8,20,3,2,535,633,-98
1,9,0,3,2,562,461,101
1,9,1,3,2,432,684,-252
1,9,2,3,2,461,790,-329
1,9,3,3,2,684,738,-54
1,9,4,3,2,790,844,-54
1,9,5,3,2,738,876,-138
1,9,6,3,2,844,769,75
1,9,7,3,2,876,702,174
1,9,8,3,2,769,688,81
1,9,9,3,2,702,688,14
1,9,10,3,2,688,715,-27
1,9,11,3,2,688,695,-7
1,9,12,3,2,715,706,9
1,9,13,3,2,695,817,-122
1,9,14,3,2,706,897,-191
1,9,15,3,2,817,805,12
1,9,16,3,2,897,732,165
1,9,17,3,2,805,757,48
1,9,18,3,2,732,690,42
1,9,19,3,2,757,659,98
1,9,20,3,2,690,691,-1
1,10,0,3,2,685,579,106
1,10,1,3,2,545,963,-418
1,10,2,3,2,579,1132,-553
1,10,3,3,2,963,1053,-90
1,10,4,3,2,1132,1170,-38
1,10,5,3,2,1053,1201,-148
1,10,6,3,2,1170,1007,163
1,10,7,3,2,1201,857,344
1,10,8,3,2,1007,852,155
1,10,9,3,2,857,859,-2
1,10,10,3,2,852,890,-38
1,10,11,3,2,859,854,5
1,10,12,3,2,890,888,2
1,10,13,3,2,854,1115,-261
1,10,14,3,2,888,1261,-373
1,10,15,3,2,1115,1119,-4
1,10,16,3,2,1261,1049,212
1,10,17,3,2,1119,1099,20
1,10,18,3,2,1049,994,55
1,10,19,3,2,1099,919,180
1,10,20,3,2,994,842,152
1,11,0,3,2,842,676,166
1,11,1,3,2,710,1049,-339
1,11,2,3,2,676,1306,-630
1,11,3,3,2,1049,1235,-186
1,11,4,3,2,1306,1293,13
1,11,5,3,2,1235,1384,-149
1,11,6,3,2,1293,1086,207
1,11,7,3,2,1384,803,581
1,11,8,3,2,1086,800,286
1,11,9,3,2,803,818,-15
1,11,10,3,2,800,839,-39
1,11,11,3,2,818,785,33
1,11,12,3,2,839,883,-44
1,11,13,3,2,785,1247,-462
1,11,14,3,2,883,1433,-550
1,11,15,3,2,1247,1293,-46
1,11,16,3,2,1433,1248,185
1,11,17,3,2,1293,1254,39
1,11,18,3,2,1248,1162,86
1,11,19,3,2,1254,1123,131
1,11,20,3,2,1162,968,194
1,12,0,3,2,924,700,224
1,12,1,3,2,804,971,-167
1,12,2,3,2,700,1308,-608
1,12,3,3,2,971,1234,-263
1,12,4,3,2,1308,1214,94
1,12,5,3,2,1234,1405,-171
1,12,6,3,2,1214,1028,186
1,12,7,3,2,1405,658,747
1,12,8,3,2,1028,648,380
1,12,9,3,2,658,651,7
1,12,10,3,2,648,669,-21
1,12,11,3,2,651,617,34
1,12,12,3,2,669,769,-100
1,12,13,3,2,617,1212,-595
1,12,14,3,2,769,1376,-607
1,12,15,3,2,1212,1283,-71
1,12,16,3,2,1376,1296,80
1,12,17,3,2,1283,1196,87
1,12,18,3,2,1296,1128,168
1,12,19,3,2,1196,1177,19
1,12,20,3,2,1128,1016,112
1,13,0,3,2,941,696,245
1,13,1,3,2,829,934,-105
1,13,2,3,2,696,1327,-631
1,13,3,3,2,934,1234,-300
1,13,4,3,2,1327,1178,149
1,13,5,3,2,1234,1424,-190
1,13,6,3,2,1178,1006,172
1,13,7,3,2,1424,634,790
1,13,8,3,2,1006,631,375
1,13,9,3,2,634,604,30
1,13,10,3,2,631,624,7
1,13,11,3,2,604,581,23
1,13,12,3,2,624,753,-129
1,13,13,3,2,581,1217,-636
1,13,14,3,2,753,1313,-560
1,13,15,3,2,1217,1263,-46
1,13,16,3,2,1313,1344,-31
1,13,17,3,2,1263,1128,135
1,13,18,3,2,1344,1060,284
1,13,19,3,2,1128,1165,-37
1,13,20,3,2,1060,1013,47
1,14,0,3,2,858,657,201
1,14,1,3,2,749,962,-213
1,14,2,3,2,657,1355,-698
1,14,3,3,2,962,1190,-228
1,14,4,3,2,1355,1153,202
1,14,5,3,2,1190,1429,-239
1,14,6,3,2,1153,1003,150
1,14,7,3,2,1429,652,777
1,14,8,3,2,1003,643,360
1,14,9,3,2,652,622,30
1,14,10,3,2,643,657,-14
1,14,11,3,2,622,604,18
1,14,12,3,2,657,777,-120
1,14,13,3,2,604,1239,-635
1,14,14,3,2,777,1271,-494
1,14,15,3,2,1239,1187,52
1,14,16,3,2,1271,1319,-48
1,14,17,3,2,1187,1111,76
1,14,18,3,2,1319,1019,300
1,14,19,3,2,1111,1065,46
1,14,20,3,2,1019,939,80
1,15,0,3,2,720,629,91
1,15,1,3,2,603,1017,-414
1,15,2,3,2,629,1323,-694
1,15,3,3,2,1017,1096,-79
1,15,4,3,2,1323,1122,201
1,15,5,3,2,1096,1389,-293
1,15,6,3,2,1122,934,188
1,15,7,3,2,1389,606,783
1,15,8,3,2,934,600,334
1,15,9,3,2,606,570,36
1,15,10,3,2,600,602,-2
1,15,11,3,2,570,532,38
1,15,12,3,2,602,719,-117
1,15,13,3,2,532,1225,-693
1,15,14,3,2,719,1253,-534
1,15,15,3,2,1225,1013,212
1,15,16,3,2,1253,1111,142
1,15,17,3,2,1013,1079,-66
1,15,18,3,2,1111,1011,100
1,15,19,3,2,1079,928,151
1,15,20,3,2,1011,832,179
1,16,0,3,2,619,663,-44
1,16,1,3,2,495,1113,-618
1,16,2,3,2,663,1283,-620
1,16,3,3,2,1113,930,183
1,16,4,3,2,1283,918,365
1,16,5,3,2,930,1154,-224
1,16,6,3,2,918,798,120
1,16,7,3,2,1154,553,601
1,16,8,3,2,798,547,251
1,16,9,3,2,553,562,-9
1,16,10,3,2,547,587,-40
1,16,11,3,2,562,532,30
1,16,12,3,2,587,658,-71
1,16,13,3,2,532,959,-427
1,16,14,3,2,658,1052,-394
1,16,15,3,2,959,826,133
1,16,16,3,2,1052,839,213
1,16,17,3,2,826,1032,-206
1,16,18,3,2,839,1028,-189
1,16,19,3,2,1032,789,243
1,16,20,3,2,1028,707,321
1,17,0,3,2,677,807,-130
1,17,1,3,2,500,1139,-639
1,17,2,3,2,807,1025,-218
1,17,3,3,2,1139,703,436
1,17,4,3,2,1025,711,314
1,17,5,3,2,703,953,-250
1,17,6,3,2,711,762,-51
1,17,7,3,2,953,610,343
1,17,8,3,2,762,625,137
1,17,9,3,2,610,630,-20
1,17,10,3,2,625,663,-38
1,17,11,3,2,630,589,41
1,17,12,3,2,663,561,102
1,17,13,3,2,589,784,-195
1,17,14,3,2,561,1024,-463
1,17,15,3,2,784,744,40
1,17,16,3,2,1024,565,459
1,17,17,3,2,744,899,-155
1,17,18,3,2,565,960,-395
1,17,19,3,2,899,657,242
1,17,20,3,2,960,725,235
1,18,0,3,2,760,896,-136
1,18,1,3,2,506,1113,-607
1,18,2,3,2,896,767,129
1,18,3,3,2,1113,516,597
1,18,4,3,2,767,620,147
1,18,5,3,2,516,949,-433
1,18,6,3,2,620,871,-251
1,18,7,3,2,949,714,235
1,18,8,3,2,871,721,150
1,18,9,3,2,714,752,-38
1,18,10,3,2,721,795,-74
1,18,11,3,2,752,675,77
1,18,12,3,2,795,519,276
1,18,13,3,2,675,615,60
1,18,14,3,2,519,879,-360
1,18,15,3,2,615,676,-61
1,18,16,3,2,879,455,424
1,18,17,3,2,676,805,-129
1,18,18,3,2,455,828,-373
1,18,19,3,2,805,498,307
1,18,20,3,2,828,743,85
1,19,0,3,2,821,960,-139
1,19,1,3,2,499,988,-489
1,19,2,3,2,960,444,516
1,19,3,3,2,988,358,630
1,19,4,3,2,444,565,-121
1,19,5,3,2,358,938,-580
1,19,6,3,2,565,872,-307
1,19,7,3,2,938,633,305
1,19,8,3,2,872,632,240
1,19,9,3,2,633,693,-60
1,19,10,3,2,632,737,-105
1,19,11,3,2,693,557,136
1,19,12,3,2,737,413,324
1,19,13,3,2,557,564,-7
1,19,14,3,2,413,767,-354
1,19,15,3,2,564,570,-6
1,19,16,3,2,767,396,371
1,19,17,3,2,570,665,-95
1,19,18,3,2,396,654,-258
1,19,19,3,2,665,438,227
1,19,20,3,2,654,810,-156
1,20,0,3,2,712,818,-106
1,20,1,3,2,455,784,-329
1,20,2,3,2,818,311,507
1,20,3,3,2,784,288,496
1,20,4,3,2,311,534,-223
1,20,5,3,2,288,898,-610
1,20,6,3,2,534,762,-228
1,20,7,3,2,898,471,427
1,20,8,3,2,762,474,288
1,20,9,3,2,471,581,-110
1,20,10,3,2,474,621,-147
1,20,11,3,2,581,406,175
1,20,12,3,2,621,369,252
1,20,13,3,2,406,521,-115
1,20,14,3,2,369,553,-184
1,20,15,3,2,521,383,138
1,20,16,3,2,553,342,211
1,20,17,3,2,383,531,-148
1,20,18,3,2,342,500,-158
1,20,19,3,2,531,393,138
1,20,20,3,2,500,645,-145
1,21,0,3,2,626,643,-17
1,21,1,3,2,434,595,-161
1,21,2,3,2,643,305,338
1,21,3,3,2,595,285,310
1,21,4,3,2,305,410,-105
1,21,5,3,2,285,681,-396
1,21,6,3,2,410,610,-200
1,21,7,3,2,681,339,342
1,21,8,3,2,610,316,294
1,21,9,3,2,339,501,-162
1,21,10,3,2,316,545,-229
1,21,11,3,2,501,358,143
1,21,12,3,2,545,396,149
1,21,13,3,2,358,509,-151
1,21,14,3,2,396,469,-73
1,21,15,3,2,509,324,185
1,21,16,3,2,469,329,140
1,21,17,3,2,324,415,-91
1,21,18,3,2,329,379,-50
1,21,19,3,2,415,400,15
1,21,20,3,2,379,500,-121
1,0,0,4,2,884,841,43
1,0,1,4,2,875,861,14
1,0,2,4,2,841,887,-46
1,0,3,4,2,861,868,-7
1,0,4,4,2,887,872,15
1,0,5,4,2,868,845,23
1,0,6,4,2,872,790,82
1,0,7,4,2,845,772,73
1,0,8,4,2,790,756,34
1,0,9,4,2,772,748,24
1,0,10,4,2,756,751,5
1,0,11,4,2,748,762,-14
1,0,12,4,2,751,774,-23
1,0,13,4,2,762,810,-48
1,0,14,4,2,774,837,-63
1,0,15,4,2,810,857,-47
1,0,16,4,2,837,878,-41
1,0,17,4,2,857,847,10
1,0,18,4,2,878,837,41
1,0,19,4,2,847,877,-30
1,0,20,4,2,837,870,-33
1,1,0,4,2,900,876,24
1,1,1,4,2,905,893,12
1,1,2,4,2,876,911,-35
1,1,3,4,2,893,867,26
1,1,4,4,2,911,832,79
1,1,5,4,2,867,765,102
1,1,6,4,2,832,688,144
1,1,7,4,2,765,666,99
1,1,8,4,2,688,645,43
1,1,9,4,2,666,633,33
1,1,10,4,2,645,635,10
1,1,11,4,2,633,647,-14
1,1,12,4,2,635,660,-25
1,1,13,4,2,647,714,-67
1,1,14,4,2,660,771,-111
1,1,15,4,2,714,826,-112
1,1,16,4,2,771,889,-118
1,1,17,4,2,826,879,-53
1,1,18,4,2,889,861,28
1,1,19,4,2,879,888,-9
1,1,20,4,2,861,882,-21
1,2,0,4,2,919,902,17
1,2,1,4,2,929,919,10
1,2,2,4,2,902,925,-23
1,2,3,4,2,919,835,84
1,2,4,4,2,925,731,194
1,2,5,4,2,835,658,177
1,2,6,4,2,731,611,120
1,2,7,4,2,658,591,67
1,2,8,4,2,611,570,41
1,2,9,4,2,591,557,34
1,2,10,4,2,570,558,12
1,2,11,4,2,557,568,-11
1,2,12,4,2,558,579,-21
1,2,13,4,2,568,613,-45
1,2,14,4,2,579,662,-83
1,2,15,4,2,613,754,-141
1,2,16,4,2,662,871,-209
1,2,17,4,2,754,899,-145
1,2,18,4,2,871,884,-13
1,2,19,4,2,899,900,-1
1,2,20,4,2,884,892,-8
1,3,0,4,2,942,881,61
1,3,1,4,2,935,878,57
1,3,2,4,2,881,876,5
1,3,3,4,2,878,768,110
1,3,4,4,2,876,630,246
1,3,5,4,2,768,552,216
1,3,6,4,2,630,521,109
1,3,7,4,2,552,507,45
1,3,8,4,2,521,492,29
1,3,9,4,2,507,482,25
1,3,10,4,2,492,482,10
1,3,11,4,2,482,487,-5
1,3,12,4,2,482,494,-12
1,3,13,4,2,487,530,-43
1,3,14,4,2,494,579,-85
1,3,15,4,2,530,673,-143
1,3,16,4,2,579,813,-234
1,3,17,4,2,673,873,-200
1,3,18,4,2,813,875,-62
1,3,19,4,2,873,898,-25
1,3,20,4,2,875,902,-27
1,4,0,4,2,968,805,163
1,4,1,4,2,923,750,173
1,4,2,4,2,805,746,59
1,4,3,4,2,750,680,70
1,4,4,4,2,746,590,156
1,4,5,4,2,680,565,115
1,4,6,4,2,590,571,19
1,4,7,4,2,565,565,0
1,4,8,4,2,571,559,12
1,4,9,4,2,565,555,10
1,4,10,4,2,559,554,5
1,4,11,4,2,555,554,1
1,4,12,4,2,554,555,-1
1,4,13,4,2,554,568,-14
1,4,14,4,2,555,573,-18
1,4,15,4,2,568,620,-52
1,4,16,4,2,573,731,-158
1,4,17,4,2,620,794,-174
1,4,18,4,2,731,820,-89
1,4,19,4,2,794,877,-83
1,4,20,4,2,820,915,-95
1,5,0,4,2,1002,775,227
1,5,1,4,2,952,650,302
1,5,2,4,2,775,657,118
1,5,3,4,2,650,695,-45
1,5,4,4,2,657,676,-19
1,5,5,4,2,695,683,12
1,5,6,4,2,676,728,-52
1,5,7,4,2,683,731,-48
1,5,8,4,2,728,733,-5
1,5,9,4,2,731,749,-18
1,5,10,4,2,733,757,-24
1,5,11,4,2,749,746,3
1,5,12,4,2,757,736,21
1,5,13,4,2,746,733,13
1,5,14,4,2,736,704,32
1,5,15,4,2,733,699,34
1,5,16,4,2,704,724,-20
1,5,17,4,2,699,748,-49
1,5,18,4,2,724,822,-98
1,5,19,4,2,748,900,-152
1,5,20,4,2,822,941,-119
1,6,0,4,2,941,648,293
1,6,1,4,2,848,490,358
1,6,2,4,2,648,519,129
1,6,3,4,2,490,616,-126
1,6,4,4,2,519,679,-160
1,6,5,4,2,616,706,-90
1,6,6,4,2,679,696,-17
1,6,7,4,2,706,666,40
1,6,8,4,2,696,666,30
1,6,9,4,2,666,694,-28
1,6,10,4,2,666,694,-28
1,6,11,4,2,694,671,23
1,6,12,4,2,694,685,9
1,6,13,4,2,671,724,-53
1,6,14,4,2,685,716,-31
1,6,15,4,2,724,684,40
1,6,16,4,2,716,641,75
1,6,17,4,2,684,623,61
1,6,18,4,2,641,698,-57
1,6,19,4,2,623,799,-176
1,6,20,4,2,698,894,-196
1,7,0,4,2,845,586,259
1,7,1,4,2,719,538,181
1,7,2,4,2,586,616,-30
1,7,3,4,2,538,708,-170
1,7,4,4,2,616,834,-218
1,7,5,4,2,708,878,-170
1,7,6,4,2,834,828,6
1,7,7,4,2,878,788,90
1,7,8,4,2,828,779,49
1,7,9,4,2,788,800,-12
1,7,10,4,2,779,813,-34
1,7,11,4,2,800,790,10
1,7,12,4,2,813,802,11
1,7,13,4,2,790,853,-63
1,7,14,4,2,802,867,-65
1,7,15,4,2,853,808,45
1,7,16,4,2,867,715,152
1,7,17,4,2,808,674,134
1,7,18,4,2,715,691,24
1,7,19,4,2,674,757,-83
1,7,20,4,2,691,868,-177
1,8,0,4,2,829,660,169
1,8,1,4,2,694,825,-131
1,8,2,4,2,660,947,-287
1,8,3,4,2,825,967,-142
1,8,4,4,2,947,1100,-153
1,8,5,4,2,967,1124,-157
1,8,6,4,2,1100,1031,69
1,8,7,4,2,1124,967,157
1,8,8,4,2,1031,955,76
1,8,9,4,2,967,971,-4
1,8,10,4,2,955,1007,-52
1,8,11,4,2,971,979,-8
1,8,12,4,2,1007,982,25
1,8,13,4,2,979,1089,-110
1,8,14,4,2,982,1162,-180
1,8,15,4,2,1089,1065,24
1,8,16,4,2,1162,954,208
1,8,17,4,2,1065,949,116
1,8,18,4,2,954,917,37
1,8,19,4,2,949,905,44
1,8,20,4,2,917,940,-23
1,9,0,4,2,860,691,169
1,9,1,4,2,683,1047,-364
1,9,2,4,2,691,1228,-537
1,9,3,4,2,1047,1152,-105
1,9,4,4,2,1228,1281,-53
1,9,5,4,2,1152,1332,-180
1,9,6,4,2,1281,1112,169
1,9,7,4,2,1332,927,405
1,9,8,4,2,1112,917,195
1,9,9,4,2,927,934,-7
1,9,10,4,2,917,957,-40
1,9,11,4,2,934,909,25
1,9,12,4,2,957,968,-11
1,9,13,4,2,909,1227,-318
1,9,14,4,2,968,1386,-418
1,9,15,4,2,1227,1243,-16
1,9,16,4,2,1386,1154,232
1,9,17,4,2,1243,1197,46
1,9,18,4,2,1154,1105,49
1,9,19,4,2,1197,1055,142
1,9,20,4,2,1105,1021,84
1,10,0,4,2,990,812,178
1,10,1,4,2,814,1273,-459
1,10,2,4,2,812,1572,-760
1,10,3,4,2,1273,1476,-203
1,10,4,4,2,1572,1573,-1
1,10,5,4,2,1476,1683,-207
1,10,6,4,2,1573,1356,217
1,10,7,4,2,1683,1063,620
1,10,8,4,2,1356,1051,305
1,10,9,4,2,1063,1062,1
1,10,10,4,2,1051,1096,-45
1,10,11,4,2,1062,1041,21
1,10,12,4,2,1096,1136,-40
1,10,13,4,2,1041,1521,-480
1,10,14,4,2,1136,1727,-591
1,10,15,4,2,1521,1554,-33
1,10,16,4,2,1727,1480,247
1,10,17,4,2,1554,1489,65
1,10,18,4,2,1480,1359,121
1,10,19,4,2,1489,1304,185
1,10,20,4,2,1359,1173,186
1,11,0,4,2,1163,913,250
1,11,1,4,2,994,1347,-353
1,11,2,4,2,913,1736,-823
1,11,3,4,2,1347,1632,-285
1,11,4,4,2,1736,1667,69
1,11,5,4,2,1632,1851,-219
1,11,6,4,2,1667,1422,245
1,11,7,4,2,1851,1030,821
1,11,8,4,2,1422,1020,402
1,11,9,4,2,1030,1020,10
1,11,10,4,2,1020,1060,-40
1,11,11,4,2,1020,1001,19
1,11,12,4,2,1060,1142,-82
1,11,13,4,2,1001,1643,-642
1,11,14,4,2,1142,1854,-712
1,11,15,4,2,1643,1703,-60
1,11,16,4,2,1854,1691,163
1,11,17,4,2,1703,1620,83
1,11,18,4,2,1691,1510,181
1,11,19,4,2,1620,1519,101
1,11,20,4,2,1510,1323,187
1,12,0,4,2,1239,926,313
1,12,1,4,2,1080,1297,-217
1,12,2,4,2,926,1765,-839
1,12,3,4,2,1297,1648,-351
1,12,4,4,2,1765,1615,150
1,12,5,4,2,1648,1880,-232
1,12,6,4,2,1615,1349,266
1,12,7,4,2,1880,859,1021
1,12,8,4,2,1349,860,489
1,12,9,4,2,859,850,9
1,12,10,4,2,860,866,-6
1,12,11,4,2,850,795,55
1,12,12,4,2,866,1015,-149
1,12,13,4,2,795,1627,-832
1,12,14,4,2,1015,1802,-787
1,12,15,4,2,1627,1701,-74
1,12,16,4,2,1802,1766,36
1,12,17,4,2,1701,1568,133
1,12,18,4,2,1766,1475,291
1,12,19,4,2,1568,1561,7
1,12,20,4,2,1475,1343,132
1,13,0,4,2,1163,890,273
1,13,1,4,2,1018,1272,-254
1,13,2,4,2,890,1795,-905
1,13,3,4,2,1272,1613,-341
1,13,4,4,2,1795,1556,239
1,13,5,4,2,1613,1911,-298
1,13,6,4,2,1556,1352,204
1,13,7,4,2,1911,858,1053
1,13,8,4,2,1352,842,510
1,13,9,4,2,858,825,33
1,13,10,4,2,842,863,-21
1,13,11,4,2,825,791,34
1,13,12,4,2,863,1025,-162
1,13,13,4,2,791,1645,-854
1,13,14,4,2,1025,1737,-712
1,13,15,4,2,1645,1622,23
1,13,16,4,2,1737,1750,-13
1,13,17,4,2,1622,1501,121
1,13,18,4,2,1750,1384,366
1,13,19,4,2,1501,1450,51
1,13,20,4,2,1384,1270,114
1,14,0,4,2,1041,866,175
1,14,1,4,2,887,1315,-428
1,14,2,4,2,866,1753,-887
1,14,3,4,2,1315,1493,-178
1,14,4,4,2,1753,1496,257
1,14,5,4,2,1493,1856,-363
1,14,6,4,2,1496,1270,226
1,14,7,4,2,1856,833,1023
1,14,8,4,2,1270,820,450
1,14,9,4,2,833,772,61
1,14,10,4,2,820,823,-3
1,14,11,4,2,772,748,24
1,14,12,4,2,823,978,-155
1,14,13,4,2,748,1621,-873
1,14,14,4,2,978,1674,-696
1,14,15,4,2,1621,1423,198
1,14,16,4,2,1674,1554,120
1,14,17,4,2,1423,1445,-22
1,14,18,4,2,1554,1359,195
1,14,19,4,2,1445,1324,121
1,14,20,4,2,1359,1187,172
1,15,0,4,2,934,889,45
1,15,1,4,2,771,1439,-668
1,15,2,4,2,889,1740,-851
1,15,3,4,2,1439,1344,95
1,15,4,4,2,1740,1319,421
1,15,5,4,2,1344,1629,-285
1,15,6,4,2,1319,1119,200
1,15,7,4,2,1629,754,875
1,15,8,4,2,1119,759,360
1,15,9,4,2,754,761,-7
1,15,10,4,2,759,784,-25
1,15,11,4,2,761,710,51
1,15,12,4,2,784,904,-120
1,15,13,4,2,710,1374,-664
1,15,14,4,2,904,1478,-574
1,15,15,4,2,1374,1244,130
1,15,16,4,2,1478,1309,169
1,15,17,4,2,1244,1404,-160
1,15,18,4,2,1309,1375,-66
1,15,19,4,2,1404,1173,231
1,15,20,4,2,1375,1034,341
1,16,0,4,2,899,1001,-102
1,16,1,4,2,689,1477,-788
1,16,2,4,2,1001,1493,-492
1,16,3,4,2,1477,1082,395
1,16,4,4,2,1493,1089,404
1,16,5,4,2,1082,1440,-358
1,16,6,4,2,1089,1108,-19
1,16,7,4,2,1440,834,606
1,16,8,4,2,1108,836,272
1,16,9,4,2,834,851,-17
1,16,10,4,2,836,902,-66
1,16,11,4,2,851,799,52
1,16,12,4,2,902,833,69
1,16,13,4,2,799,1212,-413
1,16,14,4,2,833,1448,-615
1,16,15,4,2,1212,1103,109
1,16,16,4,2,1448,971,477
1,16,17,4,2,1103,1272,-169
1,16,18,4,2,971,1284,-313
1,16,19,4,2,1272,942,330
1,16,20,4,2,1284,982,302
1,17,0,4,2,943,1105,-162
1,17,1,4,2,644,1466,-822
1,17,2,4,2,1105,1165,-60
1,17,3,4,2,1466,819,647
1,17,4,4,2,1165,963,202
1,17,5,4,2,819,1376,-557
1,17,6,4,2,963,1138,-175
1,17,7,4,2,1376,895,481
1,17,8,4,2,1138,898,240
1,17,9,4,2,895,902,-7
1,17,10,4,2,898,961,-63
1,17,11,4,2,902,819,83
1,17,12,4,2,961,720,241
1,17,13,4,2,819,997,-178
1,17,14,4,2,720,1282,-562
1,17,15,4,2,997,912,85
1,17,16,4,2,1282,690,592
1,17,17,4,2,912,1139,-227
1,17,18,4,2,690,1168,-478
1,17,19,4,2,1139,757,382
1,17,20,4,2,1168,991,177
1,18,0,4,2,1035,1220,-185
1,18,1,4,2,667,1410,-743
1,18,2,4,2,1220,861,359
1,18,3,4,2,1410,606,804
1,18,4,4,2,861,762,99
1,18,5,4,2,606,1178,-572
1,18,6,4,2,762,1057,-295
1,18,7,4,2,1178,781,397
1,18,8,4,2,1057,791,266
1,18,9,4,2,781,884,-103
1,18,10,4,2,791,919,-128
1,18,11,4,2,884,735,149
1,18,12,4,2,919,598,321
1,18,13,4,2,735,713,22
1,18,14,4,2,598,992,-394
1,18,15,4,2,713,801,-88
1,18,16,4,2,992,594,398
1,18,17,4,2,801,990,-189
1,18,18,4,2,594,1018,-424
1,18,19,4,2,990,683,307
1,18,20,4,2,1018,1012,6
1,19,0,4,2,992,1156,-164
1,19,1,4,2,649,1148,-499
1,19,2,4,2,1156,521,635
1,19,3,4,2,1148,440,708
1,19,4,4,2,521,705,-184
1,19,5,4,2,440,1184,-744
1,19,6,4,2,705,1072,-367
1,19,7,4,2,1184,752,432
1,19,8,4,2,1072,763,309
1,19,9,4,2,752,870,-118
1,19,10,4,2,763,936,-173
1,19,11,4,2,870,673,197
1,19,12,4,2,936,544,392
1,19,13,4,2,673,774,-101
1,19,14,4,2,544,949,-405
1,19,15,4,2,774,660,114
1,19,16,4,2,949,474,475
1,19,17,4,2,660,771,-111
1,19,18,4,2,474,756,-282
1,19,19,4,2,771,546,225
1,19,20,4,2,756,920,-164
1,20,0,4,2,892,941,-49
1,20,1,4,2,578,922,-344
1,20,2,4,2,941,445,496
1,20,3,4,2,922,401,521
1,20,4,4,2,445,662,-217
1,20,5,4,2,401,1104,-703
1,20,6,4,2,662,986,-324
1,20,7,4,2,1104,624,480
1,20,8,4,2,986,589,397
1,20,9,4,2,624,773,-149
1,20,10,4,2,589,843,-254
1,20,11,4,2,773,588,185
1,20,12,4,2,843,555,288
1,20,13,4,2,588,722,-134
1,20,14,4,2,555,727,-172
1,20,15,4,2,722,492,230
1,20,16,4,2,727,454,273
1,20,17,4,2,492,655,-163
1,20,18,4,2,454,587,-133
1,20,19,4,2,655,500,155
1,20,20,4,2,587,766,-179
1,0,0,5,2,1117,1070,47
1,0,1,5,2,1108,1102,6
1,0,2,5,2,1070,1133,-63
1,0,3,5,2,1102,1082,20
1,0,4,5,2,1133,1042,91
1,0,5,5,2,1082,975,107
1,0,6,5,2,1042,895,147
1,0,7,5,2,975,871,104
1,0,8,5,2,895,849,46
1,0,9,5,2,871,837,34
1,0,10,5,2,849,840,9
1,0,11,5,2,837,854,-17
1,0,12,5,2,840,869,-29
1,0,13,5,2,854,917,-63
1,0,14,5,2,869,971,-102
1,0,15,5,2,917,1038,-121
1,0,16,5,2,971,1107,-136
1,0,17,5,2,1038,1085,-47
1,0,18,5,2,1107,1062,45
1,0,19,5,2,1085,1100,-15
1,0,20,5,2,1062,1093,-31
1,1,0,5,2,1136,1115,21
1,1,1,5,2,1147,1137,10
1,1,2,5,2,1115,1145,-30
1,1,3,5,2,1137,1045,92
1,1,4,5,2,1145,940,205
1,1,5,5,2,1045,873,172
1,1,6,5,2,940,825,115
1,1,7,5,2,873,801,72
1,1,8,5,2,825,777,48
1,1,9,5,2,801,763,38
1,1,10,5,2,777,765,12
1,1,11,5,2,763,777,-14
1,1,12,5,2,765,791,-26
1,1,13,5,2,777,835,-58
1,1,14,5,2,791,884,-93
1,1,15,5,2,835,965,-130
1,1,16,5,2,884,1077,-193
1,1,17,5,2,965,1102,-137
1,1,18,5,2,1077,1096,-19
1,1,19,5,2,1102,1125,-23
1,1,20,5,2,1096,1108,-12
1,2,0,5,2,1163,1100,63
1,2,1,5,2,1162,1095,67
1,2,2,5,2,1100,1094,6
1,2,3,5,2,1095,984,111
1,2,4,5,2,1094,856,238
1,2,5,5,2,984,785,199
1,2,6,5,2,856,749,107
1,2,7,5,2,785,729,56
1,2,8,5,2,749,708,41
1,2,9,5,2,729,695,34
1,2,10,5,2,708,696,12
1,2,11,5,2,695,705,-10
1,2,12,5,2,696,715,-19
1,2,13,5,2,705,758,-53
1,2,14,5,2,715,805,-90
1,2,15,5,2,758,891,-133
1,2,16,5,2,805,1029,-224
1,2,17,5,2,891,1083,-192
1,2,18,5,2,1029,1088,-59
1,2,19,5,2,1083,1123,-40
1,2,20,5,2,1088,1123,-35
1,3,0,5,2,1197,1020,177
1,3,1,5,2,1150,967,183
1,3,2,5,2,1020,973,47
1,3,3,5,2,967,907,60
1,3,4,5,2,973,817,156
1,3,5,5,2,907,752,155
1,3,6,5,2,817,712,105
1,3,7,5,2,752,700,52
1,3,8,5,2,712,688,24
1,3,9,5,2,700,680,20
1,3,10,5,2,688,679,9
1,3,11,5,2,680,682,-2
1,3,12,5,2,679,687,-8
1,3,13,5,2,682,725,-43
1,3,14,5,2,687,762,-75
1,3,15,5,2,725,836,-111
1,3,16,5,2,762,969,-207
1,3,17,5,2,836,1022,-186
1,3,18,5,2,969,1031,-62
1,3,19,5,2,1022,1092,-70
1,3,20,5,2,1031,1137,-106
1,4,0,5,2,1235,1004,231
1,4,1,5,2,1185,891,294
1,4,2,5,2,1004,903,101
1,4,3,5,2,891,909,-18
1,4,4,5,2,903,846,57
1,4,5,5,2,909,813,96
1,4,6,5,2,846,833,13
1,4,7,5,2,813,830,-17
1,4,8,5,2,833,826,7
1,4,9,5,2,830,838,-8
1,4,10,5,2,826,846,-20
1,4,11,5,2,838,838,0
1,4,12,5,2,846,831,15
1,4,13,5,2,838,840,-2
1,4,14,5,2,831,838,-7
1,4,15,5,2,840,880,-40
1,4,16,5,2,838,953,-115
1,4,17,5,2,880,986,-106
1,4,18,5,2,953,1047,-94
1,4,19,5,2,986,1123,-137
1,4,20,5,2,1047,1164,-117
1,5,0,5,2,1177,887,290
1,5,1,5,2,1090,734,356
1,5,2,5,2,887,753,134
1,5,3,5,2,734,794,-60
1,5,4,5,2,753,787,-34
1,5,5,5,2,794,814,-20
1,5,6,5,2,787,833,-46
1,5,7,5,2,814,801,13
1,5,8,5,2,833,798,35
1,5,9,5,2,801,824,-23
1,5,10,5,2,798,824,-26
1,5,11,5,2,824,801,23
1,5,12,5,2,824,816,8
1,5,13,5,2,801,845,-44
1,5,14,5,2,816,829,-13
1,5,15,5,2,845,823,22
1,5,16,5,2,829,829,0
1,5,17,5,2,823,846,-23
1,5,18,5,2,829,933,-104
1,5,19,5,2,846,1036,-190
1,5,20,5,2,933,1120,-187
1,6,0,5,2,1089,784,305
1,6,1,5,2,952,714,238
1,6,2,5,2,784,785,-1
1,6,3,5,2,714,857,-143
1,6,4,5,2,785,959,-174
1,6,5,5,2,857,1005,-148
1,6,6,5,2,959,966,-7
1,6,7,5,2,1005,926,79
1,6,8,5,2,966,917,49
1,6,9,5,2,926,938,-12
1,6,10,5,2,917,951,-34
1,6,11,5,2,938,927,11
1,6,12,5,2,951,938,13
1,6,13,5,2,927,998,-71
1,6,14,5,2,938,1010,-72
1,6,15,5,2,998,945,53
1,6,16,5,2,1010,873,137
1,6,17,5,2,945,858,87
1,6,18,5,2,873,895,-22
1,6,19,5,2,858,980,-122
1,6,20,5,2,895,1099,-204
1,7,0,5,2,1084,799,285
1,7,1,5,2,909,914,-5
1,7,2,5,2,799,1044,-245
1,7,3,5,2,914,1106,-192
1,7,4,5,2,1044,1287,-243
1,7,5,5,2,1106,1324,-218
1,7,6,5,2,1287,1222,65
1,7,7,5,2,1324,1160,164
1,7,8,5,2,1222,1151,71
1,7,9,5,2,1160,1169,-9
1,7,10,5,2,1151,1204,-53
1,7,11,5,2,1169,1174,-5
1,7,12,5,2,1204,1175,29
1,7,13,5,2,1174,1284,-110
1,7,14,5,2,1175,1345,-170
1,7,15,5,2,1284,1228,56
1,7,16,5,2,1345,1110,235
1,7,17,5,2,1228,1098,130
1,7,18,5,2,1110,1073,37
1,7,19,5,2,1098,1099,-1
1,7,20,5,2,1073,1175,-102
1,8,0,5,2,1127,890,237
1,8,1,5,2,945,1188,-243
1,8,2,5,2,890,1385,-495
1,8,3,5,2,1188,1381,-193
1,8,4,5,2,1385,1537,-152
1,8,5,5,2,1381,1580,-199
1,8,6,5,2,1537,1374,163
1,8,7,5,2,1580,1192,388
1,8,8,5,2,1374,1184,190
1,8,9,5,2,1192,1217,-25
1,8,10,5,2,1184,1249,-65
1,8,11,5,2,1217,1193,24
1,8,12,5,2,1249,1244,5
1,8,13,5,2,1193,1499,-306
1,8,14,5,2,1244,1651,-407
1,8,15,5,2,1499,1503,-4
1,8,16,5,2,1651,1376,275
1,8,17,5,2,1503,1389,114
1,8,18,5,2,1376,1332,44
1,8,19,5,2,1389,1301,88
1,8,20,5,2,1332,1270,62
1,9,0,5,2,1165,924,241
1,9,1,5,2,952,1357,-405
1,9,2,5,2,924,1668,-744
1,9,3,5,2,1357,1575,-218
1,9,4,5,2,1668,1684,-16
1,9,5,5,2,1575,1814,-239
1,9,6,5,2,1684,1461,223
1,9,7,5,2,1814,1133,681
1,9,8,5,2,1461,1116,345
1,9,9,5,2,1133,1137,-4
1,9,10,5,2,1116,1163,-47
1,9,11,5,2,1137,1096,41
1,9,12,5,2,1163,1216,-53
1,9,13,5,2,1096,1633,-537
1,9,14,5,2,1216,1852,-636
1,9,15,5,2,1633,1678,-45
1,9,16,5,2,1852,1585,267
1,9,17,5,2,1678,1587,91
1,9,18,5,2,1585,1470,115
1,9,19,5,2,1587,1440,147
1,9,20,5,2,1470,1352,118
1,10,0,5,2,1311,1049,262
1,10,1,5,2,1098,1571,-473
1,10,2,5,2,1049,2002,-953
1,10,3,5,2,1571,1873,-302
1,10,4,5,2,2002,1947,55
1,10,5,5,2,1873,2150,-277
1,10,6,5,2,1947,1692,255
1,10,7,5,2,2150,1290,860
1,10,8,5,2,1692,1271,421
1,10,9,5,2,1290,1264,26
1,10,10,5,2,1271,1317,-46
1,10,11,5,2,1264,1257,7
1,10,12,5,2,1317,1395,-78
1,10,13,5,2,1257,1917,-660
1,10,14,5,2,1395,2148,-753
1,10,15,5,2,1917,1964,-47
1,10,16,5,2,2148,1923,225
1,10,17,5,2,1964,1855,109
1,10,18,5,2,1923,1707,216
1,10,19,5,2,1855,1700,155
1,10,20,5,2,1707,1528,179
1,11,0,5,2,1478,1139,339
1,11,1,5,2,1270,1673,-403
1,11,2,5,2,1139,2193,-1054
1,11,3,5,2,1673,2046,-373
1,11,4,5,2,2193,2068,125
1,11,5,5,2,2046,2326,-280
1,11,6,5,2,2068,1743,325
1,11,7,5,2,2326,1231,1095
1,11,8,5,2,1743,1232,511
1,11,9,5,2,1231,1219,12
1,11,10,5,2,1232,1257,-25
1,11,11,5,2,1219,1179,40
1,11,12,5,2,1257,1388,-131
1,11,13,5,2,1179,2058,-879
1,11,14,5,2,1388,2280,-892
1,11,15,5,2,2058,2121,-63
1,11,16,5,2,2280,2161,119
1,11,17,5,2,2121,1992,129
1,11,18,5,2,2161,1857,304
1,11,19,5,2,1992,1903,89
1,11,20,5,2,1857,1650,207
1,12,0,5,2,1461,1120,341
1,12,1,5,2,1269,1635,-366
1,12,2,5,2,1120,2233,-1113
1,12,3,5,2,1635,2027,-392
1,12,4,5,2,2233,1993,240
1,12,5,5,2,2027,2367,-340
1,12,6,5,2,1993,1695,298
1,12,7,5,2,2367,1083,1284
1,12,8,5,2,1695,1071,624
1,12,9,5,2,1083,1071,12
1,12,10,5,2,1071,1105,-34
1,12,11,5,2,1071,1005,66
1,12,12,5,2,1105,1287,-182
1,12,13,5,2,1005,2055,-1050
1,12,14,5,2,1287,2226,-939
1,12,15,5,2,2055,2060,-5
1,12,16,5,2,2226,2172,54
1,12,17,5,2,2060,1941,119
1,12,18,5,2,2172,1799,373
1,12,19,5,2,1941,1846,95
1,12,20,5,2,1799,1600,199
1,13,0,5,2,1346,1099,247
1,13,1,5,2,1156,1625,-469
1,13,2,5,2,1099,2193,-1094
1,13,3,5,2,1625,1916,-291
1,13,4,5,2,2193,1899,294
1,13,5,5,2,1916,2338,-422
1,13,6,5,2,1899,1619,280
1,13,7,5,2,2338,1039,1299
1,13,8,5,2,1619,1019,600
1,13,9,5,2,1039,975,64
1,13,10,5,2,1019,1029,-10
1,13,11,5,2,975,935,40
1,13,12,5,2,1029,1226,-197
1,13,13,5,2,935,2027,-1092
1,13,14,5,2,1226,2140,-914
1,13,15,5,2,2027,1858,169
1,13,16,5,2,2140,1985,155
1,13,17,5,2,1858,1835,23
1,13,18,5,2,1985,1724,261
1,13,19,5,2,1835,1709,126
1,13,20,5,2,1724,1518,206
1,14,0,5,2,1255,1126,129
1,14,1,5,2,1055,1737,-682
1,14,2,5,2,1126,2170,-1044
1,14,3,5,2,1737,1741,-4
1,14,4,5,2,2170,1693,477
1,14,5,5,2,1741,2096,-355
1,14,6,5,2,1693,1455,238
1,14,7,5,2,2096,981,1115
1,14,8,5,2,1455,979,476
1,14,9,5,2,981,963,18
1,14,10,5,2,979,1005,-26
1,14,11,5,2,963,926,37
1,14,12,5,2,1005,1163,-158
1,14,13,5,2,926,1770,-844
1,14,14,5,2,1163,1899,-736
1,14,15,5,2,1770,1654,116
1,14,16,5,2,1899,1752,147
1,14,17,5,2,1654,1770,-116
1,14,18,5,2,1752,1723,29
1,14,19,5,2,1770,1569,201
1,14,20,5,2,1723,1389,334
1,15,0,5,2,1214,1227,-13
1,15,1,5,2,965,1803,-838
1,15,2,5,2,1227,1950,-723
1,15,3,5,2,1803,1496,307
1,15,4,5,2,1950,1490,460
1,15,5,5,2,1496,1915,-419
1,15,6,5,2,1490,1429,61
1,15,7,5,2,1915,1035,880
1,15,8,5,2,1429,1048,381
1,15,9,5,2,1035,1050,-15
1,15,10,5,2,1048,1099,-51
1,15,11,5,2,1050,977,73
1,15,12,5,2,1099,1079,20
1,15,13,5,2,977,1627,-650
1,15,14,5,2,1079,1874,-795
1,15,15,5,2,1627,1521,106
1,15,16,5,2,1874,1441,433
1,15,17,5,2,1521,1644,-123
1,15,18,5,2,1441,1631,-190
1,15,19,5,2,1644,1326,318
1,15,20,5,2,1631,1309,322
1,16,0,5,2,1165,1299,-134
1,16,1,5,2,833,1804,-971
1,16,2,5,2,1299,1633,-334
1,16,3,5,2,1804,1198,606
1,16,4,5,2,1633,1341,292
1,16,5,5,2,1198,1863,-665
1,16,6,5,2,1341,1484,-143
1,16,7,5,2,1863,1119,744
1,16,8,5,2,1484,1109,375
1,16,9,5,2,1119,1123,-4
1,16,10,5,2,1109,1200,-91
1,16,11,5,2,1123,1029,94
1,16,12,5,2,1200,992,208
1,16,13,5,2,1029,1425,-396
1,16,14,5,2,992,1706,-714
1,16,15,5,2,1425,1271,154
1,16,16,5,2,1706,1096,610
1,16,17,5,2,1271,1512,-241
1,16,18,5,2,1096,1492,-396
1,16,19,5,2,1512,1042,470
1,16,20,5,2,1492,1248,244
1,17,0,5,2,1218,1429,-211
1,17,1,5,2,805,1763,-958
1,17,2,5,2,1429,1259,170
1,17,3,5,2,1763,909,854
1,17,4,5,2,1259,1105,154
1,17,5,5,2,909,1605,-696
1,17,6,5,2,1105,1324,-219
1,17,7,5,2,1605,962,643
1,17,8,5,2,1324,968,356
1,17,9,5,2,962,1034,-72
1,17,10,5,2,968,1085,-117
1,17,11,5,2,1034,879,155
1,17,12,5,2,1085,799,286
1,17,13,5,2,879,1095,-216
1,17,14,5,2,799,1395,-596
1,17,15,5,2,1095,1037,58
1,17,16,5,2,1395,829,566
1,17,17,5,2,1037,1324,-287
1,17,18,5,2,829,1358,-529
1,17,19,5,2,1324,942,382
1,17,20,5,2,1358,1260,98
1,18,0,5,2,1206,1416,-210
1,18,1,5,2,817,1570,-753
1,18,2,5,2,1416,938,478
1,18,3,5,2,1570,688,882
1,18,4,5,2,938,902,36
1,18,5,5,2,688,1424,-736
1,18,6,5,2,902,1257,-355
1,18,7,5,2,1424,900,524
1,18,8,5,2,1257,922,335
1,18,9,5,2,900,1061,-161
1,18,10,5,2,922,1118,-196
1,18,11,5,2,1061,851,210
1,18,12,5,2,1118,729,389
1,18,13,5,2,851,923,-72
1,18,14,5,2,729,1174,-445
1,18,15,5,2,923,891,32
1,18,16,5,2,1174,672,502
1,18,17,5,2,891,1096,-205
1,18,18,5,2,672,1120,-448
1,18,19,5,2,1096,791,305
1,18,20,5,2,1120,1122,-2
1,19,0,5,2,1172,1279,-107
1,19,1,5,2,772,1286,-514
1,19,2,5,2,1279,655,624
1,19,3,5,2,1286,553,733
1,19,4,5,2,655,833,-178
1,19,5,5,2,553,1390,-837
1,19,6,5,2,833,1296,-463
1,19,7,5,2,1390,905,485
1,19,8,5,2,1296,878,418
1,19,9,5,2,905,1062,-157
1,19,10,5,2,878,1158,-280
1,19,11,5,2,1062,855,207
1,19,12,5,2,1158,730,428
1,19,13,5,2,855,975,-120
1,19,14,5,2,730,1123,-393
1,19,15,5,2,975,769,206
1,19,16,5,2,1123,586,537
1,19,17,5,2,769,895,-126
1,19,18,5,2,586,843,-257
1,19,19,5,2,895,653,242
1,19,20,5,2,843,1041,-198
1,0,0,6,2,1353,1309,44
1,0,1,6,2,1350,1346,4
1,0,2,6,2,1309,1367,-58
1,0,3,6,2,1346,1260,86
1,0,4,6,2,1367,1150,217
1,0,5,6,2,1260,1083,177
1,0,6,6,2,1150,1032,118
1,0,7,6,2,1083,1006,77
1,0,8,6,2,1032,981,51
1,0,9,6,2,1006,967,39
1,0,10,6,2,981,970,11
1,0,11,6,2,967,984,-17
1,0,12,6,2,970,1000,-30
1,0,13,6,2,984,1038,-54
1,0,14,6,2,1000,1084,-84
1,0,15,6,2,1038,1177,-139
1,0,16,6,2,1084,1295,-211
1,0,17,6,2,1177,1308,-131
1,0,18,6,2,1295,1297,-2
1,0,19,6,2,1308,1337,-29
1,0,20,6,2,1297,1319,-22
1,1,0,6,2,1380,1313,67
1,1,1,6,2,1380,1313,67
1,1,2,6,2,1313,1314,-1
1,1,3,6,2,1313,1194,119
1,1,4,6,2,1314,1065,249
1,1,5,6,2,1194,1000,194
1,1,6,6,2,1065,963,102
1,1,7,6,2,1000,939,61
1,1,8,6,2,963,915,48
1,1,9,6,2,939,901,38
1,1,10,6,2,915,903,12
1,1,11,6,2,901,914,-13
1,1,12,6,2,903,927,-24
1,1,13,6,2,914,980,-66
1,1,14,6,2,927,1027,-100
1,1,15,6,2,980,1102,-122
1,1,16,6,2,1027,1235,-208
1,1,17,6,2,1102,1286,-184
1,1,18,6,2,1235,1300,-65
1,1,19,6,2,1286,1348,-62
1,1,20,6,2,1300,1339,-39
1,2,0,6,2,1418,1239,179
1,2,1,6,2,1377,1184,193
1,2,2,6,2,1239,1191,48
1,2,3,6,2,1184,1123,61
1,2,4,6,2,1191,1043,148
1,2,5,6,2,1123,985,138
1,2,6,6,2,1043,940,103
1,2,7,6,2,985,922,63
1,2,8,6,2,940,904,36
1,2,9,6,2,922,893,29
1,2,10,6,2,904,893,11
1,2,11,6,2,893,900,-7
1,2,12,6,2,893,908,-15
1,2,13,6,2,900,953,-53
1,2,14,6,2,908,988,-80
1,2,15,6,2,953,1054,-101
1,2,16,6,2,988,1185,-197
1,2,17,6,2,1054,1232,-178
1,2,18,6,2,1185,1244,-59
1,2,19,6,2,1232,1317,-85
1,2,20,6,2,1244,1358,-114
1,3,0,6,2,1464,1219,245
1,3,1,6,2,1412,1108,304
1,3,2,6,2,1219,1130,89
1,3,3,6,2,1108,1136,-28
1,3,4,6,2,1130,1073,57
1,3,5,6,2,1136,1000,136
1,3,6,6,2,1073,974,99
1,3,7,6,2,1000,965,35
1,3,8,6,2,974,955,19
1,3,9,6,2,965,963,2
1,3,10,6,2,955,971,-16
1,3,11,6,2,963,966,-3
1,3,12,6,2,971,963,8
1,3,13,6,2,966,997,-31
1,3,14,6,2,963,1027,-64
1,3,15,6,2,997,1096,-99
1,3,16,6,2,1027,1191,-164
1,3,17,6,2,1096,1214,-118
1,3,18,6,2,1191,1258,-67
1,3,19,6,2,1214,1338,-124
1,3,20,6,2,1258,1386,-128
1,4,0,6,2,1410,1116,294
1,4,1,6,2,1323,975,348
1,4,2,6,2,1116,999,117
1,4,3,6,2,975,1008,-33
1,4,4,6,2,999,957,42
1,4,5,6,2,1008,944,64
1,4,6,6,2,957,938,19
1,4,7,6,2,944,900,44
1,4,8,6,2,938,891,47
1,4,9,6,2,900,913,-13
1,4,10,6,2,891,913,-22
1,4,11,6,2,913,893,20
1,4,12,6,2,913,911,2
1,4,13,6,2,893,952,-59
1,4,14,6,2,911,963,-52
1,4,15,6,2,952,1004,-52
1,4,16,6,2,963,1058,-95
1,4,17,6,2,1004,1084,-80
1,4,18,6,2,1058,1158,-100
1,4,19,6,2,1084,1259,-175
1,4,20,6,2,1158,1343,-185
1,5,0,6,2,1325,1023,302
1,5,1,6,2,1194,958,236
1,5,2,6,2,1023,1019,4
1,5,3,6,2,958,1035,-77
1,5,4,6,2,1019,1067,-48
1,5,5,6,2,1035,1113,-78
1,5,6,6,2,1067,1103,-36
1,5,7,6,2,1113,1061,52
1,5,8,6,2,1103,1049,54
1,5,9,6,2,1061,1068,-7
1,5,10,6,2,1049,1081,-32
1,5,11,6,2,1068,1057,11
1,5,12,6,2,1081,1069,12
1,5,13,6,2,1057,1119,-62
1,5,14,6,2,1069,1123,-54
1,5,15,6,2,1119,1084,35
1,5,16,6,2,1123,1061,62
1,5,17,6,2,1084,1081,3
1,5,18,6,2,1061,1130,-69
1,5,19,6,2,1081,1217,-136
1,5,20,6,2,1130,1325,-195
1,6,0,6,2,1328,997,331
1,6,1,6,2,1142,1090,52
1,6,2,6,2,997,1213,-216
1,6,3,6,2,1090,1255,-165
1,6,4,6,2,1213,1412,-199
1,6,5,6,2,1255,1451,-196
1,6,6,6,2,1412,1360,52
1,6,7,6,2,1451,1298,153
1,6,8,6,2,1360,1289,71
1,6,9,6,2,1298,1307,-9
1,6,10,6,2,1289,1342,-53
1,6,11,6,2,1307,1311,-4
1,6,12,6,2,1342,1311,31
1,6,13,6,2,1311,1429,-118
1,6,14,6,2,1311,1488,-177
1,6,15,6,2,1429,1365,64
1,6,16,6,2,1488,1268,220
1,6,17,6,2,1365,1282,83
1,6,18,6,2,1268,1277,-9
1,6,19,6,2,1282,1322,-40
1,6,20,6,2,1277,1406,-129
1,7,0,6,2,1382,1029,353
1,7,1,6,2,1160,1277,-117
1,7,2,6,2,1029,1482,-453
1,7,3,6,2,1277,1520,-243
1,7,4,6,2,1482,1724,-242
1,7,5,6,2,1520,1780,-260
1,7,6,6,2,1724,1565,159
1,7,7,6,2,1780,1385,395
1,7,8,6,2,1565,1380,185
1,7,9,6,2,1385,1415,-30
1,7,10,6,2,1380,1446,-66
1,7,11,6,2,1415,1388,27
1,7,12,6,2,1446,1437,9
1,7,13,6,2,1388,1694,-306
1,7,14,6,2,1437,1834,-397
1,7,15,6,2,1694,1666,28
1,7,16,6,2,1834,1532,302
1,7,17,6,2,1666,1538,128
1,7,18,6,2,1532,1488,44
1,7,19,6,2,1538,1495,43
1,7,20,6,2,1488,1505,-17
1,8,0,6,2,1432,1123,309
1,8,1,6,2,1214,1498,-284
1,8,2,6,2,1123,1825,-702
1,8,3,6,2,1498,1804,-306
1,8,4,6,2,1825,1940,-115
1,8,5,6,2,1804,2062,-258
1,8,6,6,2,1940,1723,217
1,8,7,6,2,2062,1398,664
1,8,8,6,2,1723,1383,340
1,8,9,6,2,1398,1420,-22
1,8,10,6,2,1383,1455,-72
1,8,11,6,2,1420,1380,40
1,8,12,6,2,1455,1492,-37
1,8,13,6,2,1380,1905,-525
1,8,14,6,2,1492,2117,-625
1,8,15,6,2,1905,1938,-33
1,8,16,6,2,2117,1807,310
1,8,17,6,2,1938,1779,159
1,8,18,6,2,1807,1697,110
1,8,19,6,2,1779,1686,93
1,8,20,6,2,1697,1601,96
1,9,0,6,2,1486,1161,325
1,9,1,6,2,1236,1655,-419
1,9,2,6,2,1161,2098,-937
1,9,3,6,2,1655,1972,-317
1,9,4,6,2,2098,2058,40
1,9,5,6,2,1972,2281,-309
1,9,6,6,2,2058,1797,261
1,9,7,6,2,2281,1360,921
1,9,8,6,2,1797,1336,461
1,9,9,6,2,1360,1339,21
1,9,10,6,2,1336,1384,-48
1,9,11,6,2,1339,1312,27
1,9,12,6,2,1384,1475,-91
1,9,13,6,2,1312,2029,-717
1,9,14,6,2,1475,2273,-798
1,9,15,6,2,2029,2088,-59
1,9,16,6,2,2273,2028,245
1,9,17,6,2,2088,1953,135
1,9,18,6,2,2028,1818,210
1,9,19,6,2,1953,1836,117
1,9,20,6,2,1818,1707,111
1,10,0,6,2,1626,1275,351
1,10,1,6,2,1374,1897,-523
1,10,2,6,2,1275,2459,-1184
1,10,3,6,2,1897,2287,-390
1,10,4,6,2,2459,2348,111
1,10,5,6,2,2287,2625,-338
1,10,6,6,2,2348,2013,335
1,10,7,6,2,2625,1491,1134
1,10,8,6,2,2013,1483,530
1,10,9,6,2,1491,1463,28
1,10,10,6,2,1483,1514,-31
1,10,11,6,2,1463,1435,28
1,10,12,6,2,1514,1641,-127
1,10,13,6,2,1435,2332,-897
1,10,14,6,2,1641,2574,-933
1,10,15,6,2,2332,2382,-50
1,10,16,6,2,2574,2393,181
1,10,17,6,2,2382,2227,155
1,10,18,6,2,2393,2054,339
1,10,19,6,2,2227,2084,143
1,10,20,6,2,2054,1855,199
1,11,0,6,2,1700,1333,367
1,11,1,6,2,1459,2011,-552
1,11,2,6,2,1333,2661,-1328
1,11,3,6,2,2011,2425,-414
1,11,4,6,2,2661,2446,215
1,11,5,6,2,2425,2813,-388
1,11,6,6,2,2446,2089,357
1,11,7,6,2,2813,1455,1358
1,11,8,6,2,2089,1443,646
1,11,9,6,2,1455,1440,15
1,11,10,6,2,1443,1496,-53
1,11,11,6,2,1440,1389,51
1,11,12,6,2,1496,1660,-164
1,11,13,6,2,1389,2486,-1097
1,11,14,6,2,1660,2704,-1044
1,11,15,6,2,2486,2480,6
1,11,16,6,2,2704,2567,137
1,11,17,6,2,2480,2365,115
1,11,18,6,2,2567,2181,386
1,11,19,6,2,2365,2188,177
1,11,20,6,2,2181,1907,274
1,12,0,6,2,1644,1329,315
1,12,1,6,2,1407,1988,-581
1,12,2,6,2,1329,2631,-1302
1,12,3,6,2,1988,2330,-342
1,12,4,6,2,2631,2336,295
1,12,5,6,2,2330,2794,-464
1,12,6,6,2,2336,1962,374
1,12,7,6,2,2794,1264,1530
1,12,8,6,2,1962,1248,714
1,12,9,6,2,1264,1221,43
1,12,10,6,2,1248,1271,-23
1,12,11,6,2,1221,1149,72
1,12,12,6,2,1271,1488,-217
1,12,13,6,2,1149,2437,-1288
1,12,14,6,2,1488,2629,-1141
1,12,15,6,2,2437,2296,141
1,12,16,6,2,2629,2407,222
1,12,17,6,2,2296,2275,21
1,12,18,6,2,2407,2139,268
1,12,19,6,2,2275,2105,170
1,12,20,6,2,2139,1848,291
1,13,0,6,2,1560,1359,201
1,13,1,6,2,1324,2047,-723
1,13,2,6,2,1359,2610,-1251
1,13,3,6,2,2047,2164,-117
1,13,4,6,2,2610,2096,514
1,13,5,6,2,2164,2578,-414
1,13,6,6,2,2096,1804,292
1,13,7,6,2,2578,1187,1391
1,13,8,6,2,1804,1178,626
1,13,9,6,2,1187,1166,21
1,13,10,6,2,1178,1211,-33
1,13,11,6,2,1166,1113,53
1,13,12,6,2,1211,1411,-200
1,13,13,6,2,1113,2176,-1063
1,13,14,6,2,1411,2365,-954
1,13,15,6,2,2176,2089,87
1,13,16,6,2,2365,2183,182
1,13,17,6,2,2089,2160,-71
1,13,18,6,2,2183,2088,95
1,13,19,6,2,2160,1954,206
1,13,20,6,2,2088,1720,368
1,14,0,6,2,1535,1464,71
1,14,1,6,2,1249,2101,-852
1,14,2,6,2,1464,2380,-916
1,14,3,6,2,2101,1893,208
1,14,4,6,2,2380,1864,516
1,14,5,6,2,1893,2382,-489
1,14,6,6,2,1864,1765,99
1,14,7,6,2,2382,1262,1120
1,14,8,6,2,1765,1268,497
1,14,9,6,2,1262,1252,10
1,14,10,6,2,1268,1320,-52
1,14,11,6,2,1252,1193,59
1,14,12,6,2,1320,1338,-18
1,14,13,6,2,1193,2023,-830
1,14,14,6,2,1338,2295,-957
1,14,15,6,2,2023,1931,92
1,14,16,6,2,2295,1884,411
1,14,17,6,2,1931,2010,-79
1,14,18,6,2,1884,1979,-95
1,14,19,6,2,2010,1722,288
1,14,20,6,2,1979,1664,315
1,15,0,6,2,1480,1525,-45
1,15,1,6,2,1109,2130,-1021
1,15,2,6,2,1525,2090,-565
1,15,3,6,2,2130,1612,518
1,15,4,6,2,2090,1742,348
1,15,5,6,2,1612,2338,-726
1,15,6,6,2,1742,1805,-63
1,15,7,6,2,2338,1320,1018
1,15,8,6,2,1805,1321,484
1,15,9,6,2,1320,1322,-2
1,15,10,6,2,1321,1397,-76
1,15,11,6,2,1322,1207,115
1,15,12,6,2,1397,1238,159
1,15,13,6,2,1207,1840,-633
1,15,14,6,2,1238,2132,-894
1,15,15,6,2,1840,1689,151
1,15,16,6,2,2132,1566,566
1,15,17,6,2,1689,1884,-195
1,15,18,6,2,1566,1839,-273
1,15,19,6,2,1884,1426,458
1,15,20,6,2,1839,1575,264
1,16,0,6,2,1440,1623,-183
1,16,1,6,2,994,2101,-1107
1,16,2,6,2,1623,1727,-104
1,16,3,6,2,2101,1288,813
1,16,4,6,2,1727,1483,244
1,16,5,6,2,1288,2092,-804
1,16,6,6,2,1483,1670,-187
1,16,7,6,2,2092,1186,906
1,16,8,6,2,1670,1179,491
1,16,9,6,2,1186,1255,-69
1,16,10,6,2,1179,1324,-145
1,16,11,6,2,1255,1089,166
1,16,12,6,2,1324,1071,253
1,16,13,6,2,1089,1523,-434
1,16,14,6,2,1071,1819,-748
1,16,15,6,2,1523,1396,127
1,16,16,6,2,1819,1235,584
1,16,17,6,2,1396,1697,-301
1,16,18,6,2,1235,1682,-447
1,16,19,6,2,1697,1227,470
1,16,20,6,2,1682,1517,165
1,17,0,6,2,1389,1625,-236
1,17,1,6,2,955,1923,-968
1,17,2,6,2,1625,1336,289
1,17,3,6,2,1923,991,932
1,17,4,6,2,1336,1245,91
1,17,5,6,2,991,1851,-860
1,17,6,6,2,1245,1524,-279
1,17,7,6,2,1851,1081,770
1,17,8,6,2,1524,1099,425
1,17,9,6,2,1081,1211,-130
1,17,10,6,2,1099,1284,-185
1,17,11,6,2,1211,995,216
1,17,12,6,2,1284,930,354
1,17,13,6,2,995,1305,-310
1,17,14,6,2,930,1577,-647
1,17,15,6,2,1305,1127,178
1,17,16,6,2,1577,907,670
1,17,17,6,2,1127,1430,-303
1,17,18,6,2,907,1460,-553
1,17,19,6,2,1430,1050,380
1,17,20,6,2,1460,1370,90
1,18,0,6,2,1386,1539,-153
1,18,1,6,2,940,1708,-768
1,18,2,6,2,1539,1072,467
1,18,3,6,2,1708,801,907
1,18,4,6,2,1072,1030,42
1,18,5,6,2,801,1630,-829
1,18,6,6,2,1030,1481,-451
1,18,7,6,2,1630,1053,577
1,18,8,6,2,1481,1037,444
1,18,9,6,2,1053,1253,-200
1,18,10,6,2,1037,1340,-303
1,18,11,6,2,1253,1033,220
1,18,12,6,2,1340,915,425
1,18,13,6,2,1033,1124,-91
1,18,14,6,2,915,1348,-433
1,18,15,6,2,1124,1000,124
1,18,16,6,2,1348,784,564
1,18,17,6,2,1000,1220,-220
1,18,18,6,2,784,1207,-423
1,18,19,6,2,1220,898,322
1,18,20,6,2,1207,1243,-36
1,0,0,7,2,1597,1507,90
1,0,1,7,2,1583,1522,61
1,0,2,7,2,1507,1536,-29
1,0,3,7,2,1522,1409,113
1,0,4,7,2,1536,1275,261
1,0,5,7,2,1409,1210,199
1,0,6,7,2,1275,1170,105
1,0,7,7,2,1210,1144,66
1,0,8,7,2,1170,1119,51
1,0,9,7,2,1144,1105,39
1,0,10,7,2,1119,1108,11
1,0,11,7,2,1105,1121,-16
1,0,12,7,2,1108,1136,-28
1,0,13,7,2,1121,1183,-62
1,0,14,7,2,1136,1227,-91
1,0,15,7,2,1183,1314,-131
1,0,16,7,2,1227,1453,-226
1,0,17,7,2,1314,1492,-178
1,0,18,7,2,1453,1501,-48
1,0,19,7,2,1492,1560,-68
1,0,20,7,2,1501,1550,-49
1,1,0,7,2,1635,1452,183
1,1,1,7,2,1595,1402,193
1,1,2,7,2,1452,1411,41
1,1,3,7,2,1402,1333,69
1,1,4,7,2,1411,1252,159
1,1,5,7,2,1333,1200,133
1,1,6,7,2,1252,1154,98
1,1,7,7,2,1200,1132,68
1,1,8,7,2,1154,1111,43
1,1,9,7,2,1132,1099,33
1,1,10,7,2,1111,1100,11
1,1,11,7,2,1099,1109,-10
1,1,12,7,2,1100,1120,-20
1,1,13,7,2,1109,1175,-66
1,1,14,7,2,1120,1210,-90
1,1,15,7,2,1175,1265,-90
1,1,16,7,2,1210,1391,-181
1,1,17,7,2,1265,1435,-170
1,1,18,7,2,1391,1456,-65
1,1,19,7,2,1435,1542,-107
1,1,20,7,2,1456,1574,-118
1,2,0,7,2,1685,1438,247
1,2,1,7,2,1639,1325,314
1,2,2,7,2,1438,1348,90
1,2,3,7,2,1325,1352,-27
1,2,4,7,2,1348,1299,49
1,2,5,7,2,1352,1233,119
1,2,6,7,2,1299,1202,97
1,2,7,7,2,1233,1187,46
1,2,8,7,2,1202,1171,31
1,2,9,7,2,1187,1176,11
1,2,10,7,2,1171,1185,-14
1,2,11,7,2,1176,1184,-8
1,2,12,7,2,1185,1184,1
1,2,13,7,2,1184,1225,-41
1,2,14,7,2,1184,1253,-69
1,2,15,7,2,1225,1314,-89
1,2,16,7,2,1253,1407,-154
1,2,17,7,2,1314,1424,-110
1,2,18,7,2,1407,1471,-64
1,2,19,7,2,1424,1563,-139
1,2,20,7,2,1471,1607,-136
1,3,0,7,2,1639,1331,308
1,3,1,7,2,1550,1192,358
1,3,2,7,2,1331,1226,105
1,3,3,7,2,1192,1235,-43
1,3,4,7,2,1226,1184,42
1,3,5,7,2,1235,1131,104
1,3,6,7,2,1184,1079,105
1,3,7,7,2,1131,1035,96
1,3,8,7,2,1079,1020,59
1,3,9,7,2,1035,1038,-3
1,3,10,7,2,1020,1038,-18
1,3,11,7,2,1038,1021,17
1,3,12,7,2,1038,1043,-5
1,3,13,7,2,1021,1109,-88
1,3,14,7,2,1043,1152,-109
1,3,15,7,2,1109,1220,-111
1,3,16,7,2,1152,1296,-144
1,3,17,7,2,1220,1312,-92
1,3,18,7,2,1296,1369,-73
1,3,19,7,2,1312,1474,-162
1,3,20,7,2,1369,1565,-196
1,4,0,7,2,1558,1252,306
1,4,1,7,2,1427,1199,228
1,4,2,7,2,1252,1265,-13
1,4,3,7,2,1199,1249,-50
1,4,4,7,2,1265,1237,28
1,4,5,7,2,1249,1243,6
1,4,6,7,2,1237,1208,29
1,4,7,7,2,1243,1160,83
1,4,8,7,2,1208,1142,66
1,4,9,7,2,1160,1157,3
1,4,10,7,2,1142,1170,-28
1,4,11,7,2,1157,1149,8
1,4,12,7,2,1170,1164,6
1,4,13,7,2,1149,1226,-77
1,4,14,7,2,1164,1257,-93
1,4,15,7,2,1226,1265,-39
1,4,16,7,2,1257,1290,-33
1,4,17,7,2,1265,1319,-54
1,4,18,7,2,1290,1355,-65
1,4,19,7,2,1319,1440,-121
1,4,20,7,2,1355,1548,-193
1,5,0,7,2,1564,1236,328
1,5,1,7,2,1384,1334,50
1,5,2,7,2,1236,1447,-211
1,5,3,7,2,1334,1433,-99
1,5,4,7,2,1447,1520,-73
1,5,5,7,2,1433,1559,-126
1,5,6,7,2,1520,1497,23
1,5,7,7,2,1559,1433,126
1,5,8,7,2,1497,1421,76
1,5,9,7,2,1433,1437,-4
1,5,10,7,2,1421,1472,-51
1,5,11,7,2,1437,1441,-4
1,5,12,7,2,1472,1442,30
1,5,13,7,2,1441,1550,-109
1,5,14,7,2,1442,1601,-159
1,5,15,7,2,1550,1504,46
1,5,16,7,2,1601,1456,145
1,5,17,7,2,1504,1505,-1
1,5,18,7,2,1456,1512,-56
1,5,19,7,2,1505,1559,-54
1,5,20,7,2,1512,1632,-120
1,6,0,7,2,1626,1227,399
1,6,1,7,2,1393,1453,-60
1,6,2,7,2,1227,1651,-424
1,6,3,7,2,1453,1669,-216
1,6,4,7,2,1651,1849,-198
1,6,5,7,2,1669,1907,-238
1,6,6,7,2,1849,1703,146
1,6,7,7,2,1907,1523,384
1,6,8,7,2,1703,1518,185
1,6,9,7,2,1523,1553,-30
1,6,10,7,2,1518,1584,-66
1,6,11,7,2,1553,1525,28
1,6,12,7,2,1584,1573,11
1,6,13,7,2,1525,1839,-314
1,6,14,7,2,1573,1977,-404
1,6,15,7,2,1839,1803,36
1,6,16,7,2,1977,1690,287
1,6,17,7,2,1803,1722,81
1,6,18,7,2,1690,1692,-2
1,6,19,7,2,1722,1718,4
1,6,20,7,2,1692,1736,-44
1,7,0,7,2,1687,1262,425
1,7,1,7,2,1429,1587,-158
1,7,2,7,2,1262,1922,-660
1,7,3,7,2,1587,1943,-356
1,7,4,7,2,1922,2127,-205
1,7,5,7,2,1943,2262,-319
1,7,6,7,2,2127,1914,213
1,7,7,7,2,2262,1591,671
1,7,8,7,2,1914,1579,335
1,7,9,7,2,1591,1618,-27
1,7,10,7,2,1579,1652,-73
1,7,11,7,2,1618,1575,43
1,7,12,7,2,1652,1685,-33
1,7,13,7,2,1575,2100,-525
1,7,14,7,2,1685,2300,-615
1,7,15,7,2,2100,2101,-1
1,7,16,7,2,2300,1963,337
1,7,17,7,2,2101,1928,173
1,7,18,7,2,1963,1853,110
1,7,19,7,2,1928,1880,48
1,7,20,7,2,1853,1836,17
1,8,0,7,2,1753,1360,393
1,8,1,7,2,1498,1796,-298
1,8,2,7,2,1360,2255,-895
1,8,3,7,2,1796,2201,-405
1,8,4,7,2,2255,2314,-59
1,8,5,7,2,2201,2529,-328
1,8,6,7,2,2314,2059,255
1,8,7,7,2,2529,1625,904
1,8,8,7,2,2059,1603,456
1,8,9,7,2,1625,1622,3
1,8,10,7,2,1603,1676,-73
1,8,11,7,2,1622,1596,26
1,8,12,7,2,1676,1751,-75
1,8,13,7,2,1596,2301,-705
1,8,14,7,2,1751,2538,-787
1,8,15,7,2,2301,2348,-47
1,8,16,7,2,2538,2250,288
1,8,17,7,2,2348,2145,203
1,8,18,7,2,2250,2045,205
1,8,19,7,2,2145,2082,63
1,8,20,7,2,2045,1956,89
1,9,0,7,2,1801,1387,414
1,9,1,7,2,1512,1981,-469
1,9,2,7,2,1387,2555,-1168
1,9,3,7,2,1981,2386,-405
1,9,4,7,2,2555,2459,96
1,9,5,7,2,2386,2756,-370
1,9,6,7,2,2459,2118,341
1,9,7,7,2,2756,1561,1195
1,9,8,7,2,2118,1548,570
1,9,9,7,2,1561,1538,23
1,9,10,7,2,1548,1581,-33
1,9,11,7,2,1538,1490,48
1,9,12,7,2,1581,1721,-140
1,9,13,7,2,1490,2444,-954
1,9,14,7,2,1721,2699,-978
1,9,15,7,2,2444,2506,-62
1,9,16,7,2,2699,2498,201
1,9,17,7,2,2506,2325,181
1,9,18,7,2,2498,2165,333
1,9,19,7,2,2325,2220,105
1,9,20,7,2,2165,2034,131
1,10,0,7,2,1848,1469,379
1,10,1,7,2,1563,2235,-672
1,10,2,7,2,1469,2927,-1458
1,10,3,7,2,2235,2666,-431
1,10,4,7,2,2927,2726,201
1,10,5,7,2,2666,3112,-446
1,10,6,7,2,2726,2359,367
1,10,7,7,2,3112,1715,1397
1,10,8,7,2,2359,1694,665
1,10,9,7,2,1715,1684,31
1,10,10,7,2,1694,1753,-59
1,10,11,7,2,1684,1645,39
1,10,12,7,2,1753,1913,-160
1,10,13,7,2,1645,2760,-1115
1,10,14,7,2,1913,2998,-1085
1,10,15,7,2,2760,2741,19
1,10,16,7,2,2998,2799,199
1,10,17,7,2,2741,2600,141
1,10,18,7,2,2799,2378,421
1,10,19,7,2,2600,2369,231
1,10,20,7,2,2378,2112,266
1,11,0,7,2,1883,1542,341
1,11,1,7,2,1597,2364,-767
1,11,2,7,2,1542,3059,-1517
1,11,3,7,2,2364,2728,-364
1,11,4,7,2,3059,2789,270
1,11,5,7,2,2728,3240,-512
1,11,6,7,2,2789,2356,433
1,11,7,7,2,3240,1636,1604
1,11,8,7,2,2356,1620,736
1,11,9,7,2,1636,1590,46
1,11,10,7,2,1620,1662,-42
1,11,11,7,2,1590,1533,57
1,11,12,7,2,1662,1861,-199
1,11,13,7,2,1533,2868,-1335
1,11,14,7,2,1861,3107,-1246
1,11,15,7,2,2868,2716,152
1,11,16,7,2,3107,2802,305
1,11,17,7,2,2716,2699,17
1,11,18,7,2,2802,2521,281
1,11,19,7,2,2699,2447,252
1,11,20,7,2,2521,2155,366
1,12,0,7,2,1858,1589,269
1,12,1,7,2,1575,2410,-835
1,12,2,7,2,1589,3048,-1459
1,12,3,7,2,2410,2578,-168
1,12,4,7,2,3048,2533,515
1,12,5,7,2,2578,3034,-456
1,12,6,7,2,2533,2147,386
1,12,7,7,2,3034,1412,1622
1,12,8,7,2,2147,1407,740
1,12,9,7,2,1412,1412,0
1,12,10,7,2,1407,1453,-46
1,12,11,7,2,1412,1327,85
1,12,12,7,2,1453,1673,-220
1,12,13,7,2,1327,2586,-1259
1,12,14,7,2,1673,2854,-1181
1,12,15,7,2,2586,2527,59
1,12,16,7,2,2854,2605,249
1,12,17,7,2,2527,2600,-73
1,12,18,7,2,2605,2503,102
1,12,19,7,2,2600,2350,250
1,12,20,7,2,2503,2050,453
1,13,0,7,2,1840,1697,143
1,13,1,7,2,1518,2411,-893
1,13,2,7,2,1697,2820,-1123
1,13,3,7,2,2411,2316,95
1,13,4,7,2,2820,2267,553
1,13,5,7,2,2316,2864,-548
1,13,6,7,2,2267,2114,153
1,13,7,7,2,2864,1468,1396
1,13,8,7,2,2114,1467,647
1,13,9,7,2,1468,1455,13
1,13,10,7,2,1467,1526,-59
1,13,11,7,2,1455,1380,75
1,13,12,7,2,1526,1586,-60
1,13,13,7,2,1380,2429,-1049
1,13,14,7,2,1586,2761,-1175
1,13,15,7,2,2429,2366,63
1,13,16,7,2,2761,2315,446
1,13,17,7,2,2366,2400,-34
1,13,18,7,2,2315,2344,-29
1,13,19,7,2,2400,2107,293
1,13,20,7,2,2344,1995,349
1,14,0,7,2,1801,1762,39
1,14,1,7,2,1393,2428,-1035
1,14,2,7,2,1762,2520,-758
1,14,3,7,2,2428,2009,419
1,14,4,7,2,2520,2116,404
1,14,5,7,2,2009,2805,-796
1,14,6,7,2,2116,2141,-25
1,14,7,7,2,2805,1547,1258
1,14,8,7,2,2141,1541,600
1,14,9,7,2,1547,1524,23
1,14,10,7,2,1541,1618,-77
1,14,11,7,2,1524,1423,101
1,14,12,7,2,1618,1497,121
1,14,13,7,2,1423,2236,-813
1,14,14,7,2,1497,2553,-1056
1,14,15,7,2,2236,2099,137
1,14,16,7,2,2553,2009,544
1,14,17,7,2,2099,2250,-151
1,14,18,7,2,2009,2187,-178
1,14,19,7,2,2250,1822,428
1,14,20,7,2,2187,1930,257
1,15,0,7,2,1755,1849,-94
1,15,1,7,2,1270,2427,-1157
1,15,2,7,2,1849,2184,-335
1,15,3,7,2,2427,1702,725
1,15,4,7,2,2184,1884,300
1,15,5,7,2,1702,2567,-865
1,15,6,7,2,1884,1991,-107
1,15,7,7,2,2567,1387,1180
1,15,8,7,2,1991,1391,600
1,15,9,7,2,1387,1454,-67
1,15,10,7,2,1391,1521,-130
1,15,11,7,2,1454,1267,187
1,15,12,7,2,1521,1317,204
1,15,13,7,2,1267,1938,-671
1,15,14,7,2,1317,2245,-928
1,15,15,7,2,1938,1814,124
1,15,16,7,2,2245,1705,540
1,15,17,7,2,1814,2069,-255
1,15,18,7,2,1705,2029,-324
1,15,19,7,2,2069,1611,458
1,15,20,7,2,2029,1844,185
1,16,0,7,2,1611,1819,-208
1,16,1,7,2,1144,2261,-1117
1,16,2,7,2,1819,1804,15
1,16,3,7,2,2261,1370,891
1,16,4,7,2,1804,1623,181
1,16,5,7,2,1370,2338,-968
1,16,6,7,2,1623,1870,-247
1,16,7,7,2,2338,1305,1033
1,16,8,7,2,1870,1310,560
1,16,9,7,2,1305,1432,-127
1,16,10,7,2,1310,1523,-213
1,16,11,7,2,1432,1205,227
1,16,12,7,2,1523,1202,321
1,16,13,7,2,1205,1733,-528
1,16,14,7,2,1202,2001,-799
1,16,15,7,2,1733,1486,247
1,16,16,7,2,2001,1313,688
1,16,17,7,2,1486,1803,-317
1,16,18,7,2,1313,1784,-471
1,16,19,7,2,1803,1335,468
1,16,20,7,2,1784,1627,157
1,17,0,7,2,1569,1748,-179
1,17,1,7,2,1078,2061,-983
1,17,2,7,2,1748,1470,278
1,17,3,7,2,2061,1104,957
1,17,4,7,2,1470,1373,97
1,17,5,7,2,1104,2057,-953
1,17,6,7,2,1373,1748,-375
1,17,7,7,2,2057,1234,823
1,17,8,7,2,1748,1214,534
1,17,9,7,2,1234,1403,-169
1,17,10,7,2,1214,1506,-292
1,17,11,7,2,1403,1177,226
1,17,12,7,2,1506,1116,390
1,17,13,7,2,1177,1506,-329
1,17,14,7,2,1116,1751,-635
1,17,15,7,2,1506,1236,270
1,17,16,7,2,1751,1019,732
1,17,17,7,2,1236,1554,-318
1,17,18,7,2,1019,1547,-528
1,17,19,7,2,1554,1157,397
1,17,20,7,2,1547,1491,56
1,0,0,8,2,1852,1646,206
1,0,1,8,2,1798,1611,187
1,0,2,8,2,1646,1633,13
1,0,3,8,2,1611,1548,63
1,0,4,8,2,1633,1462,171
1,0,5,8,2,1548,1410,138
1,0,6,8,2,1462,1361,101
1,0,7,8,2,1410,1337,73
1,0,8,8,2,1361,1315,46
1,0,9,8,2,1337,1303,34
1,0,10,8,2,1315,1305,10
1,0,11,8,2,1303,1316,-13
1,0,12,8,2,1305,1329,-24
1,0,13,8,2,1316,1378,-62
1,0,14,8,2,1329,1410,-81
1,0,15,8,2,1378,1477,-99
1,0,16,8,2,1410,1609,-199
1,0,17,8,2,1477,1641,-164
1,0,18,8,2,1609,1657,-48
1,0,19,8,2,1641,1754,-113
1,0,20,8,2,1657,1785,-128
1,1,0,8,2,1902,1651,251
1,1,1,8,2,1857,1543,314
1,1,2,8,2,1651,1568,83
1,1,3,8,2,1543,1562,-19
1,1,4,8,2,1568,1508,60
1,1,5,8,2,1562,1448,114
1,1,6,8,2,1508,1416,92
1,1,7,8,2,1448,1397,51
1,1,8,8,2,1416,1378,38
1,1,9,8,2,1397,1382,15
1,1,10,8,2,1378,1392,-14
1,1,11,8,2,1382,1393,-11
1,1,12,8,2,1392,1396,-4
1,1,13,8,2,1393,1447,-54
1,1,14,8,2,1396,1475,-79
1,1,15,8,2,1447,1525,-78
1,1,16,8,2,1475,1613,-138
1,1,17,8,2,1525,1627,-102
1,1,18,8,2,1613,1683,-70
1,1,19,8,2,1627,1788,-161
1,1,20,8,2,1683,1823,-140
1,2,0,8,2,1860,1550,310
1,2,1,8,2,1777,1409,368
1,2,2,8,2,1550,1444,106
1,2,3,8,2,1409,1451,-42
1,2,4,8,2,1444,1410,34
1,2,5,8,2,1451,1364,87
1,2,6,8,2,1410,1307,103
1,2,7,8,2,1364,1257,107
1,2,8,8,2,1307,1236,71
1,2,9,8,2,1257,1251,6
1,2,10,8,2,1236,1252,-16
1,2,11,8,2,1251,1239,12
1,2,12,8,2,1252,1264,-12
1,2,13,8,2,1239,1337,-98
1,2,14,8,2,1264,1378,-114
1,2,15,8,2,1337,1438,-101
1,2,16,8,2,1378,1512,-134
1,2,17,8,2,1438,1522,-84
1,2,18,8,2,1512,1582,-70
1,2,19,8,2,1522,1699,-177
1,2,20,8,2,1582,1786,-204
1,3,0,8,2,1787,1467,320
1,3,1,8,2,1654,1416,238
1,3,2,8,2,1467,1492,-25
1,3,3,8,2,1416,1476,-60
1,3,4,8,2,1492,1464,28
1,3,5,8,2,1476,1430,46
1,3,6,8,2,1464,1349,115
1,3,7,8,2,1430,1295,135
1,3,8,8,2,1349,1271,78
1,3,9,8,2,1295,1282,13
1,3,10,8,2,1271,1295,-24
1,3,11,8,2,1282,1277,5
1,3,12,8,2,1295,1296,-1
1,3,13,8,2,1277,1383,-106
1,3,14,8,2,1296,1446,-150
1,3,15,8,2,1383,1481,-98
1,3,16,8,2,1446,1528,-82
1,3,17,8,2,1481,1547,-66
1,3,18,8,2,1528,1566,-38
1,3,19,8,2,1547,1655,-108
1,3,20,8,2,1566,1770,-204
1,4,0,8,2,1797,1465,332
1,4,1,8,2,1617,1575,42
1,4,2,8,2,1465,1693,-228
1,4,3,8,2,1575,1647,-72
1,4,4,8,2,1693,1690,3
1,4,5,8,2,1647,1689,-42
1,4,6,8,2,1690,1602,88
1,4,7,8,2,1689,1532,157
1,4,8,8,2,1602,1514,88
1,4,9,8,2,1532,1526,6
1,4,10,8,2,1514,1561,-47
1,4,11,8,2,1526,1533,-7
1,4,12,8,2,1561,1537,24
1,4,13,8,2,1533,1657,-124
1,4,14,8,2,1537,1735,-198
1,4,15,8,2,1657,1685,-28
1,4,16,8,2,1735,1685,50
1,4,17,8,2,1685,1743,-58
1,4,18,8,2,1685,1737,-52
1,4,19,8,2,1743,1782,-39
1,4,20,8,2,1737,1855,-118
1,5,0,8,2,1862,1466,396
1,5,1,8,2,1635,1697,-62
1,5,2,8,2,1466,1885,-419
1,5,3,8,2,1697,1847,-150
1,5,4,8,2,1885,1957,-72
1,5,5,8,2,1847,2015,-168
1,5,6,8,2,1957,1840,117
1,5,7,8,2,2015,1658,357
1,5,8,8,2,1840,1650,190
1,5,9,8,2,1658,1683,-25
1,5,10,8,2,1650,1714,-64
1,5,11,8,2,1683,1655,28
1,5,12,8,2,1714,1704,10
1,5,13,8,2,1655,1960,-305
1,5,14,8,2,1704,2090,-386
1,5,15,8,2,1960,1942,18
1,5,16,8,2,2090,1878,212
1,5,17,8,2,1942,1945,-3
1,5,18,8,2,1878,1927,-49
1,5,19,8,2,1945,1955,-10
1,5,20,8,2,1927,1962,-35
1,6,0,8,2,1931,1460,471
1,6,1,8,2,1662,1763,-101
1,6,2,8,2,1460,2091,-631
1,6,3,8,2,1763,2092,-329
1,6,4,8,2,2091,2252,-161
1,6,5,8,2,2092,2389,-297
1,6,6,8,2,2252,2052,200
1,6,7,8,2,2389,1729,660
1,6,8,8,2,2052,1717,335
1,6,9,8,2,1729,1756,-27
1,6,10,8,2,1717,1790,-73
1,6,11,8,2,1756,1712,44
1,6,12,8,2,1790,1821,-31
1,6,13,8,2,1712,2245,-533
1,6,14,8,2,1821,2443,-622
1,6,15,8,2,2245,2238,7
1,6,16,8,2,2443,2121,322
1,6,17,8,2,2238,2112,126
1,6,18,8,2,2121,2057,64
1,6,19,8,2,2112,2103,9
1,6,20,8,2,2057,2067,-10
1,7,0,8,2,2008,1499,509
1,7,1,8,2,1713,1885,-172
1,7,2,8,2,1499,2352,-853
1,7,3,8,2,1885,2340,-455
1,7,4,8,2,2352,2501,-149
1,7,5,8,2,2340,2729,-389
1,7,6,8,2,2501,2250,251
1,7,7,8,2,2729,1818,911
1,7,8,8,2,2250,1799,451
1,7,9,8,2,1818,1820,-2
1,7,10,8,2,1799,1873,-74
1,7,11,8,2,1820,1791,29
1,7,12,8,2,1873,1944,-71
1,7,13,8,2,1791,2496,-705
1,7,14,8,2,1944,2721,-777
1,7,15,8,2,2496,2511,-15
1,7,16,8,2,2721,2406,315
1,7,17,8,2,2511,2294,217
1,7,18,8,2,2406,2201,205
1,7,19,8,2,2294,2276,18
1,7,20,8,2,2201,2191,10
1,8,0,8,2,2068,1586,482
1,8,1,8,2,1774,2122,-348
1,8,2,8,2,1586,2712,-1126
1,8,3,8,2,2122,2615,-493
1,8,4,8,2,2712,2715,-3
1,8,5,8,2,2615,3004,-389
1,8,6,8,2,2715,2380,335
1,8,7,8,2,3004,1826,1178
1,8,8,8,2,2380,1815,565
1,8,9,8,2,1826,1821,5
1,8,10,8,2,1815,1873,-58
1,8,11,8,2,1821,1774,47
1,8,12,8,2,1873,1997,-124
1,8,13,8,2,1774,2716,-942
1,8,14,8,2,1997,2964,-967
1,8,15,8,2,2716,2766,-50
1,8,16,8,2,2964,2720,244
1,8,17,8,2,2766,2517,249
1,8,18,8,2,2720,2392,328
1,8,19,8,2,2517,2466,51
1,8,20,8,2,2392,2283,109
1,9,0,8,2,2023,1581,442
1,9,1,8,2,1701,2319,-618
1,9,2,8,2,1581,3023,-1442
1,9,3,8,2,2319,2765,-446
1,9,4,8,2,3023,2837,186
1,9,5,8,2,2765,3243,-478
1,9,6,8,2,2837,2464,373
1,9,7,8,2,3243,1785,1458
1,9,8,8,2,2464,1759,705
1,9,9,8,2,1785,1759,26
1,9,10,8,2,1759,1820,-61
1,9,11,8,2,1759,1700,59
1,9,12,8,2,1820,1993,-173
1,9,13,8,2,1700,2872,-1172
1,9,14,8,2,1993,3123,-1130
1,9,15,8,2,2872,2865,7
1,9,16,8,2,3123,2904,219
1,9,17,8,2,2865,2698,167
1,9,18,8,2,2904,2489,415
1,9,19,8,2,2698,2505,193
1,9,20,8,2,2489,2291,198
1,10,0,8,2,2031,1678,353
1,10,1,8,2,1701,2588,-887
1,10,2,8,2,1678,3325,-1647
1,10,3,8,2,2588,2969,-381
1,10,4,8,2,3325,3069,256
1,10,5,8,2,2969,3539,-570
1,10,6,8,2,3069,2626,443
1,10,7,8,2,3539,1896,1643
1,10,8,8,2,2626,1871,755
1,10,9,8,2,1896,1834,62
1,10,10,8,2,1871,1919,-48
1,10,11,8,2,1834,1789,45
1,10,12,8,2,1919,2114,-195
1,10,13,8,2,1789,3142,-1353
1,10,14,8,2,2114,3401,-1287
1,10,15,8,2,3142,2977,165
1,10,16,8,2,3401,3034,367
1,10,17,8,2,2977,2934,43
1,10,18,8,2,3034,2718,316
1,10,19,8,2,2934,2628,306
1,10,20,8,2,2718,2360,358
1,11,0,8,2,2097,1802,295
1,11,1,8,2,1765,2786,-1021
1,11,2,8,2,1802,3476,-1674
1,11,3,8,2,2786,2976,-190
1,11,4,8,2,3476,2986,490
1,11,5,8,2,2976,3480,-504
1,11,6,8,2,2986,2541,445
1,11,7,8,2,3480,1784,1696
1,11,8,8,2,2541,1779,762
1,11,9,8,2,1784,1781,3
1,11,10,8,2,1779,1844,-65
1,11,11,8,2,1781,1711,70
1,11,12,8,2,1844,2046,-202
1,11,13,8,2,1711,3017,-1306
1,11,14,8,2,2046,3332,-1286
1,11,15,8,2,3017,2947,70
1,11,16,8,2,3332,3000,332
1,11,17,8,2,2947,3024,-77
1,11,18,8,2,3000,2885,115
1,11,19,8,2,3024,2692,332
1,11,20,8,2,2885,2357,528
1,12,0,8,2,2138,1927,211
1,12,1,8,2,1769,2774,-1005
1,12,2,8,2,1927,3258,-1331
1,12,3,8,2,2774,2730,44
1,12,4,8,2,3258,2704,554
1,12,5,8,2,2730,3320,-590
1,12,6,8,2,2704,2457,247
1,12,7,8,2,3320,1693,1627
1,12,8,8,2,2457,1696,761
1,12,9,8,2,1693,1701,-8
1,12,10,8,2,1696,1768,-72
1,12,11,8,2,1701,1594,107
1,12,12,8,2,1768,1848,-80
1,12,13,8,2,1594,2839,-1245
1,12,14,8,2,1848,3250,-1402
1,12,15,8,2,2839,2804,35
1,12,16,8,2,3250,2737,513
1,12,17,8,2,2804,2840,-36
1,12,18,8,2,2737,2759,-22
1,12,19,8,2,2840,2503,337
1,12,20,8,2,2759,2325,434
1,13,0,8,2,2106,1995,111
1,13,1,8,2,1662,2738,-1076
1,13,2,8,2,1995,2960,-965
1,13,3,8,2,2738,2432,306
1,13,4,8,2,2960,2519,441
1,13,5,8,2,2432,3287,-855
1,13,6,8,2,2519,2490,29
1,13,7,8,2,3287,1753,1534
1,13,8,8,2,2490,1740,750
1,13,9,8,2,1753,1727,26
1,13,10,8,2,1740,1824,-84
1,13,11,8,2,1727,1610,117
1,13,12,8,2,1824,1745,79
1,13,13,8,2,1610,2642,-1032
1,13,14,8,2,1745,3019,-1274
1,13,15,8,2,2642,2534,108
1,13,16,8,2,3019,2440,579
1,13,17,8,2,2534,2640,-106
1,13,18,8,2,2440,2552,-112
1,13,19,8,2,2640,2207,433
1,13,20,8,2,2552,2261,291
1,14,0,8,2,2076,2086,-10
1,14,1,8,2,1554,2725,-1171
1,14,2,8,2,2086,2614,-528
1,14,3,8,2,2725,2099,626
1,14,4,8,2,2614,2258,356
1,14,5,8,2,2099,3034,-935
1,14,6,8,2,2258,2327,-69
1,14,7,8,2,3034,1614,1420
1,14,8,8,2,2327,1611,716
1,14,9,8,2,1614,1656,-42
1,14,10,8,2,1611,1742,-131
1,14,11,8,2,1656,1483,173
1,14,12,8,2,1742,1576,166
1,14,13,8,2,1483,2334,-851
1,14,14,8,2,1576,2666,-1090
1,14,15,8,2,2334,2224,110
1,14,16,8,2,2666,2148,518
1,14,17,8,2,2224,2435,-211
1,14,18,8,2,2148,2377,-229
1,14,19,8,2,2435,2007,428
1,14,20,8,2,2377,2199,178
1,15,0,8,2,1926,2045,-119
1,15,1,8,2,1420,2587,-1167
1,15,2,8,2,2045,2261,-216
1,15,3,8,2,2587,1784,803
1,15,4,8,2,2261,2024,237
1,15,5,8,2,1784,2813,-1029
1,15,6,8,2,2024,2191,-167
1,15,7,8,2,2813,1506,1307
1,15,8,8,2,2191,1522,669
1,15,9,8,2,1506,1631,-125
1,15,10,8,2,1522,1720,-198
1,15,11,8,2,1631,1383,248
1,15,12,8,2,1720,1448,272
1,15,13,8,2,1383,2148,-765
1,15,14,8,2,1448,2427,-979
1,15,15,8,2,2148,1904,244
1,15,16,8,2,2427,1783,644
1,15,17,8,2,1904,2175,-271
1,15,18,8,2,1783,2131,-348
1,15,19,8,2,2175,1719,456
1,15,20,8,2,2131,1954,177
1,16,0,8,2,1791,1942,-151
1,16,1,8,2,1267,2399,-1132
1,16,2,8,2,1942,1938,4
1,16,3,8,2,2399,1483,916
1,16,4,8,2,1938,1751,187
1,16,5,8,2,1483,2544,-1061
1,16,6,8,2,1751,2094,-343
1,16,7,8,2,2544,1458,1086
1,16,8,8,2,2094,1425,669
1,16,9,8,2,1458,1624,-166
1,16,10,8,2,1425,1745,-320
1,16,11,8,2,1624,1387,237
1,16,12,8,2,1745,1388,357
1,16,13,8,2,1387,1934,-547
1,16,14,8,2,1388,2175,-787
1,16,15,8,2,1934,1595,339
1,16,16,8,2,2175,1425,750
1,16,17,8,2,1595,1927,-332
1,16,18,8,2,1425,1871,-446
1,16,19,8,2,1927,1442,485
1,16,20,8,2,1871,1748,123
1,0,0,9,2,2119,1845,274
1,0,1,9,2,2060,1752,308
1,0,2,9,2,1845,1790,55
1,0,3,9,2,1752,1777,-25
1,0,4,9,2,1790,1718,72
1,0,5,9,2,1777,1658,119
1,0,6,9,2,1718,1623,95
1,0,7,9,2,1658,1602,56
1,0,8,9,2,1623,1582,41
1,0,9,9,2,1602,1586,16
1,0,10,9,2,1582,1597,-15
1,0,11,9,2,1586,1600,-14
1,0,12,9,2,1597,1605,-8
1,0,13,9,2,1600,1650,-50
1,0,14,9,2,1605,1675,-70
1,0,15,9,2,1650,1737,-87
1,0,16,9,2,1675,1831,-156
1,0,17,9,2,1737,1833,-96
1,0,18,9,2,1831,1884,-53
1,0,19,9,2,1833,2000,-167
1,0,20,9,2,1884,2034,-150
1,1,0,9,2,2077,1763,314
1,1,1,9,2,1995,1627,368
1,1,2,9,2,1763,1664,99
1,1,3,9,2,1627,1661,-34
1,1,4,9,2,1664,1619,45
1,1,5,9,2,1661,1579,82
1,1,6,9,2,1619,1521,98
1,1,7,9,2,1579,1467,112
1,1,8,9,2,1521,1443,78
1,1,9,9,2,1467,1457,10
1,1,10,9,2,1443,1459,-16
1,1,11,9,2,1457,1448,9
1,1,12,9,2,1459,1476,-17
1,1,13,9,2,1448,1559,-111
1,1,14,9,2,1476,1600,-124
1,1,15,9,2,1559,1649,-90
1,1,16,9,2,1600,1718,-118
1,1,17,9,2,1649,1725,-76
1,1,18,9,2,1718,1794,-76
1,1,19,9,2,1725,1924,-199
1,1,20,9,2,1794,2002,-208
1,2,0,9,2,2008,1686,322
1,2,1,9,2,1881,1633,248
1,2,2,9,2,1686,1710,-24
1,2,3,9,2,1633,1692,-59
1,2,4,9,2,1710,1690,20
1,2,5,9,2,1692,1663,29
1,2,6,9,2,1690,1577,113
1,2,7,9,2,1663,1517,146
1,2,8,9,2,1577,1487,90
1,2,9,9,2,1517,1495,22
1,2,10,9,2,1487,1509,-22
1,2,11,9,2,1495,1495,0
1,2,12,9,2,1509,1517,-8
1,2,13,9,2,1495,1611,-116
1,2,14,9,2,1517,1672,-155
1,2,15,9,2,1611,1699,-88
1,2,16,9,2,1672,1744,-72
1,2,17,9,2,1699,1757,-58
1,2,18,9,2,1744,1779,-35
1,2,19,9,2,1757,1880,-123
1,2,20,9,2,1779,1991,-212
1,3,0,9,2,2026,1680,346
1,3,1,9,2,1844,1792,52
1,3,2,9,2,1680,1920,-240
1,3,3,9,2,1792,1874,-82
1,3,4,9,2,1920,1917,3
1,3,5,9,2,1874,1876,-2
1,3,6,9,2,1917,1743,174
1,3,7,9,2,1876,1667,209
1,3,8,9,2,1743,1643,100
1,3,9,9,2,1667,1651,16
1,3,10,9,2,1643,1686,-43
1,3,11,9,2,1651,1661,-10
1,3,12,9,2,1686,1669,17
1,3,13,9,2,1661,1814,-153
1,3,14,9,2,1669,1924,-255
1,3,15,9,2,1814,1901,-87
1,3,16,9,2,1924,1923,1
1,3,17,9,2,1901,1971,-70
1,3,18,9,2,1923,1948,-25
1,3,19,9,2,1971,1997,-26
1,3,20,9,2,1948,2077,-129
1,4,0,9,2,2095,1695,400
1,4,1,9,2,1868,1938,-70
1,4,2,9,2,1695,2131,-436
1,4,3,9,2,1938,2061,-123
1,4,4,9,2,2131,2127,4
1,4,5,9,2,2061,2145,-84
1,4,6,9,2,2127,1945,182
1,4,7,9,2,2145,1757,388
1,4,8,9,2,1945,1743,202
1,4,9,9,2,1757,1772,-15
1,4,10,9,2,1743,1803,-60
1,4,11,9,2,1772,1747,25
1,4,12,9,2,1803,1799,4
1,4,13,9,2,1747,2067,-320
1,4,14,9,2,1799,2224,-425
1,4,15,9,2,2067,2123,-56
1,4,16,9,2,2224,2107,117
1,4,17,9,2,2123,2183,-60
1,4,18,9,2,2107,2152,-45
1,4,19,9,2,2183,2178,5
1,4,20,9,2,2152,2185,-33
1,5,0,9,2,2167,1699,468
1,5,1,9,2,1904,2007,-103
1,5,2,9,2,1699,2325,-626
1,5,3,9,2,2007,2270,-263
1,5,4,9,2,2325,2360,-35
1,5,5,9,2,2270,2497,-227
1,5,6,9,2,2360,2189,171
1,5,7,9,2,2497,1864,633
1,5,8,9,2,2189,1849,340
1,5,9,9,2,1864,1886,-22
1,5,10,9,2,1849,1920,-71
1,5,11,9,2,1886,1842,44
1,5,12,9,2,1920,1952,-32
1,5,13,9,2,1842,2366,-524
1,5,14,9,2,1952,2556,-604
1,5,15,9,2,2366,2377,-11
1,5,16,9,2,2556,2309,247
1,5,17,9,2,2377,2335,42
1,5,18,9,2,2309,2292,17
1,5,19,9,2,2335,2340,-5
1,5,20,9,2,2292,2293,-1
1,6,0,9,2,2252,1697,555
1,6,1,9,2,1946,2061,-115
1,6,2,9,2,1697,2521,-824
1,6,3,9,2,2061,2489,-428
1,6,4,9,2,2521,2626,-105
1,6,5,9,2,2489,2856,-367
1,6,6,9,2,2626,2388,238
1,6,7,9,2,2856,1956,900
1,6,8,9,2,2388,1937,451
1,6,9,9,2,1956,1958,-2
1,6,10,9,2,1937,2011,-74
1,6,11,9,2,1958,1928,30
1,6,12,9,2,2011,2080,-69
1,6,13,9,2,1928,2641,-713
1,6,14,9,2,2080,2864,-784
1,6,15,9,2,2641,2648,-7
1,6,16,9,2,2864,2564,300
1,6,17,9,2,2648,2478,170
1,6,18,9,2,2564,2405,159
1,6,19,9,2,2478,2499,-21
1,6,20,9,2,2405,2422,-17
1,7,0,9,2,2323,1725,598
1,7,1,9,2,1989,2211,-222
1,7,2,9,2,1725,2809,-1084
1,7,3,9,2,2211,2754,-543
1,7,4,9,2,2809,2902,-93
1,7,5,9,2,2754,3204,-450
1,7,6,9,2,2902,2571,331
1,7,7,9,2,3204,2019,1185
1,7,8,9,2,2571,2011,560
1,7,9,9,2,2019,2019,0
1,7,10,9,2,2011,2070,-59
1,7,11,9,2,2019,1969,50
1,7,12,9,2,2070,2190,-120
1,7,13,9,2,1969,2911,-942
1,7,14,9,2,2190,3147,-957
1,7,15,9,2,2911,2929,-18
1,7,16,9,2,3147,2876,271
1,7,17,9,2,2929,2666,263
1,7,18,9,2,2876,2548,328
1,7,19,9,2,2666,2660,6
1,7,20,9,2,2548,2518,30
1,8,0,9,2,2290,1780,510
1,8,1,9,2,1963,2460,-497
1,8,2,9,2,1780,3180,-1400
1,8,3,9,2,2460,2994,-534
1,8,4,9,2,3180,3093,87
1,8,5,9,2,2994,3491,-497
1,8,6,9,2,3093,2726,367
1,8,7,9,2,3491,2050,1441
1,8,8,9,2,2726,2026,700
1,8,9,9,2,2050,2042,8
1,8,10,9,2,2026,2112,-86
1,8,11,9,2,2042,1984,58
1,8,12,9,2,2112,2269,-157
1,8,13,9,2,1984,3144,-1160
1,8,14,9,2,2269,3388,-1119
1,8,15,9,2,3144,3125,19
1,8,16,9,2,3388,3126,262
1,8,17,9,2,3125,2890,235
1,8,18,9,2,3126,2716,410
1,8,19,9,2,2890,2751,139
1,8,20,9,2,2716,2540,176
1,9,0,9,2,2206,1790,416
1,9,1,9,2,1839,2672,-833
1,9,2,9,2,1790,3421,-1631
1,9,3,9,2,2672,3068,-396
1,9,4,9,2,3421,3180,241
1,9,5,9,2,3068,3670,-602
1,9,6,9,2,3180,2731,449
1,9,7,9,2,3670,1966,1704
1,9,8,9,2,2731,1936,795
1,9,9,9,2,1966,1909,57
1,9,10,9,2,1936,1986,-50
1,9,11,9,2,1909,1844,65
1,9,12,9,2,1986,2194,-208
1,9,13,9,2,1844,3254,-1410
1,9,14,9,2,2194,3526,-1332
1,9,15,9,2,3254,3101,153
1,9,16,9,2,3526,3139,387
1,9,17,9,2,3101,3032,69
1,9,18,9,2,3139,2829,310
1,9,19,9,2,3032,2764,268
1,9,20,9,2,2829,2539,290
1,10,0,9,2,2245,1938,307
1,10,1,9,2,1869,3010,-1141
1,10,2,9,2,1938,3742,-1804
1,10,3,9,2,3010,3217,-207
1,10,4,9,2,3742,3266,476
1,10,5,9,2,3217,3779,-562
1,10,6,9,2,3266,2811,455
1,10,7,9,2,3779,2044,1735
1,10,8,9,2,2811,2030,781
1,10,9,9,2,2044,2025,19
1,10,10,9,2,2030,2101,-71
1,10,11,9,2,2025,1967,58
1,10,12,9,2,2101,2299,-198
1,10,13,9,2,1967,3291,-1324
1,10,14,9,2,2299,3626,-1327
1,10,15,9,2,3291,3208,83
1,10,16,9,2,3626,3232,394
1,10,17,9,2,3208,3259,-51
1,10,18,9,2,3232,3082,150
1,10,19,9,2,3259,2873,386
1,10,20,9,2,3082,2562,520
1,11,0,9,2,2377,2140,237
1,11,1,9,2,1959,3150,-1191
1,11,2,9,2,2140,3686,-1546
1,11,3,9,2,3150,3128,22
1,11,4,9,2,3686,3157,529
1,11,5,9,2,3128,3766,-638
1,11,6,9,2,3157,2851,306
1,11,7,9,2,3766,2065,1701
1,11,8,9,2,2851,2068,783
1,11,9,9,2,2065,2070,-5
1,11,10,9,2,2068,2159,-91
1,11,11,9,2,2070,1978,92
1,11,12,9,2,2159,2221,-62
1,11,13,9,2,1978,3270,-1292
1,11,14,9,2,2221,3728,-1507
1,11,15,9,2,3270,3224,46
1,11,16,9,2,3728,3132,596
1,11,17,9,2,3224,3264,-40
1,11,18,9,2,3132,3141,-9
1,11,19,9,2,3264,2845,419
1,11,20,9,2,3141,2632,509
1,12,0,9,2,2404,2225,179
1,12,1,9,2,1913,3101,-1188
1,12,2,9,2,2225,3398,-1173
1,12,3,9,2,3101,2846,255
1,12,4,9,2,3398,2956,442
1,12,5,9,2,2846,3743,-897
1,12,6,9,2,2956,2833,123
1,12,7,9,2,3743,1978,1765
1,12,8,9,2,2833,1969,864
1,12,9,9,2,1978,1973,5
1,12,10,9,2,1969,2066,-97
1,12,11,9,2,1973,1824,149
1,12,12,9,2,2066,2007,59
1,12,13,9,2,1824,3052,-1228
1,12,14,9,2,2007,3508,-1501
1,12,15,9,2,3052,2972,80
1,12,16,9,2,3508,2862,646
1,12,17,9,2,2972,3080,-108
1,12,18,9,2,2862,2967,-105
1,12,19,9,2,3080,2603,477
1,12,20,9,2,2967,2591,376
1,13,0,9,2,2381,2319,62
1,13,1,9,2,1823,3035,-1212
1,13,2,9,2,2319,3054,-735
1,13,3,9,2,3035,2522,513
1,13,4,9,2,3054,2661,393
1,13,5,9,2,2522,3516,-994
1,13,6,9,2,2661,2676,-15
1,13,7,9,2,3516,1820,1696
1,13,8,9,2,2676,1810,866
1,13,9,9,2,1820,1859,-39
1,13,10,9,2,1810,1948,-138
1,13,11,9,2,1859,1670,189
1,13,12,9,2,1948,1824,124
1,13,13,9,2,1670,2740,-1070
1,13,14,9,2,1824,3132,-1308
1,13,15,9,2,2740,2659,81
1,13,16,9,2,3132,2579,553
1,13,17,9,2,2659,2825,-166
1,13,18,9,2,2579,2742,-163
1,13,19,9,2,2825,2392,433
1,13,20,9,2,2742,2530,212
1,14,0,9,2,2247,2282,-35
1,14,1,9,2,1704,2885,-1181
1,14,2,9,2,2282,2691,-409
1,14,3,9,2,2885,2181,704
1,14,4,9,2,2691,2398,293
1,14,5,9,2,2181,3280,-1099
1,14,6,9,2,2398,2527,-129
1,14,7,9,2,3280,1733,1547
1,14,8,9,2,2527,1742,785
1,14,9,9,2,1733,1833,-100
1,14,10,9,2,1742,1941,-199
1,14,11,9,2,1833,1599,234
1,14,12,9,2,1941,1707,234
1,14,13,9,2,1599,2544,-945
1,14,14,9,2,1707,2848,-1141
1,14,15,9,2,2544,2314,230
1,14,16,9,2,2848,2226,622
1,14,17,9,2,2314,2541,-227
1,14,18,9,2,2226,2479,-253
1,14,19,9,2,2541,2115,426
1,14,20,9,2,2479,2309,170
1,15,0,9,2,2106,2168,-62
1,15,1,9,2,1543,2725,-1182
1,15,2,9,2,2168,2395,-227
1,15,3,9,2,2725,1897,828
1,15,4,9,2,2395,2152,243
1,15,5,9,2,1897,3019,-1122
1,15,6,9,2,2152,2415,-263
1,15,7,9,2,3019,1659,1360
1,15,8,9,2,2415,1637,778
1,15,9,9,2,1659,1823,-164
1,15,10,9,2,1637,1942,-305
1,15,11,9,2,1823,1565,258
1,15,12,9,2,1942,1634,308
1,15,13,9,2,1565,2349,-784
1,15,14,9,2,1634,2601,-967
1,15,15,9,2,2349,2013,336
1,15,16,9,2,2601,1895,706
1,15,17,9,2,2013,2299,-286
1,15,18,9,2,1895,2218,-323
1,15,19,9,2,2299,1826,473
1,15,20,9,2,2218,2075,143
1,0,0,10,2,2294,1957,337
1,0,1,10,2,2198,1836,362
1,0,2,10,2,1957,1886,71
1,0,3,10,2,1836,1876,-40
1,0,4,10,2,1886,1829,57
1,0,5,10,2,1876,1789,87
1,0,6,10,2,1829,1728,101
1,0,7,10,2,1789,1672,117
1,0,8,10,2,1728,1647,81
1,0,9,10,2,1672,1661,11
1,0,10,10,2,1647,1664,-17
1,0,11,10,2,1661,1655,6
1,0,12,10,2,1664,1685,-21
1,0,13,10,2,1655,1762,-107
1,0,14,10,2,1685,1800,-115
1,0,15,10,2,1762,1861,-99
1,0,16,10,2,1800,1936,-136
1,0,17,10,2,1861,1931,-70
1,0,18,10,2,1936,1995,-59
1,0,19,10,2,1931,2136,-205
1,0,20,10,2,1995,2213,-218
1,1,0,10,2,2225,1899,326
1,1,1,10,2,2099,1851,248
1,1,2,10,2,1899,1930,-31
1,1,3,10,2,1851,1902,-51
1,1,4,10,2,1930,1899,31
1,1,5,10,2,1902,1878,24
1,1,6,10,2,1899,1791,108
1,1,7,10,2,1878,1727,151
1,1,8,10,2,1791,1694,97
1,1,9,10,2,1727,1701,26
1,1,10,10,2,1694,1716,-22
1,1,11,10,2,1701,1704,-3
1,1,12,10,2,1716,1729,-13
1,1,13,10,2,1704,1833,-129
1,1,14,10,2,1729,1894,-165
1,1,15,10,2,1833,1910,-77
1,1,16,10,2,1894,1950,-56
1,1,17,10,2,1910,1960,-50
1,1,18,10,2,1950,1991,-41
1,1,19,10,2,1960,2105,-145
1,1,20,10,2,1991,2207,-216
1,2,0,10,2,2247,1899,348
1,2,1,10,2,2071,2009,62
1,2,2,10,2,1899,2138,-239
1,2,3,10,2,2009,2090,-81
1,2,4,10,2,2138,2143,-5
1,2,5,10,2,2090,2109,-19
1,2,6,10,2,2143,1971,172
1,2,7,10,2,2109,1889,220
1,2,8,10,2,1971,1859,112
1,2,9,10,2,1889,1864,25
1,2,10,10,2,1859,1900,-41
1,2,11,10,2,1864,1879,-15
1,2,12,10,2,1900,1890,10
1,2,13,10,2,1879,2042,-163
1,2,14,10,2,1890,2150,-260
1,2,15,10,2,2042,2119,-77
1,2,16,10,2,2150,2139,11
1,2,17,10,2,2119,2181,-62
1,2,18,10,2,2139,2161,-22
1,2,19,10,2,2181,2222,-41
1,2,20,10,2,2161,2298,-137
1,3,0,10,2,2324,1910,414
1,3,1,10,2,2095,2155,-60
1,3,2,10,2,1910,2358,-448
1,3,3,10,2,2155,2288,-133
1,3,4,10,2,2358,2354,4
1,3,5,10,2,2288,2332,-44
1,3,6,10,2,2354,2086,268
1,3,7,10,2,2332,1892,440
1,3,8,10,2,2086,1872,214
1,3,9,10,2,1892,1897,-5
1,3,10,10,2,1872,1928,-56
1,3,11,10,2,1897,1875,22
1,3,12,10,2,1928,1931,-3
1,3,13,10,2,1875,2224,-349
1,3,14,10,2,1931,2413,-482
1,3,15,10,2,2224,2339,-115
1,3,16,10,2,2413,2345,68
1,3,17,10,2,2339,2411,-72
1,3,18,10,2,2345,2363,-18
1,3,19,10,2,2411,2393,18
1,3,20,10,2,2363,2407,-44
1,4,0,10,2,2400,1928,472
1,4,1,10,2,2137,2248,-111
1,4,2,10,2,1928,2571,-643
1,4,3,10,2,2248,2484,-236
1,4,4,10,2,2571,2530,41
1,4,5,10,2,2484,2627,-143
1,4,6,10,2,2530,2294,236
1,4,7,10,2,2627,1963,664
1,4,8,10,2,2294,1942,352
1,4,9,10,2,1963,1975,-12
1,4,10,10,2,1942,2009,-67
1,4,11,10,2,1975,1934,41
1,4,12,10,2,2009,2047,-38
1,4,13,10,2,1934,2473,-539
1,4,14,10,2,2047,2690,-643
1,4,15,10,2,2473,2558,-85
1,4,16,10,2,2690,2538,152
1,4,17,10,2,2558,2573,-15
1,4,18,10,2,2538,2517,21
1,4,19,10,2,2573,2563,10
1,4,20,10,2,2517,2516,1
1,5,0,10,2,2488,1936,552
1,5,1,10,2,2188,2305,-117
1,5,2,10,2,1936,2755,-819
1,5,3,10,2,2305,2667,-362
1,5,4,10,2,2755,2734,21
1,5,5,10,2,2667,2964,-297
1,5,6,10,2,2734,2525,209
1,5,7,10,2,2964,2091,873
1,5,8,10,2,2525,2069,456
1,5,9,10,2,2091,2088,3
1,5,10,10,2,2069,2141,-72
1,5,11,10,2,2088,2058,30
1,5,12,10,2,2141,2211,-70
1,5,13,10,2,2058,2762,-704
1,5,14,10,2,2211,2977,-766
1,5,15,10,2,2762,2787,-25
1,5,16,10,2,2977,2752,225
1,5,17,10,2,2787,2701,86
1,5,18,10,2,2752,2640,112
1,5,19,10,2,2701,2736,-35
1,5,20,10,2,2640,2648,-8
1,6,0,10,2,2567,1923,644
1,6,1,10,2,2222,2387,-165
1,6,2,10,2,1923,2978,-1055
1,6,3,10,2,2387,2903,-516
1,6,4,10,2,2978,3027,-49
1,6,5,10,2,2903,3331,-428
1,6,6,10,2,3027,2709,318
1,6,7,10,2,3331,2157,1174
1,6,8,10,2,2709,2149,560
1,6,9,10,2,2157,2157,0
1,6,10,10,2,2149,2208,-59
1,6,11,10,2,2157,2106,51
1,6,12,10,2,2208,2326,-118
1,6,13,10,2,2106,3056,-950
1,6,14,10,2,2326,3290,-964
1,6,15,10,2,3056,3066,-10
1,6,16,10,2,3290,3034,256
1,6,17,10,2,3066,2850,216
1,6,18,10,2,3034,2752,282
1,6,19,10,2,2850,2883,-33
1,6,20,10,2,2752,2749,3
1,7,0,10,2,2545,1919,626
1,7,1,10,2,2178,2549,-371
1,7,2,10,2,1919,3277,-1358
1,7,3,10,2,2549,3133,-584
1,7,4,10,2,3277,3280,-3
1,7,5,10,2,3133,3691,-558
1,7,6,10,2,3280,2917,363
1,7,7,10,2,3691,2243,1448
1,7,8,10,2,2917,2222,695
1,7,9,10,2,2243,2240,3
1,7,10,10,2,2222,2309,-87
1,7,11,10,2,2240,2179,61
1,7,12,10,2,2309,2462,-153
1,7,13,10,2,2179,3339,-1160
1,7,14,10,2,2462,3571,-1109
1,7,15,10,2,3339,3288,51
1,7,16,10,2,3571,3282,289
1,7,17,10,2,3288,3039,249
1,7,18,10,2,3282,2872,410
1,7,19,10,2,3039,2945,94
1,7,20,10,2,2872,2775,97
1,8,0,10,2,2473,1989,484
1,8,1,10,2,2101,2813,-712
1,8,2,10,2,1989,3578,-1589
1,8,3,10,2,2813,3297,-484
1,8,4,10,2,3578,3436,142
1,8,5,10,2,3297,3918,-621
1,8,6,10,2,3436,2993,443
1,8,7,10,2,3918,2231,1687
1,8,8,10,2,2993,2203,790
1,8,9,10,2,2231,2192,39
1,8,10,10,2,2203,2278,-75
1,8,11,10,2,2192,2128,64
1,8,12,10,2,2278,2470,-192
1,8,13,10,2,2128,3526,-1398
1,8,14,10,2,2470,3791,-1321
1,8,15,10,2,3526,3361,165
1,8,16,10,2,3791,3361,430
1,8,17,10,2,3361,3224,137
1,8,18,10,2,3361,3056,305
1,8,19,10,2,3224,3010,214
1,8,20,10,2,3056,2788,268
1,9,0,10,2,2420,2050,370
1,9,1,10,2,2007,3094,-1087
1,9,2,10,2,2050,3838,-1788
1,9,3,10,2,3094,3316,-222
1,9,4,10,2,3838,3377,461
1,9,5,10,2,3316,3910,-594
1,9,6,10,2,3377,2916,461
1,9,7,10,2,3910,2114,1796
1,9,8,10,2,2916,2095,821
1,9,9,10,2,2114,2100,14
1,9,10,10,2,2095,2168,-73
1,9,11,10,2,2100,2022,78
1,9,12,10,2,2168,2379,-211
1,9,13,10,2,2022,3403,-1381
1,9,14,10,2,2379,3751,-1372
1,9,15,10,2,3403,3332,71
1,9,16,10,2,3751,3337,414
1,9,17,10,2,3332,3357,-25
1,9,18,10,2,3337,3193,144
1,9,19,10,2,3357,3009,348
1,9,20,10,2,3193,2741,452
1,10,0,10,2,2525,2276,249
1,10,1,10,2,2063,3374,-1311
1,10,2,10,2,2276,3952,-1676
1,10,3,10,2,3374,3369,5
1,10,4,10,2,3952,3437,515
1,10,5,10,2,3369,4065,-696
1,10,6,10,2,3437,3121,316
1,10,7,10,2,4065,2325,1740
1,10,8,10,2,3121,2319,802
1,10,9,10,2,2325,2314,11
1,10,10,10,2,2319,2416,-97
1,10,11,10,2,2314,2234,80
1,10,12,10,2,2416,2474,-58
1,10,13,10,2,2234,3544,-1310
1,10,14,10,2,2474,4022,-1548
1,10,15,10,2,3544,3485,59
1,10,16,10,2,4022,3364,658
1,10,17,10,2,3485,3499,-14
1,10,18,10,2,3364,3338,26
1,10,19,10,2,3499,3026,473
1,10,20,10,2,3338,2837,501
1,11,0,10,2,2643,2438,205
1,11,1,10,2,2103,3477,-1374
1,11,2,10,2,2438,3826,-1388
1,11,3,10,2,3477,3244,233
1,11,4,10,2,3826,3409,417
1,11,5,10,2,3244,4189,-945
1,11,6,10,2,3409,3227,182
1,11,7,10,2,4189,2350,1839
1,11,8,10,2,3227,2341,886
1,11,9,10,2,2350,2342,8
1,11,10,10,2,2341,2457,-116
1,11,11,10,2,2342,2208,134
1,11,12,10,2,2457,2380,77
1,11,13,10,2,2208,3483,-1275
1,11,14,10,2,2380,3986,-1606
1,11,15,10,2,3483,3392,91
1,11,16,10,2,3986,3257,729
1,11,17,10,2,3392,3504,-112
1,11,18,10,2,3257,3349,-92
1,11,19,10,2,3504,2945,559
1,11,20,10,2,3349,2898,451
1,12,0,10,2,2679,2549,130
1,12,1,10,2,2074,3398,-1324
1,12,2,10,2,2549,3492,-943
1,12,3,10,2,3398,2936,462
1,12,4,10,2,3492,3098,394
1,12,5,10,2,2936,3972,-1036
1,12,6,10,2,3098,3019,79
1,12,7,10,2,3972,2045,1927
1,12,8,10,2,3019,2039,980
1,12,9,10,2,2045,2105,-60
1,12,10,10,2,2039,2190,-151
1,12,11,10,2,2105,1884,221
1,12,12,10,2,2190,2086,104
1,12,13,10,2,1884,3150,-1266
1,12,14,10,2,2086,3621,-1535
1,12,15,10,2,3150,3097,53
1,12,16,10,2,3621,3001,620
1,12,17,10,2,3097,3265,-168
1,12,18,10,2,3001,3157,-156
1,12,19,10,2,3265,2788,477
1,12,20,10,2,3157,2860,297
1,13,0,10,2,2552,2515,37
1,13,1,10,2,1973,3195,-1222
1,13,2,10,2,2515,3131,-616
1,13,3,10,2,3195,2604,591
1,13,4,10,2,3131,2801,330
1,13,5,10,2,2604,3762,-1158
1,13,6,10,2,2801,2876,-75
1,13,7,10,2,3762,1939,1823
1,13,8,10,2,2876,1941,935
1,13,9,10,2,1939,2036,-97
1,13,10,10,2,1941,2147,-206
1,13,11,10,2,2036,1786,250
1,13,12,10,2,2147,1955,192
1,13,13,10,2,1786,2950,-1164
1,13,14,10,2,1955,3314,-1359
1,13,15,10,2,2950,2749,201
1,13,16,10,2,3314,2657,657
1,13,17,10,2,2749,2931,-182
1,13,18,10,2,2657,2844,-187
1,13,19,10,2,2931,2500,431
1,13,20,10,2,2844,2640,204
1,14,0,10,2,2427,2405,22
1,14,1,10,2,1827,3023,-1196
1,14,2,10,2,2405,2825,-420
1,14,3,10,2,3023,2294,729
1,14,4,10,2,2825,2526,299
1,14,5,10,2,2294,3486,-1192
1,14,6,10,2,2526,2751,-225
1,14,7,10,2,3486,1886,1600
1,14,8,10,2,2751,1857,894
1,14,9,10,2,1886,2025,-139
1,14,10,10,2,1857,2163,-306
1,14,11,10,2,2025,1781,244
1,14,12,10,2,2163,1893,270
1,14,13,10,2,1781,2745,-964
1,14,14,10,2,1893,3022,-1129
1,14,15,10,2,2745,2423,322
1,14,16,10,2,3022,2338,684
1,14,17,10,2,2423,2665,-242
1,14,18,10,2,2338,2566,-228
1,14,19,10,2,2665,2222,443
1,14,20,10,2,2566,2430,136
1,0,0,11,2,2442,2093,349
1,0,1,11,2,2302,2060,242
1,0,2,11,2,2093,2152,-59
1,0,3,11,2,2060,2117,-57
1,0,4,11,2,2152,2109,43
1,0,5,11,2,2117,2088,29
1,0,6,11,2,2109,1998,111
1,0,7,11,2,2088,1932,156
1,0,8,11,2,1998,1898,100
1,0,9,11,2,1932,1905,27
1,0,10,11,2,1898,1921,-23
1,0,11,11,2,1905,1911,-6
1,0,12,11,2,1921,1938,-17
1,0,13,11,2,1911,2036,-125
1,0,14,11,2,1938,2094,-156
1,0,15,11,2,2036,2122,-86
1,0,16,11,2,2094,2168,-74
1,0,17,11,2,2122,2166,-44
1,0,18,11,2,2168,2192,-24
1,0,19,11,2,2166,2317,-151
1,0,20,11,2,2192,2418,-226
1,1,0,11,2,2464,2112,352
1,1,1,11,2,2289,2227,62
1,1,2,11,2,2112,2358,-246
1,1,3,11,2,2227,2300,-73
1,1,4,11,2,2358,2352,6
1,1,5,11,2,2300,2324,-24
1,1,6,11,2,2352,2185,167
1,1,7,11,2,2324,2099,225
1,1,8,11,2,2185,2066,119
1,1,9,11,2,2099,2070,29
1,1,10,11,2,2066,2107,-41
1,1,11,11,2,2070,2088,-18
1,1,12,11,2,2107,2102,5
1,1,13,11,2,2088,2264,-176
1,1,14,11,2,2102,2372,-270
1,1,15,11,2,2264,2330,-66
1,1,16,11,2,2372,2345,27
1,1,17,11,2,2330,2384,-54
1,1,18,11,2,2345,2373,-28
1,1,19,11,2,2384,2447,-63
1,1,20,11,2,2373,2514,-141
1,2,0,11,2,2545,2129,416
1,2,1,11,2,2322,2372,-50
1,2,2,11,2,2129,2576,-447
1,2,3,11,2,2372,2504,-132
1,2,4,11,2,2576,2580,-4
1,2,5,11,2,2504,2565,-61
1,2,6,11,2,2580,2314,266
1,2,7,11,2,2565,2114,451
1,2,8,11,2,2314,2088,226
1,2,9,11,2,2114,2110,4
1,2,10,11,2,2088,2142,-54
1,2,11,11,2,2110,2093,17
1,2,12,11,2,2142,2152,-10
1,2,13,11,2,2093,2452,-359
1,2,14,11,2,2152,2639,-487
1,2,15,11,2,2452,2557,-105
1,2,16,11,2,2639,2561,78
1,2,17,11,2,2557,2621,-64
1,2,18,11,2,2561,2576,-15
1,2,19,11,2,2621,2618,3
1,2,20,11,2,2576,2628,-52
1,3,0,11,2,2629,2143,486
1,3,1,11,2,2364,2465,-101
1,3,2,11,2,2143,2798,-655
1,3,3,11,2,2465,2711,-246
1,3,4,11,2,2798,2757,41
1,3,5,11,2,2711,2814,-103
1,3,6,11,2,2757,2435,322
1,3,7,11,2,2814,2098,716
1,3,8,11,2,2435,2071,364
1,3,9,11,2,2098,2100,-2
1,3,10,11,2,2071,2134,-63
1,3,11,11,2,2100,2062,38
1,3,12,11,2,2134,2179,-45
1,3,13,11,2,2062,2630,-568
1,3,14,11,2,2179,2879,-700
1,3,15,11,2,2630,2774,-144
1,3,16,11,2,2879,2776,103
1,3,17,11,2,2774,2801,-27
1,3,18,11,2,2776,2728,48
1,3,19,11,2,2801,2778,23
1,3,20,11,2,2728,2738,-10
1,4,0,11,2,2721,2165,556
1,4,1,11,2,2421,2546,-125
1,4,2,11,2,2165,3001,-836
1,4,3,11,2,2546,2881,-335
1,4,4,11,2,3001,2904,97
1,4,5,11,2,2881,3094,-213
1,4,6,11,2,2904,2630,274
1,4,7,11,2,3094,2190,904
1,4,8,11,2,2630,2162,468
1,4,9,11,2,2190,2177,13
1,4,10,11,2,2162,2230,-68
1,4,11,11,2,2177,2150,27
1,4,12,11,2,2230,2306,-76
1,4,13,11,2,2150,2869,-719
1,4,14,11,2,2306,3111,-805
1,4,15,11,2,2869,2968,-99
1,4,16,11,2,3111,2981,130
1,4,17,11,2,2968,2939,29
1,4,18,11,2,2981,2865,116
1,4,19,11,2,2939,2959,-20
1,4,20,11,2,2865,2871,-6
1,5,0,11,2,2803,2162,641
1,5,1,11,2,2464,2631,-167
1,5,2,11,2,2162,3212,-1050
1,5,3,11,2,2631,3081,-450
1,5,4,11,2,3212,3135,77
1,5,5,11,2,3081,3439,-358
1,5,6,11,2,3135,2846,289
1,5,7,11,2,3439,2292,1147
1,5,8,11,2,2846,2281,565
1,5,9,11,2,2292,2287,5
1,5,10,11,2,2281,2338,-57
1,5,11,11,2,2287,2236,51
1,5,12,11,2,2338,2457,-119
1,5,13,11,2,2236,3177,-941
1,5,14,11,2,2457,3403,-946
1,5,15,11,2,3177,3205,-28
1,5,16,11,2,3403,3222,181
1,5,17,11,2,3205,3073,132
1,5,18,11,2,3222,2987,235
1,5,19,11,2,3073,3120,-47
1,5,20,11,2,2987,2975,12
1,6,0,11,2,2789,2117,672
1,6,1,11,2,2411,2725,-314
1,6,2,11,2,2117,3446,-1329
1,6,3,11,2,2725,3282,-557
1,6,4,11,2,3446,3405,41
1,6,5,11,2,3282,3818,-536
1,6,6,11,2,3405,3055,350
1,6,7,11,2,3818,2381,1437
1,6,8,11,2,3055,2360,695
1,6,9,11,2,2381,2378,3
1,6,10,11,2,2360,2447,-87
1,6,11,11,2,2378,2316,62
1,6,12,11,2,2447,2598,-151
1,6,13,11,2,2316,3484,-1168
1,6,14,11,2,2598,3714,-1116
1,6,15,11,2,3484,3425,59
1,6,16,11,2,3714,3440,274
1,6,17,11,2,3425,3223,202
1,6,18,11,2,3440,3076,364
1,6,19,11,2,3223,3168,55
1,6,20,11,2,3076,3006,70
1,7,0,11,2,2728,2128,600
1,7,1,11,2,2316,2902,-586
1,7,2,11,2,2128,3675,-1547
1,7,3,11,2,2902,3436,-534
1,7,4,11,2,3675,3623,52
1,7,5,11,2,3436,4118,-682
1,7,6,11,2,3623,3184,439
1,7,7,11,2,4118,2424,1694
1,7,8,11,2,3184,2399,785
1,7,9,11,2,2424,2390,34
1,7,10,11,2,2399,2475,-76
1,7,11,11,2,2390,2323,67
1,7,12,11,2,2475,2663,-188
1,7,13,11,2,2323,3721,-1398
1,7,14,11,2,2663,3974,-1311
1,7,15,11,2,3721,3524,197
1,7,16,11,2,3974,3517,457
1,7,17,11,2,3524,3373,151
1,7,18,11,2,3517,3212,305
1,7,19,11,2,3373,3204,169
1,7,20,11,2,3212,3023,189
1,8,0,11,2,2687,2249,438
1,8,1,11,2,2269,3235,-966
1,8,2,11,2,2249,3995,-1746
1,8,3,11,2,3235,3545,-310
1,8,4,11,2,3995,3633,362
1,8,5,11,2,3545,4158,-613
1,8,6,11,2,3633,3178,455
1,8,7,11,2,4158,2379,1779
1,8,8,11,2,3178,2362,816
1,8,9,11,2,2379,2383,-4
1,8,10,11,2,2362,2460,-98
1,8,11,11,2,2383,2306,77
1,8,12,11,2,2460,2655,-195
1,8,13,11,2,2306,3675,-1369
1,8,14,11,2,2655,4016,-1361
1,8,15,11,2,3675,3592,83
1,8,16,11,2,4016,3559,457
1,8,17,11,2,3592,3549,43
1,8,18,11,2,3559,3420,139
1,8,19,11,2,3549,3255,294
1,8,20,11,2,3420,2990,430
1,9,0,11,2,2700,2388,312
1,9,1,11,2,2201,3458,-1257
1,9,2,11,2,2388,4048,-1660
1,9,3,11,2,3458,3468,-10
1,9,4,11,2,4048,3548,500
1,9,5,11,2,3468,4196,-728
1,9,6,11,2,3548,3226,322
1,9,7,11,2,4196,2395,1801
1,9,8,11,2,3226,2384,842
1,9,9,11,2,2395,2389,6
1,9,10,11,2,2384,2483,-99
1,9,11,11,2,2389,2289,100
1,9,12,11,2,2483,2554,-71
1,9,13,11,2,2289,3656,-1367
1,9,14,11,2,2554,4147,-1593
1,9,15,11,2,3656,3609,47
1,9,16,11,2,4147,3469,678
1,9,17,11,2,3609,3597,12
1,9,18,11,2,3469,3449,20
1,9,19,11,2,3597,3162,435
1,9,20,11,2,3449,3016,433
1,10,0,11,2,2791,2574,217
1,10,1,11,2,2207,3701,-1494
1,10,2,11,2,2574,4092,-1518
1,10,3,11,2,3701,3485,216
1,10,4,11,2,4092,3689,403
1,10,5,11,2,3485,4488,-1003
1,10,6,11,2,3689,3497,192
1,10,7,11,2,4488,2610,1878
1,10,8,11,2,3497,2592,905
1,10,9,11,2,2610,2586,24
1,10,10,11,2,2592,2714,-122
1,10,11,11,2,2586,2464,122
1,10,12,11,2,2714,2633,81
1,10,13,11,2,2464,3757,-1293
1,10,14,11,2,2633,4280,-1647
1,10,15,11,2,3757,3653,104
1,10,16,11,2,4280,3489,791
1,10,17,11,2,3653,3739,-86
1,10,18,11,2,3489,3546,-57
1,10,19,11,2,3739,3126,613
1,10,20,11,2,3546,3103,443
1,11,0,11,2,2918,2762,156
1,11,1,11,2,2264,3774,-1510
1,11,2,11,2,2762,3920,-1158
1,11,3,11,2,3774,3334,440
1,11,4,11,2,3920,3551,369
1,11,5,11,2,3334,4418,-1084
1,11,6,11,2,3551,3413,138
1,11,7,11,2,4418,2417,2001
1,11,8,11,2,3413,2411,1002
1,11,9,11,2,2417,2474,-57
1,11,10,11,2,2411,2581,-170
1,11,11,11,2,2474,2268,206
1,11,12,11,2,2581,2459,122
1,11,13,11,2,2268,3581,-1313
1,11,14,11,2,2459,4099,-1640
1,11,15,11,2,3581,3517,64
1,11,16,11,2,4099,3396,703
1,11,17,11,2,3517,3689,-172
1,11,18,11,2,3396,3539,-143
1,11,19,11,2,3689,3130,559
1,11,20,11,2,3539,3167,372
1,12,0,11,2,2850,2745,105
1,12,1,11,2,2224,3558,-1334
1,12,2,11,2,2745,3569,-824
1,12,3,11,2,3558,3018,540
1,12,4,11,2,3569,3238,331
1,12,5,11,2,3018,4218,-1200
1,12,6,11,2,3238,3219,19
1,12,7,11,2,4218,2164,2054
1,12,8,11,2,3219,2170,1049
1,12,9,11,2,2164,2282,-118
1,12,10,11,2,2170,2389,-219
1,12,11,11,2,2282,2000,282
1,12,12,11,2,2389,2217,172
1,12,13,11,2,2000,3360,-1360
1,12,14,11,2,2217,3803,-1586
1,12,15,11,2,3360,3187,173
1,12,16,11,2,3803,3079,724
1,12,17,11,2,3187,3371,-184
1,12,18,11,2,3079,3259,-180
1,12,19,11,2,3371,2896,475
1,12,20,11,2,3259,2970,289
1,13,0,11,2,2732,2638,94
1,13,1,11,2,2096,3333,-1237
1,13,2,11,2,2638,3265,-627
1,13,3,11,2,3333,2717,616
1,13,4,11,2,3265,2929,336
1,13,5,11,2,2717,3968,-1251
1,13,6,11,2,2929,3100,-171
1,13,7,11,2,3968,2092,1876
1,13,8,11,2,3100,2056,1044
1,13,9,11,2,2092,2228,-136
1,13,10,11,2,2056,2369,-313
1,13,11,11,2,2228,1968,260
1,13,12,11,2,2369,2141,228
1,13,13,11,2,1968,3151,-1183
1,13,14,11,2,2141,3488,-1347
1,13,15,11,2,3151,2858,293
1,13,16,11,2,3488,2769,719
1,13,17,11,2,2858,3055,-197
1,13,18,11,2,2769,2931,-162
1,13,19,11,2,3055,2607,448
1,13,20,11,2,2931,2761,170
1,0,0,12,2,2681,2306,375
1,0,1,12,2,2492,2436,56
1,0,2,12,2,2306,2580,-274
1,0,3,12,2,2436,2515,-79
1,0,4,12,2,2580,2562,18
1,0,5,12,2,2515,2534,-19
1,0,6,12,2,2562,2392,170
1,0,7,12,2,2534,2304,230
1,0,8,12,2,2392,2270,122
1,0,9,12,2,2304,2274,30
1,0,10,12,2,2270,2312,-42
1,0,11,12,2,2274,2295,-21
1,0,12,12,2,2312,2311,1
1,0,13,12,2,2295,2467,-172
1,0,14,12,2,2311,2572,-261
1,0,15,12,2,2467,2542,-75
1,0,16,12,2,2572,2563,9
1,0,17,12,2,2542,2590,-48
1,0,18,12,2,2563,2574,-11
1,0,19,12,2,2590,2659,-69
1,0,20,12,2,2574,2725,-151
1,1,0,12,2,2762,2342,420
1,1,1,12,2,2540,2590,-50
1,1,2,12,2,2342,2796,-454
1,1,3,12,2,2590,2714,-124
1,1,4,12,2,2796,2789,7
1,1,5,12,2,2714,2780,-66
1,1,6,12,2,2789,2528,261
1,1,7,12,2,2780,2324,456
1,1,8,12,2,2528,2295,233
1,1,9,12,2,2324,2316,8
1,1,10,12,2,2295,2349,-54
1,1,11,12,2,2316,2302,14
1,1,12,12,2,2349,2364,-15
1,1,13,12,2,2302,2674,-372
1,1,14,12,2,2364,2861,-497
1,1,15,12,2,2674,2768,-94
1,1,16,12,2,2861,2767,94
1,1,17,12,2,2768,2824,-56
1,1,18,12,2,2767,2788,-21
1,1,19,12,2,2824,2843,-19
1,1,20,12,2,2788,2844,-56
1,2,0,12,2,2850,2362,488
1,2,1,12,2,2591,2682,-91
1,2,2,12,2,2362,3016,-654
1,2,3,12,2,2682,2927,-245
1,2,4,12,2,3016,2983,33
1,2,5,12,2,2927,3047,-120
1,2,6,12,2,2983,2663,320
1,2,7,12,2,3047,2320,727
1,2,8,12,2,2663,2287,376
1,2,9,12,2,2320,2313,7
1,2,10,12,2,2287,2348,-61
1,2,11,12,2,2313,2280,33
1,2,12,12,2,2348,2400,-52
1,2,13,12,2,2280,2858,-578
1,2,14,12,2,2400,3105,-705
1,2,15,12,2,2858,2992,-134
1,2,16,12,2,3105,2992,113
1,2,17,12,2,2992,3011,-19
1,2,18,12,2,2992,2941,51
1,2,19,12,2,3011,3003,8
1,2,20,12,2,2941,2959,-18
1,3,0,12,2,2950,2380,570
1,3,1,12,2,2648,2763,-115
1,3,2,12,2,2380,3228,-848
1,3,3,12,2,2763,3108,-345
1,3,4,12,2,3228,3131,97
1,3,5,12,2,3108,3281,-173
1,3,6,12,2,3131,2771,360
1,3,7,12,2,3281,2325,956
1,3,8,12,2,2771,2291,480
1,3,9,12,2,2325,2302,23
1,3,10,12,2,2291,2355,-64
1,3,11,12,2,2302,2278,24
1,3,12,12,2,2355,2438,-83
1,3,13,12,2,2278,3026,-748
1,3,14,12,2,2438,3300,-862
1,3,15,12,2,3026,3184,-158
1,3,16,12,2,3300,3219,81
1,3,17,12,2,3184,3167,17
1,3,18,12,2,3219,3076,143
1,3,19,12,2,3167,3174,-7
1,3,20,12,2,3076,3093,-17
1,4,0,12,2,3036,2391,645
1,4,1,12,2,2697,2872,-175
1,4,2,12,2,2391,3458,-1067
1,4,3,12,2,2872,3295,-423
1,4,4,12,2,3458,3305,153
1,4,5,12,2,3295,3569,-274
1,4,6,12,2,3305,2951,354
1,4,7,12,2,3569,2391,1178
1,4,8,12,2,2951,2374,577
1,4,9,12,2,2391,2376,15
1,4,10,12,2,2374,2427,-53
1,4,11,12,2,2376,2328,48
1,4,12,12,2,2427,2552,-125
1,4,13,12,2,2328,3284,-956
1,4,14,12,2,2552,3537,-985
1,4,15,12,2,3284,3386,-102
1,4,16,12,2,3537,3451,86
1,4,17,12,2,3386,3311,75
1,4,18,12,2,3451,3212,239
1,4,19,12,2,3311,3343,-32
1,4,20,12,2,3212,3198,14
1,5,0,12,2,3025,2356,669
1,5,1,12,2,2653,2969,-316
1,5,2,12,2,2356,3680,-1324
1,5,3,12,2,2969,3460,-491
1,5,4,12,2,3680,3513,167
1,5,5,12,2,3460,3926,-466
1,5,6,12,2,3513,3192,321
1,5,7,12,2,3926,2516,1410
1,5,8,12,2,3192,2492,700
1,5,9,12,2,2516,2508,8
1,5,10,12,2,2492,2577,-85
1,5,11,12,2,2508,2446,62
1,5,12,12,2,2577,2729,-152
1,5,13,12,2,2446,3605,-1159
1,5,14,12,2,2729,3827,-1098
1,5,15,12,2,3605,3564,41
1,5,16,12,2,3827,3628,199
1,5,17,12,2,3564,3446,118
1,5,18,12,2,3628,3311,317
1,5,19,12,2,3446,3405,41
1,5,20,12,2,3311,3232,79
1,6,0,12,2,2972,2326,646
1,6,1,12,2,2549,3078,-529
1,6,2,12,2,2326,3844,-1518
1,6,3,12,2,3078,3585,-507
1,6,4,12,2,3844,3748,96
1,6,5,12,2,3585,4245,-660
1,6,6,12,2,3748,3322,426
1,6,7,12,2,4245,2562,1683
1,6,8,12,2,3322,2537,785
1,6,9,12,2,2562,2528,34
1,6,10,12,2,2537,2613,-76
1,6,11,12,2,2528,2460,68
1,6,12,12,2,2613,2799,-186
1,6,13,12,2,2460,3866,-1406
1,6,14,12,2,2799,4117,-1318
1,6,15,12,2,3866,3661,205
1,6,16,12,2,4117,3675,442
1,6,17,12,2,3661,3557,104
1,6,18,12,2,3675,3416,259
1,6,19,12,2,3557,3427,130
1,6,20,12,2,3416,3254,162
1,7,0,12,2,2942,2388,554
1,7,1,12,2,2484,3324,-840
1,7,2,12,2,2388,4092,-1704
1,7,3,12,2,3324,3684,-360
1,7,4,12,2,4092,3820,272
1,7,5,12,2,3684,4358,-674
1,7,6,12,2,3820,3369,451
1,7,7,12,2,4358,2572,1786
1,7,8,12,2,3369,2558,811
1,7,9,12,2,2572,2581,-9
1,7,10,12,2,2558,2657,-99
1,7,11,12,2,2581,2501,80
1,7,12,12,2,2657,2848,-191
1,7,13,12,2,2501,3870,-1369
1,7,14,12,2,2848,4199,-1351
1,7,15,12,2,3870,3755,115
1,7,16,12,2,4199,3715,484
1,7,17,12,2,3755,3698,57
1,7,18,12,2,3715,3576,139
1,7,19,12,2,3698,3449,249
1,7,20,12,2,3576,3225,351
1,8,0,12,2,2967,2587,380
1,8,1,12,2,2463,3599,-1136
1,8,2,12,2,2587,4205,-1618
1,8,3,12,2,3599,3697,-98
1,8,4,12,2,4205,3804,401
1,8,5,12,2,3697,4444,-747
1,8,6,12,2,3804,3488,316
1,8,7,12,2,4444,2660,1784
1,8,8,12,2,3488,2651,837
1,8,9,12,2,2660,2672,-12
1,8,10,12,2,2651,2775,-124
1,8,11,12,2,2672,2573,99
1,8,12,12,2,2775,2830,-55
1,8,13,12,2,2573,3928,-1355
1,8,14,12,2,2830,4412,-1582
1,8,15,12,2,3928,3869,59
1,8,16,12,2,4412,3691,721
1,8,17,12,2,3869,3789,80
1,8,18,12,2,3691,3676,15
1,8,19,12,2,3789,3408,381
1,8,20,12,2,3676,3265,411
1,9,0,12,2,2966,2686,280
1,9,1,12,2,2345,3785,-1440
1,9,2,12,2,2686,4188,-1502
1,9,3,12,2,3785,3584,201
1,9,4,12,2,4188,3800,388
1,9,5,12,2,3584,4619,-1035
1,9,6,12,2,3800,3602,198
1,9,7,12,2,4619,2680,1939
1,9,8,12,2,3602,2657,945
1,9,9,12,2,2680,2661,19
1,9,10,12,2,2657,2781,-124
1,9,11,12,2,2661,2519,142
1,9,12,12,2,2781,2713,68
1,9,13,12,2,2519,3869,-1350
1,9,14,12,2,2713,4405,-1692
1,9,15,12,2,3869,3777,92
1,9,16,12,2,4405,3594,811
1,9,17,12,2,3777,3837,-60
1,9,18,12,2,3594,3657,-63
1,9,19,12,2,3837,3262,575
1,9,20,12,2,3657,3282,375
1,10,0,12,2,3066,2898,168
1,10,1,12,2,2368,3998,-1630
1,10,2,12,2,2898,4186,-1288
1,10,3,12,2,3998,3575,423
1,10,4,12,2,4186,3831,355
1,10,5,12,2,3575,4717,-1142
1,10,6,12,2,3831,3683,148
1,10,7,12,2,4717,2677,2040
1,10,8,12,2,3683,2662,1021
1,10,9,12,2,2677,2718,-41
1,10,10,12,2,2662,2838,-176
1,10,11,12,2,2718,2524,194
1,10,12,12,2,2838,2712,126
1,10,13,12,2,2524,3855,-1331
1,10,14,12,2,2712,4393,-1681
1,10,15,12,2,3855,3778,77
1,10,16,12,2,4393,3628,765
1,10,17,12,2,3778,3924,-146
1,10,18,12,2,3628,3736,-108
1,10,19,12,2,3924,3311,613
1,10,20,12,2,3736,3372,364
1,11,0,12,2,3089,2958,131
1,11,1,12,2,2414,3934,-1520
1,11,2,12,2,2958,3997,-1039
1,11,3,12,2,3934,3416,518
1,11,4,12,2,3997,3691,306
1,11,5,12,2,3416,4664,-1248
1,11,6,12,2,3691,3613,78
1,11,7,12,2,4664,2536,2128
1,11,8,12,2,3613,2542,1071
1,11,9,12,2,2536,2651,-115
1,11,10,12,2,2542,2780,-238
1,11,11,12,2,2651,2384,267
1,11,12,12,2,2780,2590,190
1,11,13,12,2,2384,3791,-1407
1,11,14,12,2,2590,4281,-1691
1,11,15,12,2,3791,3607,184
1,11,16,12,2,4281,3474,807
1,11,17,12,2,3607,3795,-188
1,11,18,12,2,3474,3641,-167
1,11,19,12,2,3795,3238,557
1,11,20,12,2,3641,3277,364
1,12,0,12,2,3030,2868,162
1,12,1,12,2,2347,3696,-1349
1,12,2,12,2,2868,3703,-835
1,12,3,12,2,3696,3131,565
1,12,4,12,2,3703,3366,337
1,12,5,12,2,3131,4424,-1293
1,12,6,12,2,3366,3443,-77
1,12,7,12,2,4424,2317,2107
1,12,8,12,2,3443,2285,1158
1,12,9,12,2,2317,2474,-157
1,12,10,12,2,2285,2611,-326
1,12,11,12,2,2474,2182,292
1,12,12,12,2,2611,2403,208
1,12,13,12,2,2182,3561,-1379
1,12,14,12,2,2403,3977,-1574
1,12,15,12,2,3561,3296,265
1,12,16,12,2,3977,3191,786
1,12,17,12,2,3296,3495,-199
1,12,18,12,2,3191,3346,-155
1,12,19,12,2,3495,3003,492
1,12,20,12,2,3346,3091,255
1,0,0,13,2,2979,2536,443
1,0,1,13,2,2743,2799,-56
1,0,2,13,2,2536,3018,-482
1,0,3,13,2,2799,2929,-130
1,0,4,13,2,3018,2999,19
1,0,5,13,2,2929,2990,-61
1,0,6,13,2,2999,2735,264
1,0,7,13,2,2990,2529,461
1,0,8,13,2,2735,2499,236
1,0,9,13,2,2529,2520,9
1,0,10,13,2,2499,2554,-55
1,0,11,13,2,2520,2509,11
1,0,12,13,2,2554,2573,-19
1,0,13,13,2,2509,2877,-368
1,0,14,13,2,2573,3061,-488
1,0,15,13,2,2877,2980,-103
1,0,16,13,2,3061,2985,76
1,0,17,13,2,2980,3030,-50
1,0,18,13,2,2985,2989,-4
1,0,19,13,2,3030,3055,-25
1,0,20,13,2,2989,3055,-66
1,1,0,13,2,3067,2575,492
1,1,1,13,2,2809,2900,-91
1,1,2,13,2,2575,3236,-661
1,1,3,13,2,2900,3137,-237
1,1,4,13,2,3236,3192,44
1,1,5,13,2,3137,3262,-125
1,1,6,13,2,3192,2877,315
1,1,7,13,2,3262,2530,732
1,1,8,13,2,2877,2494,383
1,1,9,13,2,2530,2519,11
1,1,10,13,2,2494,2555,-61
1,1,11,13,2,2519,2489,30
1,1,12,13,2,2555,2612,-57
1,1,13,13,2,2489,3080,-591
1,1,14,13,2,2612,3327,-715
1,1,15,13,2,3080,3203,-123
1,1,16,13,2,3327,3198,129
1,1,17,13,2,3203,3214,-11
1,1,18,13,2,3198,3153,45
1,1,19,13,2,3214,3228,-14
1,1,20,13,2,3153,3175,-22
1,2,0,13,2,3171,2599,572
1,2,1,13,2,2875,2980,-105
1,2,2,13,2,2599,3446,-847
1,2,3,13,2,2980,3324,-344
1,2,4,13,2,3446,3357,89
1,2,5,13,2,3324,3514,-190
1,2,6,13,2,3357,2999,358
1,2,7,13,2,3514,2547,967
1,2,8,13,2,2999,2507,492
1,2,9,13,2,2547,2515,32
1,2,10,13,2,2507,2569,-62
1,2,11,13,2,2515,2496,19
1,2,12,13,2,2569,2659,-90
1,2,13,13,2,2496,3254,-758
1,2,14,13,2,2659,3526,-867
1,2,15,13,2,3254,3402,-148
1,2,16,13,2,3526,3435,91
1,2,17,13,2,3402,3377,25
1,2,18,13,2,3435,3289,146
1,2,19,13,2,3377,3399,-22
1,2,20,13,2,3289,3314,-25
1,3,0,13,2,3265,2606,659
1,3,1,13,2,2924,3089,-165
1,3,2,13,2,2606,3685,-1079
1,3,3,13,2,3089,3522,-433
1,3,4,13,2,3685,3532,153
1,3,5,13,2,3522,3756,-234
1,3,6,13,2,3532,3092,440
1,3,7,13,2,3756,2526,1230
1,3,8,13,2,3092,2503,589
1,3,9,13,2,2526,2501,25
1,3,10,13,2,2503,2552,-49
1,3,11,13,2,2501,2456,45
1,3,12,13,2,2552,2684,-132
1,3,13,13,2,2456,3441,-985
1,3,14,13,2,2684,3726,-1042
1,3,15,13,2,3441,3602,-161
1,3,16,13,2,3726,3689,37
1,3,17,13,2,3602,3539,63
1,3,18,13,2,3689,3423,266
1,3,19,13,2,3539,3558,-19
1,3,20,13,2,3423,3420,3
1,4,0,13,2,3258,2585,673
1,4,1,13,2,2886,3210,-324
1,4,2,13,2,2585,3926,-1341
1,4,3,13,2,3210,3674,-464
1,4,4,13,2,3926,3683,243
1,4,5,13,2,3674,4056,-382
1,4,6,13,2,3683,3297,386
1,4,7,13,2,4056,2615,1441
1,4,8,13,2,3297,2585,712
1,4,9,13,2,2615,2597,18
1,4,10,13,2,2585,2666,-81
1,4,11,13,2,2597,2538,59
1,4,12,13,2,2666,2824,-158
1,4,13,13,2,2538,3712,-1174
1,4,14,13,2,2824,3961,-1137
1,4,15,13,2,3712,3745,-33
1,4,16,13,2,3961,3857,104
1,4,17,13,2,3745,3684,61
1,4,18,13,2,3857,3536,321
1,4,19,13,2,3684,3628,56
1,4,20,13,2,3536,3455,81
1,5,0,13,2,3208,2565,643
1,5,1,13,2,2791,3322,-531
1,5,2,13,2,2565,4078,-1513
1,5,3,13,2,3322,3763,-441
1,5,4,13,2,4078,3856,222
1,5,5,13,2,3763,4353,-590
1,5,6,13,2,3856,3459,397
1,5,7,13,2,4353,2697,1656
1,5,8,13,2,3459,2669,790
1,5,9,13,2,2697,2658,39
1,5,10,13,2,2669,2743,-74
1,5,11,13,2,2658,2590,68
1,5,12,13,2,2743,2930,-187
1,5,13,13,2,2590,3987,-1397
1,5,14,13,2,2930,4230,-1300
1,5,15,13,2,3987,3800,187
1,5,16,13,2,4230,3863,367
1,5,17,13,2,3800,3780,20
1,5,18,13,2,3863,3651,212
1,5,19,13,2,3780,3664,116
1,5,20,13,2,3651,3480,171
1,6,0,13,2,3186,2586,600
1,6,1,13,2,2717,3500,-783
1,6,2,13,2,2586,4261,-1675
1,6,3,13,2,3500,3833,-333
1,6,4,13,2,4261,3945,316
1,6,5,13,2,3833,4485,-652
1,6,6,13,2,3945,3507,438
1,6,7,13,2,4485,2710,1775
1,6,8,13,2,3507,2696,811
1,6,9,13,2,2710,2719,-9
1,6,10,13,2,2696,2795,-99
1,6,11,13,2,2719,2638,81
1,6,12,13,2,2795,2984,-189
1,6,13,13,2,2638,4015,-1377
1,6,14,13,2,2984,4342,-1358
1,6,15,13,2,4015,3892,123
1,6,16,13,2,4342,3873,469
1,6,17,13,2,3892,3882,10
1,6,18,13,2,3873,3780,93
1,6,19,13,2,3882,3672,210
1,6,20,13,2,3780,3456,324
1,7,0,13,2,3222,2726,496
1,7,1,13,2,2678,3688,-1010
1,7,2,13,2,2726,4302,-1576
1,7,3,13,2,3688,3836,-148
1,7,4,13,2,4302,3991,311
1,7,5,13,2,3836,4644,-808
1,7,6,13,2,3991,3679,312
1,7,7,13,2,4644,2853,1791
1,7,8,13,2,3679,2847,832
1,7,9,13,2,2853,2870,-17
1,7,10,13,2,2847,2972,-125
1,7,11,13,2,2870,2768,102
1,7,12,13,2,2972,3023,-51
1,7,13,13,2,2768,4123,-1355
1,7,14,13,2,3023,4595,-1572
1,7,15,13,2,4123,4032,91
1,7,16,13,2,4595,3847,748
1,7,17,13,2,4032,3938,94
1,7,18,13,2,3847,3832,15
1,7,19,13,2,3938,3602,336
1,7,20,13,2,3832,3500,332
1,8,0,13,2,3233,2885,348
1,8,1,13,2,2607,3926,-1319
1,8,2,13,2,2885,4345,-1460
1,8,3,13,2,3926,3813,113
1,8,4,13,2,4345,4056,289
1,8,5,13,2,3813,4867,-1054
1,8,6,13,2,4056,3864,192
1,8,7,13,2,4867,2945,1922
1,8,8,13,2,3864,2924,940
1,8,9,13,2,2945,2944,1
1,8,10,13,2,2924,3073,-149
1,8,11,13,2,2944,2803,141
1,8,12,13,2,3073,2989,84
1,8,13,13,2,2803,4141,-1338
1,8,14,13,2,2989,4670,-1681
1,8,15,13,2,4141,4037,104
1,8,16,13,2,4670,3816,854
1,8,17,13,2,4037,4029,8
1,8,18,13,2,3816,3884,-68
1,8,19,13,2,4029,3508,521
1,8,20,13,2,3884,3531,353
1,9,0,13,2,3241,3010,231
1,9,1,13,2,2506,4082,-1576
1,9,2,13,2,3010,4282,-1272
1,9,3,13,2,4082,3674,408
1,9,4,13,2,4282,3942,340
1,9,5,13,2,3674,4848,-1174
1,9,6,13,2,3942,3788,154
1,9,7,13,2,4848,2747,2101
1,9,8,13,2,3788,2727,1061
1,9,9,13,2,2747,2793,-46
1,9,10,13,2,2727,2905,-178
1,9,11,13,2,2793,2579,214
1,9,12,13,2,2905,2792,113
1,9,13,13,2,2579,3967,-1388
1,9,14,13,2,2792,4518,-1726
1,9,15,13,2,3967,3902,65
1,9,16,13,2,4518,3733,785
1,9,17,13,2,3902,4022,-120
1,9,18,13,2,3733,3847,-114
1,9,19,13,2,4022,3447,575
1,9,20,13,2,3847,3551,296
1,10,0,13,2,3237,3094,143
1,10,1,13,2,2518,4158,-1640
1,10,2,13,2,3094,4263,-1169
1,10,3,13,2,4158,3657,501
1,10,4,13,2,4263,3971,292
1,10,5,13,2,3657,4963,-1306
1,10,6,13,2,3971,3883,88
1,10,7,13,2,4963,2796,2167
1,10,8,13,2,3883,2793,1090
1,10,9,13,2,2796,2895,-99
1,10,10,13,2,2793,3037,-244
1,10,11,13,2,2895,2640,255
1,10,12,13,2,3037,2843,194
1,10,13,13,2,2640,4065,-1425
1,10,14,13,2,2843,4575,-1732
1,10,15,13,2,4065,3868,197
1,10,16,13,2,4575,3706,869
1,10,17,13,2,3868,4030,-162
1,10,18,13,2,3706,3838,-132
1,10,19,13,2,4030,3419,611
1,10,20,13,2,3838,3482,356
1,11,0,13,2,3269,3081,188
1,11,1,13,2,2537,4072,-1535
1,11,2,13,2,3081,4131,-1050
1,11,3,13,2,4072,3529,543
1,11,4,13,2,4131,3819,312
1,11,5,13,2,3529,4870,-1341
1,11,6,13,2,3819,3837,-18
1,11,7,13,2,4870,2689,2181
1,11,8,13,2,3837,2657,1180
1,11,9,13,2,2689,2843,-154
1,11,10,13,2,2657,3002,-345
1,11,11,13,2,2843,2566,277
1,11,12,13,2,3002,2776,226
1,11,13,13,2,2566,3992,-1426
1,11,14,13,2,2776,4455,-1679
1,11,15,13,2,3992,3716,276
1,11,16,13,2,4455,3586,869
1,11,17,13,2,3716,3919,-203
1,11,18,13,2,3586,3728,-142
1,11,19,13,2,3919,3345,574
1,11,20,13,2,3728,3398,330
1,0,0,14,2,3284,2769,515
1,0,1,14,2,3012,3109,-97
1,0,2,14,2,2769,3458,-689
1,0,3,14,2,3109,3352,-243
1,0,4,14,2,3458,3402,56
1,0,5,14,2,3352,3472,-120
1,0,6,14,2,3402,3084,318
1,0,7,14,2,3472,2735,737
1,0,8,14,2,3084,2698,386
1,0,9,14,2,2735,2723,12
1,0,10,14,2,2698,2760,-62
1,0,11,14,2,2723,2696,27
1,0,12,14,2,2760,2821,-61
1,0,13,14,2,2696,3283,-587
1,0,14,14,2,2821,3527,-706
1,0,15,14,2,3283,3415,-132
1,0,16,14,2,3527,3416,111
1,0,17,14,2,3415,3420,-5
1,0,18,14,2,3416,3354,62
1,0,19,14,2,3420,3440,-20
1,0,20,14,2,3354,3386,-32
1,1,0,14,2,3388,2812,576
1,1,1,14,2,3093,3198,-105
1,1,2,14,2,2812,3666,-854
1,1,3,14,2,3198,3534,-336
1,1,4,14,2,3666,3566,100
1,1,5,14,2,3534,3729,-195
1,1,6,14,2,3566,3213,353
1,1,7,14,2,3729,2757,972
1,1,8,14,2,3213,2714,499
1,1,9,14,2,2757,2721,36
1,1,10,14,2,2714,2776,-62
1,1,11,14,2,2721,2705,16
1,1,12,14,2,2776,2871,-95
1,1,13,14,2,2705,3476,-771
1,1,14,14,2,2871,3748,-877
1,1,15,14,2,3476,3613,-137
1,1,16,14,2,3748,3641,107
1,1,17,14,2,3613,3580,33
1,1,18,14,2,3641,3501,140
1,1,19,14,2,3580,3624,-44
1,1,20,14,2,3501,3530,-29
1,2,0,14,2,3486,2825,661
1,2,1,14,2,3151,3306,-155
1,2,2,14,2,2825,3903,-1078
1,2,3,14,2,3306,3738,-432
1,2,4,14,2,3903,3758,145
1,2,5,14,2,3738,3989,-251
1,2,6,14,2,3758,3320,438
1,2,7,14,2,3989,2748,1241
1,2,8,14,2,3320,2719,601
1,2,9,14,2,2748,2714,34
1,2,10,14,2,2719,2766,-47
1,2,11,14,2,2714,2674,40
1,2,12,14,2,2766,2905,-139
1,2,13,14,2,2674,3669,-995
1,2,14,14,2,2905,3952,-1047
1,2,15,14,2,3669,3820,-151
1,2,16,14,2,3952,3905,47
1,2,17,14,2,3820,3749,71
1,2,18,14,2,3905,3636,269
1,2,19,14,2,3749,3783,-34
1,2,20,14,2,3636,3641,-5
1,3,0,14,2,3487,2800,687
1,3,1,14,2,3113,3427,-314
1,3,2,14,2,2800,4153,-1353
1,3,3,14,2,3427,3901,-474
1,3,4,14,2,4153,3910,243
1,3,5,14,2,3901,4243,-342
1,3,6,14,2,3910,3438,472
1,3,7,14,2,4243,2750,1493
1,3,8,14,2,3438,2714,724
1,3,9,14,2,2750,2722,28
1,3,10,14,2,2714,2791,-77
1,3,11,14,2,2722,2666,56
1,3,12,14,2,2791,2956,-165
1,3,13,14,2,2666,3869,-1203
1,3,14,14,2,2956,4150,-1194
1,3,15,14,2,3869,3961,-92
1,3,16,14,2,4150,4095,55
1,3,17,14,2,3961,3912,49
1,3,18,14,2,4095,3747,348
1,3,19,14,2,3912,3843,69
1,3,20,14,2,3747,3677,70
1,4,0,14,2,3441,2794,647
1,4,1,14,2,3024,3563,-539
1,4,2,14,2,2794,4324,-1530
1,4,3,14,2,3563,3977,-414
1,4,4,14,2,4324,4026,298
1,4,5,14,2,3977,4483,-506
1,4,6,14,2,4026,3564,462
1,4,7,14,2,4483,2796,1687
1,4,8,14,2,3564,2762,802
1,4,9,14,2,2796,2747,49
1,4,10,14,2,2762,2832,-70
1,4,11,14,2,2747,2682,65
1,4,12,14,2,2832,3025,-193
1,4,13,14,2,2682,4094,-1412
1,4,14,14,2,3025,4364,-1339
1,4,15,14,2,4094,3981,113
1,4,16,14,2,4364,4092,272
1,4,17,14,2,3981,4018,-37
1,4,18,14,2,4092,3876,216
1,4,19,14,2,4018,3887,131
1,4,20,14,2,3876,3703,173
1,5,0,14,2,3422,2825,597
1,5,1,14,2,2959,3744,-785
1,5,2,14,2,2825,4495,-1670
1,5,3,14,2,3744,4011,-267
1,5,4,14,2,4495,4053,442
1,5,5,14,2,4011,4593,-582
1,5,6,14,2,4053,3644,409
1,5,7,14,2,4593,2845,1748
1,5,8,14,2,3644,2828,816
1,5,9,14,2,2845,2849,-4
1,5,10,14,2,2828,2925,-97
1,5,11,14,2,2849,2768,81
1,5,12,14,2,2925,3115,-190
1,5,13,14,2,2768,4136,-1368
1,5,14,14,2,3115,4455,-1340
1,5,15,14,2,4136,4031,105
1,5,16,14,2,4455,4061,394
1,5,17,14,2,4031,4105,-74
1,5,18,14,2,4061,4015,46
1,5,19,14,2,4105,3909,196
1,5,20,14,2,4015,3682,333
1,6,0,14,2,3466,2924,542
1,6,1,14,2,2911,3864,-953
1,6,2,14,2,2924,4471,-1547
1,6,3,14,2,3864,3985,-121
1,6,4,14,2,4471,4116,355
1,6,5,14,2,3985,4771,-786
1,6,6,14,2,4116,3817,299
1,6,7,14,2,4771,2991,1780
1,6,8,14,2,3817,2985,832
1,6,9,14,2,2991,3008,-17
1,6,10,14,2,2985,3110,-125
1,6,11,14,2,3008,2905,103
1,6,12,14,2,3110,3159,-49
1,6,13,14,2,2905,4268,-1363
1,6,14,14,2,3159,4738,-1579
1,6,15,14,2,4268,4169,99
1,6,16,14,2,4738,4005,733
1,6,17,14,2,4169,4122,47
1,6,18,14,2,4005,4036,-31
1,6,19,14,2,4122,3825,297
1,6,20,14,2,4036,3731,305
1,7,0,14,2,3488,3024,464
1,7,1,14,2,2822,4015,-1193
1,7,2,14,2,3024,4442,-1418
1,7,3,14,2,4015,3952,63
1,7,4,14,2,4442,4243,199
1,7,5,14,2,3952,5067,-1115
1,7,6,14,2,4243,4055,188
1,7,7,14,2,5067,3138,1929
1,7,8,14,2,4055,3120,935
1,7,9,14,2,3138,3142,-4
1,7,10,14,2,3120,3270,-150
1,7,11,14,2,3142,2998,144
1,7,12,14,2,3270,3182,88
1,7,13,14,2,2998,4336,-1338
1,7,14,14,2,3182,4853,-1671
1,7,15,14,2,4336,4200,136
1,7,16,14,2,4853,3972,881
1,7,17,14,2,4200,4178,22
1,7,18,14,2,3972,4040,-68
1,7,19,14,2,4178,3702,476
1,7,20,14,2,4040,3766,274
1,8,0,14,2,3508,3209,299
1,8,1,14,2,2768,4223,-1455
1,8,2,14,2,3209,4439,-1230
1,8,3,14,2,4223,3903,320
1,8,4,14,2,4439,4198,241
1,8,5,14,2,3903,5096,-1193
1,8,6,14,2,4198,4050,148
1,8,7,14,2,5096,3012,2084
1,8,8,14,2,4050,2994,1056
1,8,9,14,2,3012,3076,-64
1,8,10,14,2,2994,3197,-203
1,8,11,14,2,3076,2863,213
1,8,12,14,2,3197,3068,129
1,8,13,14,2,2863,4239,-1376
1,8,14,14,2,3068,4783,-1715
1,8,15,14,2,4239,4162,77
1,8,16,14,2,4783,3955,828
1,8,17,14,2,4162,4214,-52
1,8,18,14,2,3955,4074,-119
1,8,19,14,2,4214,3693,521
1,8,20,14,2,4074,3800,274
1,9,0,14,2,3412,3206,206
1,9,1,14,2,2656,4242,-1586
1,9,2,14,2,3206,4359,-1153
1,9,3,14,2,4242,3756,486
1,9,4,14,2,4359,4082,277
1,9,5,14,2,3756,5094,-1338
1,9,6,14,2,4082,3988,94
1,9,7,14,2,5094,2866,2228
1,9,8,14,2,3988,2858,1130
1,9,9,14,2,2866,2970,-104
1,9,10,14,2,2858,3104,-246
1,9,11,14,2,2970,2695,275
1,9,12,14,2,3104,2923,181
1,9,13,14,2,2695,4177,-1482
1,9,14,14,2,2923,4700,-1777
1,9,15,14,2,4177,3992,185
1,9,16,14,2,4700,3811,889
1,9,17,14,2,3992,4128,-136
1,9,18,14,2,3811,3949,-138
1,9,19,14,2,4128,3555,573
1,9,20,14,2,3949,3661,288
1,10,0,14,2,3417,3217,200
1,10,1,14,2,2641,4296,-1655
1,10,2,14,2,3217,4397,-1180
1,10,3,14,2,4296,3770,526
1,10,4,14,2,4397,4099,298
1,10,5,14,2,3770,5169,-1399
1,10,6,14,2,4099,4107,-8
1,10,7,14,2,5169,2949,2220
1,10,8,14,2,4107,2908,1199
1,10,9,14,2,2949,3087,-138
1,10,10,14,2,2908,3259,-351
1,10,11,14,2,3087,2822,265
1,10,12,14,2,3259,3029,230
1,10,13,14,2,2822,4266,-1444
1,10,14,14,2,3029,4749,-1720
1,10,15,14,2,4266,3977,289
1,10,16,14,2,4749,3818,931
1,10,17,14,2,3977,4154,-177
1,10,18,14,2,3818,3925,-107
1,10,19,14,2,4154,3526,628
1,10,20,14,2,3925,3603,322
1,0,0,15,2,3605,3006,599
1,0,1,15,2,3296,3407,-111
1,0,2,15,2,3006,3888,-882
1,0,3,15,2,3407,3749,-342
1,0,4,15,2,3888,3776,112
1,0,5,15,2,3749,3939,-190
1,0,6,15,2,3776,3420,356
1,0,7,15,2,3939,2962,977
1,0,8,15,2,3420,2918,502
1,0,9,15,2,2962,2925,37
1,0,10,15,2,2918,2981,-63
1,0,11,15,2,2925,2912,13
1,0,12,15,2,2981,3080,-99
1,0,13,15,2,2912,3679,-767
1,0,14,15,2,3080,3948,-868
1,0,15,15,2,3679,3825,-146
1,0,16,15,2,3948,3859,89
1,0,17,15,2,3825,3786,39
1,0,18,15,2,3859,3702,157
1,0,19,15,2,3786,3836,-50
1,0,20,15,2,3702,3741,-39
1,1,0,15,2,3703,3038,665
1,1,1,15,2,3369,3524,-155
1,1,2,15,2,3038,4123,-1085
1,1,3,15,2,3524,3948,-424
1,1,4,15,2,4123,3967,156
1,1,5,15,2,3948,4204,-256
1,1,6,15,2,3967,3534,433
1,1,7,15,2,4204,2958,1246
1,1,8,15,2,3534,2926,608
1,1,9,15,2,2958,2920,38
1,1,10,15,2,2926,2973,-47
1,1,11,15,2,2920,2883,37
1,1,12,15,2,2973,3117,-144
1,1,13,15,2,2883,3891,-1008
1,1,14,15,2,3117,4174,-1057
1,1,15,15,2,3891,4031,-140
1,1,16,15,2,4174,4111,63
1,1,17,15,2,4031,3952,79
1,1,18,15,2,4111,3848,263
1,1,19,15,2,3952,4008,-56
1,1,20,15,2,3848,3857,-9
1,2,0,15,2,3708,3019,689
1,2,1,15,2,3340,3644,-304
1,2,2,15,2,3019,4371,-1352
1,2,3,15,2,3644,4117,-473
1,2,4,15,2,4371,4136,235
1,2,5,15,2,4117,4476,-359
1,2,6,15,2,4136,3666,470
1,2,7,15,2,4476,2972,1504
1,2,8,15,2,3666,2930,736
1,2,9,15,2,2972,2935,37
1,2,10,15,2,2930,3005,-75
1,2,11,15,2,2935,2884,51
1,2,12,15,2,3005,3177,-172
1,2,13,15,2,2884,4097,-1213
1,2,14,15,2,3177,4376,-1199
1,2,15,15,2,4097,4179,-82
1,2,16,15,2,4376,4311,65
1,2,17,15,2,4179,4122,57
1,2,18,15,2,4311,3960,351
1,2,19,15,2,4122,4068,54
1,2,20,15,2,3960,3898,62
1,3,0,15,2,3670,3009,661
1,3,1,15,2,3251,3780,-529
1,3,2,15,2,3009,4551,-1542
1,3,3,15,2,3780,4204,-424
1,3,4,15,2,4551,4253,298
1,3,5,15,2,4204,4670,-466
1,3,6,15,2,4253,3705,548
1,3,7,15,2,4670,2931,1739
1,3,8,15,2,3705,2891,814
1,3,9,15,2,2931,2872,59
1,3,10,15,2,2891,2957,-66
1,3,11,15,2,2872,2810,62
1,3,12,15,2,2957,3157,-200
1,3,13,15,2,2810,4251,-1441
1,3,14,15,2,3157,4553,-1396
1,3,15,15,2,4251,4197,54
1,3,16,15,2,4553,4330,223
1,3,17,15,2,4197,4246,-49
1,3,18,15,2,4330,4087,243
1,3,19,15,2,4246,4102,144
1,3,20,15,2,4087,3925,162
1,4,0,15,2,3655,3054,601
1,4,1,15,2,3192,3985,-793
1,4,2,15,2,3054,4741,-1687
1,4,3,15,2,3985,4225,-240
1,4,4,15,2,4741,4223,518
1,4,5,15,2,4225,4723,-498
1,4,6,15,2,4223,3749,474
1,4,7,15,2,4723,2944,1779
1,4,8,15,2,3749,2921,828
1,4,9,15,2,2944,2938,6
1,4,10,15,2,2921,3014,-93
1,4,11,15,2,2938,2860,78
1,4,12,15,2,3014,3210,-196
1,4,13,15,2,2860,4243,-1383
1,4,14,15,2,3210,4589,-1379
1,4,15,15,2,4243,4212,31
1,4,16,15,2,4589,4290,299
1,4,17,15,2,4212,4343,-131
1,4,18,15,2,4290,4240,50
1,4,19,15,2,4343,4132,211
1,4,20,15,2,4240,3905,335
1,5,0,15,2,3702,3163,539
1,5,1,15,2,3153,4108,-955
1,5,2,15,2,3163,4705,-1542
1,5,3,15,2,4108,4163,-55
1,5,4,15,2,4705,4224,481
1,5,5,15,2,4163,4879,-716
1,5,6,15,2,4224,3954,270
1,5,7,15,2,4879,3126,1753
1,5,8,15,2,3954,3117,837
1,5,9,15,2,3126,3138,-12
1,5,10,15,2,3117,3240,-123
1,5,11,15,2,3138,3035,103
1,5,12,15,2,3240,3290,-50
1,5,13,15,2,3035,4389,-1354
1,5,14,15,2,3290,4851,-1561
1,5,15,15,2,4389,4308,81
1,5,16,15,2,4851,4193,658
1,5,17,15,2,4308,4345,-37
1,5,18,15,2,4193,4271,-78
1,5,19,15,2,4345,4062,283
1,5,20,15,2,4271,3957,314
1,6,0,15,2,3732,3222,510
1,6,1,15,2,3055,4191,-1136
1,6,2,15,2,3222,4611,-1389
1,6,3,15,2,4191,4101,90
1,6,4,15,2,4611,4368,243
1,6,5,15,2,4101,5194,-1093
1,6,6,15,2,4368,4193,175
1,6,7,15,2,5194,3276,1918
1,6,8,15,2,4193,3258,935
1,6,9,15,2,3276,3280,-4
1,6,10,15,2,3258,3408,-150
1,6,11,15,2,3280,3135,145
1,6,12,15,2,3408,3318,90
1,6,13,15,2,3135,4481,-1346
1,6,14,15,2,3318,4996,-1678
1,6,15,15,2,4481,4337,144
1,6,16,15,2,4996,4130,866
1,6,17,15,2,4337,4362,-25
1,6,18,15,2,4130,4244,-114
1,6,19,15,2,4362,3925,437
1,6,20,15,2,4244,3997,247
1,7,0,15,2,3763,3348,415
1,7,1,15,2,2983,4312,-1329
1,7,2,15,2,3348,4536,-1188
1,7,3,15,2,4312,4042,270
1,7,4,15,2,4536,4385,151
1,7,5,15,2,4042,5296,-1254
1,7,6,15,2,4385,4241,144
1,7,7,15,2,5296,3205,2091
1,7,8,15,2,4241,3190,1051
1,7,9,15,2,3205,3274,-69
1,7,10,15,2,3190,3394,-204
1,7,11,15,2,3274,3058,216
1,7,12,15,2,3394,3261,133
1,7,13,15,2,3058,4434,-1376
1,7,14,15,2,3261,4966,-1705
1,7,15,15,2,4434,4325,109
1,7,16,15,2,4966,4111,855
1,7,17,15,2,4325,4363,-38
1,7,18,15,2,4111,4230,-119
1,7,19,15,2,4363,3887,476
1,7,20,15,2,4230,4035,195
1,8,0,15,2,3679,3405,274
1,8,1,15,2,2918,4383,-1465
1,8,2,15,2,3405,4516,-1111
1,8,3,15,2,4383,3985,398
1,8,4,15,2,4516,4338,178
1,8,5,15,2,3985,5342,-1357
1,8,6,15,2,4338,4250,88
1,8,7,15,2,5342,3131,2211
1,8,8,15,2,4250,3125,1125
1,8,9,15,2,3131,3253,-122
1,8,10,15,2,3125,3396,-271
1,8,11,15,2,3253,2979,274
1,8,12,15,2,3396,3199,197
1,8,13,15,2,2979,4449,-1470
1,8,14,15,2,3199,4965,-1766
1,8,15,15,2,4449,4252,197
1,8,16,15,2,4965,4033,932
1,8,17,15,2,4252,4320,-68
1,8,18,15,2,4033,4176,-143
1,8,19,15,2,4320,3801,519
1,8,20,15,2,4176,3910,266
1,9,0,15,2,3592,3329,263
1,9,1,15,2,2779,4380,-1601
1,9,2,15,2,3329,4493,-1164
1,9,3,15,2,4380,3869,511
1,9,4,15,2,4493,4210,283
1,9,5,15,2,3869,5300,-1431
1,9,6,15,2,4210,4212,-2
1,9,7,15,2,5300,3019,2281
1,9,8,15,2,4212,2973,1239
1,9,9,15,2,3019,3162,-143
1,9,10,15,2,2973,3326,-353
1,9,11,15,2,3162,2877,285
1,9,12,15,2,3326,3109,217
1,9,13,15,2,2877,4378,-1501
1,9,14,15,2,3109,4874,-1765
1,9,15,15,2,4378,4101,277
1,9,16,15,2,4874,3923,951
1,9,17,15,2,4101,4252,-151
1,9,18,15,2,3923,4036,-113
1,9,19,15,2,4252,3662,590
1,9,20,15,2,4036,3782,254
1,0,0,16,2,3920,3232,688
1,0,1,16,2,3572,3733,-161
1,0,2,16,2,3232,4345,-1113
1,0,3,16,2,3733,4163,-430
1,0,4,16,2,4345,4177,168
1,0,5,16,2,4163,4414,-251
1,0,6,16,2,4177,3741,436
1,0,7,16,2,4414,3163,1251
1,0,8,16,2,3741,3130,611
1,0,9,16,2,3163,3124,39
1,0,10,16,2,3130,3178,-48
1,0,11,16,2,3124,3090,34
1,0,12,16,2,3178,3326,-148
1,0,13,16,2,3090,4094,-1004
1,0,14,16,2,3326,4374,-1048
1,0,15,16,2,4094,4243,-149
1,0,16,16,2,4374,4329,45
1,0,17,16,2,4243,4158,85
1,0,18,16,2,4329,4049,280
1,0,19,16,2,4158,4220,-62
1,0,20,16,2,4049,4068,-19
1,1,0,16,2,3925,3232,693
1,1,1,16,2,3558,3862,-304
1,1,2,16,2,3232,4591,-1359
1,1,3,16,2,3862,4327,-465
1,1,4,16,2,4591,4345,246
1,1,5,16,2,4327,4691,-364
1,1,6,16,2,4345,3880,465
1,1,7,16,2,4691,3182,1509
1,1,8,16,2,3880,3137,743
1,1,9,16,2,3182,3141,41
1,1,10,16,2,3137,3212,-75
1,1,11,16,2,3141,3093,48
1,1,12,16,2,3212,3389,-177
1,1,13,16,2,3093,4319,-1226
1,1,14,16,2,3389,4598,-1209
1,1,15,16,2,4319,4390,-71
1,1,16,16,2,4598,4517,81
1,1,17,16,2,4390,4325,65
1,1,18,16,2,4517,4172,345
1,1,19,16,2,4325,4293,32
1,1,20,16,2,4172,4114,58
1,2,0,16,2,3891,3228,663
1,2,1,16,2,3478,3997,-519
1,2,2,16,2,3228,4769,-1541
1,2,3,16,2,3997,4420,-423
1,2,4,16,2,4769,4479,290
1,2,5,16,2,4420,4903,-483
1,2,6,16,2,4479,3933,546
1,2,7,16,2,4903,3153,1750
1,2,8,16,2,3933,3107,826
1,2,9,16,2,3153,3085,68
1,2,10,16,2,3107,3171,-64
1,2,11,16,2,3085,3028,57
1,2,12,16,2,3171,3378,-207
1,2,13,16,2,3028,4479,-1451
1,2,14,16,2,3378,4779,-1401
1,2,15,16,2,4479,4415,64
1,2,16,16,2,4779,4546,233
1,2,17,16,2,4415,4456,-41
1,2,18,16,2,4546,4300,246
1,2,19,16,2,4456,4327,129
1,2,20,16,2,4300,4146,154
1,3,0,16,2,3884,3269,615
1,3,1,16,2,3419,4202,-783
1,3,2,16,2,3269,4968,-1699
1,3,3,16,2,4202,4452,-250
1,3,4,16,2,4968,4450,518
1,3,5,16,2,4452,4910,-458
1,3,6,16,2,4450,3890,560
1,3,7,16,2,4910,3079,1831
1,3,8,16,2,3890,3050,840
1,3,9,16,2,3079,3063,16
1,3,10,16,2,3050,3139,-89
1,3,11,16,2,3063,2988,75
1,3,12,16,2,3139,3342,-203
1,3,13,16,2,2988,4400,-1412
1,3,14,16,2,3342,4778,-1436
1,3,15,16,2,4400,4428,-28
1,3,16,16,2,4778,4528,250
1,3,17,16,2,4428,4571,-143
1,3,18,16,2,4528,4451,77
1,3,19,16,2,4571,4347,224
1,3,20,16,2,4451,4127,324
1,4,0,16,2,3935,3392,543
1,4,1,16,2,3386,4349,-963
1,4,2,16,2,3392,4951,-1559
1,4,3,16,2,4349,4377,-28
1,4,4,16,2,4951,4394,557
1,4,5,16,2,4377,5009,-632
1,4,6,16,2,4394,4059,335
1,4,7,16,2,5009,3225,1784
1,4,8,16,2,4059,3210,849
1,4,9,16,2,3225,3227,-2
1,4,10,16,2,3210,3329,-119
1,4,11,16,2,3227,3127,100
1,4,12,16,2,3329,3385,-56
1,4,13,16,2,3127,4496,-1369
1,4,14,16,2,3385,4985,-1600
1,4,15,16,2,4496,4489,7
1,4,16,16,2,4985,4422,563
1,4,17,16,2,4489,4583,-94
1,4,18,16,2,4422,4496,-74
1,4,19,16,2,4583,4285,298
1,4,20,16,2,4496,4180,316
1,5,0,16,2,3968,3461,507
1,5,1,16,2,3297,4435,-1138
1,5,2,16,2,3461,4845,-1384
1,5,3,16,2,4435,4279,156
1,5,4,16,2,4845,4476,369
1,5,5,16,2,4279,5302,-1023
1,5,6,16,2,4476,4330,146
1,5,7,16,2,5302,3411,1891
1,5,8,16,2,4330,3390,940
1,5,9,16,2,3411,3410,1
1,5,10,16,2,3390,3538,-148
1,5,11,16,2,3410,3265,145
1,5,12,16,2,3538,3449,89
1,5,13,16,2,3265,4602,-1337
1,5,14,16,2,3449,5109,-1660
1,5,15,16,2,4602,4476,126
1,5,16,16,2,5109,4318,791
1,5,17,16,2,4476,4585,-109
1,5,18,16,2,4318,4479,-161
1,5,19,16,2,4585,4162,423
1,5,20,16,2,4479,4223,256
1,6,0,16,2,4007,3546,461
1,6,1,16,2,3216,4488,-1272
1,6,2,16,2,3546,4705,-1159
1,6,3,16,2,4488,4191,297
1,6,4,16,2,4705,4510,195
1,6,5,16,2,4191,5423,-1232
1,6,6,16,2,4510,4379,131
1,6,7,16,2,5423,3343,2080
1,6,8,16,2,4379,3328,1051
1,6,9,16,2,3343,3412,-69
1,6,10,16,2,3328,3532,-204
1,6,11,16,2,3412,3195,217
1,6,12,16,2,3532,3397,135
1,6,13,16,2,3195,4579,-1384
1,6,14,16,2,3397,5109,-1712
1,6,15,16,2,4579,4462,117
1,6,16,16,2,5109,4269,840
1,6,17,16,2,4462,4547,-85
1,6,18,16,2,4269,4434,-165
1,6,19,16,2,4547,4110,437
1,6,20,16,2,4434,4266,168
1,7,0,16,2,3934,3544,390
1,7,1,16,2,3133,4472,-1339
1,7,2,16,2,3544,4613,-1069
1,7,3,16,2,4472,4124,348
1,7,4,16,2,4613,4525,88
1,7,5,16,2,4124,5542,-1418
1,7,6,16,2,4525,4441,84
1,7,7,16,2,5542,3324,2218
1,7,8,16,2,4441,3321,1120
1,7,9,16,2,3324,3451,-127
1,7,10,16,2,3321,3593,-272
1,7,11,16,2,3451,3174,277
1,7,12,16,2,3593,3392,201
1,7,13,16,2,3174,4644,-1470
1,7,14,16,2,3392,5148,-1756
1,7,15,16,2,4644,4415,229
1,7,16,16,2,5148,4189,959
1,7,17,16,2,4415,4469,-54
1,7,18,16,2,4189,4332,-143
1,7,19,16,2,4469,3995,474
1,7,20,16,2,4332,4145,187
1,8,0,16,2,3859,3528,331
1,8,1,16,2,3041,4521,-1480
1,8,2,16,2,3528,4650,-1122
1,8,3,16,2,4521,4098,423
1,8,4,16,2,4650,4466,184
1,8,5,16,2,4098,5548,-1450
1,8,6,16,2,4466,4474,-8
1,8,7,16,2,5548,3284,2264
1,8,8,16,2,4474,3240,1234
1,8,9,16,2,3284,3445,-161
1,8,10,16,2,3240,3618,-378
1,8,11,16,2,3445,3161,284
1,8,12,16,2,3618,3385,233
1,8,13,16,2,3161,4650,-1489
1,8,14,16,2,3385,5139,-1754
1,8,15,16,2,4650,4361,289
1,8,16,16,2,5139,4145,994
1,8,17,16,2,4361,4444,-83
1,8,18,16,2,4145,4263,-118
1,8,19,16,2,4444,3908,536
1,8,20,16,2,4263,4031,232
1,0,0,17,2,4142,3426,716
1,0,1,17,2,3761,4071,-310
1,0,2,17,2,3426,4813,-1387
1,0,3,17,2,4071,4542,-471
1,0,4,17,2,4813,4555,258
1,0,5,17,2,4542,4901,-359
1,0,6,17,2,4555,4087,468
1,0,7,17,2,4901,3387,1514
1,0,8,17,2,4087,3341,746
1,0,9,17,2,3387,3345,42
1,0,10,17,2,3341,3417,-76
1,0,11,17,2,3345,3300,45
1,0,12,17,2,3417,3598,-181
1,0,13,17,2,3300,4522,-1222
1,0,14,17,2,3598,4798,-1200
1,0,15,17,2,4522,4602,-80
1,0,16,17,2,4798,4735,63
1,0,17,17,2,4602,4531,71
1,0,18,17,2,4735,4373,362
1,0,19,17,2,4531,4505,26
1,0,20,17,2,4373,4325,48
1,1,0,17,2,4108,3441,667
1,1,1,17,2,3696,4215,-519
1,1,2,17,2,3441,4989,-1548
1,1,3,17,2,4215,4630,-415
1,1,4,17,2,4989,4688,301
1,1,5,17,2,4630,5118,-488
1,1,6,17,2,4688,4147,541
1,1,7,17,2,5118,3363,1755
1,1,8,17,2,4147,3314,833
1,1,9,17,2,3363,3291,72
1,1,10,17,2,3314,3378,-64
1,1,11,17,2,3291,3237,54
1,1,12,17,2,3378,3590,-212
1,1,13,17,2,3237,4701,-1464
1,1,14,17,2,3590,5001,-1411
1,1,15,17,2,4701,4626,75
1,1,16,17,2,5001,4752,249
1,1,17,17,2,4626,4659,-33
1,1,18,17,2,4752,4512,240
1,1,19,17,2,4659,4552,107
1,1,20,17,2,4512,4362,150
1,2,0,17,2,4105,3488,617
1,2,1,17,2,3646,4419,-773
1,2,2,17,2,3488,5186,-1698
1,2,3,17,2,4419,4668,-249
1,2,4,17,2,5186,4676,510
1,2,5,17,2,4668,5143,-475
1,2,6,17,2,4676,4118,558
1,2,7,17,2,5143,3301,1842
1,2,8,17,2,4118,3266,852
1,2,9,17,2,3301,3276,25
1,2,10,17,2,3266,3353,-87
1,2,11,17,2,3276,3206,70
1,2,12,17,2,3353,3563,-210
1,2,13,17,2,3206,4628,-1422
1,2,14,17,2,3563,5004,-1441
1,2,15,17,2,4628,4646,-18
1,2,16,17,2,5004,4744,260
1,2,17,17,2,4646,4781,-135
1,2,18,17,2,4744,4664,80
1,2,19,17,2,4781,4572,209
1,2,20,17,2,4664,4348,316
1,3,0,17,2,4164,3607,557
1,3,1,17,2,3613,4566,-953
1,3,2,17,2,3607,5178,-1571
1,3,3,17,2,4566,4604,-38
1,3,4,17,2,5178,4621,557
1,3,5,17,2,4604,5196,-592
1,3,6,17,2,4621,4200,421
1,3,7,17,2,5196,3360,1836
1,3,8,17,2,4200,3339,861
1,3,9,17,2,3360,3352,8
1,3,10,17,2,3339,3454,-115
1,3,11,17,2,3352,3255,97
1,3,12,17,2,3454,3517,-63
1,3,13,17,2,3255,4653,-1398
1,3,14,17,2,3517,5174,-1657
1,3,15,17,2,4653,4705,-52
1,3,16,17,2,5174,4660,514
1,3,17,17,2,4705,4811,-106
1,3,18,17,2,4660,4707,-47
1,3,19,17,2,4811,4500,311
1,3,20,17,2,4707,4402,305
1,4,0,17,2,4201,3690,511
1,4,1,17,2,3530,4676,-1146
1,4,2,17,2,3690,5091,-1401
1,4,3,17,2,4676,4493,183
1,4,4,17,2,5091,4646,445
1,4,5,17,2,4493,5432,-939
1,4,6,17,2,4646,4435,211
1,4,7,17,2,5432,3510,1922
1,4,8,17,2,4435,3483,952
1,4,9,17,2,3510,3499,11
1,4,10,17,2,3483,3627,-144
1,4,11,17,2,3499,3357,142
1,4,12,17,2,3627,3544,83
1,4,13,17,2,3357,4709,-1352
1,4,14,17,2,3544,5243,-1699
1,4,15,17,2,4709,4657,52
1,4,16,17,2,5243,4547,696
1,4,17,17,2,4657,4823,-166
1,4,18,17,2,4547,4704,-157
1,4,19,17,2,4823,4385,438
1,4,20,17,2,4704,4446,258
1,5,0,17,2,4243,3785,458
1,5,1,17,2,3458,4732,-1274
1,5,2,17,2,3785,4939,-1154
1,5,3,17,2,4732,4369,363
1,5,4,17,2,4939,4618,321
1,5,5,17,2,4369,5531,-1162
1,5,6,17,2,4618,4516,102
1,5,7,17,2,5531,3478,2053
1,5,8,17,2,4516,3460,1056
1,5,9,17,2,3478,3542,-64
1,5,10,17,2,3460,3662,-202
1,5,11,17,2,3542,3325,217
1,5,12,17,2,3662,3528,134
1,5,13,17,2,3325,4700,-1375
1,5,14,17,2,3528,5222,-1694
1,5,15,17,2,4700,4601,99
1,5,16,17,2,5222,4457,765
1,5,17,17,2,4601,4770,-169
1,5,18,17,2,4457,4669,-212
1,5,19,17,2,4770,4347,423
1,5,20,17,2,4669,4492,177
1,6,0,17,2,4178,3742,436
1,6,1,17,2,3366,4648,-1282
1,6,2,17,2,3742,4782,-1040
1,6,3,17,2,4648,4273,375
1,6,4,17,2,4782,4650,132
1,6,5,17,2,4273,5669,-1396
1,6,6,17,2,4650,4579,71
1,6,7,17,2,5669,3462,2207
1,6,8,17,2,4579,3459,1120
1,6,9,17,2,3462,3589,-127
1,6,10,17,2,3459,3731,-272
1,6,11,17,2,3589,3311,278
1,6,12,17,2,3731,3528,203
1,6,13,17,2,3311,4789,-1478
1,6,14,17,2,3528,5291,-1763
1,6,15,17,2,4789,4552,237
1,6,16,17,2,5291,4347,944
1,6,17,17,2,4552,4653,-101
1,6,18,17,2,4347,4536,-189
1,6,19,17,2,4653,4218,435
1,6,20,17,2,4536,4376,160
1,7,0,17,2,4114,3667,447
1,7,1,17,2,3256,4610,-1354
1,7,2,17,2,3667,4747,-1080
1,7,3,17,2,4610,4237,373
1,7,4,17,2,4747,4653,94
1,7,5,17,2,4237,5748,-1511
1,7,6,17,2,4653,4665,-12
1,7,7,17,2,5748,3477,2271
1,7,8,17,2,4665,3436,1229
1,7,9,17,2,3477,3643,-166
1,7,10,17,2,3436,3815,-379
1,7,11,17,2,3643,3356,287
1,7,12,17,2,3815,3578,237
1,7,13,17,2,3356,4845,-1489
1,7,14,17,2,3578,5322,-1744
1,7,15,17,2,4845,4524,321
1,7,16,17,2,5322,4301,1021
1,7,17,17,2,4524,4593,-69
1,7,18,17,2,4301,4419,-118
1,7,19,17,2,4593,4102,491
1,7,20,17,2,4419,4266,153
1,0,0,18,2,4325,3635,690
1,0,1,18,2,3899,4424,-525
1,0,2,18,2,3635,5211,-1576
1,0,3,18,2,4424,4845,-421
1,0,4,18,2,5211,4898,313
1,0,5,18,2,4845,5328,-483
1,0,6,18,2,4898,4354,544
1,0,7,18,2,5328,3568,1760
1,0,8,18,2,4354,3518,836
1,0,9,18,2,3568,3495,73
1,0,10,18,2,3518,3583,-65
1,0,11,18,2,3495,3444,51
1,0,12,18,2,3583,3799,-216
1,0,13,18,2,3444,4904,-1460
1,0,14,18,2,3799,5201,-1402
1,0,15,18,2,4904,4838,66
1,0,16,18,2,5201,4970,231
1,0,17,18,2,4838,4865,-27
1,0,18,18,2,4970,4713,257
1,0,19,18,2,4865,4764,101
1,0,20,18,2,4713,4573,140
1,1,0,18,2,4322,3701,621
1,1,1,18,2,3864,4637,-773
1,1,2,18,2,3701,5406,-1705
1,1,3,18,2,4637,4878,-241
1,1,4,18,2,5406,4885,521
1,1,5,18,2,4878,5358,-480
1,1,6,18,2,4885,4332,553
1,1,7,18,2,5358,3511,1847
1,1,8,18,2,4332,3473,859
1,1,9,18,2,3511,3482,29
1,1,10,18,2,3473,3560,-87
1,1,11,18,2,3482,3415,67
1,1,12,18,2,3560,3775,-215
1,1,13,18,2,3415,4850,-1435
1,1,14,18,2,3775,5226,-1451
1,1,15,18,2,4850,4857,-7
1,1,16,18,2,5226,4950,276
1,1,17,18,2,4857,4984,-127
1,1,18,18,2,4950,4876,74
1,1,19,18,2,4984,4797,187
1,1,20,18,2,4876,4564,312
1,2,0,18,2,4385,3826,559
1,2,1,18,2,3840,4783,-943
1,2,2,18,2,3826,5396,-1570
1,2,3,18,2,4783,4820,-37
1,2,4,18,2,5396,4847,549
1,2,5,18,2,4820,5429,-609
1,2,6,18,2,4847,4428,419
1,2,7,18,2,5429,3582,1847
1,2,8,18,2,4428,3555,873
1,2,9,18,2,3582,3565,17
1,2,10,18,2,3555,3668,-113
1,2,11,18,2,3565,3473,92
1,2,12,18,2,3668,3738,-70
1,2,13,18,2,3473,4881,-1408
1,2,14,18,2,3738,5400,-1662
1,2,15,18,2,4881,4923,-42
1,2,16,18,2,5400,4876,524
1,2,17,18,2,4923,5021,-98
1,2,18,18,2,4876,4920,-44
1,2,19,18,2,5021,4725,296
1,2,20,18,2,4920,4623,297
1,3,0,18,2,4430,3905,525
1,3,1,18,2,3757,4893,-1136
1,3,2,18,2,3905,5318,-1413
1,3,3,18,2,4893,4720,173
1,3,4,18,2,5318,4873,445
1,3,5,18,2,4720,5619,-899
1,3,6,18,2,4873,4576,297
1,3,7,18,2,5619,3645,1974
1,3,8,18,2,4576,3612,964
1,3,9,18,2,3645,3624,21
1,3,10,18,2,3612,3752,-140
1,3,11,18,2,3624,3485,139
1,3,12,18,2,3752,3676,76
1,3,13,18,2,3485,4866,-1381
1,3,14,18,2,3676,5432,-1756
1,3,15,18,2,4866,4873,-7
1,3,16,18,2,5432,4785,647
1,3,17,18,2,4873,5051,-178
1,3,18,18,2,4785,4915,-130
1,3,19,18,2,5051,4600,451
1,3,20,18,2,4915,4668,247
1,4,0,18,2,4476,4014,462
1,4,1,18,2,3691,4973,-1282
1,4,2,18,2,4014,5185,-1171
1,4,3,18,2,4973,4583,390
1,4,4,18,2,5185,4788,397
1,4,5,18,2,4583,5661,-1078
1,4,6,18,2,4788,4621,167
1,4,7,18,2,5661,3577,2084
1,4,8,18,2,4621,3553,1068
1,4,9,18,2,3577,3631,-54
1,4,10,18,2,3553,3751,-198
1,4,11,18,2,3631,3417,214
1,4,12,18,2,3751,3623,128
1,4,13,18,2,3417,4807,-1390
1,4,14,18,2,3623,5356,-1733
1,4,15,18,2,4807,4782,25
1,4,16,18,2,5356,4686,670
1,4,17,18,2,4782,5008,-226
1,4,18,18,2,4686,4894,-208
1,4,19,18,2,5008,4570,438
1,4,20,18,2,4894,4715,179
1,5,0,18,2,4414,3981,433
1,5,1,18,2,3608,4892,-1284
1,5,2,18,2,3981,5016,-1035
1,5,3,18,2,4892,4451,441
1,5,4,18,2,5016,4758,258
1,5,5,18,2,4451,5777,-1326
1,5,6,18,2,4758,4716,42
1,5,7,18,2,5777,3597,2180
1,5,8,18,2,4716,3591,1125
1,5,9,18,2,3597,3719,-122
1,5,10,18,2,3591,3861,-270
1,5,11,18,2,3719,3441,278
1,5,12,18,2,3861,3659,202
1,5,13,18,2,3441,4910,-1469
1,5,14,18,2,3659,5404,-1745
1,5,15,18,2,4910,4691,219
1,5,16,18,2,5404,4535,869
1,5,17,18,2,4691,4876,-185
1,5,18,18,2,4535,4771,-236
1,5,19,18,2,4876,4455,421
1,5,20,18,2,4771,4602,169
1,6,0,18,2,4358,3865,493
1,6,1,18,2,3489,4786,-1297
1,6,2,18,2,3865,4916,-1051
1,6,3,18,2,4786,4386,400
1,6,4,18,2,4916,4778,138
1,6,5,18,2,4386,5875,-1489
1,6,6,18,2,4778,4803,-25
1,6,7,18,2,5875,3615,2260
1,6,8,18,2,4803,3574,1229
1,6,9,18,2,3615,3781,-166
1,6,10,18,2,3574,3953,-379
1,6,11,18,2,3781,3493,288
1,6,12,18,2,3953,3714,239
1,6,13,18,2,3493,4990,-1497
1,6,14,18,2,3714,5465,-1751
1,6,15,18,2,4990,4661,329
1,6,16,18,2,5465,4459,1006
1,6,17,18,2,4661,4777,-116
1,6,18,18,2,4459,4623,-164
1,6,19,18,2,4777,4325,452
1,6,20,18,2,4623,4497,126
1,0,0,19,2,4539,3895,644
1,0,1,19,2,4067,4846,-779
1,0,2,19,2,3895,5628,-1733
1,0,3,19,2,4846,5093,-247
1,0,4,19,2,5628,5095,533
1,0,5,19,2,5093,5568,-475
1,0,6,19,2,5095,4539,556
1,0,7,19,2,5568,3716,1852
1,0,8,19,2,4539,3677,862
1,0,9,19,2,3716,3686,30
1,0,10,19,2,3677,3765,-88
1,0,11,19,2,3686,3622,64
1,0,12,19,2,3765,3984,-219
1,0,13,19,2,3622,5053,-1431
1,0,14,19,2,3984,5426,-1442
1,0,15,19,2,5053,5069,-16
1,0,16,19,2,5426,5168,258
1,0,17,19,2,5069,5190,-121
1,0,18,19,2,5168,5077,91
1,0,19,19,2,5190,5009,181
1,0,20,19,2,5077,4775,302
1,1,0,19,2,4602,4039,563
1,1,1,19,2,4058,5001,-943
1,1,2,19,2,4039,5616,-1577
1,1,3,19,2,5001,5030,-29
1,1,4,19,2,5616,5056,560
1,1,5,19,2,5030,5644,-614
1,1,6,19,2,5056,4642,414
1,1,7,19,2,5644,3792,1852
1,1,8,19,2,4642,3762,880
1,1,9,19,2,3792,3771,21
1,1,10,19,2,3762,3875,-113
1,1,11,19,2,3771,3682,89
1,1,12,19,2,3875,3950,-75
1,1,13,19,2,3682,5103,-1421
1,1,14,19,2,3950,5622,-1672
1,1,15,19,2,5103,5134,-31
1,1,16,19,2,5622,5082,540
1,1,17,19,2,5134,5224,-90
1,1,18,19,2,5082,5132,-50
1,1,19,19,2,5224,4950,274
1,1,20,19,2,5132,4839,293
1,2,0,19,2,4651,4124,527
1,2,1,19,2,3984,5110,-1126
1,2,2,19,2,4124,5536,-1412
1,2,3,19,2,5110,4936,174
1,2,4,19,2,5536,5099,437
1,2,5,19,2,4936,5852,-916
1,2,6,19,2,5099,4804,295
1,2,7,19,2,5852,3867,1985
1,2,8,19,2,4804,3828,976
1,2,9,19,2,3867,3837,30
1,2,10,19,2,3828,3966,-138
1,2,11,19,2,3837,3703,134
1,2,12,19,2,3966,3897,69
1,2,13,19,2,3703,5094,-1391
1,2,14,19,2,3897,5658,-1761
1,2,15,19,2,5094,5091,3
1,2,16,19,2,5658,5001,657
1,2,17,19,2,5091,5261,-170
1,2,18,19,2,5001,5128,-127
1,2,19,19,2,5261,4825,436
1,2,20,19,2,5128,4889,239
1,3,0,19,2,4705,4229,476
1,3,1,19,2,3918,5190,-1272
1,3,2,19,2,4229,5412,-1183
1,3,3,19,2,5190,4810,380
1,3,4,19,2,5412,5015,397
1,3,5,19,2,4810,5848,-1038
1,3,6,19,2,5015,4762,253
1,3,7,19,2,5848,3712,2136
1,3,8,19,2,4762,3682,1080
1,3,9,19,2,3712,3756,-44
1,3,10,19,2,3682,3876,-194
1,3,11,19,2,3756,3545,211
1,3,12,19,2,3876,3755,121
1,3,13,19,2,3545,4964,-1419
1,3,14,19,2,3755,5545,-1790
1,3,15,19,2,4964,4998,-34
1,3,16,19,2,5545,4924,621
1,3,17,19,2,4998,5236,-238
1,3,18,19,2,4924,5105,-181
1,3,19,19,2,5236,4785,451
1,3,20,19,2,5105,4937,168
1,4,0,19,2,4647,4210,437
1,4,1,19,2,3841,5133,-1292
1,4,2,19,2,4210,5262,-1052
1,4,3,19,2,5133,4665,468
1,4,4,19,2,5262,4928,334
1,4,5,19,2,4665,5907,-1242
1,4,6,19,2,4928,4821,107
1,4,7,19,2,5907,3696,2211
1,4,8,19,2,4821,3684,1137
1,4,9,19,2,3696,3808,-112
1,4,10,19,2,3684,3950,-266
1,4,11,19,2,3808,3533,275
1,4,12,19,2,3950,3754,196
1,4,13,19,2,3533,5017,-1484
1,4,14,19,2,3754,5538,-1784
1,4,15,19,2,5017,4872,145
1,4,16,19,2,5538,4764,774
1,4,17,19,2,4872,5114,-242
1,4,18,19,2,4764,4996,-232
1,4,19,19,2,5114,4678,436
1,4,20,19,2,4996,4825,171
1,5,0,19,2,4594,4104,490
1,5,1,19,2,3731,5030,-1299
1,5,2,19,2,4104,5150,-1046
1,5,3,19,2,5030,4564,466
1,5,4,19,2,5150,4886,264
1,5,5,19,2,4564,5983,-1419
1,5,6,19,2,4886,4940,-54
1,5,7,19,2,5983,3750,2233
1,5,8,19,2,4940,3706,1234
1,5,9,19,2,3750,3911,-161
1,5,10,19,2,3706,4083,-377
1,5,11,19,2,3911,3623,288
1,5,12,19,2,4083,3845,238
1,5,13,19,2,3623,5111,-1488
1,5,14,19,2,3845,5578,-1733
1,5,15,19,2,5111,4800,311
1,5,16,19,2,5578,4647,931
1,5,17,19,2,4800,5000,-200
1,5,18,19,2,4647,4858,-211
1,5,19,19,2,5000,4562,438
1,5,20,19,2,4858,4723,135
1,0,0,20,2,4819,4233,586
1,0,1,20,2,4261,5210,-949
1,0,2,20,2,4233,5838,-1605
1,0,3,20,2,5210,5245,-35
1,0,4,20,2,5838,5266,572
1,0,5,20,2,5245,5854,-609
1,0,6,20,2,5266,4849,417
1,0,7,20,2,5854,3997,1857
1,0,8,20,2,4849,3966,883
1,0,9,20,2,3997,3975,22
1,0,10,20,2,3966,4080,-114
1,0,11,20,2,3975,3889,86
1,0,12,20,2,4080,4159,-79
1,0,13,20,2,3889,5306,-1417
1,0,14,20,2,4159,5822,-1663
1,0,15,20,2,5306,5346,-40
1,0,16,20,2,5822,5300,522
1,0,17,20,2,5346,5430,-84
1,0,18,20,2,5300,5333,-33
1,0,19,20,2,5430,5162,268
1,0,20,20,2,5333,5050,283
1,1,0,20,2,4868,4337,531
1,1,1,20,2,4202,5328,-1126
1,1,2,20,2,4337,5756,-1419
1,1,3,20,2,5328,5146,182
1,1,4,20,2,5756,5308,448
1,1,5,20,2,5146,6067,-921
1,1,6,20,2,5308,5018,290
1,1,7,20,2,6067,4077,1990
1,1,8,20,2,5018,4035,983
1,1,9,20,2,4077,4043,34
1,1,10,20,2,4035,4173,-138
1,1,11,20,2,4043,3912,131
1,1,12,20,2,4173,4109,64
1,1,13,20,2,3912,5316,-1404
1,1,14,20,2,4109,5880,-1771
1,1,15,20,2,5316,5302,14
1,1,16,20,2,5880,5207,673
1,1,17,20,2,5302,5464,-162
1,1,18,20,2,5207,5340,-133
1,1,19,20,2,5464,5050,414
1,1,20,20,2,5340,5105,235
1,2,0,20,2,4926,4448,478
1,2,1,20,2,4145,5407,-1262
1,2,2,20,2,4448,5630,-1182
1,2,3,20,2,5407,5026,381
1,2,4,20,2,5630,5241,389
1,2,5,20,2,5026,6081,-1055
1,2,6,20,2,5241,4990,251
1,2,7,20,2,6081,3934,2147
1,2,8,20,2,4990,3898,1092
1,2,9,20,2,3934,3969,-35
1,2,10,20,2,3898,4090,-192
1,2,11,20,2,3969,3763,206
1,2,12,20,2,4090,3976,114
1,2,13,20,2,3763,5192,-1429
1,2,14,20,2,3976,5771,-1795
1,2,15,20,2,5192,5216,-24
1,2,16,20,2,5771,5140,631
1,2,17,20,2,5216,5446,-230
1,2,18,20,2,5140,5318,-178
1,2,19,20,2,5446,5010,436
1,2,20,20,2,5318,5158,160
1,3,0,20,2,4876,4425,451
1,3,1,20,2,4068,5350,-1282
1,3,2,20,2,4425,5489,-1064
1,3,3,20,2,5350,4892,458
1,3,4,20,2,5489,5155,334
1,3,5,20,2,4892,6094,-1202
1,3,6,20,2,5155,4962,193
1,3,7,20,2,6094,3831,2263
1,3,8,20,2,4962,3813,1149
1,3,9,20,2,3831,3933,-102
1,3,10,20,2,3813,4075,-262
1,3,11,20,2,3933,3661,272
1,3,12,20,2,4075,3886,189
1,3,13,20,2,3661,5174,-1513
1,3,14,20,2,3886,5727,-1841
1,3,15,20,2,5174,5088,86
1,3,16,20,2,5727,5002,725
1,3,17,20,2,5088,5342,-254
1,3,18,20,2,5002,5207,-205
1,3,19,20,2,5342,4893,449
1,3,20,20,2,5207,5047,160
1,4,0,20,2,4827,4333,494
1,4,1,20,2,3964,5271,-1307
1,4,2,20,2,4333,5396,-1063
1,4,3,20,2,5271,4778,493
1,4,4,20,2,5396,5056,340
1,4,5,20,2,4778,6113,-1335
1,4,6,20,2,5056,5045,11
1,4,7,20,2,6113,3849,2264
1,4,8,20,2,5045,3799,1246
1,4,9,20,2,3849,4000,-151
1,4,10,20,2,3799,4172,-373
1,4,11,20,2,4000,3715,285
1,4,12,20,2,4172,3940,232
1,4,13,20,2,3715,5218,-1503
1,4,14,20,2,3940,5712,-1772
1,4,15,20,2,5218,4981,237
1,4,16,20,2,5712,4876,836
1,4,17,20,2,4981,5238,-257
1,4,18,20,2,4876,5083,-207
1,4,19,20,2,5238,4785,453
1,4,20,20,2,5083,4946,137
1,0,0,21,2,5085,4531,554
1,0,1,21,2,4405,5537,-1132
1,0,2,21,2,4531,5978,-1447
1,0,3,21,2,5537,5361,176
1,0,4,21,2,5978,5518,460
1,0,5,21,2,5361,6277,-916
1,0,6,21,2,5518,5225,293
1,0,7,21,2,6277,4282,1995
1,0,8,21,2,5225,4239,986
1,0,9,21,2,4282,4247,35
1,0,10,21,2,4239,4378,-139
1,0,11,21,2,4247,4119,128
1,0,12,21,2,4378,4318,60
1,0,13,21,2,4119,5519,-1400
1,0,14,21,2,4318,6080,-1762
1,0,15,21,2,5519,5514,5
1,0,16,21,2,6080,5425,655
1,0,17,21,2,5514,5670,-156
1,0,18,21,2,5425,5541,-116
1,0,19,21,2,5670,5262,408
1,0,20,21,2,5541,5316,225
1,1,0,21,2,5143,4661,482
1,1,1,21,2,4363,5625,-1262
1,1,2,21,2,4661,5850,-1189
1,1,3,21,2,5625,5236,389
1,1,4,21,2,5850,5450,400
1,1,5,21,2,5236,6296,-1060
1,1,6,21,2,5450,5204,246
1,1,7,21,2,6296,4144,2152
1,1,8,21,2,5204,4105,1099
1,1,9,21,2,4144,4175,-31
1,1,10,21,2,4105,4297,-192
1,1,11,21,2,4175,3972,203
1,1,12,21,2,4297,4188,109
1,1,13,21,2,3972,5414,-1442
1,1,14,21,2,4188,5993,-1805
1,1,15,21,2,5414,5427,-13
1,1,16,21,2,5993,5346,647
1,1,17,21,2,5427,5649,-222
1,1,18,21,2,5346,5530,-184
1,1,19,21,2,5649,5235,414
1,1,20,21,2,5530,5374,156
1,2,0,21,2,5097,4644,453
1,2,1,21,2,4295,5567,-1272
1,2,2,21,2,4644,5707,-1063
1,2,3,21,2,5567,5108,459
1,2,4,21,2,5707,5381,326
1,2,5,21,2,5108,6327,-1219
1,2,6,21,2,5381,5190,191
1,2,7,21,2,6327,4053,2274
1,2,8,21,2,5190,4029,1161
1,2,9,21,2,4053,4146,-93
1,2,10,21,2,4029,4289,-260
1,2,11,21,2,4146,3879,267
1,2,12,21,2,4289,4107,182
1,2,13,21,2,3879,5402,-1523
1,2,14,21,2,4107,5953,-1846
1,2,15,21,2,5402,5306,96
1,2,16,21,2,5953,5218,735
1,2,17,21,2,5306,5552,-246
1,2,18,21,2,5218,5420,-202
1,2,19,21,2,5552,5118,434
1,2,20,21,2,5420,5268,152
1,3,0,21,2,5056,4548,508
1,3,1,21,2,4191,5488,-1297
1,3,2,21,2,4548,5623,-1075
1,3,3,21,2,5488,5005,483
1,3,4,21,2,5623,5283,340
1,3,5,21,2,5005,6300,-1295
1,3,6,21,2,5283,5186,97
1,3,7,21,2,6300,3984,2316
1,3,8,21,2,5186,3928,1258
1,3,9,21,2,3984,4125,-141
1,3,10,21,2,3928,4297,-369
1,3,11,21,2,4125,3843,282
1,3,12,21,2,4297,4072,225
1,3,13,21,2,3843,5375,-1532
1,3,14,21,2,4072,5901,-1829
1,3,15,21,2,5375,5197,178
1,3,16,21,2,5901,5114,787
1,3,17,21,2,5197,5466,-269
1,3,18,21,2,5114,5294,-180
1,3,19,21,2,5466,5000,466
1,3,20,21,2,5294,5168,126
1,0,0,22,2,5360,4855,505
1,0,1,22,2,4566,5834,-1268
1,0,2,22,2,4855,6072,-1217
1,0,3,22,2,5834,5451,383
1,0,4,22,2,6072,5660,412
1,0,5,22,2,5451,6506,-1055
1,0,6,22,2,5660,5411,249
1,0,7,22,2,6506,4349,2157
1,0,8,22,2,5411,4309,1102
1,0,9,22,2,4349,4379,-30
1,0,10,22,2,4309,4502,-193
1,0,11,22,2,4379,4179,200
1,0,12,22,2,4502,4397,105
1,0,13,22,2,4179,5617,-1438
1,0,14,22,2,4397,6193,-1796
1,0,15,22,2,5617,5639,-22
1,0,16,22,2,6193,5564,629
1,0,17,22,2,5639,5855,-216
1,0,18,22,2,5564,5731,-167
1,0,19,22,2,5855,5447,408
1,0,20,22,2,5731,5585,146
1,1,0,22,2,5314,4857,457
1,1,1,22,2,4513,5785,-1272
1,1,2,22,2,4857,5927,-1070
1,1,3,22,2,5785,5318,467
1,1,4,22,2,5927,5590,337
1,1,5,22,2,5318,6542,-1224
1,1,6,22,2,5590,5404,186
1,1,7,22,2,6542,4263,2279
1,1,8,22,2,5404,4236,1168
1,1,9,22,2,4263,4352,-89
1,1,10,22,2,4236,4496,-260
1,1,11,22,2,4352,4088,264
1,1,12,22,2,4496,4319,177
1,1,13,22,2,4088,5624,-1536
1,1,14,22,2,4319,6175,-1856
1,1,15,22,2,5624,5517,107
1,1,16,22,2,6175,5424,751
1,1,17,22,2,5517,5755,-238
1,1,18,22,2,5424,5632,-208
1,1,19,22,2,5755,5343,412
1,1,20,22,2,5632,5484,148
1,2,0,22,2,5277,4767,510
1,2,1,22,2,4418,5705,-1287
1,2,2,22,2,4767,5841,-1074
1,2,3,22,2,5705,5221,484
1,2,4,22,2,5841,5509,332
1,2,5,22,2,5221,6533,-1312
1,2,6,22,2,5509,5414,95
1,2,7,22,2,6533,4206,2327
1,2,8,22,2,5414,4144,1270
1,2,9,22,2,4206,4338,-132
1,2,10,22,2,4144,4511,-367
1,2,11,22,2,4338,4061,277
1,2,12,22,2,4511,4293,218
1,2,13,22,2,4061,5603,-1542
1,2,14,22,2,4293,6127,-1834
1,2,15,22,2,5603,5415,188
1,2,16,22,2,6127,5330,797
1,2,17,22,2,5415,5676,-261
1,2,18,22,2,5330,5507,-177
1,2,19,22,2,5676,5225,451
1,2,20,22,2,5507,5389,118
1,0,0,23,2,5531,5051,480
1,0,1,23,2,4716,5994,-1278
1,0,2,23,2,5051,6149,-1098
1,0,3,23,2,5994,5533,461
1,0,4,23,2,6149,5800,349
1,0,5,23,2,5533,6752,-1219
1,0,6,23,2,5800,5611,189
1,0,7,23,2,6752,4468,2284
1,0,8,23,2,5611,4440,1171
1,0,9,23,2,4468,4556,-88
1,0,10,23,2,4440,4701,-261
1,0,11,23,2,4556,4295,261
1,0,12,23,2,4701,4528,173
1,0,13,23,2,4295,5827,-1532
1,0,14,23,2,4528,6375,-1847
1,0,15,23,2,5827,5729,98
1,0,16,23,2,6375,5642,733
1,0,17,23,2,5729,5961,-232
1,0,18,23,2,5642,5833,-191
1,0,19,23,2,5961,5555,406
1,0,20,23,2,5833,5695,138
1,1,0,23,2,5494,4980,514
1,1,1,23,2,4636,5923,-1287
1,1,2,23,2,4980,6061,-1081
1,1,3,23,2,5923,5431,492
1,1,4,23,2,6061,5718,343
1,1,5,23,2,5431,6748,-1317
1,1,6,23,2,5718,5628,90
1,1,7,23,2,6748,4416,2332
1,1,8,23,2,5628,4351,1277
1,1,9,23,2,4416,4544,-128
1,1,10,23,2,4351,4718,-367
1,1,11,23,2,4544,4270,274
1,1,12,23,2,4718,4505,213
1,1,13,23,2,4270,5825,-1555
1,1,14,23,2,4505,6349,-1844
1,1,15,23,2,5825,5626,199
1,1,16,23,2,6349,5536,813
1,1,17,23,2,5626,5879,-253
1,1,18,23,2,5536,5719,-183
1,1,19,23,2,5879,5450,429
1,1,20,23,2,5719,5605,114
1,0,0,24,2,5711,5174,537
1,0,1,24,2,4839,6132,-1293
1,0,2,24,2,5174,6283,-1109
1,0,3,24,2,6132,5646,486
1,0,4,24,2,6283,5928,355
1,0,5,24,2,5646,6958,-1312
1,0,6,24,2,5928,5835,93
1,0,7,24,2,6958,4621,2337
1,0,8,24,2,5835,4555,1280
1,0,9,24,2,4621,4748,-127
1,0,10,24,2,4555,4923,-368
1,0,11,24,2,4748,4477,271
1,0,12,24,2,4923,4714,209
1,0,13,24,2,4477,6028,-1551
1,0,14,24,2,4714,6549,-1835
1,0,15,24,2,6028,5838,190
1,0,16,24,2,6549,5754,795
1,0,17,24,2,5838,6085,-247
1,0,18,24,2,5754,5920,-166
1,0,19,24,2,6085,5662,423
1,0,20,24,2,5920,5816,104
1,0,0,1,3,313,320,-7
1,0,1,1,3,301,326,-25
1,0,2,1,3,305,321,-16
1,0,3,1,3,320,314,6
1,0,4,1,3,326,313,13
1,0,5,1,3,321,309,12
1,0,6,1,3,314,307,7
1,0,7,1,3,313,306,7
1,0,8,1,3,309,307,2
1,0,9,1,3,307,309,-2
1,0,10,1,3,306,312,-6
1,0,11,1,3,307,307,0
1,0,12,1,3,309,305,4
1,0,13,1,3,312,310,2
1,0,14,1,3,307,320,-13
1,0,15,1,3,305,316,-11
1,0,16,1,3,310,309,1
1,0,17,1,3,320,310,10
1,0,18,1,3,316,314,2
1,1,0,1,3,324,326,-2
1,1,1,1,3,324,322,2
1,1,2,1,3,325,317,8
1,1,3,1,3,326,317,9
1,1,4,1,3,322,321,1
1,1,5,1,3,317,318,-1
1,1,6,1,3,317,313,4
1,1,7,1,3,321,310,11
1,1,8,1,3,318,310,8
1,1,9,1,3,313,312,1
1,1,10,1,3,310,316,-6
1,1,11,1,3,310,327,-17
1,1,12,1,3,312,329,-17
1,1,13,1,3,316,326,-10
1,1,14,1,3,327,313,14
1,1,15,1,3,329,307,22
1,1,16,1,3,326,314,12
1,1,17,1,3,313,326,-13
1,1,18,1,3,307,327,-20
1,2,0,1,3,333,325,8
1,2,1,1,3,334,326,8
1,2,2,1,3,329,334,-5
1,2,3,1,3,325,341,-16
1,2,4,1,3,326,346,-20
1,2,5,1,3,334,337,-3
1,2,6,1,3,341,329,12
1,2,7,1,3,346,322,24
1,2,8,1,3,337,321,16
1,2,9,1,3,329,324,5
1,2,10,1,3,322,329,-7
1,2,11,1,3,321,338,-17
1,2,12,1,3,324,337,-13
1,2,13,1,3,329,335,-6
1,2,14,1,3,338,325,13
1,2,15,1,3,337,319,18
1,2,16,1,3,335,320,15
1,2,17,1,3,325,328,-3
1,2,18,1,3,319,331,-12
1,3,0,1,3,339,332,7
1,3,1,1,3,332,339,-7
1,3,2,1,3,327,342,-15
1,3,3,1,3,332,299,33
1,3,4,1,3,339,256,83
1,3,5,1,3,342,207,135
1,3,6,1,3,299,198,101
1,3,7,1,3,256,191,65
1,3,8,1,3,207,188,19
1,3,9,1,3,198,190,8
1,3,10,1,3,191,195,-4
1,3,11,1,3,188,222,-34
1,3,12,1,3,190,256,-66
1,3,13,1,3,195,306,-111
1,3,14,1,3,222,337,-115
1,3,15,1,3,256,345,-89
1,3,16,1,3,306,332,-26
1,3,17,1,3,337,322,15
1,3,18,1,3,345,326,19
1,4,0,1,3,347,361,-14
1,4,1,1,3,348,340,8
1,4,2,1,3,355,290,65
1,4,3,1,3,361,224,137
1,4,4,1,3,340,181,159
1,4,5,1,3,290,153,137
1,4,6,1,3,224,144,80
1,4,7,1,3,181,137,44
1,4,8,1,3,153,134,19
1,4,9,1,3,144,136,8
1,4,10,1,3,137,140,-3
1,4,11,1,3,134,154,-20
1,4,12,1,3,136,182,-46
1,4,13,1,3,140,240,-100
1,4,14,1,3,154,304,-150
1,4,15,1,3,182,344,-162
1,4,16,1,3,240,348,-108
1,4,17,1,3,304,338,-34
1,4,18,1,3,344,333,11
1,5,0,1,3,356,353,3
1,5,1,1,3,361,303,58
1,5,2,1,3,364,217,147
1,5,3,1,3,353,177,176
1,5,4,1,3,303,176,127
1,5,5,1,3,217,204,13
1,5,6,1,3,177,200,-23
1,5,7,1,3,176,197,-21
1,5,8,1,3,204,195,9
1,5,9,1,3,200,195,5
1,5,10,1,3,197,196,1
1,5,11,1,3,195,186,9
1,5,12,1,3,195,179,16
1,5,13,1,3,196,194,2
1,5,14,1,3,186,246,-60
1,5,15,1,3,179,304,-125
1,5,16,1,3,194,342,-148
1,5,17,1,3,246,353,-107
1,5,18,1,3,304,345,-41
1,6,0,1,3,353,258,95
1,6,1,1,3,322,236,86
1,6,2,1,3,285,207,78
1,6,3,1,3,258,194,64
1,6,4,1,3,236,196,40
1,6,5,1,3,207,207,0
1,6,6,1,3,194,207,-13
1,6,7,1,3,196,207,-11
1,6,8,1,3,207,207,0
1,6,9,1,3,207,206,1
1,6,10,1,3,207,205,2
1,6,11,1,3,207,213,-6
1,6,12,1,3,206,211,-5
1,6,13,1,3,205,214,-9
1,6,14,1,3,213,224,-11
1,6,15,1,3,211,255,-44
1,6,16,1,3,214,291,-77
1,6,17,1,3,224,320,-96
1,6,18,1,3,255,338,-83
1,7,0,1,3,345,146,199
1,7,1,1,3,264,179,85
1,7,2,1,3,179,244,-65
1,7,3,1,3,146,282,-136
1,7,4,1,3,179,296,-117
1,7,5,1,3,244,288,-44
1,7,6,1,3,282,292,-10
1,7,7,1,3,296,295,1
1,7,8,1,3,288,296,-8
1,7,9,1,3,292,294,-2
1,7,10,1,3,295,291,4
1,7,11,1,3,296,292,4
1,7,12,1,3,294,279,15
1,7,13,1,3,291,262,29
1,7,14,1,3,292,240,52
1,7,15,1,3,279,228,51
1,7,16,1,3,262,233,29
1,7,17,1,3,240,266,-26
1,7,18,1,3,228,319,-91
1,8,0,1,3,388,235,153
1,8,1,1,3,340,292,48
1,8,2,1,3,262,350,-88
1,8,3,1,3,235,383,-148
1,8,4,1,3,292,383,-91
1,8,5,1,3,350,392,-42
1,8,6,1,3,383,402,-19
1,8,7,1,3,383,413,-30
1,8,8,1,3,392,429,-37
1,8,9,1,3,402,430,-28
1,8,10,1,3,413,422,-9
1,8,11,1,3,429,410,19
1,8,12,1,3,430,403,27
1,8,13,1,3,422,394,28
1,8,14,1,3,410,353,57
1,8,15,1,3,403,321,82
1,8,16,1,3,394,320,74
1,8,17,1,3,353,345,8
1,8,18,1,3,321,377,-56
1,9,0,1,3,244,139,105
1,9,1,1,3,181,140,41
1,9,2,1,3,153,166,-13
1,9,3,1,3,139,175,-36
1,9,4,1,3,140,172,-32
1,9,5,1,3,166,134,32
1,9,6,1,3,175,106,69
1,9,7,1,3,172,104,68
1,9,8,1,3,134,103,31
1,9,9,1,3,106,94,12
1,9,10,1,3,104,108,-4
1,9,11,1,3,103,139,-36
1,9,12,1,3,94,178,-84
1,9,13,1,3,108,183,-75
1,9,14,1,3,139,171,-32
1,9,15,1,3,178,156,22
1,9,16,1,3,183,158,25
1,9,17,1,3,171,187,-16
1,9,18,1,3,156,239,-83
1,10,0,1,3,208,342,-134
1,10,1,1,3,180,389,-209
1,10,2,1,3,284,398,-114
1,10,3,1,3,342,422,-80
1,10,4,1,3,389,427,-38
1,10,5,1,3,398,402,-4
1,10,6,1,3,422,379,43
1,10,7,1,3,427,376,51
1,10,8,1,3,402,376,26
1,10,9,1,3,379,381,-2
1,10,10,1,3,376,385,-9
1,10,11,1,3,376,398,-22
1,10,12,1,3,381,423,-42
1,10,13,1,3,385,406,-21
1,10,14,1,3,398,381,17
1,10,15,1,3,423,347,76
1,10,16,1,3,406,317,89
1,10,17,1,3,381,296,85
1,10,18,1,3,347,287,60
1,11,0,1,3,329,551,-222
1,11,1,1,3,313,651,-338
1,11,2,1,3,466,628,-162
1,11,3,1,3,551,669,-118
1,11,4,1,3,651,624,27
1,11,5,1,3,628,588,40
1,11,6,1,3,669,550,119
1,11,7,1,3,624,563,61
1,11,8,1,3,588,569,19
1,11,9,1,3,550,575,-25
1,11,10,1,3,563,573,-10
1,11,11,1,3,569,615,-46
1,11,12,1,3,575,667,-92
1,11,13,1,3,573,662,-89
1,11,14,1,3,615,631,-16
1,11,15,1,3,667,608,59
1,11,16,1,3,662,593,69
1,11,17,1,3,631,555,76
1,11,18,1,3,608,476,132
1,12,0,1,3,402,564,-162
1,12,1,1,3,377,651,-274
1,12,2,1,3,467,638,-171
1,12,3,1,3,564,669,-105
1,12,4,1,3,651,567,84
1,12,5,1,3,638,457,181
1,12,6,1,3,669,340,329
1,12,7,1,3,567,360,207
1,12,8,1,3,457,357,100
1,12,9,1,3,340,345,-5
1,12,10,1,3,360,373,-13
1,12,11,1,3,357,513,-156
1,12,12,1,3,345,648,-303
1,12,13,1,3,373,689,-316
1,12,14,1,3,513,660,-147
1,12,15,1,3,648,640,8
1,12,16,1,3,689,637,52
1,12,17,1,3,660,614,46
1,12,18,1,3,640,527,113
1,13,0,1,3,415,563,-148
1,13,1,1,3,392,610,-218
1,13,2,1,3,420,656,-236
1,13,3,1,3,563,652,-89
1,13,4,1,3,610,582,28
1,13,5,1,3,656,455,201
1,13,6,1,3,652,299,353
1,13,7,1,3,582,309,273
1,13,8,1,3,455,299,156
1,13,9,1,3,299,297,2
1,13,10,1,3,309,344,-35
1,13,11,1,3,299,497,-198
1,13,12,1,3,297,623,-326
1,13,13,1,3,344,684,-340
1,13,14,1,3,497,648,-151
1,13,15,1,3,623,608,15
1,13,16,1,3,684,578,106
1,13,17,1,3,648,562,86
1,13,18,1,3,608,519,89
1,14,0,1,3,436,552,-116
1,14,1,1,3,406,573,-167
1,14,2,1,3,413,628,-215
1,14,3,1,3,552,610,-58
1,14,4,1,3,573,567,6
1,14,5,1,3,628,463,165
1,14,6,1,3,610,320,290
1,14,7,1,3,567,329,238
1,14,8,1,3,463,314,149
1,14,9,1,3,320,325,-5
1,14,10,1,3,329,371,-42
1,14,11,1,3,314,500,-186
1,14,12,1,3,325,576,-251
1,14,13,1,3,371,651,-280
1,14,14,1,3,500,623,-123
1,14,15,1,3,576,596,-20
1,14,16,1,3,651,561,90
1,14,17,1,3,623,549,74
1,14,18,1,3,596,550,46
1,15,0,1,3,422,576,-154
1,15,1,1,3,395,621,-226
1,15,2,1,3,433,651,-218
1,15,3,1,3,576,639,-63
1,15,4,1,3,621,558,63
1,15,5,1,3,651,439,212
1,15,6,1,3,639,295,344
1,15,7,1,3,558,317,241
1,15,8,1,3,439,291,148
1,15,9,1,3,295,283,12
1,15,10,1,3,317,338,-21
1,15,11,1,3,291,501,-210
1,15,12,1,3,283,586,-303
1,15,13,1,3,338,673,-335
1,15,14,1,3,501,641,-140
1,15,15,1,3,586,619,-33
1,15,16,1,3,673,570,103
1,15,17,1,3,641,533,108
1,15,18,1,3,619,525,94
1,16,0,1,3,297,587,-290
1,16,1,1,3,308,598,-290
1,16,2,1,3,413,627,-214
1,16,3,1,3,587,617,-30
1,16,4,1,3,598,594,4
1,16,5,1,3,627,463,164
1,16,6,1,3,617,318,299
1,16,7,1,3,594,338,256
1,16,8,1,3,463,333,130
1,16,9,1,3,318,337,-19
1,16,10,1,3,338,384,-46
1,16,11,1,3,333,526,-193
1,16,12,1,3,337,598,-261
1,16,13,1,3,384,613,-229
1,16,14,1,3,526,576,-50
1,16,15,1,3,598,562,36
1,16,16,1,3,613,541,72
1,16,17,1,3,576,441,135
1,16,18,1,3,562,425,137
1,17,0,1,3,246,544,-298
1,17,1,1,3,284,510,-226
1,17,2,1,3,416,534,-118
1,17,3,1,3,544,539,5
1,17,4,1,3,510,498,12
1,17,5,1,3,534,377,157
1,17,6,1,3,539,248,291
1,17,7,1,3,498,260,238
1,17,8,1,3,377,233,144
1,17,9,1,3,248,227,21
1,17,10,1,3,260,284,-24
1,17,11,1,3,233,443,-210
1,17,12,1,3,227,543,-316
1,17,13,1,3,284,478,-194
1,17,14,1,3,443,396,47
1,17,15,1,3,543,409,134
1,17,16,1,3,478,500,-22
1,17,17,1,3,396,433,-37
1,17,18,1,3,409,414,-5
1,18,0,1,3,290,601,-311
1,18,1,1,3,352,486,-134
1,18,2,1,3,498,376,122
1,18,3,1,3,601,309,292
1,18,4,1,3,486,313,173
1,18,5,1,3,376,260,116
1,18,6,1,3,309,232,77
1,18,7,1,3,313,266,47
1,18,8,1,3,260,266,-6
1,18,9,1,3,232,285,-53
1,18,10,1,3,266,260,6
1,18,11,1,3,266,252,14
1,18,12,1,3,285,307,-22
1,18,13,1,3,260,298,-38
1,18,14,1,3,252,356,-104
1,18,15,1,3,307,398,-91
1,18,16,1,3,298,489,-191
1,18,17,1,3,356,445,-89
1,18,18,1,3,398,366,32
1,19,0,1,3,384,444,-60
1,19,1,1,3,428,282,146
1,19,2,1,3,468,251,217
1,19,3,1,3,444,358,86
1,19,4,1,3,282,409,-127
1,19,5,1,3,251,468,-217
1,19,6,1,3,358,412,-54
1,19,7,1,3,409,447,-38
1,19,8,1,3,468,446,22
1,19,9,1,3,412,425,-13
1,19,10,1,3,447,332,115
1,19,11,1,3,446,363,83
1,19,12,1,3,425,461,-36
1,19,13,1,3,332,465,-133
1,19,14,1,3,363,340,23
1,19,15,1,3,461,309,152
1,19,16,1,3,465,319,146
1,19,17,1,3,340,330,10
1,19,18,1,3,309,354,-45
1,20,0,1,3,334,370,-36
1,20,1,1,3,374,213,161
1,20,2,1,3,395,295,100
1,20,3,1,3,370,496,-126
1,20,4,1,3,213,555,-342
1,20,5,1,3,295,529,-234
1,20,6,1,3,496,405,91
1,20,7,1,3,555,425,130
1,20,8,1,3,529,418,111
1,20,9,1,3,405,382,23
1,20,10,1,3,425,305,120
1,20,11,1,3,418,297,121
1,20,12,1,3,382,333,49
1,20,13,1,3,305,306,-1
1,20,14,1,3,297,245,52
1,20,15,1,3,333,288,45
1,20,16,1,3,306,285,21
1,20,17,1,3,245,263,-18
1,20,18,1,3,288,311,-23
1,21,0,1,3,364,329,35
1,21,1,1,3,396,152,244
1,21,2,1,3,386,174,212
1,21,3,1,3,329,287,42
1,21,4,1,3,152,270,-118
1,21,5,1,3,174,212,-38
1,21,6,1,3,287,111,176
1,21,7,1,3,270,158,112
1,21,8,1,3,212,168,44
1,21,9,1,3,111,148,-37
1,21,10,1,3,158,115,43
1,21,11,1,3,168,122,46
1,21,12,1,3,148,168,-20
1,21,13,1,3,115,168,-53
1,21,14,1,3,122,209,-87
1,21,15,1,3,168,240,-72
1,21,16,1,3,168,274,-106
1,21,17,1,3,209,286,-77
1,21,18,1,3,240,358,-118
1,22,0,1,3,247,197,50
1,22,1,1,3,270,122,148
1,22,2,1,3,236,177,59
1,22,3,1,3,197,291,-94
1,22,4,1,3,122,295,-173
1,22,5,1,3,177,270,-93
1,22,6,1,3,291,180,111
1,22,7,1,3,295,247,48
1,22,8,1,3,270,260,10
1,22,9,1,3,180,232,-52
1,22,10,1,3,247,214,33
1,22,11,1,3,260,243,17
1,22,12,1,3,232,280,-48
1,22,13,1,3,214,202,12
1,22,14,1,3,243,148,95
1,22,15,1,3,280,126,154
1,22,16,1,3,202,160,42
1,22,17,1,3,148,156,-8
1,22,18,1,3,126,164,-38
1,23,0,1,3,234,203,31
1,23,1,1,3,192,182,10
1,23,2,1,3,192,193,-1
1,23,3,1,3,203,254,-51
1,23,4,1,3,182,304,-122
1,23,5,1,3,193,279,-86
1,23,6,1,3,254,213,41
1,23,7,1,3,304,247,57
1,23,8,1,3,279,282,-3
1,23,9,1,3,213,314,-101
1,23,10,1,3,247,276,-29
1,23,11,1,3,282,293,-11
1,23,12,1,3,314,268,46
1,23,13,1,3,276,216,60
1,23,14,1,3,293,179,114
1,23,15,1,3,268,166,102
1,23,16,1,3,216,157,59
1,23,17,1,3,179,161,18
1,23,18,1,3,166,154,12
1,0,0,2,3,637,646,-9
1,0,1,2,3,625,648,-23
1,0,2,2,3,630,638,-8
1,0,3,2,3,646,631,15
1,0,4,2,3,648,634,14
1,0,5,2,3,638,627,11
1,0,6,2,3,631,620,11
1,0,7,2,3,634,616,18
1,0,8,2,3,627,617,10
1,0,9,2,3,620,621,-1
1,0,10,2,3,616,628,-12
1,0,11,2,3,617,634,-17
1,0,12,2,3,621,634,-13
1,0,13,2,3,628,636,-8
1,0,14,2,3,634,633,1
1,0,15,2,3,634,623,11
1,0,16,2,3,636,623,13
1,0,17,2,3,633,636,-3
1,0,18,2,3,623,641,-18
1,1,0,2,3,657,651,6
1,1,1,2,3,658,648,10
1,1,2,2,3,654,651,3
1,1,3,2,3,651,658,-7
1,1,4,2,3,648,667,-19
1,1,5,2,3,651,655,-4
1,1,6,2,3,658,642,16
1,1,7,2,3,667,632,35
1,1,8,2,3,655,631,24
1,1,9,2,3,642,636,6
1,1,10,2,3,632,645,-13
1,1,11,2,3,631,665,-34
1,1,12,2,3,636,666,-30
1,1,13,2,3,645,661,-16
1,1,14,2,3,665,638,27
1,1,15,2,3,666,626,40
1,1,16,2,3,661,634,27
1,1,17,2,3,638,654,-16
1,1,18,2,3,626,658,-32
1,2,0,2,3,672,657,15
1,2,1,2,3,666,665,1
1,2,2,2,3,656,676,-20
1,2,3,2,3,657,640,17
1,2,4,2,3,665,602,63
1,2,5,2,3,676,544,132
1,2,6,2,3,640,527,113
1,2,7,2,3,602,513,89
1,2,8,2,3,544,509,35
1,2,9,2,3,527,514,13
1,2,10,2,3,513,524,-11
1,2,11,2,3,509,560,-51
1,2,12,2,3,514,593,-79
1,2,13,2,3,524,641,-117
1,2,14,2,3,560,662,-102
1,2,15,2,3,593,664,-71
1,2,16,2,3,641,652,-11
1,2,17,2,3,662,650,12
1,2,18,2,3,664,657,7
1,3,0,2,3,686,693,-7
1,3,1,2,3,680,679,1
1,3,2,2,3,682,632,50
1,3,3,2,3,693,523,170
1,3,4,2,3,679,437,242
1,3,5,2,3,632,360,272
1,3,6,2,3,523,342,181
1,3,7,2,3,437,328,109
1,3,8,2,3,360,322,38
1,3,9,2,3,342,326,16
1,3,10,2,3,328,335,-7
1,3,11,2,3,322,376,-54
1,3,12,2,3,326,438,-112
1,3,13,2,3,335,546,-211
1,3,14,2,3,376,641,-265
1,3,15,2,3,438,689,-251
1,3,16,2,3,546,680,-134
1,3,17,2,3,641,660,-19
1,3,18,2,3,689,659,30
1,4,0,2,3,703,714,-11
1,4,1,2,3,709,643,66
1,4,2,2,3,719,507,212
1,4,3,2,3,714,401,313
1,4,4,2,3,643,357,286
1,4,5,2,3,507,357,150
1,4,6,2,3,401,344,57
1,4,7,2,3,357,334,23
1,4,8,2,3,357,329,28
1,4,9,2,3,344,331,13
1,4,10,2,3,334,336,-2
1,4,11,2,3,329,340,-11
1,4,12,2,3,331,361,-30
1,4,13,2,3,336,434,-98
1,4,14,2,3,340,550,-210
1,4,15,2,3,361,648,-287
1,4,16,2,3,434,690,-256
1,4,17,2,3,550,691,-141
1,4,18,2,3,648,678,-30
1,5,0,2,3,709,611,98
1,5,1,2,3,683,539,144
1,5,2,2,3,649,424,225
1,5,3,2,3,611,371,240
1,5,4,2,3,539,372,167
1,5,5,2,3,424,411,13
1,5,6,2,3,371,407,-36
1,5,7,2,3,372,404,-32
1,5,8,2,3,411,402,9
1,5,9,2,3,407,401,6
1,5,10,2,3,404,401,3
1,5,11,2,3,402,399,3
1,5,12,2,3,401,390,11
1,5,13,2,3,401,408,-7
1,5,14,2,3,399,470,-71
1,5,15,2,3,390,559,-169
1,5,16,2,3,408,633,-225
1,5,17,2,3,470,673,-203
1,5,18,2,3,559,683,-124
1,6,0,2,3,698,404,294
1,6,1,2,3,586,415,171
1,6,2,2,3,464,451,13
1,6,3,2,3,404,476,-72
1,6,4,2,3,415,492,-77
1,6,5,2,3,451,495,-44
1,6,6,2,3,476,499,-23
1,6,7,2,3,492,502,-10
1,6,8,2,3,495,503,-8
1,6,9,2,3,499,500,-1
1,6,10,2,3,502,496,6
1,6,11,2,3,503,505,-2
1,6,12,2,3,500,490,10
1,6,13,2,3,496,476,20
1,6,14,2,3,505,464,41
1,6,15,2,3,490,483,7
1,6,16,2,3,476,524,-48
1,6,17,2,3,464,586,-122
1,6,18,2,3,483,657,-174
1,7,0,2,3,733,381,352
1,7,1,2,3,604,471,133
1,7,2,2,3,441,594,-153
1,7,3,2,3,381,665,-284
1,7,4,2,3,471,679,-208
1,7,5,2,3,594,680,-86
1,7,6,2,3,665,694,-29
1,7,7,2,3,679,708,-29
1,7,8,2,3,680,725,-45
1,7,9,2,3,694,724,-30
1,7,10,2,3,708,713,-5
1,7,11,2,3,725,702,23
1,7,12,2,3,724,682,42
1,7,13,2,3,713,656,57
1,7,14,2,3,702,593,109
1,7,15,2,3,682,549,133
1,7,16,2,3,656,553,103
1,7,17,2,3,593,611,-18
1,7,18,2,3,549,696,-147
1,8,0,2,3,632,374,258
1,8,1,2,3,521,432,89
1,8,2,2,3,415,516,-101
1,8,3,2,3,374,558,-184
1,8,4,2,3,432,555,-123
1,8,5,2,3,516,526,-10
1,8,6,2,3,558,508,50
1,8,7,2,3,555,517,38
1,8,8,2,3,526,532,-6
1,8,9,2,3,508,524,-16
1,8,10,2,3,517,530,-13
1,8,11,2,3,532,549,-17
1,8,12,2,3,524,581,-57
1,8,13,2,3,530,577,-47
1,8,14,2,3,549,524,25
1,8,15,2,3,581,477,104
1,8,16,2,3,577,478,99
1,8,17,2,3,524,532,-8
1,8,18,2,3,477,616,-139
1,9,0,2,3,452,481,-29
1,9,1,2,3,361,529,-168
1,9,2,2,3,437,564,-127
1,9,3,2,3,481,597,-116
1,9,4,2,3,529,599,-70
1,9,5,2,3,564,536,28
1,9,6,2,3,597,485,112
1,9,7,2,3,599,480,119
1,9,8,2,3,536,479,57
1,9,9,2,3,485,475,10
1,9,10,2,3,480,493,-13
1,9,11,2,3,479,537,-58
1,9,12,2,3,475,601,-126
1,9,13,2,3,493,589,-96
1,9,14,2,3,537,552,-15
1,9,15,2,3,601,503,98
1,9,16,2,3,589,475,114
1,9,17,2,3,552,483,69
1,9,18,2,3,503,526,-23
1,10,0,2,3,537,893,-356
1,10,1,2,3,493,1040,-547
1,10,2,2,3,750,1026,-276
1,10,3,2,3,893,1091,-198
1,10,4,2,3,1040,1051,-11
1,10,5,2,3,1026,990,36
1,10,6,2,3,1091,929,162
1,10,7,2,3,1051,939,112
1,10,8,2,3,990,945,45
1,10,9,2,3,929,956,-27
1,10,10,2,3,939,958,-19
1,10,11,2,3,945,1013,-68
1,10,12,2,3,956,1090,-134
1,10,13,2,3,958,1068,-110
1,10,14,2,3,1013,1012,1
1,10,15,2,3,1090,955,135
1,10,16,2,3,1068,910,158
1,10,17,2,3,1012,851,161
1,10,18,2,3,955,763,192
1,11,0,2,3,731,1115,-384
1,11,1,2,3,690,1302,-612
1,11,2,2,3,933,1266,-333
1,11,3,2,3,1115,1338,-223
1,11,4,2,3,1302,1191,111
1,11,5,2,3,1266,1045,221
1,11,6,2,3,1338,890,448
1,11,7,2,3,1191,923,268
1,11,8,2,3,1045,926,119
1,11,9,2,3,890,920,-30
1,11,10,2,3,923,946,-23
1,11,11,2,3,926,1128,-202
1,11,12,2,3,920,1315,-395
1,11,13,2,3,946,1351,-405
1,11,14,2,3,1128,1291,-163
1,11,15,2,3,1315,1248,67
1,11,16,2,3,1351,1230,121
1,11,17,2,3,1291,1169,122
1,11,18,2,3,1248,1003,245
1,12,0,2,3,817,1127,-310
1,12,1,2,3,769,1261,-492
1,12,2,2,3,887,1294,-407
1,12,3,2,3,1127,1321,-194
1,12,4,2,3,1261,1149,112
1,12,5,2,3,1294,912,382
1,12,6,2,3,1321,639,682
1,12,7,2,3,1149,669,480
1,12,8,2,3,912,656,256
1,12,9,2,3,639,642,-3
1,12,10,2,3,669,717,-48
1,12,11,2,3,656,1010,-354
1,12,12,2,3,642,1271,-629
1,12,13,2,3,717,1373,-656
1,12,14,2,3,1010,1308,-298
1,12,15,2,3,1271,1248,23
1,12,16,2,3,1373,1215,158
1,12,17,2,3,1308,1176,132
1,12,18,2,3,1248,1046,202
1,13,0,2,3,851,1115,-264
1,13,1,2,3,798,1183,-385
1,13,2,2,3,833,1284,-451
1,13,3,2,3,1115,1262,-147
1,13,4,2,3,1183,1149,34
1,13,5,2,3,1284,918,366
1,13,6,2,3,1262,619,643
1,13,7,2,3,1149,638,511
1,13,8,2,3,918,613,305
1,13,9,2,3,619,622,-3
1,13,10,2,3,638,715,-77
1,13,11,2,3,613,997,-384
1,13,12,2,3,622,1199,-577
1,13,13,2,3,715,1335,-620
1,13,14,2,3,997,1271,-274
1,13,15,2,3,1199,1204,-5
1,13,16,2,3,1335,1139,196
1,13,17,2,3,1271,1111,160
1,13,18,2,3,1204,1069,135
1,14,0,2,3,858,1128,-270
1,14,1,2,3,801,1194,-393
1,14,2,2,3,846,1279,-433
1,14,3,2,3,1128,1249,-121
1,14,4,2,3,1194,1125,69
1,14,5,2,3,1279,902,377
1,14,6,2,3,1249,615,634
1,14,7,2,3,1125,646,479
1,14,8,2,3,902,605,297
1,14,9,2,3,615,608,7
1,14,10,2,3,646,709,-63
1,14,11,2,3,605,1001,-396
1,14,12,2,3,608,1162,-554
1,14,13,2,3,709,1324,-615
1,14,14,2,3,1001,1264,-263
1,14,15,2,3,1162,1215,-53
1,14,16,2,3,1324,1131,193
1,14,17,2,3,1264,1082,182
1,14,18,2,3,1215,1075,140
1,15,0,2,3,719,1163,-444
1,15,1,2,3,703,1219,-516
1,15,2,2,3,846,1278,-432
1,15,3,2,3,1163,1256,-93
1,15,4,2,3,1219,1152,67
1,15,5,2,3,1278,902,376
1,15,6,2,3,1256,613,643
1,15,7,2,3,1152,655,497
1,15,8,2,3,902,624,278
1,15,9,2,3,613,620,-7
1,15,10,2,3,655,722,-67
1,15,11,2,3,624,1027,-403
1,15,12,2,3,620,1184,-564
1,15,13,2,3,722,1286,-564
1,15,14,2,3,1027,1217,-190
1,15,15,2,3,1184,1181,3
1,15,16,2,3,1286,1111,175
1,15,17,2,3,1217,974,243
1,15,18,2,3,1181,950,231
1,16,0,2,3,543,1131,-588
1,16,1,2,3,592,1108,-516
1,16,2,2,3,829,1161,-332
1,16,3,2,3,1131,1156,-25
1,16,4,2,3,1108,1092,16
1,16,5,2,3,1161,840,321
1,16,6,2,3,1156,566,590
1,16,7,2,3,1092,598,494
1,16,8,2,3,840,566,274
1,16,9,2,3,566,564,2
1,16,10,2,3,598,668,-70
1,16,11,2,3,566,969,-403
1,16,12,2,3,564,1141,-577
1,16,13,2,3,668,1091,-423
1,16,14,2,3,969,972,-3
1,16,15,2,3,1141,971,170
1,16,16,2,3,1091,1041,50
1,16,17,2,3,972,874,98
1,16,18,2,3,971,839,132
1,17,0,2,3,536,1145,-609
1,17,1,2,3,636,996,-360
1,17,2,2,3,914,910,4
1,17,3,2,3,1145,848,297
1,17,4,2,3,996,811,185
1,17,5,2,3,910,637,273
1,17,6,2,3,848,480,368
1,17,7,2,3,811,526,285
1,17,8,2,3,637,499,138
1,17,9,2,3,480,512,-32
1,17,10,2,3,526,544,-18
1,17,11,2,3,499,695,-196
1,17,12,2,3,512,850,-338
1,17,13,2,3,544,776,-232
1,17,14,2,3,695,752,-57
1,17,15,2,3,850,807,43
1,17,16,2,3,776,989,-213
1,17,17,2,3,752,878,-126
1,17,18,2,3,807,780,27
1,18,0,2,3,674,1045,-371
1,18,1,2,3,780,768,12
1,18,2,2,3,966,627,339
1,18,3,2,3,1045,667,378
1,18,4,2,3,768,722,46
1,18,5,2,3,627,728,-101
1,18,6,2,3,667,644,23
1,18,7,2,3,722,713,9
1,18,8,2,3,728,712,16
1,18,9,2,3,644,710,-66
1,18,10,2,3,713,592,121
1,18,11,2,3,712,615,97
1,18,12,2,3,710,768,-58
1,18,13,2,3,592,763,-171
1,18,14,2,3,615,696,-81
1,18,15,2,3,768,707,61
1,18,16,2,3,763,808,-45
1,18,17,2,3,696,775,-79
1,18,18,2,3,707,720,-13
1,19,0,2,3,718,814,-96
1,19,1,2,3,802,495,307
1,19,2,2,3,863,546,317
1,19,3,2,3,814,854,-40
1,19,4,2,3,495,964,-469
1,19,5,2,3,546,997,-451
1,19,6,2,3,854,817,37
1,19,7,2,3,964,872,92
1,19,8,2,3,997,864,133
1,19,9,2,3,817,807,10
1,19,10,2,3,872,637,235
1,19,11,2,3,864,660,204
1,19,12,2,3,807,794,13
1,19,13,2,3,637,771,-134
1,19,14,2,3,660,585,75
1,19,15,2,3,794,597,197
1,19,16,2,3,771,604,167
1,19,17,2,3,585,593,-8
1,19,18,2,3,597,665,-68
1,20,0,2,3,698,699,-1
1,20,1,2,3,770,365,405
1,20,2,2,3,781,469,312
1,20,3,2,3,699,783,-84
1,20,4,2,3,365,825,-460
1,20,5,2,3,469,741,-272
1,20,6,2,3,783,516,267
1,20,7,2,3,825,583,242
1,20,8,2,3,741,586,155
1,20,9,2,3,516,530,-14
1,20,10,2,3,583,420,163
1,20,11,2,3,586,419,167
1,20,12,2,3,530,501,29
1,20,13,2,3,420,474,-54
1,20,14,2,3,419,454,-35
1,20,15,2,3,501,528,-27
1,20,16,2,3,474,559,-85
1,20,17,2,3,454,549,-95
1,20,18,2,3,528,669,-141
1,21,0,2,3,611,526,85
1,21,1,2,3,666,274,392
1,21,2,2,3,622,351,271
1,21,3,2,3,526,578,-52
1,21,4,2,3,274,565,-291
1,21,5,2,3,351,482,-131
1,21,6,2,3,578,291,287
1,21,7,2,3,565,405,160
1,21,8,2,3,482,428,54
1,21,9,2,3,291,380,-89
1,21,10,2,3,405,329,76
1,21,11,2,3,428,365,63
1,21,12,2,3,380,448,-68
1,21,13,2,3,329,370,-41
1,21,14,2,3,365,357,8
1,21,15,2,3,448,366,82
1,21,16,2,3,370,434,-64
1,21,17,2,3,357,442,-85
1,21,18,2,3,366,522,-156
1,22,0,2,3,481,400,81
1,22,1,2,3,462,304,158
1,22,2,2,3,428,370,58
1,22,3,2,3,400,545,-145
1,22,4,2,3,304,599,-295
1,22,5,2,3,370,549,-179
1,22,6,2,3,545,393,152
1,22,7,2,3,599,494,105
1,22,8,2,3,549,542,7
1,22,9,2,3,393,546,-153
1,22,10,2,3,494,490,4
1,22,11,2,3,542,536,6
1,22,12,2,3,546,548,-2
1,22,13,2,3,490,418,72
1,22,14,2,3,536,327,209
1,22,15,2,3,548,292,256
1,22,16,2,3,418,317,101
1,22,17,2,3,327,317,10
1,22,18,2,3,292,318,-26
1,0,0,3,3,970,971,-1
1,0,1,3,3,959,974,-15
1,0,2,3,3,959,972,-13
1,0,3,3,3,971,972,-1
1,0,4,3,3,974,980,-6
1,0,5,3,3,972,964,8
1,0,6,3,3,972,949,23
1,0,7,3,3,980,938,42
1,0,8,3,3,964,938,26
1,0,9,3,3,949,945,4
1,0,10,3,3,938,957,-19
1,0,11,3,3,938,972,-34
1,0,12,3,3,945,971,-26
1,0,13,3,3,957,971,-14
1,0,14,3,3,972,958,14
1,0,15,3,3,971,942,29
1,0,16,3,3,971,943,28
1,0,17,3,3,958,964,-6
1,0,18,3,3,942,972,-30
1,1,0,3,3,996,983,13
1,1,1,3,3,990,987,3
1,1,2,3,3,981,993,-12
1,1,3,3,3,983,957,26
1,1,4,3,3,987,923,64
1,1,5,3,3,993,862,131
1,1,6,3,3,957,840,117
1,1,7,3,3,923,823,100
1,1,8,3,3,862,819,43
1,1,9,3,3,840,826,14
1,1,10,3,3,823,840,-17
1,1,11,3,3,819,887,-68
1,1,12,3,3,826,922,-96
1,1,13,3,3,840,967,-127
1,1,14,3,3,887,975,-88
1,1,15,3,3,922,971,-49
1,1,16,3,3,967,966,1
1,1,17,3,3,975,976,-1
1,1,18,3,3,971,984,-13
1,2,0,3,3,1019,1018,1
1,2,1,3,3,1014,1005,9
1,2,2,3,3,1011,966,45
1,2,3,3,3,1018,864,154
1,2,4,3,3,1005,783,222
1,2,5,3,3,966,697,269
1,2,6,3,3,864,671,193
1,2,7,3,3,783,650,133
1,2,8,3,3,697,643,54
1,2,9,3,3,671,650,21
1,2,10,3,3,650,664,-14
1,2,11,3,3,643,714,-71
1,2,12,3,3,650,775,-125
1,2,13,3,3,664,881,-217
1,2,14,3,3,714,966,-252
1,2,15,3,3,775,1008,-233
1,2,16,3,3,881,1000,-119
1,2,17,3,3,966,988,-22
1,2,18,3,3,1008,990,18
1,3,0,3,3,1042,1046,-4
1,3,1,3,3,1041,982,59
1,3,2,3,3,1046,849,197
1,3,3,3,3,1046,700,346
1,3,4,3,3,982,613,369
1,3,5,3,3,849,564,285
1,3,6,3,3,700,542,158
1,3,7,3,3,613,525,88
1,3,8,3,3,564,517,47
1,3,9,3,3,542,521,21
1,3,10,3,3,525,531,-6
1,3,11,3,3,517,562,-45
1,3,12,3,3,521,617,-96
1,3,13,3,3,531,740,-209
1,3,14,3,3,562,887,-325
1,3,15,3,3,617,993,-376
1,3,16,3,3,740,1022,-282
1,3,17,3,3,887,1013,-126
1,3,18,3,3,993,1004,-11
1,4,0,3,3,1056,972,84
1,4,1,3,3,1031,879,152
1,4,2,3,3,1004,714,290
1,4,3,3,3,972,595,377
1,4,4,3,3,879,553,326
1,4,5,3,3,714,564,150
1,4,6,3,3,595,551,44
1,4,7,3,3,553,541,12
1,4,8,3,3,564,536,28
1,4,9,3,3,551,537,14
1,4,10,3,3,541,541,0
1,4,11,3,3,536,553,-17
1,4,12,3,3,537,572,-35
1,4,13,3,3,541,648,-107
1,4,14,3,3,553,774,-221
1,4,15,3,3,572,903,-331
1,4,16,3,3,648,981,-333
1,4,17,3,3,774,1011,-237
1,4,18,3,3,903,1016,-113
1,5,0,3,3,1054,757,297
1,5,1,3,3,947,718,229
1,5,2,3,3,828,668,160
1,5,3,3,3,757,653,104
1,5,4,3,3,718,668,50
1,5,5,3,3,668,699,-31
1,5,6,3,3,653,699,-46
1,5,7,3,3,668,699,-31
1,5,8,3,3,699,698,1
1,5,9,3,3,699,695,4
1,5,10,3,3,699,692,7
1,5,11,3,3,698,691,7
1,5,12,3,3,695,669,26
1,5,13,3,3,692,670,22
1,5,14,3,3,691,710,-19
1,5,15,3,3,669,787,-118
1,5,16,3,3,670,866,-196
1,5,17,3,3,710,939,-229
1,5,18,3,3,787,1002,-215
1,6,0,3,3,1086,639,447
1,6,1,3,3,926,707,219
1,6,2,3,3,726,801,-75
1,6,3,3,3,639,859,-220
1,6,4,3,3,707,875,-168
1,6,5,3,3,801,887,-86
1,6,6,3,3,859,901,-42
1,6,7,3,3,875,915,-40
1,6,8,3,3,887,932,-45
1,6,9,3,3,901,930,-29
1,6,10,3,3,915,918,-3
1,6,11,3,3,932,915,17
1,6,12,3,3,930,893,37
1,6,13,3,3,918,870,48
1,6,14,3,3,915,817,98
1,6,15,3,3,893,804,89
1,6,16,3,3,870,844,26
1,6,17,3,3,817,931,-114
1,6,18,3,3,804,1034,-230
1,7,0,3,3,977,520,457
1,7,1,3,3,785,611,174
1,7,2,3,3,594,760,-166
1,7,3,3,3,520,840,-320
1,7,4,3,3,611,851,-240
1,7,5,3,3,760,814,-54
1,7,6,3,3,840,800,40
1,7,7,3,3,851,812,39
1,7,8,3,3,814,828,-14
1,7,9,3,3,800,818,-18
1,7,10,3,3,812,821,-9
1,7,11,3,3,828,841,-13
1,7,12,3,3,818,860,-42
1,7,13,3,3,821,839,-18
1,7,14,3,3,841,764,77
1,7,15,3,3,860,705,155
1,7,16,3,3,839,711,128
1,7,17,3,3,764,798,-34
1,7,18,3,3,705,935,-230
1,8,0,3,3,840,716,124
1,8,1,3,3,701,821,-120
1,8,2,3,3,699,914,-215
1,8,3,3,3,716,980,-264
1,8,4,3,3,821,982,-161
1,8,5,3,3,914,928,-14
1,8,6,3,3,980,887,93
1,8,7,3,3,982,893,89
1,8,8,3,3,928,908,20
1,8,9,3,3,887,905,-18
1,8,10,3,3,893,915,-22
1,8,11,3,3,908,947,-39
1,8,12,3,3,905,1004,-99
1,8,13,3,3,915,983,-68
1,8,14,3,3,947,905,42
1,8,15,3,3,1004,824,180
1,8,16,3,3,983,795,188
1,8,17,3,3,905,828,77
1,8,18,3,3,824,903,-79
1,9,0,3,3,781,1032,-251
1,9,1,3,3,674,1180,-506
1,9,2,3,3,903,1192,-289
1,9,3,3,3,1032,1266,-234
1,9,4,3,3,1180,1223,-43
1,9,5,3,3,1192,1124,68
1,9,6,3,3,1266,1035,231
1,9,7,3,3,1223,1043,180
1,9,8,3,3,1124,1048,76
1,9,9,3,3,1035,1050,-15
1,9,10,3,3,1043,1066,-23
1,9,11,3,3,1048,1152,-104
1,9,12,3,3,1050,1268,-218
1,9,13,3,3,1066,1251,-185
1,9,14,3,3,1152,1183,-31
1,9,15,3,3,1268,1111,157
1,9,16,3,3,1251,1068,183
1,9,17,3,3,1183,1038,145
1,9,18,3,3,1111,1002,109
1,10,0,3,3,939,1457,-518
1,10,1,3,3,870,1691,-821
1,10,2,3,3,1217,1664,-447
1,10,3,3,3,1457,1760,-303
1,10,4,3,3,1691,1618,73
1,10,5,3,3,1664,1447,217
1,10,6,3,3,1760,1269,491
1,10,7,3,3,1618,1299,319
1,10,8,3,3,1447,1302,145
1,10,9,3,3,1269,1301,-32
1,10,10,3,3,1299,1331,-32
1,10,11,3,3,1302,1526,-224
1,10,12,3,3,1301,1738,-437
1,10,13,3,3,1331,1757,-426
1,10,14,3,3,1526,1672,-146
1,10,15,3,3,1738,1595,143
1,10,16,3,3,1757,1547,210
1,10,17,3,3,1672,1465,207
1,10,18,3,3,1595,1290,305
1,11,0,3,3,1146,1678,-532
1,11,1,3,3,1082,1912,-830
1,11,2,3,3,1353,1922,-569
1,11,3,3,3,1678,1990,-312
1,11,4,3,3,1912,1773,139
1,11,5,3,3,1922,1500,422
1,11,6,3,3,1990,1189,801
1,11,7,3,3,1773,1232,541
1,11,8,3,3,1500,1225,275
1,11,9,3,3,1189,1217,-28
1,11,10,3,3,1232,1290,-58
1,11,11,3,3,1225,1625,-400
1,11,12,3,3,1217,1938,-721
1,11,13,3,3,1290,2035,-745
1,11,14,3,3,1625,1939,-314
1,11,15,3,3,1938,1856,82
1,11,16,3,3,2035,1808,227
1,11,17,3,3,1939,1731,208
1,11,18,3,3,1856,1522,334
1,12,0,3,3,1253,1679,-426
1,12,1,3,3,1175,1834,-659
1,12,2,3,3,1300,1922,-622
1,12,3,3,3,1679,1931,-252
1,12,4,3,3,1834,1716,118
1,12,5,3,3,1922,1375,547
1,12,6,3,3,1931,959,972
1,12,7,3,3,1716,998,718
1,12,8,3,3,1375,970,405
1,12,9,3,3,959,967,-8
1,12,10,3,3,998,1088,-90
1,12,11,3,3,970,1510,-540
1,12,12,3,3,967,1847,-880
1,12,13,3,3,1088,2024,-936
1,12,14,3,3,1510,1931,-421
1,12,15,3,3,1847,1844,3
1,12,16,3,3,2024,1776,248
1,12,17,3,3,1931,1725,206
1,12,18,3,3,1844,1596,248
1,13,0,3,3,1273,1691,-418
1,13,1,3,3,1193,1804,-611
1,13,2,3,3,1266,1935,-669
1,13,3,3,3,1691,1901,-210
1,13,4,3,3,1804,1707,97
1,13,5,3,3,1935,1357,578
1,13,6,3,3,1901,914,987
1,13,7,3,3,1707,955,752
1,13,8,3,3,1357,904,453
1,13,9,3,3,914,905,9
1,13,10,3,3,955,1053,-98
1,13,11,3,3,904,1498,-594
1,13,12,3,3,905,1785,-880
1,13,13,3,3,1053,2008,-955
1,13,14,3,3,1498,1912,-414
1,13,15,3,3,1785,1823,-38
1,13,16,3,3,2008,1709,299
1,13,17,3,3,1912,1644,268
1,13,18,3,3,1823,1594,229
1,14,0,3,3,1155,1715,-560
1,14,1,3,3,1109,1792,-683
1,14,2,3,3,1259,1906,-647
1,14,3,3,3,1715,1866,-151
1,14,4,3,3,1792,1719,73
1,14,5,3,3,1906,1365,541
1,14,6,3,3,1866,933,933
1,14,7,3,3,1719,984,735
1,14,8,3,3,1365,938,427
1,14,9,3,3,933,945,-12
1,14,10,3,3,984,1093,-109
1,14,11,3,3,938,1527,-589
1,14,12,3,3,945,1760,-815
1,14,13,3,3,1093,1937,-844
1,14,14,3,3,1527,1840,-313
1,14,15,3,3,1760,1777,-17
1,14,16,3,3,1937,1672,265
1,14,17,3,3,1840,1523,317
1,14,18,3,3,1777,1500,277
1,15,0,3,3,965,1707,-742
1,15,1,3,3,987,1729,-742
1,15,2,3,3,1262,1812,-550
1,15,3,3,3,1707,1795,-88
1,15,4,3,3,1729,1650,79
1,15,5,3,3,1812,1279,533
1,15,6,3,3,1795,861,934
1,15,7,3,3,1650,915,735
1,15,8,3,3,1279,857,422
1,15,9,3,3,861,847,14
1,15,10,3,3,915,1006,-91
1,15,11,3,3,857,1470,-613
1,15,12,3,3,847,1727,-880
1,15,13,3,3,1006,1764,-758
1,15,14,3,3,1470,1613,-143
1,15,15,3,3,1727,1590,137
1,15,16,3,3,1764,1611,153
1,15,17,3,3,1613,1407,206
1,15,18,3,3,1590,1364,226
1,16,0,3,3,833,1732,-899
1,16,1,3,3,944,1594,-650
1,16,2,3,3,1327,1537,-210
1,16,3,3,3,1732,1465,267
1,16,4,3,3,1594,1405,189
1,16,5,3,3,1537,1100,437
1,16,6,3,3,1465,798,667
1,16,7,3,3,1405,864,541
1,16,8,3,3,1100,832,268
1,16,9,3,3,798,849,-51
1,16,10,3,3,864,928,-64
1,16,11,3,3,832,1221,-389
1,16,12,3,3,849,1448,-599
1,16,13,3,3,928,1389,-461
1,16,14,3,3,1221,1328,-107
1,16,15,3,3,1448,1369,79
1,16,16,3,3,1389,1530,-141
1,16,17,3,3,1328,1319,9
1,16,18,3,3,1369,1205,164
1,17,0,3,3,920,1589,-669
1,17,1,3,3,1064,1278,-214
1,17,2,3,3,1382,1161,221
1,17,3,3,3,1589,1206,383
1,17,4,3,3,1278,1220,58
1,17,5,3,3,1161,1105,56
1,17,6,3,3,1206,892,314
1,17,7,3,3,1220,973,247
1,17,8,3,3,1105,945,160
1,17,9,3,3,892,937,-45
1,17,10,3,3,973,876,97
1,17,11,3,3,945,1058,-113
1,17,12,3,3,937,1311,-374
1,17,13,3,3,876,1241,-365
1,17,14,3,3,1058,1092,-34
1,17,15,3,3,1311,1116,195
1,17,16,3,3,1241,1308,-67
1,17,17,3,3,1092,1208,-116
1,17,18,3,3,1116,1134,-18
1,18,0,3,3,1008,1415,-407
1,18,1,3,3,1154,981,173
1,18,2,3,3,1361,922,439
1,18,3,3,3,1415,1163,252
1,18,4,3,3,981,1277,-296
1,18,5,3,3,922,1257,-335
1,18,6,3,3,1163,1049,114
1,18,7,3,3,1277,1138,139
1,18,8,3,3,1257,1130,127
1,18,9,3,3,1049,1092,-43
1,18,10,3,3,1138,897,241
1,18,11,3,3,1130,912,218
1,18,12,3,3,1092,1101,-9
1,18,13,3,3,897,1069,-172
1,18,14,3,3,912,941,-29
1,18,15,3,3,1101,995,106
1,18,16,3,3,1069,1093,-24
1,18,17,3,3,941,1038,-97
1,18,18,3,3,995,1031,-36
1,19,0,3,3,1082,1143,-61
1,19,1,3,3,1198,647,551
1,19,2,3,3,1249,720,529
1,19,3,3,3,1143,1141,2
1,19,4,3,3,647,1234,-587
1,19,5,3,3,720,1209,-489
1,19,6,3,3,1141,928,213
1,19,7,3,3,1234,1030,204
1,19,8,3,3,1209,1032,177
1,19,9,3,3,928,955,-27
1,19,10,3,3,1030,752,278
1,19,11,3,3,1032,782,250
1,19,12,3,3,955,962,-7
1,19,13,3,3,752,939,-187
1,19,14,3,3,782,794,-12
1,19,15,3,3,962,837,125
1,19,16,3,3,939,878,61
1,19,17,3,3,794,879,-85
1,19,18,3,3,837,1023,-186
1,20,0,3,3,945,896,49
1,20,1,3,3,1040,487,553
1,20,2,3,3,1017,646,371
1,20,3,3,3,896,1074,-178
1,20,4,3,3,487,1120,-633
1,20,5,3,3,646,1011,-365
1,20,6,3,3,1074,696,378
1,20,7,3,3,1120,830,290
1,20,8,3,3,1011,846,165
1,20,9,3,3,696,762,-66
1,20,10,3,3,830,634,196
1,20,11,3,3,846,662,184
1,20,12,3,3,762,781,-19
1,20,13,3,3,634,676,-42
1,20,14,3,3,662,602,60
1,20,15,3,3,781,654,127
1,20,16,3,3,676,719,-43
1,20,17,3,3,602,705,-103
1,20,18,3,3,654,833,-179
1,21,0,3,3,845,729,116
1,21,1,3,3,858,456,402
1,21,2,3,3,814,544,270
1,21,3,3,3,729,832,-103
1,21,4,3,3,456,869,-413
1,21,5,3,3,544,761,-217
1,21,6,3,3,832,504,328
1,21,7,3,3,869,652,217
1,21,8,3,3,761,710,51
1,21,9,3,3,504,694,-190
1,21,10,3,3,652,605,47
1,21,11,3,3,710,658,52
1,21,12,3,3,694,716,-22
1,21,13,3,3,605,586,19
1,21,14,3,3,658,536,122
1,21,15,3,3,716,532,184
1,21,16,3,3,586,591,-5
1,21,17,3,3,536,603,-67
1,21,18,3,3,532,676,-144
1,0,0,4,3,1309,1303,6
1,0,1,4,3,1291,1313,-22
1,0,2,4,3,1286,1314,-28
1,0,3,4,3,1303,1271,32
1,0,4,4,3,1313,1236,77
1,0,5,4,3,1314,1171,143
1,0,6,4,3,1271,1147,124
1,0,7,4,3,1236,1129,107
1,0,8,4,3,1171,1126,45
1,0,9,4,3,1147,1135,12
1,0,10,4,3,1129,1152,-23
1,0,11,4,3,1126,1194,-68
1,0,12,4,3,1135,1227,-92
1,0,13,4,3,1152,1277,-125
1,0,14,4,3,1194,1295,-101
1,0,15,4,3,1227,1287,-60
1,0,16,4,3,1277,1275,2
1,0,17,4,3,1295,1286,9
1,0,18,4,3,1287,1298,-11
1,1,0,4,3,1343,1344,-1
1,1,1,4,3,1338,1327,11
1,1,2,4,3,1336,1283,53
1,1,3,4,3,1344,1181,163
1,1,4,4,3,1327,1104,223
1,1,5,4,3,1283,1015,268
1,1,6,4,3,1181,984,197
1,1,7,4,3,1104,960,144
1,1,8,4,3,1015,953,62
1,1,9,4,3,984,962,22
1,1,10,4,3,960,980,-20
1,1,11,4,3,953,1041,-88
1,1,12,4,3,962,1104,-142
1,1,13,4,3,980,1207,-227
1,1,14,4,3,1041,1279,-238
1,1,15,4,3,1104,1315,-211
1,1,16,4,3,1207,1314,-107
1,1,17,4,3,1279,1314,-35
1,1,18,4,3,1315,1317,-2
1,2,0,4,3,1375,1371,4
1,2,1,4,3,1375,1308,67
1,2,2,4,3,1375,1183,192
1,2,3,4,3,1371,1041,330
1,2,4,4,3,1308,959,349
1,2,5,4,3,1183,901,282
1,2,6,4,3,1041,871,170
1,2,7,4,3,959,847,112
1,2,8,4,3,901,838,63
1,2,9,4,3,871,845,26
1,2,10,4,3,847,860,-13
1,2,11,4,3,838,900,-62
1,2,12,4,3,845,954,-109
1,2,13,4,3,860,1075,-215
1,2,14,4,3,900,1212,-312
1,2,15,4,3,954,1312,-358
1,2,16,4,3,1075,1342,-267
1,2,17,4,3,1212,1341,-129
1,2,18,4,3,1312,1335,-23
1,3,0,4,3,1395,1304,91
1,3,1,4,3,1363,1218,145
1,3,2,4,3,1331,1056,275
1,3,3,4,3,1304,894,410
1,3,4,4,3,1218,809,409
1,3,5,4,3,1056,771,285
1,3,6,4,3,894,749,145
1,3,7,4,3,809,732,77
1,3,8,4,3,771,724,47
1,3,9,4,3,749,727,22
1,3,10,4,3,732,736,-4
1,3,11,4,3,724,775,-51
1,3,12,4,3,727,828,-101
1,3,13,4,3,736,954,-218
1,3,14,4,3,775,1111,-336
1,3,15,4,3,828,1248,-420
1,3,16,4,3,954,1313,-359
1,3,17,4,3,1111,1333,-222
1,3,18,4,3,1248,1342,-94
1,4,0,4,3,1401,1118,283
1,4,1,4,3,1295,1058,237
1,4,2,4,3,1183,958,225
1,4,3,4,3,1118,877,241
1,4,4,4,3,1058,849,209
1,4,5,4,3,958,852,106
1,4,6,4,3,877,843,34
1,4,7,4,3,849,836,13
1,4,8,4,3,852,832,20
1,4,9,4,3,843,831,12
1,4,10,4,3,836,832,4
1,4,11,4,3,832,845,-13
1,4,12,4,3,831,851,-20
1,4,13,4,3,832,910,-78
1,4,14,4,3,845,1014,-169
1,4,15,4,3,851,1131,-280
1,4,16,4,3,910,1214,-304
1,4,17,4,3,1014,1277,-263
1,4,18,4,3,1131,1335,-204
1,5,0,4,3,1442,992,450
1,5,1,4,3,1287,1010,277
1,5,2,4,3,1090,1018,72
1,5,3,4,3,992,1036,-44
1,5,4,4,3,1010,1051,-41
1,5,5,4,3,1018,1091,-73
1,5,6,4,3,1036,1101,-65
1,5,7,4,3,1051,1112,-61
1,5,8,4,3,1091,1127,-36
1,5,9,4,3,1101,1125,-24
1,5,10,4,3,1112,1114,-2
1,5,11,4,3,1127,1101,26
1,5,12,4,3,1125,1072,53
1,5,13,4,3,1114,1064,50
1,5,14,4,3,1101,1063,38
1,5,15,4,3,1072,1108,-36
1,5,16,4,3,1064,1186,-122
1,5,17,4,3,1063,1284,-221
1,5,18,4,3,1108,1379,-271
1,6,0,4,3,1330,778,552
1,6,1,4,3,1107,847,260
1,6,2,4,3,879,967,-88
1,6,3,4,3,778,1034,-256
1,6,4,4,3,847,1047,-200
1,6,5,4,3,967,1021,-54
1,6,6,4,3,1034,1007,27
1,6,7,4,3,1047,1019,28
1,6,8,4,3,1021,1035,-14
1,6,9,4,3,1007,1024,-17
1,6,10,4,3,1019,1026,-7
1,6,11,4,3,1035,1054,-19
1,6,12,4,3,1024,1071,-47
1,6,13,4,3,1026,1053,-27
1,6,14,4,3,1054,988,66
1,6,15,4,3,1071,960,111
1,6,16,4,3,1053,1002,51
1,6,17,4,3,988,1118,-130
1,6,18,4,3,960,1273,-313
1,7,0,4,3,1185,862,323
1,7,1,4,3,965,1000,-35
1,7,2,4,3,878,1158,-280
1,7,3,4,3,862,1262,-400
1,7,4,4,3,1000,1278,-278
1,7,5,4,3,1158,1216,-58
1,7,6,4,3,1262,1179,83
1,7,7,4,3,1278,1188,90
1,7,8,4,3,1216,1204,12
1,7,9,4,3,1179,1199,-20
1,7,10,4,3,1188,1206,-18
1,7,11,4,3,1204,1239,-35
1,7,12,4,3,1199,1283,-84
1,7,13,4,3,1206,1245,-39
1,7,14,4,3,1239,1145,94
1,7,15,4,3,1283,1052,231
1,7,16,4,3,1245,1028,217
1,7,17,4,3,1145,1094,51
1,7,18,4,3,1052,1222,-170
1,8,0,4,3,1169,1267,-98
1,8,1,4,3,1014,1472,-458
1,8,2,4,3,1165,1542,-377
1,8,3,4,3,1267,1649,-382
1,8,4,4,3,1472,1606,-134
1,8,5,4,3,1542,1516,26
1,8,6,4,3,1649,1437,212
1,8,7,4,3,1606,1456,150
1,8,8,4,3,1516,1477,39
1,8,9,4,3,1437,1480,-43
1,8,10,4,3,1456,1488,-32
1,8,11,4,3,1477,1562,-85
1,8,12,4,3,1480,1671,-191
1,8,13,4,3,1488,1645,-157
1,8,14,4,3,1562,1536,26
1,8,15,4,3,1671,1432,239
1,8,16,4,3,1645,1388,257
1,8,17,4,3,1536,1383,153
1,8,18,4,3,1432,1379,53
1,9,0,4,3,1183,1596,-413
1,9,1,4,3,1051,1831,-780
1,9,2,4,3,1370,1830,-460
1,9,3,4,3,1596,1935,-339
1,9,4,4,3,1831,1790,41
1,9,5,4,3,1830,1581,249
1,9,6,4,3,1935,1375,560
1,9,7,4,3,1790,1403,387
1,9,8,4,3,1581,1405,176
1,9,9,4,3,1375,1395,-20
1,9,10,4,3,1403,1439,-36
1,9,11,4,3,1405,1665,-260
1,9,12,4,3,1395,1916,-521
1,9,13,4,3,1439,1940,-501
1,9,14,4,3,1665,1843,-178
1,9,15,4,3,1916,1751,165
1,9,16,4,3,1940,1705,235
1,9,17,4,3,1843,1652,191
1,9,18,4,3,1751,1529,222
1,10,0,4,3,1354,2020,-666
1,10,1,4,3,1262,2301,-1039
1,10,2,4,3,1637,2320,-683
1,10,3,4,3,2020,2412,-392
1,10,4,4,3,2301,2200,101
1,10,5,4,3,2320,1902,418
1,10,6,4,3,2412,1568,844
1,10,7,4,3,2200,1608,592
1,10,8,4,3,1902,1601,301
1,10,9,4,3,1568,1598,-30
1,10,10,4,3,1608,1675,-67
1,10,11,4,3,1601,2023,-422
1,10,12,4,3,1598,2361,-763
1,10,13,4,3,1675,2441,-766
1,10,14,4,3,2023,2320,-297
1,10,15,4,3,2361,2203,158
1,10,16,4,3,2441,2125,316
1,10,17,4,3,2320,2027,293
1,10,18,4,3,2203,1809,394
1,11,0,4,3,1582,2230,-648
1,11,1,4,3,1488,2485,-997
1,11,2,4,3,1766,2550,-784
1,11,3,4,3,2230,2600,-370
1,11,4,4,3,2485,2340,145
1,11,5,4,3,2550,1963,587
1,11,6,4,3,2600,1509,1091
1,11,7,4,3,2340,1561,779
1,11,8,4,3,1963,1539,424
1,11,9,4,3,1509,1542,-33
1,11,10,4,3,1561,1661,-100
1,11,11,4,3,1539,2125,-586
1,11,12,4,3,1542,2514,-972
1,11,13,4,3,1661,2686,-1025
1,11,14,4,3,2125,2562,-437
1,11,15,4,3,2514,2452,62
1,11,16,4,3,2686,2369,317
1,11,17,4,3,2562,2280,282
1,11,18,4,3,2452,2072,380
1,12,0,4,3,1675,2255,-580
1,12,1,4,3,1570,2455,-885
1,12,2,4,3,1733,2573,-840
1,12,3,4,3,2255,2570,-315
1,12,4,4,3,2455,2274,181
1,12,5,4,3,2573,1814,759
1,12,6,4,3,2570,1254,1316
1,12,7,4,3,2274,1315,959
1,12,8,4,3,1814,1261,553
1,12,9,4,3,1254,1250,4
1,12,10,4,3,1315,1426,-111
1,12,11,4,3,1261,2011,-750
1,12,12,4,3,1250,2433,-1183
1,12,13,4,3,1426,2697,-1271
1,12,14,4,3,2011,2572,-561
1,12,15,4,3,2433,2463,-30
1,12,16,4,3,2697,2346,351
1,12,17,4,3,2572,2258,314
1,12,18,4,3,2463,2121,342
1,13,0,4,3,1570,2278,-708
1,13,1,4,3,1501,2402,-901
1,13,2,4,3,1679,2562,-883
1,13,3,4,3,2278,2518,-240
1,13,4,4,3,2402,2301,101
1,13,5,4,3,2562,1820,742
1,13,6,4,3,2518,1232,1286
1,13,7,4,3,2301,1293,1008
1,13,8,4,3,1820,1237,583
1,13,9,4,3,1232,1242,-10
1,13,10,4,3,1293,1437,-144
1,13,11,4,3,1237,2024,-787
1,13,12,4,3,1242,2383,-1141
1,13,13,4,3,1437,2621,-1184
1,13,14,4,3,2024,2488,-464
1,13,15,4,3,2383,2385,-2
1,13,16,4,3,2621,2250,371
1,13,17,4,3,2488,2085,403
1,13,18,4,3,2385,2019,366
1,14,0,4,3,1401,2259,-858
1,14,1,4,3,1393,2302,-909
1,14,2,4,3,1675,2440,-765
1,14,3,4,3,2259,2405,-146
1,14,4,4,3,2302,2217,85
1,14,5,4,3,2440,1742,698
1,14,6,4,3,2405,1181,1224
1,14,7,4,3,2217,1244,973
1,14,8,4,3,1742,1171,571
1,14,9,4,3,1181,1172,9
1,14,10,4,3,1244,1377,-133
1,14,11,4,3,1171,1970,-799
1,14,12,4,3,1172,2303,-1131
1,14,13,4,3,1377,2415,-1038
1,14,14,4,3,1970,2236,-266
1,14,15,4,3,2303,2186,117
1,14,16,4,3,2415,2172,243
1,14,17,4,3,2236,1956,280
1,14,18,4,3,2186,1914,272
1,15,0,4,3,1255,2308,-1053
1,15,1,4,3,1339,2215,-876
1,15,2,4,3,1760,2188,-428
1,15,3,4,3,2308,2104,204
1,15,4,4,3,2215,1963,252
1,15,5,4,3,2188,1539,649
1,15,6,4,3,2104,1093,1011
1,15,7,4,3,1963,1181,782
1,15,8,4,3,1539,1123,416
1,15,9,4,3,1093,1132,-39
1,15,10,4,3,1181,1266,-85
1,15,11,4,3,1123,1722,-599
1,15,12,4,3,1132,2034,-902
1,15,13,4,3,1266,2062,-796
1,15,14,4,3,1722,1969,-247
1,15,15,4,3,2034,1988,46
1,15,16,4,3,2062,2100,-38
1,15,17,4,3,1969,1852,117
1,15,18,4,3,1988,1730,258
1,16,0,4,3,1217,2176,-959
1,16,1,4,3,1372,1876,-504
1,16,2,4,3,1795,1788,7
1,16,3,4,3,2176,1823,353
1,16,4,4,3,1876,1814,62
1,16,5,4,3,1788,1568,220
1,16,6,4,3,1823,1210,613
1,16,7,4,3,1814,1311,503
1,16,8,4,3,1568,1278,290
1,16,9,4,3,1210,1274,-64
1,16,10,4,3,1311,1260,51
1,16,11,4,3,1278,1584,-306
1,16,12,4,3,1274,1909,-635
1,16,13,4,3,1260,1854,-594
1,16,14,4,3,1584,1668,-84
1,16,15,4,3,1909,1678,231
1,16,16,4,3,1854,1849,5
1,16,17,4,3,1668,1649,19
1,16,18,4,3,1678,1559,119
1,17,0,4,3,1254,1959,-705
1,17,1,4,3,1438,1491,-53
1,17,2,4,3,1777,1456,321
1,17,3,4,3,1959,1702,257
1,17,4,4,3,1491,1775,-284
1,17,5,4,3,1456,1634,-178
1,17,6,4,3,1702,1297,405
1,17,7,4,3,1775,1398,377
1,17,8,4,3,1634,1363,271
1,17,9,4,3,1297,1319,-22
1,17,10,4,3,1398,1181,217
1,17,11,4,3,1363,1355,8
1,17,12,4,3,1319,1644,-325
1,17,13,4,3,1181,1547,-366
1,17,14,4,3,1355,1337,18
1,17,15,4,3,1644,1404,240
1,17,16,4,3,1547,1593,-46
1,17,17,4,3,1337,1471,-134
1,17,18,4,3,1404,1445,-41
1,18,0,4,3,1372,1744,-372
1,18,1,4,3,1550,1133,417
1,18,2,4,3,1747,1096,651
1,18,3,4,3,1744,1450,294
1,18,4,4,3,1133,1547,-414
1,18,5,4,3,1096,1469,-373
1,18,6,4,3,1450,1160,290
1,18,7,4,3,1547,1296,251
1,18,8,4,3,1469,1298,171
1,18,9,4,3,1160,1240,-80
1,18,10,4,3,1296,1012,284
1,18,11,4,3,1298,1034,264
1,18,12,4,3,1240,1269,-29
1,18,13,4,3,1012,1237,-225
1,18,14,4,3,1034,1150,-116
1,18,15,4,3,1269,1235,34
1,18,16,4,3,1237,1367,-130
1,18,17,4,3,1150,1324,-174
1,18,18,4,3,1235,1389,-154
1,19,0,4,3,1329,1340,-11
1,19,1,4,3,1468,769,699
1,19,2,4,3,1485,897,588
1,19,3,4,3,1340,1432,-92
1,19,4,4,3,769,1529,-760
1,19,5,4,3,897,1479,-582
1,19,6,4,3,1432,1108,324
1,19,7,4,3,1529,1277,252
1,19,8,4,3,1479,1292,187
1,19,9,4,3,1108,1187,-79
1,19,10,4,3,1277,966,311
1,19,11,4,3,1292,1025,267
1,19,12,4,3,1187,1242,-55
1,19,13,4,3,966,1141,-175
1,19,14,4,3,1025,942,83
1,19,15,4,3,1242,963,279
1,19,16,4,3,1141,1038,103
1,19,17,4,3,942,1035,-93
1,19,18,4,3,963,1187,-224
1,20,0,4,3,1179,1099,80
1,20,1,4,3,1232,669,563
1,20,2,4,3,1209,839,370
1,20,3,4,3,1099,1328,-229
1,20,4,4,3,669,1424,-755
1,20,5,4,3,839,1290,-451
1,20,6,4,3,1328,909,419
1,20,7,4,3,1424,1077,347
1,20,8,4,3,1290,1128,162
1,20,9,4,3,909,1076,-167
1,20,10,4,3,1077,910,167
1,20,11,4,3,1128,955,173
1,20,12,4,3,1076,1049,27
1,20,13,4,3,910,892,18
1,20,14,4,3,955,781,174
1,20,15,4,3,1049,820,229
1,20,16,4,3,892,876,16
1,20,17,4,3,781,866,-85
1,20,18,4,3,820,987,-167
1,0,0,5,3,1656,1664,-8
1,0,1,5,3,1639,1653,-14
1,0,2,5,3,1641,1604,37
1,0,3,5,3,1664,1495,169
1,0,4,5,3,1653,1417,236
1,0,5,5,3,1604,1324,280
1,0,6,5,3,1495,1291,204
1,0,7,5,3,1417,1266,151
1,0,8,5,3,1324,1260,64
1,0,9,5,3,1291,1271,20
1,0,10,5,3,1266,1292,-26
1,0,11,5,3,1260,1348,-88
1,0,12,5,3,1271,1409,-138
1,0,13,5,3,1292,1517,-225
1,0,14,5,3,1348,1599,-251
1,0,15,5,3,1409,1631,-222
1,0,16,5,3,1517,1623,-106
1,0,17,5,3,1599,1624,-25
1,0,18,5,3,1631,1631,0
1,1,0,5,3,1699,1697,2
1,1,1,5,3,1699,1630,69
1,1,2,5,3,1700,1500,200
1,1,3,5,3,1697,1358,339
1,1,4,5,3,1630,1280,350
1,1,5,5,3,1500,1219,281
1,1,6,5,3,1358,1184,174
1,1,7,5,3,1280,1157,123
1,1,8,5,3,1219,1148,71
1,1,9,5,3,1184,1157,27
1,1,10,5,3,1157,1176,-19
1,1,11,5,3,1148,1227,-79
1,1,12,5,3,1157,1283,-126
1,1,13,5,3,1176,1401,-225
1,1,14,5,3,1227,1525,-298
1,1,15,5,3,1283,1619,-336
1,1,16,5,3,1401,1656,-255
1,1,17,5,3,1525,1667,-142
1,1,18,5,3,1619,1662,-43
1,2,0,5,3,1728,1629,99
1,2,1,5,3,1697,1544,153
1,2,2,5,3,1660,1390,270
1,2,3,5,3,1629,1235,394
1,2,4,5,3,1544,1155,389
1,2,5,5,3,1390,1108,282
1,2,6,5,3,1235,1078,157
1,2,7,5,3,1155,1054,101
1,2,8,5,3,1108,1045,63
1,2,9,5,3,1078,1051,27
1,2,10,5,3,1054,1065,-11
1,2,11,5,3,1045,1113,-68
1,2,12,5,3,1051,1165,-114
1,2,13,5,3,1065,1289,-224
1,2,14,5,3,1113,1436,-323
1,2,15,5,3,1165,1567,-402
1,2,16,5,3,1289,1633,-344
1,2,17,5,3,1436,1661,-225
1,2,18,5,3,1567,1673,-106
1,3,0,5,3,1740,1450,290
1,3,1,5,3,1627,1397,230
1,3,2,5,3,1510,1300,210
1,3,3,5,3,1450,1176,274
1,3,4,5,3,1397,1105,292
1,3,5,5,3,1300,1059,241
1,3,6,5,3,1176,1041,135
1,3,7,5,3,1105,1027,78
1,3,8,5,3,1059,1020,39
1,3,9,5,3,1041,1021,20
1,3,10,5,3,1027,1027,0
1,3,11,5,3,1020,1067,-47
1,3,12,5,3,1021,1107,-86
1,3,13,5,3,1027,1216,-189
1,3,14,5,3,1067,1351,-284
1,3,15,5,3,1107,1476,-369
1,3,16,5,3,1216,1546,-330
1,3,17,5,3,1351,1599,-248
1,3,18,5,3,1476,1661,-185
1,4,0,5,3,1789,1353,436
1,4,1,5,3,1635,1350,285
1,4,2,5,3,1445,1308,137
1,4,3,5,3,1353,1260,93
1,4,4,5,3,1350,1232,118
1,4,5,5,3,1308,1244,64
1,4,6,5,3,1260,1245,15
1,4,7,5,3,1232,1249,-17
1,4,8,5,3,1244,1261,-17
1,4,9,5,3,1245,1261,-16
1,4,10,5,3,1249,1254,-5
1,4,11,5,3,1261,1255,6
1,4,12,5,3,1261,1254,7
1,4,13,5,3,1254,1304,-50
1,4,14,5,3,1255,1367,-112
1,4,15,5,3,1254,1452,-198
1,4,16,5,3,1304,1534,-230
1,4,17,5,3,1367,1622,-255
1,4,18,5,3,1452,1712,-260
1,5,0,5,3,1686,1131,555
1,5,1,5,3,1468,1150,318
1,5,2,5,3,1243,1184,59
1,5,3,5,3,1131,1211,-80
1,5,4,5,3,1150,1223,-73
1,5,5,5,3,1184,1225,-41
1,5,6,5,3,1211,1207,4
1,5,7,5,3,1223,1216,7
1,5,8,5,3,1225,1230,-5
1,5,9,5,3,1207,1219,-12
1,5,10,5,3,1216,1222,-6
1,5,11,5,3,1230,1240,-10
1,5,12,5,3,1219,1250,-31
1,5,13,5,3,1222,1247,-25
1,5,14,5,3,1240,1234,6
1,5,15,5,3,1250,1264,-14
1,5,16,5,3,1247,1344,-97
1,5,17,5,3,1234,1471,-237
1,5,18,5,3,1264,1618,-354
1,6,0,5,3,1538,1120,418
1,6,1,5,3,1287,1236,51
1,6,2,5,3,1163,1365,-202
1,6,3,5,3,1120,1456,-336
1,6,4,5,3,1236,1474,-238
1,6,5,5,3,1365,1423,-58
1,6,6,5,3,1456,1386,70
1,6,7,5,3,1474,1395,79
1,6,8,5,3,1423,1411,12
1,6,9,5,3,1386,1405,-19
1,6,10,5,3,1395,1411,-16
1,6,11,5,3,1411,1452,-41
1,6,12,5,3,1405,1494,-89
1,6,13,5,3,1411,1459,-48
1,6,14,5,3,1452,1369,83
1,6,15,5,3,1494,1307,187
1,6,16,5,3,1459,1319,140
1,6,17,5,3,1369,1414,-45
1,6,18,5,3,1307,1560,-253
1,7,0,5,3,1514,1413,101
1,7,1,5,3,1278,1651,-373
1,7,2,5,3,1344,1786,-442
1,7,3,5,3,1413,1931,-518
1,7,4,5,3,1651,1902,-251
1,7,5,5,3,1786,1804,-18
1,7,6,5,3,1931,1729,202
1,7,7,5,3,1902,1751,151
1,7,8,5,3,1804,1773,31
1,7,9,5,3,1729,1774,-45
1,7,10,5,3,1751,1779,-28
1,7,11,5,3,1773,1854,-81
1,7,12,5,3,1774,1950,-176
1,7,13,5,3,1779,1907,-128
1,7,14,5,3,1854,1776,78
1,7,15,5,3,1950,1660,290
1,7,16,5,3,1907,1621,286
1,7,17,5,3,1776,1649,127
1,7,18,5,3,1660,1698,-38
1,8,0,5,3,1571,1831,-260
1,8,1,5,3,1391,2123,-732
1,8,2,5,3,1632,2180,-548
1,8,3,5,3,1831,2318,-487
1,8,4,5,3,2123,2173,-50
1,8,5,5,3,2180,1973,207
1,8,6,5,3,2318,1777,541
1,8,7,5,3,2173,1816,357
1,8,8,5,3,1973,1834,139
1,8,9,5,3,1777,1825,-48
1,8,10,5,3,1816,1861,-45
1,8,11,5,3,1834,2075,-241
1,8,12,5,3,1825,2319,-494
1,8,13,5,3,1861,2334,-473
1,8,14,5,3,2075,2196,-121
1,8,15,5,3,2319,2072,247
1,8,16,5,3,2334,2025,309
1,8,17,5,3,2196,1997,199
1,8,18,5,3,2072,1906,166
1,9,0,5,3,1598,2159,-561
1,9,1,5,3,1443,2441,-998
1,9,2,5,3,1790,2486,-696
1,9,3,5,3,2159,2587,-428
1,9,4,5,3,2441,2372,69
1,9,5,5,3,2486,2036,450
1,9,6,5,3,2587,1674,913
1,9,7,5,3,2372,1712,660
1,9,8,5,3,2036,1704,332
1,9,9,5,3,1674,1692,-18
1,9,10,5,3,1712,1783,-71
1,9,11,5,3,1704,2162,-458
1,9,12,5,3,1692,2539,-847
1,9,13,5,3,1783,2624,-841
1,9,14,5,3,2162,2491,-329
1,9,15,5,3,2539,2359,180
1,9,16,5,3,2624,2283,341
1,9,17,5,3,2491,2214,277
1,9,18,5,3,2359,2048,311
1,10,0,5,3,1790,2572,-782
1,10,1,5,3,1668,2874,-1206
1,10,2,5,3,2050,2948,-898
1,10,3,5,3,2572,3022,-450
1,10,4,5,3,2874,2767,107
1,10,5,5,3,2948,2365,583
1,10,6,5,3,3022,1888,1134
1,10,7,5,3,2767,1937,830
1,10,8,5,3,2365,1915,450
1,10,9,5,3,1888,1923,-35
1,10,10,5,3,1937,2046,-109
1,10,11,5,3,1915,2523,-608
1,10,12,5,3,1923,2937,-1014
1,10,13,5,3,2046,3092,-1046
1,10,14,5,3,2523,2943,-420
1,10,15,5,3,2937,2799,138
1,10,16,5,3,3092,2686,406
1,10,17,5,3,2943,2576,367
1,10,18,5,3,2799,2359,440
1,11,0,5,3,2004,2806,-802
1,11,1,5,3,1883,3106,-1223
1,11,2,5,3,2199,3201,-1002
1,11,3,5,3,2806,3239,-433
1,11,4,5,3,3106,2898,208
1,11,5,5,3,3201,2402,799
1,11,6,5,3,3239,1804,1435
1,11,7,5,3,2898,1878,1020
1,11,8,5,3,2402,1830,572
1,11,9,5,3,1804,1825,-21
1,11,10,5,3,1878,1999,-121
1,11,11,5,3,1830,2626,-796
1,11,12,5,3,1825,3100,-1275
1,11,13,5,3,1999,3359,-1360
1,11,14,5,3,2626,3203,-577
1,11,15,5,3,3100,3071,29
1,11,16,5,3,3359,2939,420
1,11,17,5,3,3203,2813,390
1,11,18,5,3,3071,2597,474
1,12,0,5,3,1972,2842,-870
1,12,1,5,3,1878,3053,-1175
1,12,2,5,3,2146,3200,-1054
1,12,3,5,3,2842,3187,-345
1,12,4,5,3,3053,2868,185
1,12,5,5,3,3200,2277,923
1,12,6,5,3,3187,1572,1615
1,12,7,5,3,2868,1653,1215
1,12,8,5,3,2277,1594,683
1,12,9,5,3,1572,1587,-15
1,12,10,5,3,1653,1810,-157
1,12,11,5,3,1594,2537,-943
1,12,12,5,3,1587,3031,-1444
1,12,13,5,3,1810,3310,-1500
1,12,14,5,3,2537,3148,-611
1,12,15,5,3,3031,3025,6
1,12,16,5,3,3310,2887,423
1,12,17,5,3,3148,2699,449
1,12,18,5,3,3025,2546,479
1,13,0,5,3,1816,2822,-1006
1,13,1,5,3,1785,2912,-1127
1,13,2,5,3,2095,3096,-1001
1,13,3,5,3,2822,3057,-235
1,13,4,5,3,2912,2799,113
1,13,5,5,3,3096,2197,899
1,13,6,5,3,3057,1480,1577
1,13,7,5,3,2799,1553,1246
1,13,8,5,3,2197,1470,727
1,13,9,5,3,1480,1469,11
1,13,10,5,3,1553,1721,-168
1,13,11,5,3,1470,2467,-997
1,13,12,5,3,1469,2926,-1457
1,13,13,5,3,1721,3099,-1378
1,13,14,5,3,2467,2884,-417
1,13,15,5,3,2926,2794,132
1,13,16,5,3,3099,2750,349
1,13,17,5,3,2884,2518,366
1,13,18,5,3,2794,2433,361
1,14,0,5,3,1691,2860,-1169
1,14,1,5,3,1745,2788,-1043
1,14,2,5,3,2173,2816,-643
1,14,3,5,3,2860,2714,146
1,14,4,5,3,2788,2530,258
1,14,5,5,3,2816,2002,814
1,14,6,5,3,2714,1413,1301
1,14,7,5,3,2530,1510,1020
1,14,8,5,3,2002,1437,565
1,14,9,5,3,1413,1457,-44
1,14,10,5,3,1510,1637,-127
1,14,11,5,3,1437,2222,-785
1,14,12,5,3,1457,2610,-1153
1,14,13,5,3,1637,2713,-1076
1,14,14,5,3,2222,2592,-370
1,14,15,5,3,2610,2584,26
1,14,16,5,3,2713,2661,52
1,14,17,5,3,2592,2401,191
1,14,18,5,3,2584,2280,304
1,15,0,5,3,1639,2752,-1113
1,15,1,5,3,1767,2497,-730
1,15,2,5,3,2228,2439,-211
1,15,3,5,3,2752,2462,290
1,15,4,5,3,2497,2372,125
1,15,5,5,3,2439,2007,432
1,15,6,5,3,2462,1505,957
1,15,7,5,3,2372,1628,744
1,15,8,5,3,2007,1569,438
1,15,9,5,3,1505,1557,-52
1,15,10,5,3,1628,1598,30
1,15,11,5,3,1569,2085,-516
1,15,12,5,3,1557,2495,-938
1,15,13,5,3,1598,2527,-929
1,15,14,5,3,2085,2309,-224
1,15,15,5,3,2495,2297,198
1,15,16,5,3,2527,2419,108
1,15,17,5,3,2309,2182,127
1,15,18,5,3,2297,2084,213
1,16,0,5,3,1551,2546,-995
1,16,1,5,3,1746,2089,-343
1,16,2,5,3,2190,2083,107
1,16,3,5,3,2546,2319,227
1,16,4,5,3,2089,2369,-280
1,16,5,5,3,2083,2097,-14
1,16,6,5,3,2319,1615,704
1,16,7,5,3,2369,1736,633
1,16,8,5,3,2097,1696,401
1,16,9,5,3,1615,1656,-41
1,16,10,5,3,1736,1565,171
1,16,11,5,3,1696,1881,-185
1,16,12,5,3,1656,2242,-586
1,16,13,5,3,1565,2160,-595
1,16,14,5,3,1881,1913,-32
1,16,15,5,3,2242,1966,276
1,16,16,5,3,2160,2134,26
1,16,17,5,3,1913,1912,1
1,16,18,5,3,1966,1870,96
1,17,0,5,3,1618,2288,-670
1,17,1,5,3,1834,1643,191
1,17,2,5,3,2163,1630,533
1,17,3,5,3,2288,1989,299
1,17,4,5,3,1643,2045,-402
1,17,5,5,3,1630,1846,-216
1,17,6,5,3,1989,1408,581
1,17,7,5,3,2045,1556,489
1,17,8,5,3,1846,1531,315
1,17,9,5,3,1408,1467,-59
1,17,10,5,3,1556,1296,260
1,17,11,5,3,1531,1477,54
1,17,12,5,3,1467,1812,-345
1,17,13,5,3,1296,1715,-419
1,17,14,5,3,1477,1546,-69
1,17,15,5,3,1812,1644,168
1,17,16,5,3,1715,1867,-152
1,17,17,5,3,1546,1757,-211
1,17,18,5,3,1644,1803,-159
1,18,0,5,3,1619,1941,-322
1,18,1,5,3,1820,1255,565
1,18,2,5,3,1983,1273,710
1,18,3,5,3,1941,1741,200
1,18,4,5,3,1255,1842,-587
1,18,5,5,3,1273,1739,-466
1,18,6,5,3,1741,1340,401
1,18,7,5,3,1842,1543,299
1,18,8,5,3,1739,1558,181
1,18,9,5,3,1340,1472,-132
1,18,10,5,3,1543,1226,317
1,18,11,5,3,1558,1277,281
1,18,12,5,3,1472,1549,-77
1,18,13,5,3,1226,1439,-213
1,18,14,5,3,1277,1298,-21
1,18,15,5,3,1549,1361,188
1,18,16,5,3,1439,1527,-88
1,18,17,5,3,1298,1480,-182
1,18,18,5,3,1361,1553,-192
1,19,0,5,3,1563,1543,20
1,19,1,5,3,1660,951,709
1,19,2,5,3,1677,1090,587
1,19,3,5,3,1543,1686,-143
1,19,4,5,3,951,1833,-882
1,19,5,5,3,1090,1758,-668
1,19,6,5,3,1686,1321,365
1,19,7,5,3,1833,1524,309
1,19,8,5,3,1758,1574,184
1,19,9,5,3,1321,1501,-180
1,19,10,5,3,1524,1242,282
1,19,11,5,3,1574,1318,256
1,19,12,5,3,1501,1510,-9
1,19,13,5,3,1242,1357,-115
1,19,14,5,3,1318,1121,197
1,19,15,5,3,1510,1129,381
1,19,16,5,3,1357,1195,162
1,19,17,5,3,1121,1196,-75
1,19,18,5,3,1129,1341,-212
1,0,0,6,3,2012,2017,-5
1,0,1,6,3,2000,1956,44
1,0,2,6,3,2005,1821,184
1,0,3,6,3,2017,1672,345
1,0,4,6,3,1956,1593,363
1,0,5,6,3,1821,1528,293
1,0,6,6,3,1672,1491,181
1,0,7,6,3,1593,1463,130
1,0,8,6,3,1528,1455,73
1,0,9,6,3,1491,1466,25
1,0,10,6,3,1463,1488,-25
1,0,11,6,3,1455,1534,-79
1,0,12,6,3,1466,1588,-122
1,0,13,6,3,1488,1711,-223
1,0,14,6,3,1534,1845,-311
1,0,15,6,3,1588,1935,-347
1,0,16,6,3,1711,1965,-254
1,0,17,6,3,1845,1977,-132
1,0,18,6,3,1935,1976,-41
1,1,0,6,3,2052,1955,97
1,1,1,6,3,2021,1866,155
1,1,2,6,3,1985,1707,278
1,1,3,6,3,1955,1552,403
1,1,4,6,3,1866,1476,390
1,1,5,6,3,1707,1426,281
1,1,6,6,3,1552,1391,161
1,1,7,6,3,1476,1364,112
1,1,8,6,3,1426,1355,71
1,1,9,6,3,1391,1363,28
1,1,10,6,3,1364,1381,-17
1,1,11,6,3,1355,1440,-85
1,1,12,6,3,1363,1494,-131
1,1,13,6,3,1381,1615,-234
1,1,14,6,3,1440,1749,-309
1,1,15,6,3,1494,1874,-380
1,1,16,6,3,1615,1947,-332
1,1,17,6,3,1749,1987,-238
1,1,18,6,3,1874,2000,-126
1,2,0,6,3,2073,1775,298
1,2,1,6,3,1961,1723,238
1,2,2,6,3,1839,1634,205
1,2,3,6,3,1775,1517,258
1,2,4,6,3,1723,1451,272
1,2,5,6,3,1634,1396,238
1,2,6,6,3,1517,1370,147
1,2,7,6,3,1451,1349,102
1,2,8,6,3,1396,1341,55
1,2,9,6,3,1370,1345,25
1,2,10,6,3,1349,1356,-7
1,2,11,6,3,1341,1405,-64
1,2,12,6,3,1345,1444,-99
1,2,13,6,3,1356,1551,-195
1,2,14,6,3,1405,1676,-271
1,2,15,6,3,1444,1795,-351
1,2,16,6,3,1551,1866,-315
1,2,17,6,3,1676,1927,-251
1,2,18,6,3,1795,1992,-197
1,3,0,6,3,2128,1685,443
1,3,1,6,3,1967,1689,278
1,3,2,6,3,1772,1650,122
1,3,3,6,3,1685,1559,126
1,3,4,6,3,1689,1488,201
1,3,5,6,3,1650,1451,199
1,3,6,6,3,1559,1443,116
1,3,7,6,3,1488,1440,48
1,3,8,6,3,1451,1449,2
1,3,9,6,3,1443,1451,-8
1,3,10,6,3,1440,1449,-9
1,3,11,6,3,1449,1477,-28
1,3,12,6,3,1451,1510,-59
1,3,13,6,3,1449,1610,-161
1,3,14,6,3,1477,1704,-227
1,3,15,6,3,1510,1797,-287
1,3,16,6,3,1610,1866,-256
1,3,17,6,3,1704,1944,-240
1,3,18,6,3,1797,2038,-241
1,4,0,6,3,2033,1492,541
1,4,1,6,3,1816,1490,326
1,4,2,6,3,1598,1474,124
1,4,3,6,3,1492,1435,57
1,4,4,6,3,1490,1404,86
1,4,5,6,3,1474,1378,96
1,4,6,6,3,1435,1351,84
1,4,7,6,3,1404,1353,51
1,4,8,6,3,1378,1364,14
1,4,9,6,3,1351,1355,-4
1,4,10,6,3,1353,1362,-9
1,4,11,6,3,1364,1394,-30
1,4,12,6,3,1355,1432,-77
1,4,13,6,3,1362,1487,-125
1,4,14,6,3,1394,1538,-144
1,4,15,6,3,1432,1608,-176
1,4,16,6,3,1487,1692,-205
1,4,17,6,3,1538,1809,-271
1,4,18,6,3,1608,1951,-343
1,5,0,6,3,1894,1473,421
1,5,1,6,3,1648,1539,109
1,5,2,6,3,1527,1582,-55
1,5,3,6,3,1473,1633,-160
1,5,4,6,3,1539,1650,-111
1,5,5,6,3,1582,1627,-45
1,5,6,6,3,1633,1586,47
1,5,7,6,3,1650,1592,58
1,5,8,6,3,1627,1606,21
1,5,9,6,3,1586,1600,-14
1,5,10,6,3,1592,1607,-15
1,5,11,6,3,1606,1638,-32
1,5,12,6,3,1600,1673,-73
1,5,13,6,3,1607,1653,-46
1,5,14,6,3,1638,1615,23
1,5,15,6,3,1673,1611,62
1,5,16,6,3,1653,1661,-8
1,5,17,6,3,1615,1767,-152
1,5,18,6,3,1611,1905,-294
1,6,0,6,3,1867,1671,196
1,6,1,6,3,1600,1887,-287
1,6,2,6,3,1629,1993,-364
1,6,3,6,3,1671,2125,-454
1,6,4,6,3,1887,2098,-211
1,6,5,6,3,1993,2011,-18
1,6,6,6,3,2125,1936,189
1,6,7,6,3,2098,1958,140
1,6,8,6,3,2011,1980,31
1,6,9,6,3,1936,1980,-44
1,6,10,6,3,1958,1984,-26
1,6,11,6,3,1980,2067,-87
1,6,12,6,3,1980,2161,-181
1,6,13,6,3,1984,2121,-137
1,6,14,6,3,2067,2000,67
1,6,15,6,3,2161,1915,246
1,6,16,6,3,2121,1912,209
1,6,17,6,3,2000,1969,31
1,6,18,6,3,1915,2036,-121
1,7,0,6,3,1916,1977,-61
1,7,1,6,3,1655,2302,-647
1,7,2,6,3,1811,2424,-613
1,7,3,6,3,1977,2600,-623
1,7,4,6,3,2302,2469,-167
1,7,5,6,3,2424,2261,163
1,7,6,6,3,2600,2069,531
1,7,7,6,3,2469,2111,358
1,7,8,6,3,2261,2130,131
1,7,9,6,3,2069,2119,-50
1,7,10,6,3,2111,2152,-41
1,7,11,6,3,2130,2367,-237
1,7,12,6,3,2119,2598,-479
1,7,13,6,3,2152,2596,-444
1,7,14,6,3,2367,2436,-69
1,7,15,6,3,2598,2300,298
1,7,16,6,3,2596,2258,338
1,7,17,6,3,2436,2263,173
1,7,18,6,3,2300,2225,75
1,8,0,6,3,1986,2394,-408
1,8,1,6,3,1783,2733,-950
1,8,2,6,3,2052,2836,-784
1,8,3,6,3,2394,2970,-576
1,8,4,6,3,2733,2755,-22
1,8,5,6,3,2836,2428,408
1,8,6,6,3,2970,2076,894
1,8,7,6,3,2755,2125,630
1,8,8,6,3,2428,2133,295
1,8,9,6,3,2076,2122,-46
1,8,10,6,3,2125,2205,-80
1,8,11,6,3,2133,2572,-439
1,8,12,6,3,2122,2942,-820
1,8,13,6,3,2205,3018,-813
1,8,14,6,3,2572,2844,-272
1,8,15,6,3,2942,2680,262
1,8,16,6,3,3018,2603,415
1,8,17,6,3,2844,2559,285
1,8,18,6,3,2680,2425,255
1,9,0,6,3,2034,2711,-677
1,9,1,6,3,1849,3014,-1165
1,9,2,6,3,2203,3114,-911
1,9,3,6,3,2711,3197,-486
1,9,4,6,3,3014,2939,75
1,9,5,6,3,3114,2499,615
1,9,6,6,3,3197,1994,1203
1,9,7,6,3,2939,2041,898
1,9,8,6,3,2499,2018,481
1,9,9,6,3,1994,2017,-23
1,9,10,6,3,2041,2154,-113
1,9,11,6,3,2018,2662,-644
1,9,12,6,3,2017,3115,-1098
1,9,13,6,3,2154,3275,-1121
1,9,14,6,3,2662,3114,-452
1,9,15,6,3,3115,2955,160
1,9,16,6,3,3275,2844,431
1,9,17,6,3,3114,2763,351
1,9,18,6,3,2955,2598,357
1,10,0,6,3,2212,3148,-936
1,10,1,6,3,2063,3495,-1432
1,10,2,6,3,2483,3599,-1116
1,10,3,6,3,3148,3661,-513
1,10,4,6,3,3495,3325,170
1,10,5,6,3,3599,2804,795
1,10,6,6,3,3661,2183,1478
1,10,7,6,3,3325,2254,1071
1,10,8,6,3,2804,2206,598
1,10,9,6,3,2183,2206,-23
1,10,10,6,3,2254,2384,-130
1,10,11,6,3,2206,3024,-818
1,10,12,6,3,2206,3523,-1317
1,10,13,6,3,2384,3765,-1381
1,10,14,6,3,3024,3584,-560
1,10,15,6,3,3523,3418,105
1,10,16,6,3,3765,3256,509
1,10,17,6,3,3584,3109,475
1,10,18,6,3,3418,2884,534
1,11,0,6,3,2301,3393,-1092
1,11,1,6,3,2191,3704,-1513
1,11,2,6,3,2612,3828,-1216
1,11,3,6,3,3393,3856,-463
1,11,4,6,3,3704,3492,212
1,11,5,6,3,3828,2865,963
1,11,6,6,3,3856,2122,1734
1,11,7,6,3,3492,2216,1276
1,11,8,6,3,2865,2163,702
1,11,9,6,3,2122,2162,-40
1,11,10,6,3,2216,2383,-167
1,11,11,6,3,2163,3152,-989
1,11,12,6,3,2162,3698,-1536
1,11,13,6,3,2383,3972,-1589
1,11,14,6,3,3152,3779,-627
1,11,15,6,3,3698,3633,65
1,11,16,6,3,3972,3480,492
1,11,17,6,3,3779,3254,525
1,11,18,6,3,3633,3022,611
1,12,0,6,3,2218,3386,-1168
1,12,1,6,3,2162,3563,-1401
1,12,2,6,3,2562,3734,-1172
1,12,3,6,3,3386,3726,-340
1,12,4,6,3,3563,3366,197
1,12,5,6,3,3734,2654,1080
1,12,6,6,3,3726,1820,1906
1,12,7,6,3,3366,1913,1453
1,12,8,6,3,2654,1827,827
1,12,9,6,3,1820,1814,6
1,12,10,6,3,1913,2094,-181
1,12,11,6,3,1827,2980,-1153
1,12,12,6,3,1814,3574,-1760
1,12,13,6,3,2094,3788,-1694
1,12,14,6,3,2980,3544,-564
1,12,15,6,3,3574,3434,140
1,12,16,6,3,3788,3387,401
1,12,17,6,3,3544,3132,412
1,12,18,6,3,3434,2960,474
1,13,0,6,3,2106,3423,-1317
1,13,1,6,3,2137,3398,-1261
1,13,2,6,3,2593,3472,-879
1,13,3,6,3,3423,3366,57
1,13,4,6,3,3398,3112,286
1,13,5,6,3,3472,2457,1015
1,13,6,6,3,3366,1712,1654
1,13,7,6,3,3112,1819,1293
1,13,8,6,3,2457,1736,721
1,13,9,6,3,1712,1754,-42
1,13,10,6,3,1819,1981,-162
1,13,11,6,3,1736,2719,-983
1,13,12,6,3,1754,3233,-1479
1,13,13,6,3,1981,3397,-1416
1,13,14,6,3,2719,3240,-521
1,13,15,6,3,3233,3192,41
1,13,16,6,3,3397,3239,158
1,13,17,6,3,3240,2963,277
1,13,18,6,3,3192,2799,393
1,14,0,6,3,2075,3304,-1229
1,14,1,6,3,2173,3070,-897
1,14,2,6,3,2641,3067,-426
1,14,3,6,3,3304,3072,232
1,14,4,6,3,3070,2939,131
1,14,5,6,3,3067,2470,597
1,14,6,6,3,3072,1825,1247
1,14,7,6,3,2939,1957,982
1,14,8,6,3,2470,1883,587
1,14,9,6,3,1825,1882,-57
1,14,10,6,3,1957,1969,-12
1,14,11,6,3,1883,2585,-702
1,14,12,6,3,1882,3071,-1189
1,14,13,6,3,1969,3178,-1209
1,14,14,6,3,2585,2932,-347
1,14,15,6,3,3071,2893,178
1,14,16,6,3,3178,2980,198
1,14,17,6,3,2932,2731,201
1,14,18,6,3,2893,2634,259
1,15,0,6,3,1973,3122,-1149
1,15,1,6,3,2141,2710,-569
1,15,2,6,3,2623,2734,-111
1,15,3,6,3,3122,2958,164
1,15,4,6,3,2710,2927,-217
1,15,5,6,3,2734,2536,198
1,15,6,6,3,2958,1910,1048
1,15,7,6,3,2927,2053,874
1,15,8,6,3,2536,1987,549
1,15,9,6,3,1910,1939,-29
1,15,10,6,3,2053,1903,150
1,15,11,6,3,1987,2382,-395
1,15,12,6,3,1939,2828,-889
1,15,13,6,3,1903,2833,-930
1,15,14,6,3,2382,2554,-172
1,15,15,6,3,2828,2585,243
1,15,16,6,3,2833,2704,129
1,15,17,6,3,2554,2445,109
1,15,18,6,3,2585,2395,190
1,16,0,6,3,1915,2875,-960
1,16,1,6,3,2142,2241,-99
1,16,2,6,3,2576,2257,319
1,16,3,6,3,2875,2606,269
1,16,4,6,3,2241,2639,-398
1,16,5,6,3,2257,2309,-52
1,16,6,6,3,2606,1726,880
1,16,7,6,3,2639,1894,745
1,16,8,6,3,2309,1864,445
1,16,9,6,3,1726,1804,-78
1,16,10,6,3,1894,1680,214
1,16,11,6,3,1864,2003,-139
1,16,12,6,3,1804,2410,-606
1,16,13,6,3,1680,2328,-648
1,16,14,6,3,2003,2122,-119
1,16,15,6,3,2410,2206,204
1,16,16,6,3,2328,2408,-80
1,16,17,6,3,2122,2198,-76
1,16,18,6,3,2206,2228,-22
1,17,0,6,3,1865,2485,-620
1,17,1,6,3,2104,1765,339
1,17,2,6,3,2399,1807,592
1,17,3,6,3,2485,2280,205
1,17,4,6,3,1765,2340,-575
1,17,5,6,3,1807,2116,-309
1,17,6,6,3,2280,1588,692
1,17,7,6,3,2340,1803,537
1,17,8,6,3,2116,1791,325
1,17,9,6,3,1588,1699,-111
1,17,10,6,3,1803,1510,293
1,17,11,6,3,1791,1720,71
1,17,12,6,3,1699,2092,-393
1,17,13,6,3,1510,1917,-407
1,17,14,6,3,1720,1694,26
1,17,15,6,3,2092,1770,322
1,17,16,6,3,1917,2027,-110
1,17,17,6,3,1694,1913,-219
1,17,18,6,3,1770,1967,-197
1,18,0,6,3,1853,2144,-291
1,18,1,6,3,2012,1437,575
1,18,2,6,3,2175,1466,709
1,18,3,6,3,2144,1995,149
1,18,4,6,3,1437,2146,-709
1,18,5,6,3,1466,2018,-552
1,18,6,6,3,1995,1553,442
1,18,7,6,3,2146,1790,356
1,18,8,6,3,2018,1840,178
1,18,9,6,3,1553,1786,-233
1,18,10,6,3,1790,1502,288
1,18,11,6,3,1840,1570,270
1,18,12,6,3,1786,1817,-31
1,18,13,6,3,1502,1655,-153
1,18,14,6,3,1570,1477,93
1,18,15,6,3,1817,1527,290
1,18,16,6,3,1655,1684,-29
1,18,17,6,3,1477,1641,-164
1,18,18,6,3,1527,1707,-180
1,0,0,7,3,2365,2275,90
1,0,1,7,3,2322,2192,130
1,0,2,7,3,2290,2028,262
1,0,3,7,3,2275,1866,409
1,0,4,7,3,2192,1789,403
1,0,5,7,3,2028,1735,293
1,0,6,7,3,1866,1698,168
1,0,7,7,3,1789,1670,119
1,0,8,7,3,1735,1662,73
1,0,9,7,3,1698,1672,26
1,0,10,7,3,1670,1693,-23
1,0,11,7,3,1662,1747,-85
1,0,12,7,3,1672,1799,-127
1,0,13,7,3,1693,1925,-232
1,0,14,7,3,1747,2069,-322
1,0,15,7,3,1799,2190,-391
1,0,16,7,3,1925,2256,-331
1,0,17,7,3,2069,2297,-228
1,0,18,7,3,2190,2314,-124
1,1,0,7,3,2397,2101,296
1,1,1,7,3,2285,2045,240
1,1,2,7,3,2164,1951,213
1,1,3,7,3,2101,1834,267
1,1,4,7,3,2045,1772,273
1,1,5,7,3,1951,1714,237
1,1,6,7,3,1834,1683,151
1,1,7,7,3,1772,1659,113
1,1,8,7,3,1714,1651,63
1,1,9,7,3,1683,1657,26
1,1,10,7,3,1659,1672,-13
1,1,11,7,3,1651,1732,-81
1,1,12,7,3,1657,1773,-116
1,1,13,7,3,1672,1877,-205
1,1,14,7,3,1732,1989,-257
1,1,15,7,3,1773,2102,-329
1,1,16,7,3,1877,2180,-303
1,1,17,7,3,1989,2253,-264
1,1,18,7,3,2102,2319,-217
1,2,0,7,3,2461,2010,451
1,2,1,7,3,2301,2015,286
1,2,2,7,3,2101,1984,117
1,2,3,7,3,2010,1900,110
1,2,4,7,3,2015,1834,181
1,2,5,7,3,1984,1788,196
1,2,6,7,3,1900,1772,128
1,2,7,7,3,1834,1762,72
1,2,8,7,3,1788,1770,18
1,2,9,7,3,1772,1775,-3
1,2,10,7,3,1762,1778,-16
1,2,11,7,3,1770,1815,-45
1,2,12,7,3,1775,1847,-72
1,2,13,7,3,1778,1945,-167
1,2,14,7,3,1815,2029,-214
1,2,15,7,3,1847,2116,-269
1,2,16,7,3,1945,2186,-241
1,2,17,7,3,2029,2272,-243
1,2,18,7,3,2116,2369,-253
1,3,0,7,3,2372,1824,548
1,3,1,7,3,2148,1829,319
1,3,2,7,3,1925,1816,109
1,3,3,7,3,1824,1734,90
1,3,4,7,3,1829,1660,169
1,3,5,7,3,1816,1585,231
1,3,6,7,3,1734,1549,185
1,3,7,7,3,1660,1544,116
1,3,8,7,3,1585,1552,33
1,3,9,7,3,1549,1545,4
1,3,10,7,3,1544,1557,-13
1,3,11,7,3,1552,1616,-64
1,3,12,7,3,1545,1688,-143
1,3,13,7,3,1557,1793,-236
1,3,14,7,3,1616,1875,-259
1,3,15,7,3,1688,1953,-265
1,3,16,7,3,1793,2024,-231
1,3,17,7,3,1875,2131,-256
1,3,18,7,3,1953,2277,-324
1,4,0,7,3,2241,1834,407
1,4,1,7,3,1996,1879,117
1,4,2,7,3,1882,1872,10
1,4,3,7,3,1834,1857,-23
1,4,4,7,3,1879,1831,48
1,4,5,7,3,1872,1780,92
1,4,6,7,3,1857,1730,127
1,4,7,7,3,1831,1729,102
1,4,8,7,3,1780,1740,40
1,4,9,7,3,1730,1736,-6
1,4,10,7,3,1729,1747,-18
1,4,11,7,3,1740,1792,-52
1,4,12,7,3,1736,1855,-119
1,4,13,7,3,1747,1893,-146
1,4,14,7,3,1792,1919,-127
1,4,15,7,3,1855,1955,-100
1,4,16,7,3,1893,2009,-116
1,4,17,7,3,1919,2105,-186
1,4,18,7,3,1955,2238,-283
1,5,0,7,3,2223,2024,199
1,5,1,7,3,1961,2190,-229
1,5,2,7,3,1993,2210,-217
1,5,3,7,3,2024,2302,-278
1,5,4,7,3,2190,2274,-84
1,5,5,7,3,2210,2215,-5
1,5,6,7,3,2302,2136,166
1,5,7,7,3,2274,2155,119
1,5,8,7,3,2215,2175,40
1,5,9,7,3,2136,2175,-39
1,5,10,7,3,2155,2180,-25
1,5,11,7,3,2175,2253,-78
1,5,12,7,3,2175,2340,-165
1,5,13,7,3,2180,2315,-135
1,5,14,7,3,2253,2246,7
1,5,15,7,3,2340,2219,121
1,5,16,7,3,2315,2254,61
1,5,17,7,3,2246,2322,-76
1,5,18,7,3,2219,2381,-162
1,6,0,7,3,2269,2235,34
1,6,1,7,3,1977,2538,-561
1,6,2,7,3,2096,2631,-535
1,6,3,7,3,2235,2794,-559
1,6,4,7,3,2538,2665,-127
1,6,5,7,3,2631,2468,163
1,6,6,7,3,2794,2276,518
1,6,7,7,3,2665,2318,347
1,6,8,7,3,2468,2337,131
1,6,9,7,3,2276,2325,-49
1,6,10,7,3,2318,2357,-39
1,6,11,7,3,2337,2580,-243
1,6,12,7,3,2325,2809,-484
1,6,13,7,3,2357,2810,-453
1,6,14,7,3,2580,2660,-80
1,6,15,7,3,2809,2555,254
1,6,16,7,3,2810,2549,261
1,6,17,7,3,2660,2583,77
1,6,18,7,3,2555,2563,-8
1,7,0,7,3,2331,2540,-209
1,7,1,7,3,2047,2912,-865
1,7,2,7,3,2231,3080,-849
1,7,3,7,3,2540,3252,-712
1,7,4,7,3,2912,3051,-139
1,7,5,7,3,3080,2716,364
1,7,6,7,3,3252,2368,884
1,7,7,7,3,3051,2420,631
1,7,8,7,3,2716,2429,287
1,7,9,7,3,2368,2416,-48
1,7,10,7,3,2420,2496,-76
1,7,11,7,3,2429,2864,-435
1,7,12,7,3,2416,3221,-805
1,7,13,7,3,2496,3280,-784
1,7,14,7,3,2864,3084,-220
1,7,15,7,3,3221,2908,313
1,7,16,7,3,3280,2836,444
1,7,17,7,3,3084,2825,259
1,7,18,7,3,2908,2744,164
1,8,0,7,3,2422,2946,-524
1,8,1,7,3,2189,3306,-1117
1,8,2,7,3,2465,3464,-999
1,8,3,7,3,2946,3580,-634
1,8,4,7,3,3306,3322,-16
1,8,5,7,3,3464,2891,573
1,8,6,7,3,3580,2396,1184
1,8,7,7,3,3322,2454,868
1,8,8,7,3,2891,2447,444
1,8,9,7,3,2396,2447,-51
1,8,10,7,3,2454,2576,-122
1,8,11,7,3,2447,3072,-625
1,8,12,7,3,2447,3518,-1071
1,8,13,7,3,2576,3669,-1093
1,8,14,7,3,3072,3467,-395
1,8,15,7,3,3518,3276,242
1,8,16,7,3,3669,3164,505
1,8,17,7,3,3467,3108,359
1,8,18,7,3,3276,2975,301
1,9,0,7,3,2456,3287,-831
1,9,1,7,3,2244,3635,-1391
1,9,2,7,3,2636,3765,-1129
1,9,3,7,3,3287,3836,-549
1,9,4,7,3,3635,3497,138
1,9,5,7,3,3765,2938,827
1,9,6,7,3,3836,2289,1547
1,9,7,7,3,3497,2358,1139
1,9,8,7,3,2938,2309,629
1,9,9,7,3,2289,2300,-11
1,9,10,7,3,2358,2492,-134
1,9,11,7,3,2309,3163,-854
1,9,12,7,3,2300,3701,-1401
1,9,13,7,3,2492,3948,-1456
1,9,14,7,3,3163,3755,-592
1,9,15,7,3,3701,3574,127
1,9,16,7,3,3948,3414,534
1,9,17,7,3,3755,3296,459
1,9,18,7,3,3574,3123,451
1,10,0,7,3,2509,3735,-1226
1,10,1,7,3,2371,4093,-1722
1,10,2,7,3,2896,4226,-1330
1,10,3,7,3,3735,4278,-543
1,10,4,7,3,4093,3919,174
1,10,5,7,3,4226,3267,959
1,10,6,7,3,4278,2501,1777
1,10,7,7,3,3919,2592,1327
1,10,8,7,3,3267,2539,728
1,10,9,7,3,2501,2543,-42
1,10,10,7,3,2592,2768,-176
1,10,11,7,3,2539,3550,-1011
1,10,12,7,3,2543,4121,-1578
1,10,13,7,3,2768,4378,-1610
1,10,14,7,3,3550,4160,-610
1,10,15,7,3,4121,3980,141
1,10,16,7,3,4378,3797,581
1,10,17,7,3,4160,3550,610
1,10,18,7,3,3980,3309,671
1,11,0,7,3,2547,3937,-1390
1,11,1,7,3,2475,4214,-1739
1,11,2,7,3,3028,4362,-1334
1,11,3,7,3,3937,4395,-458
1,11,4,7,3,4214,3990,224
1,11,5,7,3,4362,3242,1120
1,11,6,7,3,4395,2370,2025
1,11,7,7,3,3990,2476,1514
1,11,8,7,3,3242,2396,846
1,11,9,7,3,2370,2389,-19
1,11,10,7,3,2476,2667,-191
1,11,11,7,3,2396,3595,-1199
1,11,12,7,3,2389,4241,-1852
1,11,13,7,3,2667,4450,-1783
1,11,14,7,3,3595,4175,-580
1,11,15,7,3,4241,4042,199
1,11,16,7,3,4450,3980,470
1,11,17,7,3,4175,3687,488
1,11,18,7,3,4042,3436,606
1,12,0,7,3,2508,3987,-1479
1,12,1,7,3,2514,4049,-1535
1,12,2,7,3,3060,4110,-1050
1,12,3,7,3,3987,4035,-48
1,12,4,7,3,4049,3679,370
1,12,5,7,3,4110,2914,1196
1,12,6,7,3,4035,2052,1983
1,12,7,7,3,3679,2179,1500
1,12,8,7,3,2914,2093,821
1,12,9,7,3,2052,2099,-47
1,12,10,7,3,2179,2354,-175
1,12,11,7,3,2093,3232,-1139
1,12,12,7,3,2099,3881,-1782
1,12,13,7,3,2354,4086,-1732
1,12,14,7,3,3232,3900,-668
1,12,15,7,3,3881,3832,49
1,12,16,7,3,4086,3876,210
1,12,17,7,3,3900,3577,323
1,12,18,7,3,3832,3326,506
1,13,0,7,3,2490,3867,-1377
1,13,1,7,3,2565,3680,-1115
1,13,2,7,3,3061,3723,-662
1,13,3,7,3,3867,3724,143
1,13,4,7,3,3680,3521,159
1,13,5,7,3,3723,2925,798
1,13,6,7,3,3724,2124,1600
1,13,7,7,3,3521,2266,1255
1,13,8,7,3,2925,2182,743
1,13,9,7,3,2124,2179,-55
1,13,10,7,3,2266,2313,-47
1,13,11,7,3,2182,3082,-900
1,13,12,7,3,2179,3694,-1515
1,13,13,7,3,2313,3862,-1549
1,13,14,7,3,3082,3580,-498
1,13,15,7,3,3694,3501,193
1,13,16,7,3,3862,3558,304
1,13,17,7,3,3580,3293,287
1,13,18,7,3,3501,3153,348
1,14,0,7,3,2409,3674,-1265
1,14,1,7,3,2547,3283,-736
1,14,2,7,3,3036,3362,-326
1,14,3,7,3,3674,3568,106
1,14,4,7,3,3283,3494,-211
1,14,5,7,3,3362,2999,363
1,14,6,7,3,3568,2230,1338
1,14,7,7,3,3494,2382,1112
1,14,8,7,3,2999,2301,698
1,14,9,7,3,2230,2264,-34
1,14,10,7,3,2382,2274,108
1,14,11,7,3,2301,2882,-581
1,14,12,7,3,2264,3404,-1140
1,14,13,7,3,2274,3484,-1210
1,14,14,7,3,2882,3177,-295
1,14,15,7,3,3404,3181,223
1,14,16,7,3,3484,3265,219
1,14,17,7,3,3177,2994,183
1,14,18,7,3,3181,2945,236
1,15,0,7,3,2337,3451,-1114
1,15,1,7,3,2537,2862,-325
1,15,2,7,3,3009,2908,101
1,15,3,7,3,3451,3245,206
1,15,4,7,3,2862,3197,-335
1,15,5,7,3,2908,2748,160
1,15,6,7,3,3245,2021,1224
1,15,7,7,3,3197,2211,986
1,15,8,7,3,2748,2155,593
1,15,9,7,3,2021,2087,-66
1,15,10,7,3,2211,2018,193
1,15,11,7,3,2155,2504,-349
1,15,12,7,3,2087,2996,-909
1,15,13,7,3,2018,3001,-983
1,15,14,7,3,2504,2763,-259
1,15,15,7,3,2996,2825,171
1,15,16,7,3,3001,2978,23
1,15,17,7,3,2763,2731,32
1,15,18,7,3,2825,2753,72
1,16,0,7,3,2162,3072,-910
1,16,1,7,3,2412,2363,49
1,16,2,7,3,2812,2434,378
1,16,3,7,3,3072,2897,175
1,16,4,7,3,2363,2934,-571
1,16,5,7,3,2434,2579,-145
1,16,6,7,3,2897,1906,991
1,16,7,7,3,2934,2141,793
1,16,8,7,3,2579,2124,455
1,16,9,7,3,1906,2036,-130
1,16,10,7,3,2141,1894,247
1,16,11,7,3,2124,2246,-122
1,16,12,7,3,2036,2690,-654
1,16,13,7,3,1894,2530,-636
1,16,14,7,3,2246,2270,-24
1,16,15,7,3,2690,2332,358
1,16,16,7,3,2530,2568,-38
1,16,17,7,3,2270,2354,-84
1,16,18,7,3,2332,2392,-60
1,17,0,7,3,2099,2688,-589
1,17,1,7,3,2296,1947,349
1,17,2,7,3,2591,2000,591
1,17,3,7,3,2688,2534,154
1,17,4,7,3,1947,2644,-697
1,17,5,7,3,2000,2395,-395
1,17,6,7,3,2534,1801,733
1,17,7,7,3,2644,2050,594
1,17,8,7,3,2395,2073,322
1,17,9,7,3,1801,2013,-212
1,17,10,7,3,2050,1786,264
1,17,11,7,3,2073,2013,60
1,17,12,7,3,2013,2360,-347
1,17,13,7,3,1786,2133,-347
1,17,14,7,3,2013,1873,140
1,17,15,7,3,2360,1936,424
1,17,16,7,3,2133,2184,-51
1,17,17,7,3,1873,2074,-201
1,17,18,7,3,1936,2121,-185
1,0,0,8,3,2710,2421,289
1,0,1,8,3,2586,2371,215
1,0,2,8,3,2469,2272,197
1,0,3,8,3,2421,2148,273
1,0,4,8,3,2371,2085,286
1,0,5,8,3,2272,2023,249
1,0,6,8,3,2148,1990,158
1,0,7,8,3,2085,1965,120
1,0,8,8,3,2023,1958,65
1,0,9,8,3,1990,1966,24
1,0,10,8,3,1965,1984,-19
1,0,11,8,3,1958,2039,-81
1,0,12,8,3,1966,2078,-112
1,0,13,8,3,1984,2187,-203
1,0,14,8,3,2039,2309,-270
1,0,15,8,3,2078,2418,-340
1,0,16,8,3,2187,2489,-302
1,0,17,8,3,2309,2563,-254
1,0,18,8,3,2418,2633,-215
1,1,0,8,3,2785,2336,449
1,1,1,8,3,2625,2337,288
1,1,2,8,3,2426,2301,125
1,1,3,8,3,2336,2217,119
1,1,4,8,3,2337,2155,182
1,1,5,8,3,2301,2106,195
1,1,6,8,3,2217,2085,132
1,1,7,8,3,2155,2072,83
1,1,8,8,3,2106,2080,26
1,1,9,8,3,2085,2087,-2
1,1,10,8,3,2072,2094,-22
1,1,11,8,3,2080,2142,-62
1,1,12,8,3,2087,2176,-89
1,1,13,8,3,2094,2271,-177
1,1,14,8,3,2142,2342,-200
1,1,15,8,3,2176,2423,-247
1,1,16,8,3,2271,2500,-229
1,1,17,8,3,2342,2598,-256
1,1,18,8,3,2423,2696,-273
1,2,0,8,3,2705,2149,556
1,2,1,8,3,2482,2155,327
1,2,2,8,3,2254,2150,104
1,2,3,8,3,2149,2075,74
1,2,4,8,3,2155,2006,149
1,2,5,8,3,2150,1922,228
1,2,6,8,3,2075,1878,197
1,2,7,8,3,2006,1866,140
1,2,8,8,3,1922,1873,49
1,2,9,8,3,1878,1869,9
1,2,10,8,3,1866,1886,-20
1,2,11,8,3,1873,1954,-81
1,2,12,8,3,1869,2025,-156
1,2,13,8,3,1886,2128,-242
1,2,14,8,3,1954,2200,-246
1,2,15,8,3,2025,2272,-247
1,2,16,8,3,2128,2344,-216
1,2,17,8,3,2200,2459,-259
1,2,18,8,3,2272,2608,-336
1,3,0,8,3,2580,2166,414
1,3,1,8,3,2328,2218,110
1,3,2,8,3,2209,2214,-5
1,3,3,8,3,2166,2156,10
1,3,4,8,3,2218,2087,131
1,3,5,8,3,2214,1987,227
1,3,6,8,3,2156,1928,228
1,3,7,8,3,2087,1920,167
1,3,8,8,3,1987,1928,59
1,3,9,8,3,1928,1926,2
1,3,10,8,3,1920,1942,-22
1,3,11,8,3,1928,2014,-86
1,3,12,8,3,1926,2111,-185
1,3,13,8,3,1942,2199,-257
1,3,14,8,3,2014,2256,-242
1,3,15,8,3,2111,2300,-189
1,3,16,8,3,2199,2341,-142
1,3,17,8,3,2256,2427,-171
1,3,18,8,3,2300,2564,-264
1,4,0,8,3,2570,2385,185
1,4,1,8,3,2309,2530,-221
1,4,2,8,3,2348,2500,-152
1,4,3,8,3,2385,2526,-141
1,4,4,8,3,2530,2455,75
1,4,5,8,3,2500,2368,132
1,4,6,8,3,2526,2280,246
1,4,7,8,3,2455,2292,163
1,4,8,8,3,2368,2309,59
1,4,9,8,3,2280,2311,-31
1,4,10,8,3,2292,2320,-28
1,4,11,8,3,2309,2407,-98
1,4,12,8,3,2311,2522,-211
1,4,13,8,3,2320,2555,-235
1,4,14,8,3,2407,2550,-143
1,4,15,8,3,2522,2563,-41
1,4,16,8,3,2555,2602,-47
1,4,17,8,3,2550,2660,-110
1,4,18,8,3,2563,2714,-151
1,5,0,8,3,2625,2588,37
1,5,1,8,3,2338,2841,-503
1,5,2,8,3,2460,2848,-388
1,5,3,8,3,2588,2971,-383
1,5,4,8,3,2841,2841,0
1,5,5,8,3,2848,2672,176
1,5,6,8,3,2971,2476,495
1,5,7,8,3,2841,2515,326
1,5,8,8,3,2672,2532,140
1,5,9,8,3,2476,2520,-44
1,5,10,8,3,2515,2553,-38
1,5,11,8,3,2532,2766,-234
1,5,12,8,3,2520,2988,-468
1,5,13,8,3,2553,3004,-451
1,5,14,8,3,2766,2906,-140
1,5,15,8,3,2988,2859,129
1,5,16,8,3,3004,2891,113
1,5,17,8,3,2906,2936,-30
1,5,18,8,3,2859,2908,-49
1,6,0,8,3,2684,2798,-114
1,6,1,8,3,2369,3148,-779
1,6,2,8,3,2516,3287,-771
1,6,3,8,3,2798,3446,-648
1,6,4,8,3,3148,3247,-99
1,6,5,8,3,3287,2923,364
1,6,6,8,3,3446,2575,871
1,6,7,8,3,3247,2627,620
1,6,8,8,3,2923,2636,287
1,6,9,8,3,2575,2622,-47
1,6,10,8,3,2627,2701,-74
1,6,11,8,3,2636,3077,-441
1,6,12,8,3,2622,3432,-810
1,6,13,8,3,2701,3494,-793
1,6,14,8,3,3077,3308,-231
1,6,15,8,3,3432,3163,269
1,6,16,8,3,3494,3127,367
1,6,17,8,3,3308,3145,163
1,6,18,8,3,3163,3082,81
1,7,0,8,3,2767,3092,-325
1,7,1,8,3,2453,3485,-1032
1,7,2,8,3,2644,3708,-1064
1,7,3,8,3,3092,3862,-770
1,7,4,8,3,3485,3618,-133
1,7,5,8,3,3708,3179,529
1,7,6,8,3,3862,2688,1174
1,7,7,8,3,3618,2749,869
1,7,8,8,3,3179,2743,436
1,7,9,8,3,2688,2741,-53
1,7,10,8,3,2749,2867,-118
1,7,11,8,3,2743,3364,-621
1,7,12,8,3,2741,3797,-1056
1,7,13,8,3,2867,3931,-1064
1,7,14,8,3,3364,3707,-343
1,7,15,8,3,3797,3504,293
1,7,16,8,3,3931,3397,534
1,7,17,8,3,3707,3374,333
1,7,18,8,3,3504,3294,210
1,8,0,8,3,2844,3522,-678
1,8,1,8,3,2584,3927,-1343
1,8,2,8,3,2898,4115,-1217
1,8,3,8,3,3522,4219,-697
1,8,4,8,3,3927,3880,47
1,8,5,8,3,4115,3330,785
1,8,6,8,3,4219,2691,1528
1,8,7,8,3,3880,2771,1109
1,8,8,8,3,3330,2738,592
1,8,9,8,3,2691,2730,-39
1,8,10,8,3,2771,2914,-143
1,8,11,8,3,2738,3573,-835
1,8,12,8,3,2730,4104,-1374
1,8,13,8,3,2914,4342,-1428
1,8,14,8,3,3573,4108,-535
1,8,15,8,3,4104,3895,209
1,8,16,8,3,4342,3734,608
1,8,17,8,3,4108,3641,467
1,8,18,8,3,3895,3500,395
1,9,0,8,3,2753,3874,-1121
1,9,1,8,3,2552,4233,-1681
1,9,2,8,3,3049,4392,-1343
1,9,3,8,3,3874,4453,-579
1,9,4,8,3,4233,4091,142
1,9,5,8,3,4392,3401,991
1,9,6,8,3,4453,2607,1846
1,9,7,8,3,4091,2696,1395
1,9,8,8,3,3401,2642,759
1,9,9,8,3,2607,2637,-30
1,9,10,8,3,2696,2876,-180
1,9,11,8,3,2642,3689,-1047
1,9,12,8,3,2637,4299,-1662
1,9,13,8,3,2876,4561,-1685
1,9,14,8,3,3689,4331,-642
1,9,15,8,3,4299,4136,163
1,9,16,8,3,4561,3955,606
1,9,17,8,3,4331,3737,594
1,9,18,8,3,4136,3548,588
1,10,0,8,3,2755,4279,-1524
1,10,1,8,3,2655,4603,-1948
1,10,2,8,3,3312,4760,-1448
1,10,3,8,3,4279,4817,-538
1,10,4,8,3,4603,4417,186
1,10,5,8,3,4760,3644,1116
1,10,6,8,3,4817,2749,2068
1,10,7,8,3,4417,2852,1565
1,10,8,8,3,3644,2772,872
1,10,9,8,3,2749,2770,-21
1,10,10,8,3,2852,3052,-200
1,10,11,8,3,2772,3993,-1221
1,10,12,8,3,2770,4664,-1894
1,10,13,8,3,3052,4856,-1804
1,10,14,8,3,3993,4556,-563
1,10,15,8,3,4664,4389,275
1,10,16,8,3,4856,4297,559
1,10,17,8,3,4556,3983,573
1,10,18,8,3,4389,3723,666
1,11,0,8,3,2837,4538,-1701
1,11,1,8,3,2827,4700,-1873
1,11,2,8,3,3526,4738,-1212
1,11,3,8,3,4538,4704,-166
1,11,4,8,3,4700,4303,397
1,11,5,8,3,4738,3502,1236
1,11,6,8,3,4704,2602,2102
1,11,7,8,3,4303,2742,1561
1,11,8,8,3,3502,2662,840
1,11,9,8,3,2602,2674,-72
1,11,10,8,3,2742,2927,-185
1,11,11,8,3,2662,3847,-1185
1,11,12,8,3,2674,4548,-1874
1,11,13,8,3,2927,4748,-1821
1,11,14,8,3,3847,4531,-684
1,11,15,8,3,4548,4440,108
1,11,16,8,3,4748,4469,279
1,11,17,8,3,4531,4132,399
1,11,18,8,3,4440,3802,638
1,12,0,8,3,2892,4431,-1539
1,12,1,8,3,2942,4331,-1389
1,12,2,8,3,3528,4361,-833
1,12,3,8,3,4431,4393,38
1,12,4,8,3,4331,4088,243
1,12,5,8,3,4361,3382,979
1,12,6,8,3,4393,2464,1929
1,12,7,8,3,4088,2626,1462
1,12,8,8,3,3382,2539,843
1,12,9,8,3,2464,2524,-60
1,12,10,8,3,2626,2686,-60
1,12,11,8,3,2539,3595,-1056
1,12,12,8,3,2524,4342,-1818
1,12,13,8,3,2686,4551,-1865
1,12,14,8,3,3595,4240,-645
1,12,15,8,3,4342,4141,201
1,12,16,8,3,4551,4195,356
1,12,17,8,3,4240,3907,333
1,12,18,8,3,4141,3680,461
1,13,0,8,3,2824,4237,-1413
1,13,1,8,3,2939,3893,-954
1,13,2,8,3,3456,4018,-562
1,13,3,8,3,4237,4220,17
1,13,4,8,3,3893,4076,-183
1,13,5,8,3,4018,3454,564
1,13,6,8,3,4220,2529,1691
1,13,7,8,3,4076,2691,1385
1,13,8,8,3,3454,2600,854
1,13,9,8,3,2529,2561,-32
1,13,10,8,3,2691,2618,73
1,13,11,8,3,2600,3379,-779
1,13,12,8,3,2561,4027,-1466
1,13,13,8,3,2618,4168,-1550
1,13,14,8,3,3379,3825,-446
1,13,15,8,3,4027,3789,238
1,13,16,8,3,4168,3843,325
1,13,17,8,3,3825,3556,269
1,13,18,8,3,3789,3464,325
1,14,0,8,3,2773,4003,-1230
1,14,1,8,3,2943,3435,-492
1,14,2,8,3,3422,3536,-114
1,14,3,8,3,4003,3855,148
1,14,4,8,3,3435,3764,-329
1,14,5,8,3,3536,3211,325
1,14,6,8,3,3855,2341,1514
1,14,7,8,3,3764,2540,1224
1,14,8,8,3,3211,2469,742
1,14,9,8,3,2341,2412,-71
1,14,10,8,3,2540,2389,151
1,14,11,8,3,2469,3004,-535
1,14,12,8,3,2412,3572,-1160
1,14,13,8,3,2389,3652,-1263
1,14,14,8,3,3004,3386,-382
1,14,15,8,3,3572,3421,151
1,14,16,8,3,3652,3539,113
1,14,17,8,3,3386,3280,106
1,14,18,8,3,3421,3303,118
1,15,0,8,3,2584,3648,-1064
1,15,1,8,3,2807,2984,-177
1,15,2,8,3,3245,3085,160
1,15,3,8,3,3648,3536,112
1,15,4,8,3,2984,3492,-508
1,15,5,8,3,3085,3018,67
1,15,6,8,3,3536,2201,1335
1,15,7,8,3,3492,2458,1034
1,15,8,8,3,3018,2415,603
1,15,9,8,3,2201,2319,-118
1,15,10,8,3,2458,2232,226
1,15,11,8,3,2415,2747,-332
1,15,12,8,3,2319,3276,-957
1,15,13,8,3,2232,3203,-971
1,15,14,8,3,2747,2911,-164
1,15,15,8,3,3276,2951,325
1,15,16,8,3,3203,3138,65
1,15,17,8,3,2911,2887,24
1,15,18,8,3,2951,2917,34
1,16,0,8,3,2396,3275,-879
1,16,1,8,3,2604,2545,59
1,16,2,8,3,3004,2627,377
1,16,3,8,3,3275,3151,124
1,16,4,8,3,2545,3238,-693
1,16,5,8,3,2627,2858,-231
1,16,6,8,3,3151,2119,1032
1,16,7,8,3,3238,2388,850
1,16,8,8,3,2858,2406,452
1,16,9,8,3,2119,2350,-231
1,16,10,8,3,2388,2170,218
1,16,11,8,3,2406,2539,-133
1,16,12,8,3,2350,2958,-608
1,16,13,8,3,2170,2746,-576
1,16,14,8,3,2539,2449,90
1,16,15,8,3,2958,2498,460
1,16,16,8,3,2746,2725,21
1,16,17,8,3,2449,2515,-66
1,16,18,8,3,2498,2546,-48
1,0,0,9,3,3098,2656,442
1,0,1,9,3,2926,2663,263
1,0,2,9,3,2731,2622,109
1,0,3,9,3,2656,2531,125
1,0,4,9,3,2663,2468,195
1,0,5,9,3,2622,2415,207
1,0,6,9,3,2531,2392,139
1,0,7,9,3,2468,2378,90
1,0,8,9,3,2415,2387,28
1,0,9,9,3,2392,2396,-4
1,0,10,9,3,2378,2406,-28
1,0,11,9,3,2387,2449,-62
1,0,12,9,3,2396,2481,-85
1,0,13,9,3,2406,2581,-175
1,0,14,9,3,2449,2662,-213
1,0,15,9,3,2481,2739,-258
1,0,16,9,3,2581,2809,-228
1,0,17,9,3,2662,2908,-246
1,0,18,9,3,2739,3010,-271
1,1,0,9,3,3029,2475,554
1,1,1,9,3,2806,2477,329
1,1,2,9,3,2579,2467,112
1,1,3,9,3,2475,2392,83
1,1,4,9,3,2477,2327,150
1,1,5,9,3,2467,2240,227
1,1,6,9,3,2392,2191,201
1,1,7,9,3,2327,2176,151
1,1,8,9,3,2240,2183,57
1,1,9,9,3,2191,2181,10
1,1,10,9,3,2176,2202,-26
1,1,11,9,3,2183,2281,-98
1,1,12,9,3,2181,2354,-173
1,1,13,9,3,2202,2454,-252
1,1,14,9,3,2281,2513,-232
1,1,15,9,3,2354,2579,-225
1,1,16,9,3,2454,2658,-204
1,1,17,9,3,2513,2785,-272
1,1,18,9,3,2579,2935,-356
1,2,0,9,3,2913,2491,422
1,2,1,9,3,2662,2544,118
1,2,2,9,3,2538,2548,-10
1,2,3,9,3,2491,2497,-6
1,2,4,9,3,2544,2433,111
1,2,5,9,3,2548,2324,224
1,2,6,9,3,2497,2257,240
1,2,7,9,3,2433,2242,191
1,2,8,9,3,2324,2249,75
1,2,9,9,3,2257,2250,7
1,2,10,9,3,2242,2271,-29
1,2,11,9,3,2249,2352,-103
1,2,12,9,3,2250,2448,-198
1,2,13,9,3,2271,2534,-263
1,2,14,9,3,2352,2581,-229
1,2,15,9,3,2448,2619,-171
1,2,16,9,3,2534,2661,-127
1,2,17,9,3,2581,2755,-174
1,2,18,9,3,2619,2895,-276
1,3,0,9,3,2909,2717,192
1,3,1,9,3,2641,2869,-228
1,3,2,9,3,2675,2842,-167
1,3,3,9,3,2717,2825,-108
1,3,4,9,3,2869,2711,158
1,3,5,9,3,2842,2575,267
1,3,6,9,3,2825,2478,347
1,3,7,9,3,2711,2483,228
1,3,8,9,3,2575,2497,78
1,3,9,9,3,2478,2501,-23
1,3,10,9,3,2483,2515,-32
1,3,11,9,3,2497,2629,-132
1,3,12,9,3,2501,2778,-277
1,3,13,9,3,2515,2861,-346
1,3,14,9,3,2629,2887,-258
1,3,15,9,3,2778,2908,-130
1,3,16,9,3,2861,2934,-73
1,3,17,9,3,2887,2982,-95
1,3,18,9,3,2908,3040,-132
1,4,0,9,3,2972,2949,23
1,4,1,9,3,2686,3181,-495
1,4,2,9,3,2815,3138,-323
1,4,3,9,3,2949,3195,-246
1,4,4,9,3,3181,3022,159
1,4,5,9,3,3138,2825,313
1,4,6,9,3,3195,2620,575
1,4,7,9,3,3022,2652,370
1,4,8,9,3,2825,2666,159
1,4,9,9,3,2620,2656,-36
1,4,10,9,3,2652,2693,-41
1,4,11,9,3,2666,2920,-254
1,4,12,9,3,2656,3170,-514
1,4,13,9,3,2693,3244,-551
1,4,14,9,3,2920,3210,-290
1,4,15,9,3,3170,3203,-33
1,4,16,9,3,3244,3239,5
1,4,17,9,3,3210,3274,-64
1,4,18,9,3,3203,3241,-38
1,5,0,9,3,3040,3151,-111
1,5,1,9,3,2730,3451,-721
1,5,2,9,3,2880,3504,-624
1,5,3,9,3,3151,3623,-472
1,5,4,9,3,3451,3423,28
1,5,5,9,3,3504,3127,377
1,5,6,9,3,3623,2775,848
1,5,7,9,3,3423,2824,599
1,5,8,9,3,3127,2831,296
1,5,9,9,3,2775,2817,-42
1,5,10,9,3,2824,2897,-73
1,5,11,9,3,2831,3263,-432
1,5,12,9,3,2817,3611,-794
1,5,13,9,3,2897,3688,-791
1,5,14,9,3,3263,3554,-291
1,5,15,9,3,3611,3467,144
1,5,16,9,3,3688,3469,219
1,5,17,9,3,3554,3498,56
1,5,18,9,3,3467,3427,40
1,6,0,9,3,3120,3350,-230
1,6,1,9,3,2775,3721,-946
1,6,2,9,3,2929,3915,-986
1,6,3,9,3,3350,4056,-706
1,6,4,9,3,3721,3814,-93
1,6,5,9,3,3915,3386,529
1,6,6,9,3,4056,2895,1161
1,6,7,9,3,3814,2956,858
1,6,8,9,3,3386,2950,436
1,6,9,9,3,2895,2947,-52
1,6,10,9,3,2956,3072,-116
1,6,11,9,3,2950,3577,-627
1,6,12,9,3,2947,4008,-1061
1,6,13,9,3,3072,4145,-1073
1,6,14,9,3,3577,3931,-354
1,6,15,9,3,4008,3759,249
1,6,16,9,3,4145,3688,457
1,6,17,9,3,3931,3694,237
1,6,18,9,3,3759,3632,127
1,7,0,9,3,3189,3668,-479
1,7,1,9,3,2848,4106,-1258
1,7,2,9,3,3077,4359,-1282
1,7,3,9,3,3668,4501,-833
1,7,4,9,3,4106,4176,-70
1,7,5,9,3,4359,3618,741
1,7,6,9,3,4501,2983,1518
1,7,7,9,3,4176,3066,1110
1,7,8,9,3,3618,3034,584
1,7,9,9,3,2983,3024,-41
1,7,10,9,3,3066,3205,-139
1,7,11,9,3,3034,3865,-831
1,7,12,9,3,3024,4383,-1359
1,7,13,9,3,3205,4604,-1399
1,7,14,9,3,3865,4348,-483
1,7,15,9,3,4383,4123,260
1,7,16,9,3,4604,3967,637
1,7,17,9,3,4348,3907,441
1,7,18,9,3,4123,3819,304
1,8,0,9,3,3141,4109,-968
1,8,1,9,3,2892,4525,-1633
1,8,2,9,3,3311,4742,-1431
1,8,3,9,3,4109,4836,-727
1,8,4,9,3,4525,4474,51
1,8,5,9,3,4742,3793,949
1,8,6,9,3,4836,3009,1827
1,8,7,9,3,4474,3109,1365
1,8,8,9,3,3793,3071,722
1,8,9,9,3,3009,3067,-58
1,8,10,9,3,3109,3298,-189
1,8,11,9,3,3071,4099,-1028
1,8,12,9,3,3067,4702,-1635
1,8,13,9,3,3298,4955,-1657
1,8,14,9,3,4099,4684,-585
1,8,15,9,3,4702,4457,245
1,8,16,9,3,4955,4275,680
1,8,17,9,3,4684,4082,602
1,8,18,9,3,4457,3925,532
1,9,0,9,3,2999,4418,-1419
1,9,1,9,3,2836,4743,-1907
1,9,2,9,3,3465,4926,-1461
1,9,3,9,3,4418,4992,-574
1,9,4,9,3,4743,4589,154
1,9,5,9,3,4926,3778,1148
1,9,6,9,3,4992,2855,2137
1,9,7,9,3,4589,2956,1633
1,9,8,9,3,3778,2875,903
1,9,9,9,3,2855,2864,-9
1,9,10,9,3,2956,3160,-204
1,9,11,9,3,2875,4132,-1257
1,9,12,9,3,2864,4842,-1978
1,9,13,9,3,3160,5039,-1879
1,9,14,9,3,4132,4727,-595
1,9,15,9,3,4842,4545,297
1,9,16,9,3,5039,4455,584
1,9,17,9,3,4727,4170,557
1,9,18,9,3,4545,3962,583
1,10,0,9,3,3045,4880,-1835
1,10,1,9,3,3007,5089,-2082
1,10,2,9,3,3810,5136,-1326
1,10,3,9,3,4880,5126,-246
1,10,4,9,3,5089,4730,359
1,10,5,9,3,5136,3904,1232
1,10,6,9,3,5126,2981,2145
1,10,7,9,3,4730,3118,1612
1,10,8,9,3,3904,3038,866
1,10,9,9,3,2981,3055,-74
1,10,10,9,3,3118,3312,-194
1,10,11,9,3,3038,4245,-1207
1,10,12,9,3,3055,4971,-1916
1,10,13,9,3,3312,5154,-1842
1,10,14,9,3,4245,4912,-667
1,10,15,9,3,4971,4787,184
1,10,16,9,3,5154,4786,368
1,10,17,9,3,4912,4428,484
1,10,18,9,3,4787,4089,698
1,11,0,9,3,3221,4982,-1761
1,11,1,9,3,3255,4982,-1727
1,11,2,9,3,3994,4989,-995
1,11,3,9,3,4982,5062,-80
1,11,4,9,3,4982,4712,270
1,11,5,9,3,4989,3970,1019
1,11,6,9,3,5062,3014,2048
1,11,7,9,3,4712,3189,1523
1,11,8,9,3,3970,3108,862
1,11,9,9,3,3014,3099,-85
1,11,10,9,3,3189,3259,-70
1,11,11,9,3,3108,4210,-1102
1,11,12,9,3,3099,5009,-1910
1,11,13,9,3,3259,5213,-1954
1,11,14,9,3,4210,4871,-661
1,11,15,9,3,5009,4749,260
1,11,16,9,3,5213,4788,425
1,11,17,9,3,4871,4462,409
1,11,18,9,3,4749,4156,593
1,12,0,9,3,3226,4801,-1575
1,12,1,9,3,3316,4544,-1228
1,12,2,9,3,3923,4656,-733
1,12,3,9,3,4801,4889,-88
1,12,4,9,3,4544,4643,-99
1,12,5,9,3,4656,3911,745
1,12,6,9,3,4889,2869,2020
1,12,7,9,3,4643,3051,1592
1,12,8,9,3,3911,2957,954
1,12,9,9,3,2869,2906,-37
1,12,10,9,3,3051,2991,60
1,12,11,9,3,2957,3892,-935
1,12,12,9,3,2906,4675,-1769
1,12,13,9,3,2991,4857,-1866
1,12,14,9,3,3892,4485,-593
1,12,15,9,3,4675,4429,246
1,12,16,9,3,4857,4480,377
1,12,17,9,3,4485,4170,315
1,12,18,9,3,4429,3991,438
1,13,0,9,3,3188,4566,-1378
1,13,1,9,3,3335,4045,-710
1,13,2,9,3,3842,4192,-350
1,13,3,9,3,4566,4507,59
1,13,4,9,3,4045,4346,-301
1,13,5,9,3,4192,3666,526
1,13,6,9,3,4507,2640,1867
1,13,7,9,3,4346,2849,1497
1,13,8,9,3,3666,2768,898
1,13,9,9,3,2640,2709,-69
1,13,10,9,3,2849,2733,116
1,13,11,9,3,2768,3501,-733
1,13,12,9,3,2709,4195,-1486
1,13,13,9,3,2733,4336,-1603
1,13,14,9,3,3501,4034,-533
1,13,15,9,3,4195,4029,166
1,13,16,9,3,4336,4117,219
1,13,17,9,3,4034,3842,192
1,13,18,9,3,4029,3822,207
1,14,0,9,3,3020,4200,-1180
1,14,1,9,3,3213,3557,-344
1,14,2,9,3,3658,3713,-55
1,14,3,9,3,4200,4146,54
1,14,4,9,3,3557,4059,-502
1,14,5,9,3,3713,3481,232
1,14,6,9,3,4146,2521,1625
1,14,7,9,3,4059,2787,1272
1,14,8,9,3,3481,2729,752
1,14,9,9,3,2521,2644,-123
1,14,10,9,3,2787,2603,184
1,14,11,9,3,2729,3247,-518
1,14,12,9,3,2644,3852,-1208
1,14,13,9,3,2603,3854,-1251
1,14,14,9,3,3247,3534,-287
1,14,15,9,3,3852,3547,305
1,14,16,9,3,3854,3699,155
1,14,17,9,3,3534,3436,98
1,14,18,9,3,3547,3467,80
1,15,0,9,3,2818,3851,-1033
1,15,1,9,3,2999,3166,-167
1,15,2,9,3,3437,3278,159
1,15,3,9,3,3851,3790,61
1,15,4,9,3,3166,3796,-630
1,15,5,9,3,3278,3297,-19
1,15,6,9,3,3790,2414,1376
1,15,7,9,3,3796,2705,1091
1,15,8,9,3,3297,2697,600
1,15,9,9,3,2414,2633,-219
1,15,10,9,3,2705,2508,197
1,15,11,9,3,2697,3040,-343
1,15,12,9,3,2633,3544,-911
1,15,13,9,3,2508,3419,-911
1,15,14,9,3,3040,3090,-50
1,15,15,9,3,3544,3117,427
1,15,16,9,3,3419,3295,124
1,15,17,9,3,3090,3048,42
1,15,18,9,3,3117,3071,46
1,0,0,10,3,3342,2795,547
1,0,1,10,3,3107,2803,304
1,0,2,10,3,2884,2788,96
1,0,3,10,3,2795,2706,89
1,0,4,10,3,2803,2640,163
1,0,5,10,3,2788,2549,239
1,0,6,10,3,2706,2498,208
1,0,7,10,3,2640,2482,158
1,0,8,10,3,2549,2490,59
1,0,9,10,3,2498,2490,8
1,0,10,10,3,2482,2514,-32
1,0,11,10,3,2490,2588,-98
1,0,12,10,3,2490,2659,-169
1,0,13,10,3,2514,2764,-250
1,0,14,10,3,2588,2833,-245
1,0,15,10,3,2659,2895,-236
1,0,16,10,3,2764,2967,-203
1,0,17,10,3,2833,3095,-262
1,0,18,10,3,2895,3249,-354
1,1,0,10,3,3237,2817,420
1,1,1,10,3,2986,2866,120
1,1,2,10,3,2863,2865,-2
1,1,3,10,3,2817,2814,3
1,1,4,10,3,2866,2754,112
1,1,5,10,3,2865,2642,223
1,1,6,10,3,2814,2570,244
1,1,7,10,3,2754,2552,202
1,1,8,10,3,2642,2559,83
1,1,9,10,3,2570,2562,8
1,1,10,10,3,2552,2587,-35
1,1,11,10,3,2559,2679,-120
1,1,12,10,3,2562,2777,-215
1,1,13,10,3,2587,2860,-273
1,1,14,10,3,2679,2894,-215
1,1,15,10,3,2777,2926,-149
1,1,16,10,3,2860,2975,-115
1,1,17,10,3,2894,3081,-187
1,1,18,10,3,2926,3222,-296
1,2,0,10,3,3242,3042,200
1,2,1,10,3,2975,3195,-220
1,2,2,10,3,3004,3176,-172
1,2,3,10,3,3042,3166,-124
1,2,4,10,3,3195,3057,138
1,2,5,10,3,3176,2912,264
1,2,6,10,3,3166,2807,359
1,2,7,10,3,3057,2805,252
1,2,8,10,3,2912,2818,94
1,2,9,10,3,2807,2825,-18
1,2,10,10,3,2805,2844,-39
1,2,11,10,3,2818,2967,-149
1,2,12,10,3,2825,3115,-290
1,2,13,10,3,2844,3196,-352
1,2,14,10,3,2967,3212,-245
1,2,15,10,3,3115,3227,-112
1,2,16,10,3,3196,3254,-58
1,2,17,10,3,3212,3310,-98
1,2,18,10,3,3227,3371,-144
1,3,0,10,3,3311,3281,30
1,3,1,10,3,3018,3520,-502
1,3,2,10,3,3142,3480,-338
1,3,3,10,3,3281,3494,-213
1,3,4,10,3,3520,3278,242
1,3,5,10,3,3480,3032,448
1,3,6,10,3,3494,2818,676
1,3,7,10,3,3278,2843,435
1,3,8,10,3,3032,2854,178
1,3,9,10,3,2818,2846,-28
1,3,10,10,3,2843,2888,-45
1,3,11,10,3,2854,3142,-288
1,3,12,10,3,2846,3426,-580
1,3,13,10,3,2888,3550,-662
1,3,14,10,3,3142,3547,-405
1,3,15,10,3,3426,3548,-122
1,3,16,10,3,3550,3571,-21
1,3,17,10,3,3547,3596,-49
1,3,18,10,3,3548,3567,-19
1,4,0,10,3,3387,3512,-125
1,4,1,10,3,3078,3791,-713
1,4,2,10,3,3235,3794,-559
1,4,3,10,3,3512,3847,-335
1,4,4,10,3,3791,3604,187
1,4,5,10,3,3794,3280,514
1,4,6,10,3,3847,2919,928
1,4,7,10,3,3604,2961,643
1,4,8,10,3,3280,2965,315
1,4,9,10,3,2919,2953,-34
1,4,10,10,3,2961,3037,-76
1,4,11,10,3,2965,3417,-452
1,4,12,10,3,2953,3793,-840
1,4,13,10,3,3037,3928,-891
1,4,14,10,3,3417,3858,-441
1,4,15,10,3,3793,3811,-18
1,4,16,10,3,3928,3817,111
1,4,17,10,3,3858,3836,22
1,4,18,10,3,3811,3760,51
1,5,0,10,3,3476,3703,-227
1,5,1,10,3,3136,4024,-888
1,5,2,10,3,3293,4132,-839
1,5,3,10,3,3703,4233,-530
1,5,4,10,3,4024,3990,34
1,5,5,10,3,4132,3590,542
1,5,6,10,3,4233,3095,1138
1,5,7,10,3,3990,3153,837
1,5,8,10,3,3590,3145,445
1,5,9,10,3,3095,3142,-47
1,5,10,10,3,3153,3268,-115
1,5,11,10,3,3145,3763,-618
1,5,12,10,3,3142,4187,-1045
1,5,13,10,3,3268,4339,-1071
1,5,14,10,3,3763,4177,-414
1,5,15,10,3,4187,4063,124
1,5,16,10,3,4339,4030,309
1,5,17,10,3,4177,4047,130
1,5,18,10,3,4063,3977,86
1,6,0,10,3,3542,3926,-384
1,6,1,10,3,3170,4342,-1172
1,6,2,10,3,3362,4566,-1204
1,6,3,10,3,3926,4695,-769
1,6,4,10,3,4342,4372,-30
1,6,5,10,3,4566,3825,741
1,6,6,10,3,4695,3190,1505
1,6,7,10,3,4372,3273,1099
1,6,8,10,3,3825,3241,584
1,6,9,10,3,3190,3230,-40
1,6,10,10,3,3273,3410,-137
1,6,11,10,3,3241,4078,-837
1,6,12,10,3,3230,4594,-1364
1,6,13,10,3,3410,4818,-1408
1,6,14,10,3,4078,4572,-494
1,6,15,10,3,4594,4378,216
1,6,16,10,3,4818,4258,560
1,6,17,10,3,4572,4227,345
1,6,18,10,3,4378,4157,221
1,7,0,10,3,3486,4255,-769
1,7,1,10,3,3156,4704,-1548
1,7,2,10,3,3490,4986,-1496
1,7,3,10,3,4255,5118,-863
1,7,4,10,3,4704,4770,-66
1,7,5,10,3,4986,4081,905
1,7,6,10,3,5118,3301,1817
1,7,7,10,3,4770,3404,1366
1,7,8,10,3,4081,3367,714
1,7,9,10,3,3301,3361,-60
1,7,10,10,3,3404,3589,-185
1,7,11,10,3,3367,4391,-1024
1,7,12,10,3,3361,4981,-1620
1,7,13,10,3,3589,5217,-1628
1,7,14,10,3,4391,4924,-533
1,7,15,10,3,4981,4685,296
1,7,16,10,3,5217,4508,709
1,7,17,10,3,4924,4348,576
1,7,18,10,3,4685,4244,441
1,8,0,10,3,3387,4653,-1266
1,8,1,10,3,3176,5035,-1859
1,8,2,10,3,3727,5276,-1549
1,8,3,10,3,4653,5375,-722
1,8,4,10,3,5035,4972,63
1,8,5,10,3,5276,4170,1106
1,8,6,10,3,5375,3257,2118
1,8,7,10,3,4972,3369,1603
1,8,8,10,3,4170,3304,866
1,8,9,10,3,3257,3294,-37
1,8,10,10,3,3369,3582,-213
1,8,11,10,3,3304,4542,-1238
1,8,12,10,3,3294,5245,-1951
1,8,13,10,3,3582,5433,-1851
1,8,14,10,3,4542,5080,-538
1,8,15,10,3,5245,4866,379
1,8,16,10,3,5433,4775,658
1,8,17,10,3,5080,4515,565
1,8,18,10,3,4866,4339,527
1,9,0,10,3,3289,5019,-1730
1,9,1,10,3,3188,5229,-2041
1,9,2,10,3,3963,5302,-1339
1,9,3,10,3,5019,5301,-282
1,9,4,10,3,5229,4902,327
1,9,5,10,3,5302,4038,1264
1,9,6,10,3,5301,3087,2214
1,9,7,10,3,4902,3222,1680
1,9,8,10,3,4038,3141,897
1,9,9,10,3,3087,3149,-62
1,9,10,10,3,3222,3420,-198
1,9,11,10,3,3141,4384,-1243
1,9,12,10,3,3149,5149,-2000
1,9,13,10,3,3420,5337,-1917
1,9,14,10,3,4384,5083,-699
1,9,15,10,3,5149,4943,206
1,9,16,10,3,5337,4944,393
1,9,17,10,3,5083,4615,468
1,9,18,10,3,4943,4328,615
1,10,0,10,3,3429,5324,-1895
1,10,1,10,3,3435,5371,-1936
1,10,2,10,3,4278,5387,-1109
1,10,3,10,3,5324,5484,-160
1,10,4,10,3,5371,5139,232
1,10,5,10,3,5387,4372,1015
1,10,6,10,3,5484,3393,2091
1,10,7,10,3,5139,3565,1574
1,10,8,10,3,4372,3484,888
1,10,9,10,3,3393,3480,-87
1,10,10,10,3,3565,3644,-79
1,10,11,10,3,3484,4608,-1124
1,10,12,10,3,3480,5432,-1952
1,10,13,10,3,3644,5619,-1975
1,10,14,10,3,4608,5252,-644
1,10,15,10,3,5432,5096,336
1,10,16,10,3,5619,5105,514
1,10,17,10,3,5252,4758,494
1,10,18,10,3,5096,4443,653
1,11,0,10,3,3555,5352,-1797
1,11,1,10,3,3629,5195,-1566
1,11,2,10,3,4389,5284,-895
1,11,3,10,3,5352,5558,-206
1,11,4,10,3,5195,5267,-72
1,11,5,10,3,5284,4499,785
1,11,6,10,3,5558,3419,2139
1,11,7,10,3,5267,3614,1653
1,11,8,10,3,4499,3526,973
1,11,9,10,3,3419,3481,-62
1,11,10,10,3,3614,3564,50
1,11,11,10,3,3526,4507,-981
1,11,12,10,3,3481,5342,-1861
1,11,13,10,3,3564,5519,-1955
1,11,14,10,3,4507,5116,-609
1,11,15,10,3,5342,5037,305
1,11,16,10,3,5519,5073,446
1,11,17,10,3,5116,4725,391
1,11,18,10,3,5037,4467,570
1,12,0,10,3,3590,5130,-1540
1,12,1,10,3,3712,4696,-984
1,12,2,10,3,4309,4830,-521
1,12,3,10,3,5130,5176,-46
1,12,4,10,3,4696,4913,-217
1,12,5,10,3,4830,4123,707
1,12,6,10,3,5176,2980,2196
1,12,7,10,3,4913,3209,1704
1,12,8,10,3,4123,3125,998
1,12,9,10,3,2980,3054,-74
1,12,10,10,3,3209,3106,103
1,12,11,10,3,3125,4014,-889
1,12,12,10,3,3054,4843,-1789
1,12,13,10,3,3106,5025,-1919
1,12,14,10,3,4014,4694,-680
1,12,15,10,3,4843,4669,174
1,12,16,10,3,5025,4754,271
1,12,17,10,3,4694,4456,238
1,12,18,10,3,4669,4349,320
1,13,0,10,3,3435,4763,-1328
1,13,1,10,3,3605,4167,-562
1,13,2,10,3,4078,4369,-291
1,13,3,10,3,4763,4798,-35
1,13,4,10,3,4167,4641,-474
1,13,5,10,3,4369,3936,433
1,13,6,10,3,4798,2820,1978
1,13,7,10,3,4641,3096,1545
1,13,8,10,3,3936,3028,908
1,13,9,10,3,2820,2941,-121
1,13,10,10,3,3096,2947,149
1,13,11,10,3,3028,3744,-716
1,13,12,10,3,2941,4475,-1534
1,13,13,10,3,2947,4538,-1591
1,13,14,10,3,3744,4182,-438
1,13,15,10,3,4475,4155,320
1,13,16,10,3,4538,4277,261
1,13,17,10,3,4182,3998,184
1,13,18,10,3,4155,3986,169
1,14,0,10,3,3254,4403,-1149
1,14,1,10,3,3405,3739,-334
1,14,2,10,3,3850,3906,-56
1,14,3,10,3,4403,4400,3
1,14,4,10,3,3739,4363,-624
1,14,5,10,3,3906,3760,146
1,14,6,10,3,4400,2734,1666
1,14,7,10,3,4363,3034,1329
1,14,8,10,3,3760,3011,749
1,14,9,10,3,2734,2958,-224
1,14,10,10,3,3034,2879,155
1,14,11,10,3,3011,3540,-529
1,14,12,10,3,2958,4120,-1162
1,14,13,10,3,2879,4070,-1191
1,14,14,10,3,3540,3713,-173
1,14,15,10,3,4120,3713,407
1,14,16,10,3,4070,3856,214
1,14,17,10,3,3713,3597,116
1,14,18,10,3,3713,3621,92
1,0,0,11,3,3550,3137,413
1,0,1,11,3,3287,3192,95
1,0,2,11,3,3168,3186,-18
1,0,3,11,3,3137,3128,9
1,0,4,11,3,3192,3067,125
1,0,5,11,3,3186,2951,235
1,0,6,11,3,3128,2877,251
1,0,7,11,3,3067,2858,209
1,0,8,11,3,2951,2866,85
1,0,9,11,3,2877,2871,6
1,0,10,11,3,2858,2899,-41
1,0,11,11,3,2866,2986,-120
1,0,12,11,3,2871,3082,-211
1,0,13,11,3,2899,3170,-271
1,0,14,11,3,2986,3214,-228
1,0,15,11,3,3082,3242,-160
1,0,16,11,3,3170,3284,-114
1,0,17,11,3,3214,3391,-177
1,0,18,11,3,3242,3536,-294
1,1,0,11,3,3566,3368,198
1,1,1,11,3,3299,3517,-218
1,1,2,11,3,3329,3493,-164
1,1,3,11,3,3368,3483,-115
1,1,4,11,3,3517,3378,139
1,1,5,11,3,3493,3230,263
1,1,6,11,3,3483,3120,363
1,1,7,11,3,3378,3115,263
1,1,8,11,3,3230,3128,102
1,1,9,11,3,3120,3137,-17
1,1,10,11,3,3115,3160,-45
1,1,11,11,3,3128,3294,-166
1,1,12,11,3,3137,3444,-307
1,1,13,11,3,3160,3522,-362
1,1,14,11,3,3294,3525,-231
1,1,15,11,3,3444,3534,-90
1,1,16,11,3,3522,3568,-46
1,1,17,11,3,3525,3636,-111
1,1,18,11,3,3534,3698,-164
1,2,0,11,3,3644,3606,38
1,2,1,11,3,3352,3846,-494
1,2,2,11,3,3471,3814,-343
1,2,3,11,3,3606,3835,-229
1,2,4,11,3,3846,3624,222
1,2,5,11,3,3814,3369,445
1,2,6,11,3,3835,3147,688
1,2,7,11,3,3624,3165,459
1,2,8,11,3,3369,3175,194
1,2,9,11,3,3147,3170,-23
1,2,10,11,3,3165,3217,-52
1,2,11,11,3,3175,3480,-305
1,2,12,11,3,3170,3763,-593
1,2,13,11,3,3217,3885,-668
1,2,14,11,3,3480,3872,-392
1,2,15,11,3,3763,3867,-104
1,2,16,11,3,3885,3891,-6
1,2,17,11,3,3872,3924,-52
1,2,18,11,3,3867,3898,-31
1,3,0,11,3,3726,3844,-118
1,3,1,11,3,3410,4130,-720
1,3,2,11,3,3562,4136,-574
1,3,3,11,3,3844,4146,-302
1,3,4,11,3,4130,3860,270
1,3,5,11,3,4136,3487,649
1,3,6,11,3,4146,3117,1029
1,3,7,11,3,3860,3152,708
1,3,8,11,3,3487,3153,334
1,3,9,11,3,3117,3143,-26
1,3,10,11,3,3152,3232,-80
1,3,11,11,3,3153,3639,-486
1,3,12,11,3,3143,4049,-906
1,3,13,11,3,3232,4234,-1002
1,3,14,11,3,3639,4195,-556
1,3,15,11,3,4049,4156,-107
1,3,16,11,3,4234,4149,85
1,3,17,11,3,4195,4158,37
1,3,18,11,3,4156,4086,70
1,4,0,11,3,3823,4064,-241
1,4,1,11,3,3484,4364,-880
1,4,2,11,3,3648,4422,-774
1,4,3,11,3,4064,4457,-393
1,4,4,11,3,4364,4171,193
1,4,5,11,3,4422,3743,679
1,4,6,11,3,4457,3239,1218
1,4,7,11,3,4171,3290,881
1,4,8,11,3,3743,3279,464
1,4,9,11,3,3239,3278,-39
1,4,10,11,3,3290,3408,-118
1,4,11,11,3,3279,3917,-638
1,4,12,11,3,3278,4369,-1091
1,4,13,11,3,3408,4579,-1171
1,4,14,11,3,3917,4481,-564
1,4,15,11,3,4369,4407,-38
1,4,16,11,3,4579,4378,201
1,4,17,11,3,4481,4385,96
1,4,18,11,3,4407,4310,97
1,5,0,11,3,3898,4279,-381
1,5,1,11,3,3531,4645,-1114
1,5,2,11,3,3726,4783,-1057
1,5,3,11,3,4279,4872,-593
1,5,4,11,3,4645,4548,97
1,5,5,11,3,4783,4029,754
1,5,6,11,3,4872,3390,1482
1,5,7,11,3,4548,3470,1078
1,5,8,11,3,4029,3436,593
1,5,9,11,3,3390,3425,-35
1,5,10,11,3,3470,3606,-136
1,5,11,11,3,3436,4264,-828
1,5,12,11,3,3425,4773,-1348
1,5,13,11,3,3606,5012,-1406
1,5,14,11,3,4264,4818,-554
1,5,15,11,3,4773,4682,91
1,5,16,11,3,5012,4600,412
1,5,17,11,3,4818,4580,238
1,5,18,11,3,4682,4502,180
1,6,0,11,3,3839,4513,-674
1,6,1,11,3,3478,4940,-1462
1,6,2,11,3,3775,5193,-1418
1,6,3,11,3,4513,5312,-799
1,6,4,11,3,4940,4966,-26
1,6,5,11,3,5193,4288,905
1,6,6,11,3,5312,3508,1804
1,6,7,11,3,4966,3611,1355
1,6,8,11,3,4288,3574,714
1,6,9,11,3,3508,3567,-59
1,6,10,11,3,3611,3794,-183
1,6,11,11,3,3574,4604,-1030
1,6,12,11,3,3567,5192,-1625
1,6,13,11,3,3794,5431,-1637
1,6,14,11,3,4604,5148,-544
1,6,15,11,3,5192,4940,252
1,6,16,11,3,5431,4799,632
1,6,17,11,3,5148,4668,480
1,6,18,11,3,4940,4582,358
1,7,0,11,3,3732,4799,-1067
1,7,1,11,3,3440,5214,-1774
1,7,2,11,3,3906,5520,-1614
1,7,3,11,3,4799,5657,-858
1,7,4,11,3,5214,5268,-54
1,7,5,11,3,5520,4458,1062
1,7,6,11,3,5657,3549,2108
1,7,7,11,3,5268,3664,1604
1,7,8,11,3,4458,3600,858
1,7,9,11,3,3549,3588,-39
1,7,10,11,3,3664,3873,-209
1,7,11,11,3,3600,4834,-1234
1,7,12,11,3,3588,5524,-1936
1,7,13,11,3,3873,5695,-1822
1,7,14,11,3,4834,5320,-486
1,7,15,11,3,5524,5094,430
1,7,16,11,3,5695,5008,687
1,7,17,11,3,5320,4781,539
1,7,18,11,3,5094,4658,436
1,8,0,11,3,3677,5254,-1577
1,8,1,11,3,3528,5521,-1993
1,8,2,11,3,4225,5652,-1427
1,8,3,11,3,5254,5684,-430
1,8,4,11,3,5521,5285,236
1,8,5,11,3,5652,4430,1222
1,8,6,11,3,5684,3489,2195
1,8,7,11,3,5285,3635,1650
1,8,8,11,3,4430,3570,860
1,8,9,11,3,3489,3579,-90
1,8,10,11,3,3635,3842,-207
1,8,11,11,3,3570,4794,-1224
1,8,12,11,3,3579,5552,-1973
1,8,13,11,3,3842,5731,-1889
1,8,14,11,3,4794,5436,-642
1,8,15,11,3,5552,5264,288
1,8,16,11,3,5731,5264,467
1,8,17,11,3,5436,4960,476
1,8,18,11,3,5264,4705,559
1,9,0,11,3,3673,5463,-1790
1,9,1,11,3,3616,5511,-1895
1,9,2,11,3,4431,5553,-1122
1,9,3,11,3,5463,5659,-196
1,9,4,11,3,5511,5311,200
1,9,5,11,3,5553,4506,1047
1,9,6,11,3,5659,3499,2160
1,9,7,11,3,5311,3669,1642
1,9,8,11,3,4506,3587,919
1,9,9,11,3,3499,3574,-75
1,9,10,11,3,3669,3752,-83
1,9,11,11,3,3587,4747,-1160
1,9,12,11,3,3574,5610,-2036
1,9,13,11,3,3752,5802,-2050
1,9,14,11,3,4747,5423,-676
1,9,15,11,3,5610,5252,358
1,9,16,11,3,5802,5263,539
1,9,17,11,3,5423,4945,478
1,9,18,11,3,5252,4682,570
1,10,0,11,3,3763,5694,-1931
1,10,1,11,3,3809,5584,-1775
1,10,2,11,3,4673,5682,-1009
1,10,3,11,3,5694,5980,-286
1,10,4,11,3,5584,5694,-110
1,10,5,11,3,5682,4901,781
1,10,6,11,3,5980,3798,2182
1,10,7,11,3,5694,3990,1704
1,10,8,11,3,4901,3902,999
1,10,9,11,3,3798,3862,-64
1,10,10,11,3,3990,3949,41
1,10,11,11,3,3902,4905,-1003
1,10,12,11,3,3862,5765,-1903
1,10,13,11,3,3949,5925,-1976
1,10,14,11,3,4905,5497,-592
1,10,15,11,3,5765,5384,381
1,10,16,11,3,5925,5390,535
1,10,17,11,3,5497,5021,476
1,10,18,11,3,5384,4754,630
1,11,0,11,3,3919,5681,-1762
1,11,1,11,3,4025,5347,-1322
1,11,2,11,3,4775,5458,-683
1,11,3,11,3,5681,5845,-164
1,11,4,11,3,5347,5537,-190
1,11,5,11,3,5458,4711,747
1,11,6,11,3,5845,3530,2315
1,11,7,11,3,5537,3772,1765
1,11,8,11,3,4711,3694,1017
1,11,9,11,3,3530,3629,-99
1,11,10,11,3,3772,3679,93
1,11,11,11,3,3694,4629,-935
1,11,12,11,3,3629,5510,-1881
1,11,13,11,3,3679,5687,-2008
1,11,14,11,3,4629,5325,-696
1,11,15,11,3,5510,5277,233
1,11,16,11,3,5687,5347,340
1,11,17,11,3,5325,5011,314
1,11,18,11,3,5277,4825,452
1,12,0,11,3,3837,5327,-1490
1,12,1,11,3,3982,4818,-836
1,12,2,11,3,4545,5007,-462
1,12,3,11,3,5327,5467,-140
1,12,4,11,3,4818,5208,-390
1,12,5,11,3,5007,4393,614
1,12,6,11,3,5467,3160,2307
1,12,7,11,3,5208,3456,1752
1,12,8,11,3,4393,3385,1008
1,12,9,11,3,3160,3286,-126
1,12,10,11,3,3456,3320,136
1,12,11,11,3,3385,4257,-872
1,12,12,11,3,3286,5123,-1837
1,12,13,11,3,3320,5227,-1907
1,12,14,11,3,4257,4842,-585
1,12,15,11,3,5123,4795,328
1,12,16,11,3,5227,4914,313
1,12,17,11,3,4842,4612,230
1,12,18,11,3,4795,4513,282
1,13,0,11,3,3669,4966,-1297
1,13,1,11,3,3797,4349,-552
1,13,2,11,3,4270,4562,-292
1,13,3,11,3,4966,5052,-86
1,13,4,11,3,4349,4945,-596
1,13,5,11,3,4562,4215,347
1,13,6,11,3,5052,3033,2019
1,13,7,11,3,4945,3343,1602
1,13,8,11,3,4215,3310,905
1,13,9,11,3,3033,3255,-222
1,13,10,11,3,3343,3223,120
1,13,11,11,3,3310,4037,-727
1,13,12,11,3,3255,4743,-1488
1,13,13,11,3,3223,4754,-1531
1,13,14,11,3,4037,4361,-324
1,13,15,11,3,4743,4321,422
1,13,16,11,3,4754,4434,320
1,13,17,11,3,4361,4159,202
1,13,18,11,3,4321,4140,181
1,0,0,12,3,3879,3688,191
1,0,1,12,3,3600,3843,-243
1,0,2,12,3,3634,3814,-180
1,0,3,12,3,3688,3797,-109
1,0,4,12,3,3843,3691,152
1,0,5,12,3,3814,3539,275
1,0,6,12,3,3797,3427,370
1,0,7,12,3,3691,3421,270
1,0,8,12,3,3539,3435,104
1,0,9,12,3,3427,3446,-19
1,0,10,12,3,3421,3472,-51
1,0,11,12,3,3435,3601,-166
1,0,12,12,3,3446,3749,-303
1,0,13,12,3,3472,3832,-360
1,0,14,12,3,3601,3845,-244
1,0,15,12,3,3749,3850,-101
1,0,16,12,3,3832,3877,-45
1,0,17,12,3,3845,3946,-101
1,0,18,12,3,3850,4012,-162
1,1,0,12,3,3968,3932,36
1,1,1,12,3,3676,4168,-492
1,1,2,12,3,3796,4131,-335
1,1,3,12,3,3932,4152,-220
1,1,4,12,3,4168,3945,223
1,1,5,12,3,4131,3687,444
1,1,6,12,3,4152,3460,692
1,1,7,12,3,3945,3475,470
1,1,8,12,3,3687,3485,202
1,1,9,12,3,3460,3482,-22
1,1,10,12,3,3475,3533,-58
1,1,11,12,3,3485,3807,-322
1,1,12,12,3,3482,4092,-610
1,1,13,12,3,3533,4211,-678
1,1,14,12,3,3807,4185,-378
1,1,15,12,3,4092,4174,-82
1,1,16,12,3,4211,4205,6
1,1,17,12,3,4185,4250,-65
1,1,18,12,3,4174,4225,-51
1,2,0,12,3,4059,4169,-110
1,2,1,12,3,3744,4456,-712
1,2,2,12,3,3891,4470,-579
1,2,3,12,3,4169,4487,-318
1,2,4,12,3,4456,4206,250
1,2,5,12,3,4470,3824,646
1,2,6,12,3,4487,3446,1041
1,2,7,12,3,4206,3474,732
1,2,8,12,3,3824,3474,350
1,2,9,12,3,3446,3467,-21
1,2,10,12,3,3474,3561,-87
1,2,11,12,3,3474,3977,-503
1,2,12,12,3,3467,4386,-919
1,2,13,12,3,3561,4569,-1008
1,2,14,12,3,3977,4520,-543
1,2,15,12,3,4386,4475,-89
1,2,16,12,3,4569,4469,100
1,2,17,12,3,4520,4486,34
1,2,18,12,3,4475,4417,58
1,3,0,12,3,4162,4396,-234
1,3,1,12,3,3816,4703,-887
1,3,2,12,3,3975,4764,-789
1,3,3,12,3,4396,4756,-360
1,3,4,12,3,4703,4427,276
1,3,5,12,3,4764,3950,814
1,3,6,12,3,4756,3437,1319
1,3,7,12,3,4427,3481,946
1,3,8,12,3,3950,3467,483
1,3,9,12,3,3437,3468,-31
1,3,10,12,3,3481,3603,-122
1,3,11,12,3,3467,4139,-672
1,3,12,12,3,3468,4625,-1157
1,3,13,12,3,3603,4885,-1282
1,3,14,12,3,4139,4818,-679
1,3,15,12,3,4625,4752,-127
1,3,16,12,3,4885,4710,175
1,3,17,12,3,4818,4707,111
1,3,18,12,3,4752,4636,116
1,4,0,12,3,4245,4640,-395
1,4,1,12,3,3879,4985,-1106
1,4,2,12,3,4081,5073,-992
1,4,3,12,3,4640,5096,-456
1,4,4,12,3,4985,4729,256
1,4,5,12,3,5073,4182,891
1,4,6,12,3,5096,3534,1562
1,4,7,12,3,4729,3607,1122
1,4,8,12,3,4182,3570,612
1,4,9,12,3,3534,3561,-27
1,4,10,12,3,3607,3746,-139
1,4,11,12,3,3570,4418,-848
1,4,12,12,3,3561,4955,-1394
1,4,13,12,3,3746,5252,-1506
1,4,14,12,3,4418,5122,-704
1,4,15,12,3,4955,5026,-71
1,4,16,12,3,5252,4948,304
1,4,17,12,3,5122,4918,204
1,4,18,12,3,5026,4835,191
1,5,0,12,3,4195,4866,-671
1,5,1,12,3,3839,5243,-1404
1,5,2,12,3,4139,5410,-1271
1,5,3,12,3,4866,5489,-623
1,5,4,12,3,5243,5142,101
1,5,5,12,3,5410,4492,918
1,5,6,12,3,5489,3708,1781
1,5,7,12,3,5142,3808,1334
1,5,8,12,3,4492,3769,723
1,5,9,12,3,3708,3762,-54
1,5,10,12,3,3808,3990,-182
1,5,11,12,3,3769,4790,-1021
1,5,12,12,3,3762,5371,-1609
1,5,13,12,3,3990,5625,-1635
1,5,14,12,3,4790,5394,-604
1,5,15,12,3,5371,5244,127
1,5,16,12,3,5625,5141,484
1,5,17,12,3,5394,5021,373
1,5,18,12,3,5244,4927,317
1,6,0,12,3,4085,5057,-972
1,6,1,12,3,3762,5450,-1688
1,6,2,12,3,4191,5727,-1536
1,6,3,12,3,5057,5851,-794
1,6,4,12,3,5450,5464,-14
1,6,5,12,3,5727,4665,1062
1,6,6,12,3,5851,3756,2095
1,6,7,12,3,5464,3871,1593
1,6,8,12,3,4665,3807,858
1,6,9,12,3,3756,3794,-38
1,6,10,12,3,3871,4078,-207
1,6,11,12,3,3807,5047,-1240
1,6,12,12,3,3794,5735,-1941
1,6,13,12,3,4078,5909,-1831
1,6,14,12,3,5047,5544,-497
1,6,15,12,3,5735,5349,386
1,6,16,12,3,5909,5299,610
1,6,17,12,3,5544,5101,443
1,6,18,12,3,5349,4996,353
1,7,0,12,3,4022,5400,-1378
1,7,1,12,3,3792,5700,-1908
1,7,2,12,3,4404,5896,-1492
1,7,3,12,3,5400,5966,-566
1,7,4,12,3,5700,5581,119
1,7,5,12,3,5896,4718,1178
1,7,6,12,3,5966,3781,2185
1,7,7,12,3,5581,3930,1651
1,7,8,12,3,4718,3866,852
1,7,9,12,3,3781,3873,-92
1,7,10,12,3,3930,4133,-203
1,7,11,12,3,3866,5086,-1220
1,7,12,12,3,3873,5831,-1958
1,7,13,12,3,4133,5993,-1860
1,7,14,12,3,5086,5676,-590
1,7,15,12,3,5831,5492,339
1,7,16,12,3,5993,5497,496
1,7,17,12,3,5676,5226,450
1,7,18,12,3,5492,5024,468
1,8,0,12,3,4061,5698,-1637
1,8,1,12,3,3956,5803,-1847
1,8,2,12,3,4693,5903,-1210
1,8,3,12,3,5698,6042,-344
1,8,4,12,3,5803,5694,109
1,8,5,12,3,5903,4898,1005
1,8,6,12,3,6042,3901,2141
1,8,7,12,3,5694,4082,1612
1,8,8,12,3,4898,4016,882
1,8,9,12,3,3901,4004,-103
1,8,10,12,3,4082,4174,-92
1,8,11,12,3,4016,5157,-1141
1,8,12,12,3,4004,6013,-2009
1,8,13,12,3,4174,6196,-2022
1,8,14,12,3,5157,5776,-619
1,8,15,12,3,6013,5573,440
1,8,16,12,3,6196,5583,613
1,8,17,12,3,5776,5290,486
1,8,18,12,3,5573,5059,514
1,9,0,12,3,4007,5833,-1826
1,9,1,12,3,3990,5724,-1734
1,9,2,12,3,4826,5848,-1022
1,9,3,12,3,5833,6155,-322
1,9,4,12,3,5724,5866,-142
1,9,5,12,3,5848,5035,813
1,9,6,12,3,6155,3904,2251
1,9,7,12,3,5866,4094,1772
1,9,8,12,3,5035,4005,1030
1,9,9,12,3,3904,3956,-52
1,9,10,12,3,4094,4057,37
1,9,11,12,3,4005,5044,-1039
1,9,12,12,3,3956,5943,-1987
1,9,13,12,3,4057,6108,-2051
1,9,14,12,3,5044,5668,-624
1,9,15,12,3,5943,5540,403
1,9,16,12,3,6108,5548,560
1,9,17,12,3,5668,5208,460
1,9,18,12,3,5540,4993,547
1,10,0,12,3,4127,6023,-1896
1,10,1,12,3,4205,5736,-1531
1,10,2,12,3,5059,5856,-797
1,10,3,12,3,6023,6267,-244
1,10,4,12,3,5736,5964,-228
1,10,5,12,3,5856,5113,743
1,10,6,12,3,6267,3909,2358
1,10,7,12,3,5964,4148,1816
1,10,8,12,3,5113,4070,1043
1,10,9,12,3,3909,4010,-101
1,10,10,12,3,4148,4064,84
1,10,11,12,3,4070,5027,-957
1,10,12,12,3,4010,5933,-1923
1,10,13,12,3,4064,6093,-2029
1,10,14,12,3,5027,5706,-679
1,10,15,12,3,5933,5624,309
1,10,16,12,3,6093,5664,429
1,10,17,12,3,5706,5307,399
1,10,18,12,3,5624,5112,512
1,11,0,12,3,4166,5878,-1712
1,11,1,12,3,4295,5469,-1174
1,11,2,12,3,5011,5635,-624
1,11,3,12,3,5878,6136,-258
1,11,4,12,3,5469,5832,-363
1,11,5,12,3,5635,4981,654
1,11,6,12,3,6136,3710,2426
1,11,7,12,3,5832,4019,1813
1,11,8,12,3,4981,3954,1027
1,11,9,12,3,3710,3861,-151
1,11,10,12,3,4019,3893,126
1,11,11,12,3,3954,4872,-918
1,11,12,12,3,3861,5790,-1929
1,11,13,12,3,3893,5889,-1996
1,11,14,12,3,4872,5473,-601
1,11,15,12,3,5790,5403,387
1,11,16,12,3,5889,5507,382
1,11,17,12,3,5473,5167,306
1,11,18,12,3,5403,4989,414
1,12,0,12,3,4071,5530,-1459
1,12,1,12,3,4174,5000,-826
1,12,2,12,3,4737,5200,-463
1,12,3,12,3,5530,5721,-191
1,12,4,12,3,5000,5512,-512
1,12,5,12,3,5200,4672,528
1,12,6,12,3,5721,3373,2348
1,12,7,12,3,5512,3703,1809
1,12,8,12,3,4672,3667,1005
1,12,9,12,3,3373,3600,-227
1,12,10,12,3,3703,3596,107
1,12,11,12,3,3667,4550,-883
1,12,12,12,3,3600,5391,-1791
1,12,13,12,3,3596,5443,-1847
1,12,14,12,3,4550,5021,-471
1,12,15,12,3,5391,4961,430
1,12,16,12,3,5443,5071,372
1,12,17,12,3,5021,4773,248
1,12,18,12,3,4961,4667,294
1,0,0,13,3,4281,4252,29
1,0,1,13,3,3977,4494,-517
1,0,2,13,3,4101,4452,-351
1,0,3,13,3,4252,4466,-214
1,0,4,13,3,4494,4258,236
1,0,5,13,3,4452,3996,456
1,0,6,13,3,4466,3767,699
1,0,7,13,3,4258,3781,477
1,0,8,13,3,3996,3792,204
1,0,9,13,3,3767,3791,-24
1,0,10,13,3,3781,3845,-64
1,0,11,13,3,3792,4114,-322
1,0,12,13,3,3791,4397,-606
1,0,13,13,3,3845,4521,-676
1,0,14,13,3,4114,4505,-391
1,0,15,13,3,4397,4490,-93
1,0,16,13,3,4521,4514,7
1,0,17,13,3,4505,4560,-55
1,0,18,13,3,4490,4539,-49
1,1,0,13,3,4383,4495,-112
1,1,1,13,3,4068,4778,-710
1,1,2,13,3,4216,4787,-571
1,1,3,13,3,4495,4804,-309
1,1,4,13,3,4778,4527,251
1,1,5,13,3,4787,4142,645
1,1,6,13,3,4804,3759,1045
1,1,7,13,3,4527,3784,743
1,1,8,13,3,4142,3784,358
1,1,9,13,3,3759,3779,-20
1,1,10,13,3,3784,3877,-93
1,1,11,13,3,3784,4304,-520
1,1,12,13,3,3779,4715,-936
1,1,13,13,3,3877,4895,-1018
1,1,14,13,3,4304,4833,-529
1,1,15,13,3,4715,4782,-67
1,1,16,13,3,4895,4783,112
1,1,17,13,3,4833,4812,21
1,1,18,13,3,4782,4744,38
1,2,0,13,3,4495,4721,-226
1,2,1,13,3,4150,5029,-879
1,2,2,13,3,4304,5098,-794
1,2,3,13,3,4721,5097,-376
1,2,4,13,3,5029,4773,256
1,2,5,13,3,5098,4287,811
1,2,6,13,3,5097,3766,1331
1,2,7,13,3,4773,3803,970
1,2,8,13,3,4287,3788,499
1,2,9,13,3,3766,3792,-26
1,2,10,13,3,3803,3932,-129
1,2,11,13,3,3788,4477,-689
1,2,12,13,3,3792,4962,-1170
1,2,13,13,3,3932,5220,-1288
1,2,14,13,3,4477,5143,-666
1,2,15,13,3,4962,5071,-109
1,2,16,13,3,5220,5030,190
1,2,17,13,3,5143,5035,108
1,2,18,13,3,5071,4967,104
1,3,0,13,3,4584,4972,-388
1,3,1,13,3,4211,5324,-1113
1,3,2,13,3,4408,5415,-1007
1,3,3,13,3,4972,5395,-423
1,3,4,13,3,5324,4985,339
1,3,5,13,3,5415,4389,1026
1,3,6,13,3,5395,3732,1663
1,3,7,13,3,4985,3798,1187
1,3,8,13,3,4389,3758,631
1,3,9,13,3,3732,3751,-19
1,3,10,13,3,3798,3941,-143
1,3,11,13,3,3758,4640,-882
1,3,12,13,3,3751,5211,-1460
1,3,13,13,3,3941,5558,-1617
1,3,14,13,3,4640,5459,-819
1,3,15,13,3,5211,5371,-160
1,3,16,13,3,5558,5280,278
1,3,17,13,3,5459,5240,219
1,3,18,13,3,5371,5161,210
1,4,0,13,3,4542,5227,-685
1,4,1,13,3,4187,5583,-1396
1,4,2,13,3,4494,5700,-1206
1,4,3,13,3,5227,5713,-486
1,4,4,13,3,5583,5323,260
1,4,5,13,3,5700,4645,1055
1,4,6,13,3,5713,3852,1861
1,4,7,13,3,5323,3945,1378
1,4,8,13,3,4645,3903,742
1,4,9,13,3,3852,3898,-46
1,4,10,13,3,3945,4130,-185
1,4,11,13,3,3903,4944,-1041
1,4,12,13,3,3898,5553,-1655
1,4,13,13,3,4130,5865,-1735
1,4,14,13,3,4944,5698,-754
1,4,15,13,3,5553,5588,-35
1,4,16,13,3,5865,5489,376
1,4,17,13,3,5698,5359,339
1,4,18,13,3,5588,5260,328
1,5,0,13,3,4441,5410,-969
1,5,1,13,3,4123,5753,-1630
1,5,2,13,3,4555,5944,-1389
1,5,3,13,3,5410,6028,-618
1,5,4,13,3,5753,5640,113
1,5,5,13,3,5944,4869,1075
1,5,6,13,3,6028,3956,2072
1,5,7,13,3,5640,4068,1572
1,5,8,13,3,4869,4002,867
1,5,9,13,3,3956,3989,-33
1,5,10,13,3,4068,4274,-206
1,5,11,13,3,4002,5233,-1231
1,5,12,13,3,3989,5914,-1925
1,5,13,13,3,4274,6103,-1829
1,5,14,13,3,5233,5790,-557
1,5,15,13,3,5914,5653,261
1,5,16,13,3,6103,5641,462
1,5,17,13,3,5790,5454,336
1,5,18,13,3,5653,5341,312
1,6,0,13,3,4375,5658,-1283
1,6,1,13,3,4114,5936,-1822
1,6,2,13,3,4689,6103,-1414
1,6,3,13,3,5658,6160,-502
1,6,4,13,3,5936,5777,159
1,6,5,13,3,6103,4925,1178
1,6,6,13,3,6160,3988,2172
1,6,7,13,3,5777,4137,1640
1,6,8,13,3,4925,4073,852
1,6,9,13,3,3988,4079,-91
1,6,10,13,3,4137,4338,-201
1,6,11,13,3,4073,5299,-1226
1,6,12,13,3,4079,6042,-1963
1,6,13,13,3,4338,6207,-1869
1,6,14,13,3,5299,5900,-601
1,6,15,13,3,6042,5747,295
1,6,16,13,3,6207,5788,419
1,6,17,13,3,5900,5546,354
1,6,18,13,3,5747,5362,385
1,7,0,13,3,4406,5844,-1438
1,7,1,13,3,4220,5982,-1762
1,7,2,13,3,4872,6147,-1275
1,7,3,13,3,5844,6324,-480
1,7,4,13,3,5982,5990,-8
1,7,5,13,3,6147,5186,961
1,7,6,13,3,6324,4193,2131
1,7,7,13,3,5990,4377,1613
1,7,8,13,3,5186,4312,874
1,7,9,13,3,4193,4298,-105
1,7,10,13,3,4377,4465,-88
1,7,11,13,3,4312,5449,-1137
1,7,12,13,3,4298,6292,-1994
1,7,13,13,3,4465,6458,-1993
1,7,14,13,3,5449,6016,-567
1,7,15,13,3,6292,5801,491
1,7,16,13,3,6458,5816,642
1,7,17,13,3,6016,5556,460
1,7,18,13,3,5801,5378,423
1,8,0,13,3,4395,6068,-1673
1,8,1,13,3,4330,6016,-1686
1,8,2,13,3,5088,6198,-1110
1,8,3,13,3,6068,6538,-470
1,8,4,13,3,6016,6249,-233
1,8,5,13,3,6198,5427,771
1,8,6,13,3,6538,4306,2232
1,8,7,13,3,6249,4507,1742
1,8,8,13,3,5427,4434,993
1,8,9,13,3,4306,4386,-80
1,8,10,13,3,4507,4479,28
1,8,11,13,3,4434,5454,-1020
1,8,12,13,3,4386,6346,-1960
1,8,13,13,3,4479,6502,-2023
1,8,14,13,3,5454,6021,-567
1,8,15,13,3,6346,5861,485
1,8,16,13,3,6502,5868,634
1,8,17,13,3,6021,5553,468
1,8,18,13,3,5861,5370,491
1,9,0,13,3,4371,6162,-1791
1,9,1,13,3,4386,5876,-1490
1,9,2,13,3,5212,6022,-810
1,9,3,13,3,6162,6442,-280
1,9,4,13,3,5876,6136,-260
1,9,5,13,3,6022,5247,775
1,9,6,13,3,6442,4015,2427
1,9,7,13,3,6136,4252,1884
1,9,8,13,3,5247,4173,1074
1,9,9,13,3,4015,4104,-89
1,9,10,13,3,4252,4172,80
1,9,11,13,3,4173,5166,-993
1,9,12,13,3,4104,6111,-2007
1,9,13,13,3,4172,6276,-2104
1,9,14,13,3,5166,5877,-711
1,9,15,13,3,6111,5780,331
1,9,16,13,3,6276,5822,454
1,9,17,13,3,5877,5494,383
1,9,18,13,3,5780,5351,429
1,10,0,13,3,4374,6220,-1846
1,10,1,13,3,4475,5858,-1383
1,10,2,13,3,5295,6033,-738
1,10,3,13,3,6220,6558,-338
1,10,4,13,3,5858,6259,-401
1,10,5,13,3,6033,5383,650
1,10,6,13,3,6558,4089,2469
1,10,7,13,3,6259,4395,1864
1,10,8,13,3,5383,4330,1053
1,10,9,13,3,4089,4242,-153
1,10,10,13,3,4395,4278,117
1,10,11,13,3,4330,5270,-940
1,10,12,13,3,4242,6213,-1971
1,10,13,13,3,4278,6295,-2017
1,10,14,13,3,5270,5854,-584
1,10,15,13,3,6213,5750,463
1,10,16,13,3,6295,5824,471
1,10,17,13,3,5854,5463,391
1,10,18,13,3,5750,5276,474
1,11,0,13,3,4400,6081,-1681
1,11,1,13,3,4487,5651,-1164
1,11,2,13,3,5203,5828,-625
1,11,3,13,3,6081,6390,-309
1,11,4,13,3,5651,6136,-485
1,11,5,13,3,5828,5260,568
1,11,6,13,3,6390,3923,2467
1,11,7,13,3,6136,4266,1870
1,11,8,13,3,5260,4236,1024
1,11,9,13,3,3923,4175,-252
1,11,10,13,3,4266,4169,97
1,11,11,13,3,4236,5165,-929
1,11,12,13,3,4175,6058,-1883
1,11,13,13,3,4169,6105,-1936
1,11,14,13,3,5165,5652,-487
1,11,15,13,3,6058,5569,489
1,11,16,13,3,6105,5664,441
1,11,17,13,3,5652,5328,324
1,11,18,13,3,5569,5143,426
1,0,0,14,3,4696,4815,-119
1,0,1,14,3,4369,5104,-735
1,0,2,14,3,4521,5108,-587
1,0,3,14,3,4815,5118,-303
1,0,4,14,3,5104,4840,264
1,0,5,14,3,5108,4451,657
1,0,6,14,3,5118,4066,1052
1,0,7,14,3,4840,4090,750
1,0,8,14,3,4451,4091,360
1,0,9,14,3,4066,4088,-22
1,0,10,14,3,4090,4189,-99
1,0,11,14,3,4091,4611,-520
1,0,12,14,3,4088,5020,-932
1,0,13,14,3,4189,5205,-1016
1,0,14,14,3,4611,5153,-542
1,0,15,14,3,5020,5098,-78
1,0,16,14,3,5205,5092,113
1,0,17,14,3,5153,5122,31
1,0,18,14,3,5098,5058,40
1,1,0,14,3,4819,5047,-228
1,1,1,14,3,4474,5351,-877
1,1,2,14,3,4629,5415,-786
1,1,3,14,3,5047,5414,-367
1,1,4,14,3,5351,5094,257
1,1,5,14,3,5415,4605,810
1,1,6,14,3,5414,4079,1335
1,1,7,14,3,5094,4113,981
1,1,8,14,3,4605,4098,507
1,1,9,14,3,4079,4104,-25
1,1,10,14,3,4113,4248,-135
1,1,11,14,3,4098,4804,-706
1,1,12,14,3,4104,5291,-1187
1,1,13,14,3,4248,5546,-1298
1,1,14,14,3,4804,5456,-652
1,1,15,14,3,5291,5378,-87
1,1,16,14,3,5546,5344,202
1,1,17,14,3,5456,5361,95
1,1,18,14,3,5378,5294,84
1,2,0,14,3,4917,5297,-380
1,2,1,14,3,4545,5650,-1105
1,2,2,14,3,4737,5749,-1012
1,2,3,14,3,5297,5736,-439
1,2,4,14,3,5650,5331,319
1,2,5,14,3,5749,4726,1023
1,2,6,14,3,5736,4061,1675
1,2,7,14,3,5331,4120,1211
1,2,8,14,3,4726,4079,647
1,2,9,14,3,4061,4075,-14
1,2,10,14,3,4120,4270,-150
1,2,11,14,3,4079,4978,-899
1,2,12,14,3,4075,5548,-1473
1,2,13,14,3,4270,5893,-1623
1,2,14,14,3,4978,5784,-806
1,2,15,14,3,5548,5690,-142
1,2,16,14,3,5893,5600,293
1,2,17,14,3,5784,5568,216
1,2,18,14,3,5690,5492,198
1,3,0,14,3,4881,5559,-678
1,3,1,14,3,4519,5922,-1403
1,3,2,14,3,4821,6042,-1221
1,3,3,14,3,5559,6012,-453
1,3,4,14,3,5922,5579,343
1,3,5,14,3,6042,4852,1190
1,3,6,14,3,6012,4050,1962
1,3,7,14,3,5579,4136,1443
1,3,8,14,3,4852,4091,761
1,3,9,14,3,4050,4088,-38
1,3,10,14,3,4136,4325,-189
1,3,11,14,3,4091,5166,-1075
1,3,12,14,3,4088,5809,-1721
1,3,13,14,3,4325,6171,-1846
1,3,14,14,3,5166,6035,-869
1,3,15,14,3,5809,5933,-124
1,3,16,14,3,6171,5821,350
1,3,17,14,3,6035,5681,354
1,3,18,14,3,5933,5586,347
1,4,0,14,3,4788,5771,-983
1,4,1,14,3,4471,6093,-1622
1,4,2,14,3,4910,6234,-1324
1,4,3,14,3,5771,6252,-481
1,4,4,14,3,6093,5821,272
1,4,5,14,3,6234,5022,1212
1,4,6,14,3,6252,4100,2152
1,4,7,14,3,5821,4205,1616
1,4,8,14,3,5022,4136,886
1,4,9,14,3,4100,4125,-25
1,4,10,14,3,4205,4414,-209
1,4,11,14,3,4136,5387,-1251
1,4,12,14,3,4125,6096,-1971
1,4,13,14,3,4414,6343,-1929
1,4,14,14,3,5387,6094,-707
1,4,15,14,3,6096,5997,99
1,4,16,14,3,6343,5989,354
1,4,17,14,3,6094,5792,302
1,4,18,14,3,5997,5674,323
1,5,0,14,3,4731,6011,-1280
1,5,1,14,3,4475,6239,-1764
1,5,2,14,3,5053,6320,-1267
1,5,3,14,3,6011,6337,-326
1,5,4,14,3,6239,5953,286
1,5,5,14,3,6320,5129,1191
1,5,6,14,3,6337,4188,2149
1,5,7,14,3,5953,4334,1619
1,5,8,14,3,5129,4268,861
1,5,9,14,3,4188,4274,-86
1,5,10,14,3,4334,4534,-200
1,5,11,14,3,4268,5485,-1217
1,5,12,14,3,4274,6221,-1947
1,5,13,14,3,4534,6401,-1867
1,5,14,14,3,5485,6146,-661
1,5,15,14,3,6221,6051,170
1,5,16,14,3,6401,6130,271
1,5,17,14,3,6146,5899,247
1,5,18,14,3,6051,5707,344
1,6,0,14,3,4759,6102,-1343
1,6,1,14,3,4542,6218,-1676
1,6,2,14,3,5157,6354,-1197
1,6,3,14,3,6102,6518,-416
1,6,4,14,3,6218,6186,32
1,6,5,14,3,6354,5393,961
1,6,6,14,3,6518,4400,2118
1,6,7,14,3,6186,4584,1602
1,6,8,14,3,5393,4519,874
1,6,9,14,3,4400,4504,-104
1,6,10,14,3,4584,4670,-86
1,6,11,14,3,4519,5662,-1143
1,6,12,14,3,4504,6503,-1999
1,6,13,14,3,4670,6672,-2002
1,6,14,14,3,5662,6240,-578
1,6,15,14,3,6503,6056,447
1,6,16,14,3,6672,6107,565
1,6,17,14,3,6240,5876,364
1,6,18,14,3,6056,5716,340
1,7,0,14,3,4740,6214,-1474
1,7,1,14,3,4594,6195,-1601
1,7,2,14,3,5267,6442,-1175
1,7,3,14,3,6214,6820,-606
1,7,4,14,3,6195,6545,-350
1,7,5,14,3,6442,5715,727
1,7,6,14,3,6820,4598,2222
1,7,7,14,3,6545,4802,1743
1,7,8,14,3,5715,4730,985
1,7,9,14,3,4598,4680,-82
1,7,10,14,3,4802,4770,32
1,7,11,14,3,4730,5746,-1016
1,7,12,14,3,4680,6625,-1945
1,7,13,14,3,4770,6764,-1994
1,7,14,14,3,5746,6261,-515
1,7,15,14,3,6625,6089,536
1,7,16,14,3,6764,6101,663
1,7,17,14,3,6261,5819,442
1,7,18,14,3,6089,5689,400
1,8,0,14,3,4759,6397,-1638
1,8,1,14,3,4726,6168,-1442
1,8,2,14,3,5474,6372,-898
1,8,3,14,3,6397,6825,-428
1,8,4,14,3,6168,6519,-351
1,8,5,14,3,6372,5639,733
1,8,6,14,3,6825,4417,2408
1,8,7,14,3,6519,4665,1854
1,8,8,14,3,5639,4602,1037
1,8,9,14,3,4417,4534,-117
1,8,10,14,3,4665,4594,71
1,8,11,14,3,4602,5576,-974
1,8,12,14,3,4534,6514,-1980
1,8,13,14,3,4594,6670,-2076
1,8,14,14,3,5576,6230,-654
1,8,15,14,3,6514,6101,413
1,8,16,14,3,6670,6142,528
1,8,17,14,3,6230,5839,391
1,8,18,14,3,6101,5728,373
1,9,0,14,3,4618,6359,-1741
1,9,1,14,3,4656,5998,-1342
1,9,2,14,3,5448,6199,-751
1,9,3,14,3,6359,6733,-374
1,9,4,14,3,5998,6431,-433
1,9,5,14,3,6199,5517,682
1,9,6,14,3,6733,4195,2538
1,9,7,14,3,6431,4499,1932
1,9,8,14,3,5517,4433,1084
1,9,9,14,3,4195,4336,-141
1,9,10,14,3,4499,4386,113
1,9,11,14,3,4433,5409,-976
1,9,12,14,3,4336,6391,-2055
1,9,13,14,3,4386,6478,-2092
1,9,14,14,3,5409,6025,-616
1,9,15,14,3,6391,5906,485
1,9,16,14,3,6478,5982,496
1,9,17,14,3,6025,5650,375
1,9,18,14,3,5906,5515,391
1,10,0,14,3,4608,6423,-1815
1,10,1,14,3,4667,6040,-1373
1,10,2,14,3,5487,6226,-739
1,10,3,14,3,6423,6812,-389
1,10,4,14,3,6040,6563,-523
1,10,5,14,3,6226,5662,564
1,10,6,14,3,6812,4302,2510
1,10,7,14,3,6563,4642,1921
1,10,8,14,3,5662,4612,1050
1,10,9,14,3,4302,4556,-254
1,10,10,14,3,4642,4554,88
1,10,11,14,3,4612,5563,-951
1,10,12,14,3,4556,6481,-1925
1,10,13,14,3,4554,6511,-1957
1,10,14,14,3,5563,6033,-470
1,10,15,14,3,6481,5916,565
1,10,16,14,3,6511,5981,530
1,10,17,14,3,6033,5624,409
1,10,18,14,3,5916,5430,486
1,0,0,15,3,5132,5367,-235
1,0,1,15,3,4775,5677,-902
1,0,2,15,3,4934,5736,-802
1,0,3,15,3,5367,5728,-361
1,0,4,15,3,5677,5407,270
1,0,5,15,3,5736,4914,822
1,0,6,15,3,5728,4386,1342
1,0,7,15,3,5407,4419,988
1,0,8,15,3,4914,4405,509
1,0,9,15,3,4386,4413,-27
1,0,10,15,3,4419,4560,-141
1,0,11,15,3,4405,5111,-706
1,0,12,15,3,4413,5596,-1183
1,0,13,15,3,4560,5856,-1296
1,0,14,15,3,5111,5776,-665
1,0,15,15,3,5596,5694,-98
1,0,16,15,3,5856,5653,203
1,0,17,15,3,5776,5671,105
1,0,18,15,3,5694,5608,86
1,1,0,15,3,5241,5623,-382
1,1,1,15,3,4869,5972,-1103
1,1,2,15,3,5062,6066,-1004
1,1,3,15,3,5623,6053,-430
1,1,4,15,3,5972,5652,320
1,1,5,15,3,6066,5044,1022
1,1,6,15,3,6053,4374,1679
1,1,7,15,3,5652,4430,1222
1,1,8,15,3,5044,4389,655
1,1,9,15,3,4374,4387,-13
1,1,10,15,3,4430,4586,-156
1,1,11,15,3,4389,5305,-916
1,1,12,15,3,4387,5877,-1490
1,1,13,15,3,4586,6219,-1633
1,1,14,15,3,5305,6097,-792
1,1,15,15,3,5877,5997,-120
1,1,16,15,3,6219,5914,305
1,1,17,15,3,6097,5894,203
1,1,18,15,3,5997,5819,178
1,2,0,15,3,5214,5884,-670
1,2,1,15,3,4853,6248,-1395
1,2,2,15,3,5150,6376,-1226
1,2,3,15,3,5884,6353,-469
1,2,4,15,3,6248,5925,323
1,2,5,15,3,6376,5189,1187
1,2,6,15,3,6353,4379,1974
1,2,7,15,3,5925,4458,1467
1,2,8,15,3,5189,4412,777
1,2,9,15,3,4379,4412,-33
1,2,10,15,3,4458,4654,-196
1,2,11,15,3,4412,5504,-1092
1,2,12,15,3,4412,6146,-1734
1,2,13,15,3,4654,6506,-1852
1,2,14,15,3,5504,6360,-856
1,2,15,15,3,6146,6252,-106
1,2,16,15,3,6506,6141,365
1,2,17,15,3,6360,6009,351
1,2,18,15,3,6252,5917,335
1,3,0,15,3,5127,6103,-976
1,3,1,15,3,4803,6432,-1629
1,3,2,15,3,5237,6576,-1339
1,3,3,15,3,6103,6551,-448
1,3,4,15,3,6432,6077,355
1,3,5,15,3,6576,5229,1347
1,3,6,15,3,6551,4298,2253
1,3,7,15,3,6077,4396,1681
1,3,8,15,3,5229,4324,905
1,3,9,15,3,4298,4315,-17
1,3,10,15,3,4396,4609,-213
1,3,11,15,3,4324,5609,-1285
1,3,12,15,3,4315,6352,-2037
1,3,13,15,3,4609,6649,-2040
1,3,14,15,3,5609,6431,-822
1,3,15,15,3,6352,6342,10
1,3,16,15,3,6649,6321,328
1,3,17,15,3,6431,6114,317
1,3,18,15,3,6342,6000,342
1,4,0,15,3,5078,6372,-1294
1,4,1,15,3,4823,6579,-1756
1,4,2,15,3,5408,6610,-1202
1,4,3,15,3,6372,6561,-189
1,4,4,15,3,6579,6134,445
1,4,5,15,3,6610,5282,1328
1,4,6,15,3,6561,4332,2229
1,4,7,15,3,6134,4471,1663
1,4,8,15,3,5282,4402,880
1,4,9,15,3,4332,4410,-78
1,4,10,15,3,4471,4674,-203
1,4,11,15,3,4402,5639,-1237
1,4,12,15,3,4410,6403,-1993
1,4,13,15,3,4674,6641,-1967
1,4,14,15,3,5639,6450,-811
1,4,15,15,3,6403,6395,8
1,4,16,15,3,6641,6478,163
1,4,17,15,3,6450,6237,213
1,4,18,15,3,6395,6040,355
1,5,0,15,3,5115,6455,-1340
1,5,1,15,3,4903,6521,-1618
1,5,2,15,3,5521,6571,-1050
1,5,3,15,3,6455,6695,-240
1,5,4,15,3,6521,6362,159
1,5,5,15,3,6571,5597,974
1,5,6,15,3,6695,4600,2095
1,5,7,15,3,6362,4781,1581
1,5,8,15,3,5597,4714,883
1,5,9,15,3,4600,4699,-99
1,5,10,15,3,4781,4866,-85
1,5,11,15,3,4714,5848,-1134
1,5,12,15,3,4699,6682,-1983
1,5,13,15,3,4866,6866,-2000
1,5,14,15,3,5848,6486,-638
1,5,15,15,3,6682,6360,322
1,5,16,15,3,6866,6449,417
1,5,17,15,3,6486,6229,257
1,5,18,15,3,6360,6061,299
1,6,0,15,3,5093,6472,-1379
1,6,1,15,3,4916,6431,-1515
1,6,2,15,3,5552,6649,-1097
1,6,3,15,3,6472,7014,-542
1,6,4,15,3,6431,6741,-310
1,6,5,15,3,6649,5922,727
1,6,6,15,3,7014,4805,2209
1,6,7,15,3,6741,5009,1732
1,6,8,15,3,5922,4937,985
1,6,9,15,3,4805,4886,-81
1,6,10,15,3,5009,4975,34
1,6,11,15,3,4937,5959,-1022
1,6,12,15,3,4886,6836,-1950
1,6,13,15,3,4975,6978,-2003
1,6,14,15,3,5959,6485,-526
1,6,15,15,3,6836,6344,492
1,6,16,15,3,6978,6392,586
1,6,17,15,3,6485,6139,346
1,6,18,15,3,6344,6027,317
1,7,0,15,3,5104,6543,-1439
1,7,1,15,3,4990,6347,-1357
1,7,2,15,3,5653,6616,-963
1,7,3,15,3,6543,7107,-564
1,7,4,15,3,6347,6815,-468
1,7,5,15,3,6616,5927,689
1,7,6,15,3,7107,4709,2398
1,7,7,15,3,6815,4960,1855
1,7,8,15,3,5927,4898,1029
1,7,9,15,3,4709,4828,-119
1,7,10,15,3,4960,4885,75
1,7,11,15,3,4898,5868,-970
1,7,12,15,3,4828,6793,-1965
1,7,13,15,3,4885,6932,-2047
1,7,14,15,3,5868,6470,-602
1,7,15,15,3,6793,6329,464
1,7,16,15,3,6932,6375,557
1,7,17,15,3,6470,6105,365
1,7,18,15,3,6329,6047,282
1,8,0,15,3,5006,6594,-1588
1,8,1,15,3,4996,6290,-1294
1,8,2,15,3,5710,6549,-839
1,8,3,15,3,6594,7116,-522
1,8,4,15,3,6290,6814,-524
1,8,5,15,3,6549,5909,640
1,8,6,15,3,7116,4597,2519
1,8,7,15,3,6814,4912,1902
1,8,8,15,3,5909,4862,1047
1,8,9,15,3,4597,4766,-169
1,8,10,15,3,4912,4808,104
1,8,11,15,3,4862,5819,-957
1,8,12,15,3,4766,6794,-2028
1,8,13,15,3,4808,6872,-2064
1,8,14,15,3,5819,6378,-559
1,8,15,15,3,6794,6227,567
1,8,16,15,3,6872,6302,570
1,8,17,15,3,6378,5995,383
1,8,18,15,3,6227,5892,335
1,9,0,15,3,4852,6562,-1710
1,9,1,15,3,4848,6180,-1332
1,9,2,15,3,5640,6392,-752
1,9,3,15,3,6562,6987,-425
1,9,4,15,3,6180,6735,-555
1,9,5,15,3,6392,5796,596
1,9,6,15,3,6987,4408,2579
1,9,7,15,3,6735,4746,1989
1,9,8,15,3,5796,4715,1081
1,9,9,15,3,4408,4650,-242
1,9,10,15,3,4746,4662,84
1,9,11,15,3,4715,5702,-987
1,9,12,15,3,4650,6659,-2009
1,9,13,15,3,4662,6694,-2032
1,9,14,15,3,5702,6204,-502
1,9,15,15,3,6659,6072,587
1,9,16,15,3,6694,6139,555
1,9,17,15,3,6204,5811,393
1,9,18,15,3,6072,5669,403
1,0,0,16,3,5554,5943,-389
1,0,1,16,3,5170,6298,-1128
1,0,2,16,3,5367,6387,-1020
1,0,3,16,3,5943,6367,-424
1,0,4,16,3,6298,5965,333
1,0,5,16,3,6387,5353,1034
1,0,6,16,3,6367,4681,1686
1,0,7,16,3,5965,4736,1229
1,0,8,16,3,5353,4696,657
1,0,9,16,3,4681,4696,-15
1,0,10,16,3,4736,4898,-162
1,0,11,16,3,4696,5612,-916
1,0,12,16,3,4696,6182,-1486
1,0,13,16,3,4898,6529,-1631
1,0,14,16,3,5612,6417,-805
1,0,15,16,3,6182,6313,-131
1,0,16,16,3,6529,6223,306
1,0,17,16,3,6417,6204,213
1,0,18,16,3,6313,6133,180
1,1,0,16,3,5538,6210,-672
1,1,1,16,3,5177,6570,-1393
1,1,2,16,3,5475,6693,-1218
1,1,3,16,3,6210,6670,-460
1,1,4,16,3,6570,6246,324
1,1,5,16,3,6693,5507,1186
1,1,6,16,3,6670,4692,1978
1,1,7,16,3,6246,4768,1478
1,1,8,16,3,5507,4722,785
1,1,9,16,3,4692,4724,-32
1,1,10,16,3,4768,4970,-202
1,1,11,16,3,4722,5831,-1109
1,1,12,16,3,4724,6475,-1751
1,1,13,16,3,4970,6832,-1862
1,1,14,16,3,5831,6673,-842
1,1,15,16,3,6475,6559,-84
1,1,16,16,3,6832,6455,377
1,1,17,16,3,6673,6335,338
1,1,18,16,3,6559,6244,315
1,2,0,16,3,5460,6428,-968
1,2,1,16,3,5137,6758,-1621
1,2,2,16,3,5566,6910,-1344
1,2,3,16,3,6428,6892,-464
1,2,4,16,3,6758,6423,335
1,2,5,16,3,6910,5566,1344
1,2,6,16,3,6892,4627,2265
1,2,7,16,3,6423,4718,1705
1,2,8,16,3,5566,4645,921
1,2,9,16,3,4627,4639,-12
1,2,10,16,3,4718,4938,-220
1,2,11,16,3,4645,5947,-1302
1,2,12,16,3,4639,6689,-2050
1,2,13,16,3,4938,6984,-2046
1,2,14,16,3,5947,6756,-809
1,2,15,16,3,6689,6661,28
1,2,16,16,3,6984,6641,343
1,2,17,16,3,6756,6442,314
1,2,18,16,3,6661,6331,330
1,3,0,16,3,5417,6704,-1287
1,3,1,16,3,5155,6918,-1763
1,3,2,16,3,5735,6952,-1217
1,3,3,16,3,6704,6860,-156
1,3,4,16,3,6918,6390,528
1,3,5,16,3,6952,5489,1463
1,3,6,16,3,6860,4530,2330
1,3,7,16,3,6390,4662,1728
1,3,8,16,3,5489,4590,899
1,3,9,16,3,4530,4600,-70
1,3,10,16,3,4662,4869,-207
1,3,11,16,3,4590,5861,-1271
1,3,12,16,3,4600,6659,-2059
1,3,13,16,3,4869,6947,-2078
1,3,14,16,3,5861,6787,-926
1,3,15,16,3,6659,6740,-81
1,3,16,16,3,6947,6810,137
1,3,17,16,3,6787,6559,228
1,3,18,16,3,6740,6366,374
1,4,0,16,3,5462,6816,-1354
1,4,1,16,3,5251,6861,-1610
1,4,2,16,3,5876,6861,-985
1,4,3,16,3,6816,6919,-103
1,4,4,16,3,6861,6543,318
1,4,5,16,3,6861,5750,1111
1,4,6,16,3,6919,4744,2175
1,4,7,16,3,6543,4918,1625
1,4,8,16,3,5750,4848,902
1,4,9,16,3,4744,4835,-91
1,4,10,16,3,4918,5006,-88
1,4,11,16,3,4848,6002,-1154
1,4,12,16,3,4835,6864,-2029
1,4,13,16,3,5006,7106,-2100
1,4,14,16,3,6002,6790,-788
1,4,15,16,3,6864,6704,160
1,4,16,16,3,7106,6797,309
1,4,17,16,3,6790,6567,223
1,4,18,16,3,6704,6394,310
1,5,0,16,3,5449,6825,-1376
1,5,1,16,3,5277,6734,-1457
1,5,2,16,3,5916,6866,-950
1,5,3,16,3,6825,7191,-366
1,5,4,16,3,6734,6917,-183
1,5,5,16,3,6866,6126,740
1,5,6,16,3,7191,5005,2186
1,5,7,16,3,6917,5206,1711
1,5,8,16,3,6126,5132,994
1,5,9,16,3,5005,5081,-76
1,5,10,16,3,5206,5171,35
1,5,11,16,3,5132,6145,-1013
1,5,12,16,3,5081,7015,-1934
1,5,13,16,3,5171,7172,-2001
1,5,14,16,3,6145,6731,-586
1,5,15,16,3,7015,6648,367
1,5,16,16,3,7172,6734,438
1,5,17,16,3,6731,6492,239
1,5,18,16,3,6648,6372,276
1,6,0,16,3,5457,6801,-1344
1,6,1,16,3,5312,6583,-1271
1,6,2,16,3,5938,6823,-885
1,6,3,16,3,6801,7301,-500
1,6,4,16,3,6583,7011,-428
1,6,5,16,3,6823,6134,689
1,6,6,16,3,7301,4916,2385
1,6,7,16,3,7011,5167,1844
1,6,8,16,3,6134,5105,1029
1,6,9,16,3,4916,5034,-118
1,6,10,16,3,5167,5090,77
1,6,11,16,3,5105,6081,-976
1,6,12,16,3,5034,7004,-1970
1,6,13,16,3,5090,7146,-2056
1,6,14,16,3,6081,6694,-613
1,6,15,16,3,7004,6584,420
1,6,16,16,3,7146,6666,480
1,6,17,16,3,6694,6425,269
1,6,18,16,3,6584,6385,199
1,7,0,16,3,5351,6740,-1389
1,7,1,16,3,5260,6469,-1209
1,7,2,16,3,5889,6793,-904
1,7,3,16,3,6740,7398,-658
1,7,4,16,3,6469,7110,-641
1,7,5,16,3,6793,6197,596
1,7,6,16,3,7398,4889,2509
1,7,7,16,3,7110,5207,1903
1,7,8,16,3,6197,5158,1039
1,7,9,16,3,4889,5060,-171
1,7,10,16,3,5207,5099,108
1,7,11,16,3,5158,6111,-953
1,7,12,16,3,5060,7073,-2013
1,7,13,16,3,5099,7134,-2035
1,7,14,16,3,6111,6618,-507
1,7,15,16,3,7073,6455,618
1,7,16,16,3,7134,6535,599
1,7,17,16,3,6618,6261,357
1,7,18,16,3,6455,6211,244
1,8,0,16,3,5240,6797,-1557
1,8,1,16,3,5188,6472,-1284
1,8,2,16,3,5902,6742,-840
1,8,3,16,3,6797,7370,-573
1,8,4,16,3,6472,7118,-646
1,8,5,16,3,6742,6188,554
1,8,6,16,3,7370,4810,2560
1,8,7,16,3,7118,5159,1959
1,8,8,16,3,6188,5144,1044
1,8,9,16,3,4810,5080,-270
1,8,10,16,3,5159,5084,75
1,8,11,16,3,5144,6112,-968
1,8,12,16,3,5080,7062,-1982
1,8,13,16,3,5084,7088,-2004
1,8,14,16,3,6112,6557,-445
1,8,15,16,3,7062,6393,669
1,8,16,16,3,7088,6459,629
1,8,17,16,3,6557,6156,401
1,8,18,16,3,6393,6046,347
1,0,0,17,3,5851,6530,-679
1,0,1,17,3,5478,6896,-1418
1,0,2,17,3,5780,7014,-1234
1,0,3,17,3,6530,6984,-454
1,0,4,17,3,6896,6559,337
1,0,5,17,3,7014,5816,1198
1,0,6,17,3,6984,4999,1985
1,0,7,17,3,6559,5074,1485
1,0,8,17,3,5816,5029,787
1,0,9,17,3,4999,5033,-34
1,0,10,17,3,5074,5282,-208
1,0,11,17,3,5029,6138,-1109
1,0,12,17,3,5033,6780,-1747
1,0,13,17,3,5282,7142,-1860
1,0,14,17,3,6138,6993,-855
1,0,15,17,3,6780,6875,-95
1,0,16,17,3,7142,6764,378
1,0,17,17,3,6993,6645,348
1,0,18,17,3,6875,6558,317
1,1,0,17,3,5784,6754,-970
1,1,1,17,3,5461,7080,-1619
1,1,2,17,3,5891,7227,-1336
1,1,3,17,3,6754,7209,-455
1,1,4,17,3,7080,6744,336
1,1,5,17,3,7227,5884,1343
1,1,6,17,3,7209,4940,2269
1,1,7,17,3,6744,5028,1716
1,1,8,17,3,5884,4955,929
1,1,9,17,3,4940,4951,-11
1,1,10,17,3,5028,5254,-226
1,1,11,17,3,4955,6274,-1319
1,1,12,17,3,4951,7018,-2067
1,1,13,17,3,5254,7310,-2056
1,1,14,17,3,6274,7069,-795
1,1,15,17,3,7018,6968,50
1,1,16,17,3,7310,6955,355
1,1,17,17,3,7069,6768,301
1,1,18,17,3,6968,6658,310
1,2,0,17,3,5750,7029,-1279
1,2,1,17,3,5489,7244,-1755
1,2,2,17,3,6064,7286,-1222
1,2,3,17,3,7029,7201,-172
1,2,4,17,3,7244,6736,508
1,2,5,17,3,7286,5826,1460
1,2,6,17,3,7201,4859,2342
1,2,7,17,3,6736,4984,1752
1,2,8,17,3,5826,4911,915
1,2,9,17,3,4859,4924,-65
1,2,10,17,3,4984,5198,-214
1,2,11,17,3,4911,6199,-1288
1,2,12,17,3,4924,6996,-2072
1,2,13,17,3,5198,7282,-2084
1,2,14,17,3,6199,7112,-913
1,2,15,17,3,6996,7059,-63
1,2,16,17,3,7282,7130,152
1,2,17,17,3,7112,6887,225
1,2,18,17,3,7059,6697,362
1,3,0,17,3,5801,7148,-1347
1,3,1,17,3,5583,7200,-1617
1,3,2,17,3,6203,7203,-1000
1,3,3,17,3,7148,7218,-70
1,3,4,17,3,7200,6799,401
1,3,5,17,3,7203,5957,1246
1,3,6,17,3,7218,4942,2276
1,3,7,17,3,6799,5109,1690
1,3,8,17,3,5957,5036,921
1,3,9,17,3,4942,5025,-83
1,3,10,17,3,5109,5201,-92
1,3,11,17,3,5036,6224,-1188
1,3,12,17,3,5025,7120,-2095
1,3,13,17,3,5201,7412,-2211
1,3,14,17,3,6224,7127,-903
1,3,15,17,3,7120,7049,71
1,3,16,17,3,7412,7129,283
1,3,17,17,3,7127,6889,238
1,3,18,17,3,7049,6720,329
1,4,0,17,3,5796,7186,-1390
1,4,1,17,3,5625,7074,-1449
1,4,2,17,3,6271,7156,-885
1,4,3,17,3,7186,7415,-229
1,4,4,17,3,7074,7098,-24
1,4,5,17,3,7156,6279,877
1,4,6,17,3,7415,5149,2266
1,4,7,17,3,7098,5343,1755
1,4,8,17,3,6279,5266,1013
1,4,9,17,3,5149,5217,-68
1,4,10,17,3,5343,5311,32
1,4,11,17,3,5266,6299,-1033
1,4,12,17,3,5217,7197,-1980
1,4,13,17,3,5311,7412,-2101
1,4,14,17,3,6299,7035,-736
1,4,15,17,3,7197,6992,205
1,4,16,17,3,7412,7082,330
1,4,17,17,3,7035,6830,205
1,4,18,17,3,6992,6705,287
1,5,0,17,3,5813,7154,-1341
1,5,1,17,3,5673,6886,-1213
1,5,2,17,3,6302,7040,-738
1,5,3,17,3,7154,7478,-324
1,5,4,17,3,6886,7187,-301
1,5,5,17,3,7040,6338,702
1,5,6,17,3,7478,5116,2362
1,5,7,17,3,7187,5364,1823
1,5,8,17,3,6338,5300,1038
1,5,9,17,3,5116,5229,-113
1,5,10,17,3,5364,5286,78
1,5,11,17,3,5300,6267,-967
1,5,12,17,3,5229,7183,-1954
1,5,13,17,3,5286,7340,-2054
1,5,14,17,3,6267,6940,-673
1,5,15,17,3,7183,6888,295
1,5,16,17,3,7340,7008,332
1,5,17,17,3,6940,6778,162
1,5,18,17,3,6888,6730,158
1,6,0,17,3,5704,6998,-1294
1,6,1,17,3,5582,6705,-1123
1,6,2,17,3,6174,7000,-826
1,6,3,17,3,6998,7592,-594
1,6,4,17,3,6705,7306,-601
1,6,5,17,3,7000,6404,596
1,6,6,17,3,7592,5096,2496
1,6,7,17,3,7306,5414,1892
1,6,8,17,3,6404,5365,1039
1,6,9,17,3,5096,5266,-170
1,6,10,17,3,5414,5304,110
1,6,11,17,3,5365,6324,-959
1,6,12,17,3,5266,7284,-2018
1,6,13,17,3,5304,7348,-2044
1,6,14,17,3,6324,6842,-518
1,6,15,17,3,7284,6710,574
1,6,16,17,3,7348,6826,522
1,6,17,17,3,6842,6581,261
1,6,18,17,3,6710,6549,161
1,7,0,17,3,5585,6943,-1358
1,7,1,17,3,5452,6651,-1199
1,7,2,17,3,6081,6986,-905
1,7,3,17,3,6943,7652,-709
1,7,4,17,3,6651,7414,-763
1,7,5,17,3,6986,6476,510
1,7,6,17,3,7652,5102,2550
1,7,7,17,3,7414,5454,1960
1,7,8,17,3,6476,5440,1036
1,7,9,17,3,5102,5374,-272
1,7,10,17,3,5454,5375,79
1,7,11,17,3,5440,6404,-964
1,7,12,17,3,5374,7341,-1967
1,7,13,17,3,5375,7350,-1975
1,7,14,17,3,6404,6797,-393
1,7,15,17,3,7341,6621,720
1,7,16,17,3,7350,6692,658
1,7,17,17,3,6797,6422,375
1,7,18,17,3,6621,6365,256
1,0,0,18,3,6097,7074,-977
1,0,1,18,3,5762,7406,-1644
1,0,2,18,3,6196,7548,-1352
1,0,3,18,3,7074,7523,-449
1,0,4,18,3,7406,7057,349
1,0,5,18,3,7548,6193,1355
1,0,6,18,3,7523,5247,2276
1,0,7,18,3,7057,5334,1723
1,0,8,18,3,6193,5262,931
1,0,9,18,3,5247,5260,-13
1,0,10,18,3,5334,5566,-232
1,0,11,18,3,5262,6581,-1319
1,0,12,18,3,5260,7323,-2063
1,0,13,18,3,5566,7620,-2054
1,0,14,18,3,6581,7389,-808
1,0,15,18,3,7323,7284,39
1,0,16,18,3,7620,7264,356
1,0,17,18,3,7389,7078,311
1,0,18,18,3,7284,6972,312
1,1,0,18,3,6074,7355,-1281
1,1,1,18,3,5813,7566,-1753
1,1,2,18,3,6389,7603,-1214
1,1,3,18,3,7355,7518,-163
1,1,4,18,3,7566,7057,509
1,1,5,18,3,7603,6144,1459
1,1,6,18,3,7518,5172,2346
1,1,7,18,3,7057,5294,1763
1,1,8,18,3,6144,5221,923
1,1,9,18,3,5172,5236,-64
1,1,10,18,3,5294,5514,-220
1,1,11,18,3,5221,6526,-1305
1,1,12,18,3,5236,7325,-2089
1,1,13,18,3,5514,7608,-2094
1,1,14,18,3,6526,7425,-899
1,1,15,18,3,7325,7366,-41
1,1,16,18,3,7608,7444,164
1,1,17,18,3,7425,7213,212
1,1,18,18,3,7366,7024,342
1,2,0,18,3,6134,7473,-1339
1,2,1,18,3,5917,7526,-1609
1,2,2,18,3,6532,7537,-1005
1,2,3,18,3,7473,7559,-86
1,2,4,18,3,7526,7145,381
1,2,5,18,3,7537,6294,1243
1,2,6,18,3,7559,5271,2288
1,2,7,18,3,7145,5431,1714
1,2,8,18,3,6294,5357,937
1,2,9,18,3,5271,5349,-78
1,2,10,18,3,5431,5530,-99
1,2,11,18,3,5357,6562,-1205
1,2,12,18,3,5349,7457,-2108
1,2,13,18,3,5530,7747,-2217
1,2,14,18,3,6562,7452,-890
1,2,15,18,3,7457,7368,89
1,2,16,18,3,7747,7449,298
1,2,17,18,3,7452,7217,235
1,2,18,18,3,7368,7051,317
1,3,0,18,3,6135,7518,-1383
1,3,1,18,3,5957,7413,-1456
1,3,2,18,3,6598,7498,-900
1,3,3,18,3,7518,7714,-196
1,3,4,18,3,7413,7354,59
1,3,5,18,3,7498,6486,1012
1,3,6,18,3,7714,5347,2367
1,3,7,18,3,7354,5534,1820
1,3,8,18,3,6486,5454,1032
1,3,9,18,3,5347,5407,-60
1,3,10,18,3,5534,5506,28
1,3,11,18,3,5454,6521,-1067
1,3,12,18,3,5407,7453,-2046
1,3,13,18,3,5506,7718,-2212
1,3,14,18,3,6521,7372,-851
1,3,15,18,3,7453,7337,116
1,3,16,18,3,7718,7414,304
1,3,17,18,3,7372,7152,220
1,3,18,18,3,7337,7031,306
1,4,0,18,3,6160,7515,-1355
1,4,1,18,3,6021,7226,-1205
1,4,2,18,3,6657,7330,-673
1,4,3,18,3,7515,7702,-187
1,4,4,18,3,7226,7368,-142
1,4,5,18,3,7330,6491,839
1,4,6,18,3,7702,5260,2442
1,4,7,18,3,7368,5501,1867
1,4,8,18,3,6491,5434,1057
1,4,9,18,3,5260,5365,-105
1,4,10,18,3,5501,5426,75
1,4,11,18,3,5434,6421,-987
1,4,12,18,3,5365,7365,-2000
1,4,13,18,3,5426,7580,-2154
1,4,14,18,3,6421,7244,-823
1,4,15,18,3,7365,7232,133
1,4,16,18,3,7580,7356,224
1,4,17,18,3,7244,7116,128
1,4,18,18,3,7232,7063,169
1,5,0,18,3,6060,7351,-1291
1,5,1,18,3,5943,7008,-1065
1,5,2,18,3,6538,7217,-679
1,5,3,18,3,7351,7769,-418
1,5,4,18,3,7008,7482,-474
1,5,5,18,3,7217,6608,609
1,5,6,18,3,7769,5296,2473
1,5,7,18,3,7482,5611,1871
1,5,8,18,3,6608,5560,1048
1,5,9,18,3,5296,5461,-165
1,5,10,18,3,5611,5500,111
1,5,11,18,3,5560,6510,-950
1,5,12,18,3,5461,7463,-2002
1,5,13,18,3,5500,7542,-2042
1,5,14,18,3,6510,7088,-578
1,5,15,18,3,7463,7014,449
1,5,16,18,3,7542,7168,374
1,5,17,18,3,7088,6934,154
1,5,18,18,3,7014,6894,120
1,6,0,18,3,5938,7201,-1263
1,6,1,18,3,5774,6887,-1113
1,6,2,18,3,6366,7193,-827
1,6,3,18,3,7201,7846,-645
1,6,4,18,3,6887,7610,-723
1,6,5,18,3,7193,6683,510
1,6,6,18,3,7846,5309,2537
1,6,7,18,3,7610,5661,1949
1,6,8,18,3,6683,5647,1036
1,6,9,18,3,5309,5580,-271
1,6,10,18,3,5661,5580,81
1,6,11,18,3,5647,6617,-970
1,6,12,18,3,5580,7552,-1972
1,6,13,18,3,5580,7564,-1984
1,6,14,18,3,6617,7021,-404
1,6,15,18,3,7552,6876,676
1,6,16,18,3,7564,6983,581
1,6,17,18,3,7021,6742,279
1,6,18,18,3,6876,6703,173
1,0,0,19,3,6387,7675,-1288
1,0,1,19,3,6114,7892,-1778
1,0,2,19,3,6694,7924,-1230
1,0,3,19,3,7675,7832,-157
1,0,4,19,3,7892,7370,522
1,0,5,19,3,7924,6453,1471
1,0,6,19,3,7832,5479,2353
1,0,7,19,3,7370,5600,1770
1,0,8,19,3,6453,5528,925
1,0,9,19,3,5479,5545,-66
1,0,10,19,3,5600,5826,-226
1,0,11,19,3,5528,6833,-1305
1,0,12,19,3,5545,7630,-2085
1,0,13,19,3,5826,7918,-2092
1,0,14,19,3,6833,7745,-912
1,0,15,19,3,7630,7682,-52
1,0,16,19,3,7918,7753,165
1,0,17,19,3,7745,7523,222
1,0,18,19,3,7682,7338,344
1,1,0,19,3,6458,7799,-1341
1,1,1,19,3,6241,7848,-1607
1,1,2,19,3,6857,7854,-997
1,1,3,19,3,7799,7876,-77
1,1,4,19,3,7848,7466,382
1,1,5,19,3,7854,6612,1242
1,1,6,19,3,7876,5584,2292
1,1,7,19,3,7466,5741,1725
1,1,8,19,3,6612,5667,945
1,1,9,19,3,5584,5661,-77
1,1,10,19,3,5741,5846,-105
1,1,11,19,3,5667,6889,-1222
1,1,12,19,3,5661,7786,-2125
1,1,13,19,3,5846,8073,-2227
1,1,14,19,3,6889,7765,-876
1,1,15,19,3,7786,7675,111
1,1,16,19,3,8073,7763,310
1,1,17,19,3,7765,7543,222
1,1,18,19,3,7675,7378,297
1,2,0,19,3,6468,7843,-1375
1,2,1,19,3,6291,7739,-1448
1,2,2,19,3,6927,7832,-905
1,2,3,19,3,7843,8055,-212
1,2,4,19,3,7739,7700,39
1,2,5,19,3,7832,6823,1009
1,2,6,19,3,8055,5676,2379
1,2,7,19,3,7700,5856,1844
1,2,8,19,3,6823,5775,1048
1,2,9,19,3,5676,5731,-55
1,2,10,19,3,5856,5835,21
1,2,11,19,3,5775,6859,-1084
1,2,12,19,3,5731,7790,-2059
1,2,13,19,3,5835,8053,-2218
1,2,14,19,3,6859,7697,-838
1,2,15,19,3,7790,7656,134
1,2,16,19,3,8053,7734,319
1,2,17,19,3,7697,7480,217
1,2,18,19,3,7656,7362,294
1,3,0,19,3,6499,7847,-1348
1,3,1,19,3,6353,7565,-1212
1,3,2,19,3,6984,7672,-688
1,3,3,19,3,7847,8001,-154
1,3,4,19,3,7565,7624,-59
1,3,5,19,3,7672,6698,974
1,3,6,19,3,8001,5458,2543
1,3,7,19,3,7624,5692,1932
1,3,8,19,3,6698,5622,1076
1,3,9,19,3,5458,5555,-97
1,3,10,19,3,5692,5621,71
1,3,11,19,3,5622,6643,-1021
1,3,12,19,3,5555,7621,-2066
1,3,13,19,3,5621,7886,-2265
1,3,14,19,3,6643,7581,-938
1,3,15,19,3,7621,7577,44
1,3,16,19,3,7886,7688,198
1,3,17,19,3,7581,7438,143
1,3,18,19,3,7577,7389,188
1,4,0,19,3,6407,7712,-1305
1,4,1,19,3,6291,7348,-1057
1,4,2,19,3,6893,7507,-614
1,4,3,19,3,7712,7993,-281
1,4,4,19,3,7348,7663,-315
1,4,5,19,3,7507,6761,746
1,4,6,19,3,7993,5440,2553
1,4,7,19,3,7663,5748,1915
1,4,8,19,3,6761,5694,1067
1,4,9,19,3,5440,5597,-157
1,4,10,19,3,5748,5640,108
1,4,11,19,3,5694,6664,-970
1,4,12,19,3,5597,7645,-2048
1,4,13,19,3,5640,7782,-2142
1,4,14,19,3,6664,7392,-728
1,4,15,19,3,7645,7358,287
1,4,16,19,3,7782,7516,266
1,4,17,19,3,7392,7272,120
1,4,18,19,3,7358,7227,131
1,5,0,19,3,6294,7554,-1260
1,5,1,19,3,6135,7190,-1055
1,5,2,19,3,6730,7410,-680
1,5,3,19,3,7554,8023,-469
1,5,4,19,3,7190,7786,-596
1,5,5,19,3,7410,6887,523
1,5,6,19,3,8023,5509,2514
1,5,7,19,3,7786,5858,1928
1,5,8,19,3,6887,5842,1045
1,5,9,19,3,5509,5775,-266
1,5,10,19,3,5858,5776,82
1,5,11,19,3,5842,6803,-961
1,5,12,19,3,5775,7731,-1956
1,5,13,19,3,5776,7758,-1982
1,5,14,19,3,6803,7267,-464
1,5,15,19,3,7731,7180,551
1,5,16,19,3,7758,7325,433
1,5,17,19,3,7267,7095,172
1,5,18,19,3,7180,7048,132
1,0,0,20,3,6771,8119,-1348
1,0,1,20,3,6542,8174,-1632
1,0,2,20,3,7162,8175,-1013
1,0,3,20,3,8119,8190,-71
1,0,4,20,3,8174,7779,395
1,0,5,20,3,8175,6921,1254
1,0,6,20,3,8190,5891,2299
1,0,7,20,3,7779,6047,1732
1,0,8,20,3,6921,5974,947
1,0,9,20,3,5891,5970,-79
1,0,10,20,3,6047,6158,-111
1,0,11,20,3,5974,7196,-1222
1,0,12,20,3,5970,8091,-2121
1,0,13,20,3,6158,8383,-2225
1,0,14,20,3,7196,8085,-889
1,0,15,20,3,8091,7991,100
1,0,16,20,3,8383,8072,311
1,0,17,20,3,8085,7853,232
1,0,18,20,3,7991,7692,299
1,1,0,20,3,6792,8169,-1377
1,1,1,20,3,6615,8061,-1446
1,1,2,20,3,7252,8149,-897
1,1,3,20,3,8169,8372,-203
1,1,4,20,3,8061,8021,40
1,1,5,20,3,8149,7141,1008
1,1,6,20,3,8372,5989,2383
1,1,7,20,3,8021,6166,1855
1,1,8,20,3,7141,6085,1056
1,1,9,20,3,5989,6043,-54
1,1,10,20,3,6166,6151,15
1,1,11,20,3,6085,7186,-1101
1,1,12,20,3,6043,8119,-2076
1,1,13,20,3,6151,8379,-2228
1,1,14,20,3,7186,8010,-824
1,1,15,20,3,8119,7963,156
1,1,16,20,3,8379,8048,331
1,1,17,20,3,8010,7806,204
1,1,18,20,3,7963,7689,274
1,2,0,20,3,6832,8172,-1340
1,2,1,20,3,6687,7891,-1204
1,2,2,20,3,7313,8006,-693
1,2,3,20,3,8172,8342,-170
1,2,4,20,3,7891,7970,-79
1,2,5,20,3,8006,7035,971
1,2,6,20,3,8342,5787,2555
1,2,7,20,3,7970,6014,1956
1,2,8,20,3,7035,5943,1092
1,2,9,20,3,5787,5879,-92
1,2,10,20,3,6014,5950,64
1,2,11,20,3,5943,6981,-1038
1,2,12,20,3,5879,7958,-2079
1,2,13,20,3,5950,8221,-2271
1,2,14,20,3,6981,7906,-925
1,2,15,20,3,7958,7896,62
1,2,16,20,3,8221,8008,213
1,2,17,20,3,7906,7766,140
1,2,18,20,3,7896,7720,176
1,3,0,20,3,6746,8044,-1298
1,3,1,20,3,6623,7687,-1064
1,3,2,20,3,7220,7849,-629
1,3,3,20,3,8044,8292,-248
1,3,4,20,3,7687,7919,-232
1,3,5,20,3,7849,6968,881
1,3,6,20,3,8292,5638,2654
1,3,7,20,3,7919,5939,1980
1,3,8,20,3,6968,5882,1086
1,3,9,20,3,5638,5787,-149
1,3,10,20,3,5939,5835,104
1,3,11,20,3,5882,6886,-1004
1,3,12,20,3,5787,7901,-2114
1,3,13,20,3,5835,8088,-2253
1,3,14,20,3,6886,7729,-843
1,3,15,20,3,7901,7703,198
1,3,16,20,3,8088,7848,240
1,3,17,20,3,7729,7594,135
1,3,18,20,3,7703,7553,150
1,4,0,20,3,6641,7915,-1274
1,4,1,20,3,6483,7530,-1047
1,4,2,20,3,7085,7700,-615
1,4,3,20,3,7915,8247,-332
1,4,4,20,3,7530,7967,-437
1,4,5,20,3,7700,7040,660
1,4,6,20,3,8247,5653,2594
1,4,7,20,3,7967,5995,1972
1,4,8,20,3,7040,5976,1064
1,4,9,20,3,5653,5911,-258
1,4,10,20,3,5995,5916,79
1,4,11,20,3,5976,6957,-981
1,4,12,20,3,5911,7913,-2002
1,4,13,20,3,5916,7998,-2082
1,4,14,20,3,6957,7571,-614
1,4,15,20,3,7913,7524,389
1,4,16,20,3,7998,7673,325
1,4,17,20,3,7571,7433,138
1,4,18,20,3,7524,7381,143
1,0,0,21,3,7105,8489,-1384
1,0,1,21,3,6916,8387,-1471
1,0,2,21,3,7557,8470,-913
1,0,3,21,3,8489,8686,-197
1,0,4,21,3,8387,8334,53
1,0,5,21,3,8470,7450,1020
1,0,6,21,3,8686,6296,2390
1,0,7,21,3,8334,6472,1862
1,0,8,21,3,7450,6392,1058
1,0,9,21,3,6296,6352,-56
1,0,10,21,3,6472,6463,9
1,0,11,21,3,6392,7493,-1101
1,0,12,21,3,6352,8424,-2072
1,0,13,21,3,6463,8689,-2226
1,0,14,21,3,7493,8330,-837
1,0,15,21,3,8424,8279,145
1,0,16,21,3,8689,8357,332
1,0,17,21,3,8330,8116,214
1,0,18,21,3,8279,8003,276
1,1,0,21,3,7156,8498,-1342
1,1,1,21,3,7011,8213,-1202
1,1,2,21,3,7638,8323,-685
1,1,3,21,3,8498,8659,-161
1,1,4,21,3,8213,8291,-78
1,1,5,21,3,8323,7353,970
1,1,6,21,3,8659,6100,2559
1,1,7,21,3,8291,6324,1967
1,1,8,21,3,7353,6253,1100
1,1,9,21,3,6100,6191,-91
1,1,10,21,3,6324,6266,58
1,1,11,21,3,6253,7308,-1055
1,1,12,21,3,6191,8287,-2096
1,1,13,21,3,6266,8547,-2281
1,1,14,21,3,7308,8219,-911
1,1,15,21,3,8287,8203,84
1,1,16,21,3,8547,8322,225
1,1,17,21,3,8219,8092,127
1,1,18,21,3,8203,8047,156
1,2,0,21,3,7079,8369,-1290
1,2,1,21,3,6957,8013,-1056
1,2,2,21,3,7549,8183,-634
1,2,3,21,3,8369,8633,-264
1,2,4,21,3,8013,8265,-252
1,2,5,21,3,8183,7305,878
1,2,6,21,3,8633,5967,2666
1,2,7,21,3,8265,6261,2004
1,2,8,21,3,7305,6203,1102
1,2,9,21,3,5967,6111,-144
1,2,10,21,3,6261,6164,97
1,2,11,21,3,6203,7224,-1021
1,2,12,21,3,6111,8238,-2127
1,2,13,21,3,6164,8423,-2259
1,2,14,21,3,7224,8054,-830
1,2,15,21,3,8238,8022,216
1,2,16,21,3,8423,8168,255
1,2,17,21,3,8054,7922,132
1,2,18,21,3,8022,7884,138
1,3,0,21,3,6980,8247,-1267
1,3,1,21,3,6815,7869,-1054
1,3,2,21,3,7412,8042,-630
1,3,3,21,3,8247,8546,-299
1,3,4,21,3,7869,8223,-354
1,3,5,21,3,8042,7247,795
1,3,6,21,3,8546,5851,2695
1,3,7,21,3,8223,6186,2037
1,3,8,21,3,7247,6164,1083
1,3,9,21,3,5851,6101,-250
1,3,10,21,3,6186,6111,75
1,3,11,21,3,6164,7179,-1015
1,3,12,21,3,6101,8169,-2068
1,3,13,21,3,6111,8304,-2193
1,3,14,21,3,7179,7908,-729
1,3,15,21,3,8169,7869,300
1,3,16,21,3,8304,8005,299
1,3,17,21,3,7908,7755,153
1,3,18,21,3,7869,7707,162
1,0,0,22,3,7469,8818,-1349
1,0,1,22,3,7312,8539,-1227
1,0,2,22,3,7943,8644,-701
1,0,3,22,3,8818,8973,-155
1,0,4,22,3,8539,8604,-65
1,0,5,22,3,8644,7662,982
1,0,6,22,3,8973,6407,2566
1,0,7,22,3,8604,6630,1974
1,0,8,22,3,7662,6560,1102
1,0,9,22,3,6407,6500,-93
1,0,10,22,3,6630,6578,52
1,0,11,22,3,6560,7615,-1055
1,0,12,22,3,6500,8592,-2092
1,0,13,22,3,6578,8857,-2279
1,0,14,22,3,7615,8539,-924
1,0,15,22,3,8592,8519,73
1,0,16,22,3,8857,8631,226
1,0,17,22,3,8539,8402,137
1,0,18,22,3,8519,8361,158
1,1,0,22,3,7403,8695,-1292
1,1,1,22,3,7281,8335,-1054
1,1,2,22,3,7874,8500,-626
1,1,3,22,3,8695,8950,-255
1,1,4,22,3,8335,8586,-251
1,1,5,22,3,8500,7623,877
1,1,6,22,3,8950,6280,2670
1,1,7,22,3,8586,6571,2015
1,1,8,22,3,7623,6513,1110
1,1,9,22,3,6280,6423,-143
1,1,10,22,3,6571,6480,91
1,1,11,22,3,6513,7551,-1038
1,1,12,22,3,6423,8567,-2144
1,1,13,22,3,6480,8749,-2269
1,1,14,22,3,7551,8367,-816
1,1,15,22,3,8567,8329,238
1,1,16,22,3,8749,8482,267
1,1,17,22,3,8367,8248,119
1,1,18,22,3,8329,8211,118
1,2,0,22,3,7313,8572,-1259
1,2,1,22,3,7149,8195,-1046
1,2,2,22,3,7741,8376,-635
1,2,3,22,3,8572,8887,-315
1,2,4,22,3,8195,8569,-374
1,2,5,22,3,8376,7584,792
1,2,6,22,3,8887,6180,2707
1,2,7,22,3,8569,6508,2061
1,2,8,22,3,7584,6485,1099
1,2,9,22,3,6180,6425,-245
1,2,10,22,3,6508,6440,68
1,2,11,22,3,6485,7517,-1032
1,2,12,22,3,6425,8506,-2081
1,2,13,22,3,6440,8639,-2199
1,2,14,22,3,7517,8233,-716
1,2,15,22,3,8506,8188,318
1,2,16,22,3,8639,8325,314
1,2,17,22,3,8233,8083,150
1,2,18,22,3,8188,8038,150
1,0,0,23,3,7716,9015,-1299
1,0,1,23,3,7582,8661,-1079
1,0,2,23,3,8179,8821,-642
1,0,3,23,3,9015,9264,-249
1,0,4,23,3,8661,8899,-238
1,0,5,23,3,8821,7932,889
1,0,6,23,3,9264,6587,2677
1,0,7,23,3,8899,6877,2022
1,0,8,23,3,7932,6820,1112
1,0,9,23,3,6587,6732,-145
1,0,10,23,3,6877,6792,85
1,0,11,23,3,6820,7858,-1038
1,0,12,23,3,6732,8872,-2140
1,0,13,23,3,6792,9059,-2267
1,0,14,23,3,7858,8687,-829
1,0,15,23,3,8872,8645,227
1,0,16,23,3,9059,8791,268
1,0,17,23,3,8687,8558,129
1,0,18,23,3,8645,8525,120
1,1,0,23,3,7637,8898,-1261
1,1,1,23,3,7473,8517,-1044
1,1,2,23,3,8066,8693,-627
1,1,3,23,3,8898,9204,-306
1,1,4,23,3,8517,8890,-373
1,1,5,23,3,8693,7902,791
1,1,6,23,3,9204,6493,2711
1,1,7,23,3,8890,6818,2072
1,1,8,23,3,7902,6795,1107
1,1,9,23,3,6493,6737,-244
1,1,10,23,3,6818,6756,62
1,1,11,23,3,6795,7844,-1049
1,1,12,23,3,6737,8835,-2098
1,1,13,23,3,6756,8965,-2209
1,1,14,23,3,7844,8546,-702
1,1,15,23,3,8835,8495,340
1,1,16,23,3,8965,8639,326
1,1,17,23,3,8546,8409,137
1,1,18,23,3,8495,8365,130
1,0,0,24,3,7950,9218,-1268
1,0,1,24,3,7774,8843,-1069
1,0,2,24,3,8371,9014,-643
1,0,3,24,3,9218,9518,-300
1,0,4,24,3,8843,9203,-360
1,0,5,24,3,9014,8211,803
1,0,6,24,3,9518,6800,2718
1,0,7,24,3,9203,7124,2079
1,0,8,24,3,8211,7102,1109
1,0,9,24,3,6800,7046,-246
1,0,10,24,3,7124,7068,56
1,0,11,24,3,7102,8151,-1049
1,0,12,24,3,7046,9140,-2094
1,0,13,24,3,7068,9275,-2207
1,0,14,24,3,8151,8866,-715
1,0,15,24,3,9140,8811,329
1,0,16,24,3,9275,8948,327
1,0,17,24,3,8866,8719,147
1,0,18,24,3,8811,8679,132
1,0,0,1,4,411,432,-21
1,0,1,1,4,412,425,-13
1,0,2,1,4,416,417,-1
1,0,3,1,4,424,415,9
1,0,4,1,4,432,411,21
1,0,5,1,4,425,409,16
1,0,6,1,4,417,409,8
1,0,7,1,4,415,411,4
1,0,8,1,4,411,414,-3
1,0,9,1,4,409,410,-1
1,0,10,1,4,409,409,0
1,0,11,1,4,411,415,-4
1,0,12,1,4,414,418,-4
1,0,13,1,4,410,418,-8
1,0,14,1,4,409,419,-10
1,0,15,1,4,415,418,-3
1,0,16,1,4,418,412,6
1,1,0,1,4,430,429,1
1,1,1,1,4,436,425,11
1,1,2,1,4,433,423,10
1,1,3,1,4,428,425,3
1,1,4,1,4,429,421,8
1,1,5,1,4,425,416,9
1,1,6,1,4,423,414,9
1,1,7,1,4,425,415,10
1,1,8,1,4,421,419,2
1,1,9,1,4,416,431,-15
1,1,10,1,4,414,434,-20
1,1,11,1,4,415,433,-18
1,1,12,1,4,419,428,-9
1,1,13,1,4,431,414,17
1,1,14,1,4,434,418,16
1,1,15,1,4,433,428,5
1,1,16,1,4,428,428,0
1,2,0,1,4,440,444,-4
1,2,1,1,4,444,449,-5
1,2,2,1,4,437,454,-17
1,2,3,1,4,433,455,-22
1,2,4,1,4,444,444,0
1,2,5,1,4,449,435,14
1,2,6,1,4,454,430,24
1,2,7,1,4,455,431,24
1,2,8,1,4,444,435,9
1,2,9,1,4,435,446,-11
1,2,10,1,4,430,447,-17
1,2,11,1,4,431,446,-15
1,2,12,1,4,435,442,-7
1,2,13,1,4,446,428,18
1,2,14,1,4,447,429,18
1,2,15,1,4,446,435,11
1,2,16,1,4,442,434,8
1,3,0,1,4,444,454,-10
1,3,1,1,4,444,414,30
1,3,2,1,4,442,368,74
1,3,3,1,4,444,322,122
1,3,4,1,4,454,270,184
1,3,5,1,4,414,260,154
1,3,6,1,4,368,254,114
1,3,7,1,4,322,253,69
1,3,8,1,4,270,257,13
1,3,9,1,4,260,285,-25
1,3,10,1,4,254,321,-67
1,3,11,1,4,253,373,-120
1,3,12,1,4,257,427,-170
1,3,13,1,4,285,444,-159
1,3,14,1,4,321,449,-128
1,3,15,1,4,373,443,-70
1,3,16,1,4,427,433,-6
1,4,0,1,4,462,416,46
1,4,1,1,4,474,344,130
1,4,2,1,4,475,275,200
1,4,3,1,4,455,229,226
1,4,4,1,4,416,198,218
1,4,5,1,4,344,188,156
1,4,6,1,4,275,182,93
1,4,7,1,4,229,181,48
1,4,8,1,4,198,184,14
1,4,9,1,4,188,199,-11
1,4,10,1,4,182,229,-47
1,4,11,1,4,181,288,-107
1,4,12,1,4,184,363,-179
1,4,13,1,4,199,419,-220
1,4,14,1,4,229,454,-225
1,4,15,1,4,288,461,-173
1,4,16,1,4,363,448,-85
1,5,0,1,4,475,342,133
1,5,1,1,4,486,286,200
1,5,2,1,4,473,245,228
1,5,3,1,4,422,243,179
1,5,4,1,4,342,269,73
1,5,5,1,4,286,265,21
1,5,6,1,4,245,262,-17
1,5,7,1,4,243,260,-17
1,5,8,1,4,269,261,8
1,5,9,1,4,265,251,14
1,5,10,1,4,262,244,18
1,5,11,1,4,260,260,0
1,5,12,1,4,261,301,-40
1,5,13,1,4,251,362,-111
1,5,14,1,4,244,423,-179
1,5,15,1,4,260,460,-200
1,5,16,1,4,301,461,-160
1,6,0,1,4,442,294,148
1,6,1,1,4,409,276,133
1,6,2,1,4,367,263,104
1,6,3,1,4,325,265,60
1,6,4,1,4,294,276,18
1,6,5,1,4,276,276,0
1,6,6,1,4,263,276,-13
1,6,7,1,4,265,275,-10
1,6,8,1,4,276,274,2
1,6,9,1,4,276,282,-6
1,6,10,1,4,276,279,-3
1,6,11,1,4,275,282,-7
1,6,12,1,4,274,301,-27
1,6,13,1,4,282,321,-39
1,6,14,1,4,279,362,-83
1,6,15,1,4,282,407,-125
1,6,16,1,4,301,435,-134
1,7,0,1,4,394,284,110
1,7,1,1,4,304,339,-35
1,7,2,1,4,236,378,-142
1,7,3,1,4,228,393,-165
1,7,4,1,4,284,387,-103
1,7,5,1,4,339,391,-52
1,7,6,1,4,378,393,-15
1,7,7,1,4,393,393,0
1,7,8,1,4,387,390,-3
1,7,9,1,4,391,390,1
1,7,10,1,4,393,376,17
1,7,11,1,4,393,358,35
1,7,12,1,4,390,339,51
1,7,13,1,4,390,312,78
1,7,14,1,4,376,312,64
1,7,15,1,4,358,343,15
1,7,16,1,4,339,391,-52
1,8,0,1,4,466,413,53
1,8,1,1,4,403,477,-74
1,8,2,1,4,356,518,-162
1,8,3,1,4,370,513,-143
1,8,4,1,4,413,529,-116
1,8,5,1,4,477,548,-71
1,8,6,1,4,518,559,-41
1,8,7,1,4,513,567,-54
1,8,8,1,4,529,568,-39
1,8,9,1,4,548,556,-8
1,8,10,1,4,559,541,18
1,8,11,1,4,567,532,35
1,8,12,1,4,568,487,81
1,8,13,1,4,556,452,104
1,8,14,1,4,541,449,92
1,8,15,1,4,532,438,94
1,8,16,1,4,487,476,11
1,9,0,1,4,287,207,80
1,9,1,1,4,222,230,-8
1,9,2,1,4,208,216,-8
1,9,3,1,4,183,201,-18
1,9,4,1,4,207,170,37
1,9,5,1,4,230,145,85
1,9,6,1,4,216,132,84
1,9,7,1,4,201,130,71
1,9,8,1,4,170,147,23
1,9,9,1,4,145,167,-22
1,9,10,1,4,132,205,-73
1,9,11,1,4,130,236,-106
1,9,12,1,4,147,230,-83
1,9,13,1,4,167,222,-55
1,9,14,1,4,205,216,-11
1,9,15,1,4,236,234,2
1,9,16,1,4,230,290,-60
1,10,0,1,4,284,546,-262
1,10,1,1,4,328,540,-212
1,10,2,1,4,402,550,-148
1,10,3,1,4,465,559,-94
1,10,4,1,4,546,521,25
1,10,5,1,4,540,504,36
1,10,6,1,4,550,508,42
1,10,7,1,4,559,500,59
1,10,8,1,4,521,510,11
1,10,9,1,4,504,530,-26
1,10,10,1,4,508,547,-39
1,10,11,1,4,500,535,-35
1,10,12,1,4,510,526,-16
1,10,13,1,4,530,496,34
1,10,14,1,4,547,429,118
1,10,15,1,4,535,416,119
1,10,16,1,4,526,402,124
1,11,0,1,4,452,881,-429
1,11,1,1,4,566,844,-278
1,11,2,1,4,641,847,-206
1,11,3,1,4,774,818,-44
1,11,4,1,4,881,766,115
1,11,5,1,4,844,741,103
1,11,6,1,4,847,763,84
1,11,7,1,4,818,753,65
1,11,8,1,4,766,764,2
1,11,9,1,4,741,815,-74
1,11,10,1,4,763,851,-88
1,11,11,1,4,753,851,-98
1,11,12,1,4,764,873,-109
1,11,13,1,4,815,844,-29
1,11,14,1,4,851,777,74
1,11,15,1,4,851,766,85
1,11,16,1,4,873,689,184
1,12,0,1,4,528,875,-347
1,12,1,1,4,614,870,-256
1,12,2,1,4,668,780,-112
1,12,3,1,4,777,681,96
1,12,4,1,4,875,572,303
1,12,5,1,4,870,471,399
1,12,6,1,4,780,471,309
1,12,7,1,4,681,460,221
1,12,8,1,4,572,504,68
1,12,9,1,4,471,624,-153
1,12,10,1,4,471,751,-280
1,12,11,1,4,460,848,-388
1,12,12,1,4,504,911,-407
1,12,13,1,4,624,878,-254
1,12,14,1,4,751,837,-86
1,12,15,1,4,848,836,12
1,12,16,1,4,911,745,166
1,13,0,1,4,538,843,-305
1,13,1,1,4,579,905,-326
1,13,2,1,4,673,752,-79
1,13,3,1,4,733,688,45
1,13,4,1,4,843,548,295
1,13,5,1,4,905,409,496
1,13,6,1,4,752,405,347
1,13,7,1,4,688,390,298
1,13,8,1,4,548,454,94
1,13,9,1,4,409,593,-184
1,13,10,1,4,405,714,-309
1,13,11,1,4,390,841,-451
1,13,12,1,4,454,897,-443
1,13,13,1,4,593,825,-232
1,13,14,1,4,714,796,-82
1,13,15,1,4,841,775,66
1,13,16,1,4,897,696,201
1,14,0,1,4,558,804,-246
1,14,1,1,4,582,864,-282
1,14,2,1,4,667,710,-43
1,14,3,1,4,695,694,1
1,14,4,1,4,804,556,248
1,14,5,1,4,864,429,435
1,14,6,1,4,710,441,269
1,14,7,1,4,694,418,276
1,14,8,1,4,556,480,76
1,14,9,1,4,429,612,-183
1,14,10,1,4,441,680,-239
1,14,11,1,4,418,806,-388
1,14,12,1,4,480,864,-384
1,14,13,1,4,612,776,-164
1,14,14,1,4,680,791,-111
1,14,15,1,4,806,762,44
1,14,16,1,4,864,703,161
1,15,0,1,4,541,858,-317
1,15,1,1,4,602,889,-287
1,15,2,1,4,683,722,-39
1,15,3,1,4,740,676,64
1,15,4,1,4,858,533,325
1,15,5,1,4,889,400,489
1,15,6,1,4,722,409,313
1,15,7,1,4,676,377,299
1,15,8,1,4,533,443,90
1,15,9,1,4,400,593,-193
1,15,10,1,4,409,672,-263
1,15,11,1,4,377,833,-456
1,15,12,1,4,443,896,-453
1,15,13,1,4,593,790,-197
1,15,14,1,4,672,817,-145
1,15,15,1,4,833,756,77
1,15,16,1,4,896,674,222
1,16,0,1,4,416,846,-430
1,16,1,1,4,527,866,-339
1,16,2,1,4,662,724,-62
1,16,3,1,4,717,711,6
1,16,4,1,4,846,557,289
1,16,5,1,4,866,445,421
1,16,6,1,4,724,450,274
1,16,7,1,4,711,431,280
1,16,8,1,4,557,511,46
1,16,9,1,4,445,638,-193
1,16,10,1,4,450,696,-246
1,16,11,1,4,431,787,-356
1,16,12,1,4,511,830,-319
1,16,13,1,4,638,732,-94
1,16,14,1,4,696,730,-34
1,16,15,1,4,787,658,129
1,16,16,1,4,830,581,249
1,17,0,1,4,392,741,-349
1,17,1,1,4,491,730,-239
1,17,2,1,4,607,610,-3
1,17,3,1,4,656,608,48
1,17,4,1,4,741,444,297
1,17,5,1,4,730,331,399
1,17,6,1,4,610,343,267
1,17,7,1,4,608,294,314
1,17,8,1,4,444,367,77
1,17,9,1,4,331,526,-195
1,17,10,1,4,343,604,-261
1,17,11,1,4,294,618,-324
1,17,12,1,4,367,638,-271
1,17,13,1,4,526,570,-44
1,17,14,1,4,604,575,29
1,17,15,1,4,618,593,25
1,17,16,1,4,638,588,50
1,18,0,1,4,474,614,-140
1,18,1,1,4,590,488,102
1,18,2,1,4,677,382,295
1,18,3,1,4,670,388,282
1,18,4,1,4,614,344,270
1,18,5,1,4,488,339,149
1,18,6,1,4,382,341,41
1,18,7,1,4,388,369,19
1,18,8,1,4,344,367,-23
1,18,9,1,4,339,327,12
1,18,10,1,4,341,410,-69
1,18,11,1,4,369,380,-11
1,18,12,1,4,367,423,-56
1,18,13,1,4,327,556,-229
1,18,14,1,4,410,562,-152
1,18,15,1,4,380,570,-190
1,18,16,1,4,423,566,-143
1,19,0,1,4,618,381,237
1,19,1,1,4,558,438,120
1,19,2,1,4,548,481,67
1,19,3,1,4,516,567,-51
1,19,4,1,4,381,599,-218
1,19,5,1,4,438,570,-132
1,19,6,1,4,481,604,-123
1,19,7,1,4,567,556,11
1,19,8,1,4,599,490,109
1,19,9,1,4,570,520,50
1,19,10,1,4,604,571,33
1,19,11,1,4,556,530,26
1,19,12,1,4,490,528,-38
1,19,13,1,4,520,517,3
1,19,14,1,4,571,388,183
1,19,15,1,4,530,393,137
1,19,16,1,4,528,531,-3
1,20,0,1,4,564,392,172
1,20,1,1,4,471,539,-68
1,20,2,1,4,438,628,-190
1,20,3,1,4,443,708,-265
1,20,4,1,4,392,649,-257
1,20,5,1,4,539,557,-18
1,20,6,1,4,628,571,57
1,20,7,1,4,708,502,206
1,20,8,1,4,649,457,192
1,20,9,1,4,557,443,114
1,20,10,1,4,571,417,154
1,20,11,1,4,502,381,121
1,20,12,1,4,457,383,74
1,20,13,1,4,443,408,35
1,20,14,1,4,417,333,84
1,20,15,1,4,381,340,41
1,20,16,1,4,383,474,-91
1,21,0,1,4,599,236,363
1,21,1,1,4,458,319,139
1,21,2,1,4,418,328,90
1,21,3,1,4,387,296,91
1,21,4,1,4,236,256,-20
1,21,5,1,4,319,199,120
1,21,6,1,4,328,194,134
1,21,7,1,4,296,192,104
1,21,8,1,4,256,203,53
1,21,9,1,4,199,158,41
1,21,10,1,4,194,192,2
1,21,11,1,4,192,223,-31
1,21,12,1,4,203,252,-49
1,21,13,1,4,158,310,-152
1,21,14,1,4,192,329,-137
1,21,15,1,4,223,370,-147
1,21,16,1,4,252,459,-207
1,22,0,1,4,367,217,150
1,22,1,1,4,310,328,-18
1,22,2,1,4,273,340,-67
1,22,3,1,4,242,365,-123
1,22,4,1,4,217,331,-114
1,22,5,1,4,328,296,32
1,22,6,1,4,340,330,10
1,22,7,1,4,365,293,72
1,22,8,1,4,331,330,1
1,22,9,1,4,296,326,-30
1,22,10,1,4,330,313,17
1,22,11,1,4,293,300,-7
1,22,12,1,4,330,260,70
1,22,13,1,4,326,196,130
1,22,14,1,4,313,180,133
1,22,15,1,4,300,214,86
1,22,16,1,4,260,212,48
1,23,0,1,4,303,262,41
1,23,1,1,4,261,319,-58
1,23,2,1,4,257,352,-95
1,23,3,1,4,251,359,-108
1,23,4,1,4,262,339,-77
1,23,5,1,4,319,345,-26
1,23,6,1,4,352,337,15
1,23,7,1,4,359,374,-15
1,23,8,1,4,339,408,-69
1,23,9,1,4,345,383,-38
1,23,10,1,4,337,360,-23
1,23,11,1,4,374,310,64
1,23,12,1,4,408,286,122
1,23,13,1,4,383,233,150
1,23,14,1,4,360,199,161
1,23,15,1,4,310,231,79
1,23,16,1,4,286,208,78
1,0,0,2,4,841,861,-20
1,0,1,2,4,848,850,-2
1,0,2,2,4,849,840,9
1,0,3,2,4,852,840,12
1,0,4,2,4,861,832,29
1,0,5,2,4,850,825,25
1,0,6,2,4,840,823,17
1,0,7,2,4,840,826,14
1,0,8,2,4,832,833,-1
1,0,9,2,4,825,841,-16
1,0,10,2,4,823,843,-20
1,0,11,2,4,826,848,-22
1,0,12,2,4,833,846,-13
1,0,13,2,4,841,832,9
1,0,14,2,4,843,837,6
1,0,15,2,4,848,846,2
1,0,16,2,4,846,840,6
1,1,0,2,4,870,873,-3
1,1,1,2,4,880,874,6
1,1,2,2,4,870,877,-7
1,1,3,2,4,861,880,-19
1,1,4,2,4,873,865,8
1,1,5,2,4,874,851,23
1,1,6,2,4,877,844,33
1,1,7,2,4,880,846,34
1,1,8,2,4,865,854,11
1,1,9,2,4,851,877,-26
1,1,10,2,4,844,881,-37
1,1,11,2,4,846,879,-33
1,1,12,2,4,854,870,-16
1,1,13,2,4,877,842,35
1,1,14,2,4,881,847,34
1,1,15,2,4,879,863,16
1,1,16,2,4,870,862,8
1,2,0,2,4,884,898,-14
1,2,1,2,4,888,863,25
1,2,2,2,4,879,822,57
1,2,3,2,4,877,777,100
1,2,4,2,4,898,714,184
1,2,5,2,4,863,695,168
1,2,6,2,4,822,684,138
1,2,7,2,4,777,684,93
1,2,8,2,4,714,692,22
1,2,9,2,4,695,731,-36
1,2,10,2,4,684,768,-84
1,2,11,2,4,684,819,-135
1,2,12,2,4,692,869,-177
1,2,13,2,4,731,872,-141
1,2,14,2,4,768,878,-110
1,2,15,2,4,819,878,-59
1,2,16,2,4,869,867,2
1,3,0,2,4,906,870,36
1,3,1,2,4,918,758,160
1,3,2,2,4,917,643,274
1,3,3,2,4,899,551,348
1,3,4,2,4,870,468,402
1,3,5,2,4,758,448,310
1,3,6,2,4,643,436,207
1,3,7,2,4,551,434,117
1,3,8,2,4,468,441,27
1,3,9,2,4,448,484,-36
1,3,10,2,4,436,550,-114
1,3,11,2,4,434,661,-227
1,3,12,2,4,441,790,-349
1,3,13,2,4,484,863,-379
1,3,14,2,4,550,903,-353
1,3,15,2,4,661,904,-243
1,3,16,2,4,790,881,-91
1,4,0,2,4,937,758,179
1,4,1,2,4,960,630,330
1,4,2,2,4,948,520,428
1,4,3,2,4,877,472,405
1,4,4,2,4,758,467,291
1,4,5,2,4,630,453,177
1,4,6,2,4,520,444,76
1,4,7,2,4,472,441,31
1,4,8,2,4,467,445,22
1,4,9,2,4,453,450,3
1,4,10,2,4,444,473,-29
1,4,11,2,4,441,548,-107
1,4,12,2,4,445,664,-219
1,4,13,2,4,450,781,-331
1,4,14,2,4,473,877,-404
1,4,15,2,4,548,921,-373
1,4,16,2,4,664,909,-245
1,5,0,2,4,917,636,281
1,5,1,2,4,895,562,333
1,5,2,2,4,840,508,332
1,5,3,2,4,747,508,239
1,5,4,2,4,636,545,91
1,5,5,2,4,562,541,21
1,5,6,2,4,508,538,-30
1,5,7,2,4,508,535,-27
1,5,8,2,4,545,535,10
1,5,9,2,4,541,533,8
1,5,10,2,4,538,523,15
1,5,11,2,4,535,542,-7
1,5,12,2,4,535,602,-67
1,5,13,2,4,533,683,-150
1,5,14,2,4,523,785,-262
1,5,15,2,4,542,867,-325
1,5,16,2,4,602,896,-294
1,6,0,2,4,836,578,258
1,6,1,2,4,713,615,98
1,6,2,2,4,603,641,-38
1,6,3,2,4,553,658,-105
1,6,4,2,4,578,663,-85
1,6,5,2,4,615,667,-52
1,6,6,2,4,641,669,-28
1,6,7,2,4,658,668,-10
1,6,8,2,4,663,664,-1
1,6,9,2,4,667,672,-5
1,6,10,2,4,669,655,14
1,6,11,2,4,668,640,28
1,6,12,2,4,664,640,24
1,6,13,2,4,672,633,39
1,6,14,2,4,655,674,-19
1,6,15,2,4,640,750,-110
1,6,16,2,4,640,826,-186
1,7,0,2,4,860,697,163
1,7,1,2,4,707,816,-109
1,7,2,2,4,592,896,-304
1,7,3,2,4,598,906,-308
1,7,4,2,4,697,916,-219
1,7,5,2,4,816,939,-123
1,7,6,2,4,896,952,-56
1,7,7,2,4,906,960,-54
1,7,8,2,4,916,958,-42
1,7,9,2,4,939,946,-7
1,7,10,2,4,952,917,35
1,7,11,2,4,960,890,70
1,7,12,2,4,958,826,132
1,7,13,2,4,946,764,182
1,7,14,2,4,917,761,156
1,7,15,2,4,890,781,109
1,7,16,2,4,826,867,-41
1,8,0,2,4,753,620,133
1,8,1,2,4,625,707,-82
1,8,2,2,4,564,734,-170
1,8,3,2,4,553,714,-161
1,8,4,2,4,620,699,-79
1,8,5,2,4,707,693,14
1,8,6,2,4,734,691,43
1,8,7,2,4,714,697,17
1,8,8,2,4,699,715,-16
1,8,9,2,4,693,723,-30
1,8,10,2,4,691,746,-55
1,8,11,2,4,697,768,-71
1,8,12,2,4,715,717,-2
1,8,13,2,4,723,674,49
1,8,14,2,4,746,665,81
1,8,15,2,4,768,672,96
1,8,16,2,4,717,766,-49
1,9,0,2,4,571,753,-182
1,9,1,2,4,550,770,-220
1,9,2,2,4,610,766,-156
1,9,3,2,4,648,760,-112
1,9,4,2,4,753,691,62
1,9,5,2,4,770,649,121
1,9,6,2,4,766,640,126
1,9,7,2,4,760,630,130
1,9,8,2,4,691,657,34
1,9,9,2,4,649,697,-48
1,9,10,2,4,640,752,-112
1,9,11,2,4,630,771,-141
1,9,12,2,4,657,756,-99
1,9,13,2,4,697,718,-21
1,9,14,2,4,752,645,107
1,9,15,2,4,771,650,121
1,9,16,2,4,756,692,64
1,10,0,2,4,736,1427,-691
1,10,1,2,4,894,1384,-490
1,10,2,2,4,1043,1397,-354
1,10,3,2,4,1239,1377,-138
1,10,4,2,4,1427,1287,140
1,10,5,2,4,1384,1245,139
1,10,6,2,4,1397,1271,126
1,10,7,2,4,1377,1253,124
1,10,8,2,4,1287,1274,13
1,10,9,2,4,1245,1345,-100
1,10,10,2,4,1271,1398,-127
1,10,11,2,4,1253,1386,-133
1,10,12,2,4,1274,1399,-125
1,10,13,2,4,1345,1340,5
1,10,14,2,4,1398,1206,192
1,10,15,2,4,1386,1182,204
1,10,16,2,4,1399,1091,308
1,11,0,2,4,980,1756,-776
1,11,1,2,4,1180,1714,-534
1,11,2,2,4,1309,1627,-318
1,11,3,2,4,1551,1499,52
1,11,4,2,4,1756,1338,418
1,11,5,2,4,1714,1212,502
1,11,6,2,4,1627,1234,393
1,11,7,2,4,1499,1213,286
1,11,8,2,4,1338,1268,70
1,11,9,2,4,1212,1439,-227
1,11,10,2,4,1234,1602,-368
1,11,11,2,4,1213,1699,-486
1,11,12,2,4,1268,1784,-516
1,11,13,2,4,1439,1722,-283
1,11,14,2,4,1602,1614,-12
1,11,15,2,4,1699,1602,97
1,11,16,2,4,1784,1434,350
1,12,0,2,4,1066,1718,-652
1,12,1,2,4,1193,1775,-582
1,12,2,2,4,1341,1532,-191
1,12,3,2,4,1510,1369,141
1,12,4,2,4,1718,1120,598
1,12,5,2,4,1775,880,895
1,12,6,2,4,1532,876,656
1,12,7,2,4,1369,850,519
1,12,8,2,4,1120,958,162
1,12,9,2,4,880,1217,-337
1,12,10,2,4,876,1465,-589
1,12,11,2,4,850,1689,-839
1,12,12,2,4,958,1808,-850
1,12,13,2,4,1217,1703,-486
1,12,14,2,4,1465,1633,-168
1,12,15,2,4,1689,1611,78
1,12,16,2,4,1808,1441,367
1,13,0,2,4,1096,1647,-551
1,13,1,2,4,1161,1769,-608
1,13,2,2,4,1340,1462,-122
1,13,3,2,4,1428,1382,46
1,13,4,2,4,1647,1104,543
1,13,5,2,4,1769,838,931
1,13,6,2,4,1462,846,616
1,13,7,2,4,1382,808,574
1,13,8,2,4,1104,934,170
1,13,9,2,4,838,1205,-367
1,13,10,2,4,846,1394,-548
1,13,11,2,4,808,1647,-839
1,13,12,2,4,934,1761,-827
1,13,13,2,4,1205,1601,-396
1,13,14,2,4,1394,1587,-193
1,13,15,2,4,1647,1537,110
1,13,16,2,4,1761,1399,362
1,14,0,2,4,1099,1662,-563
1,14,1,2,4,1184,1753,-569
1,14,2,2,4,1350,1432,-82
1,14,3,2,4,1435,1370,65
1,14,4,2,4,1662,1089,573
1,14,5,2,4,1753,829,924
1,14,6,2,4,1432,850,582
1,14,7,2,4,1370,795,575
1,14,8,2,4,1089,923,166
1,14,9,2,4,829,1205,-376
1,14,10,2,4,850,1352,-502
1,14,11,2,4,795,1639,-844
1,14,12,2,4,923,1760,-837
1,14,13,2,4,1205,1566,-361
1,14,14,2,4,1352,1608,-256
1,14,15,2,4,1639,1518,121
1,14,16,2,4,1760,1377,383
1,15,0,2,4,957,1704,-747
1,15,1,2,4,1129,1755,-626
1,15,2,2,4,1345,1446,-101
1,15,3,2,4,1457,1387,70
1,15,4,2,4,1704,1090,614
1,15,5,2,4,1755,845,910
1,15,6,2,4,1446,859,587
1,15,7,2,4,1387,808,579
1,15,8,2,4,1090,954,136
1,15,9,2,4,845,1231,-386
1,15,10,2,4,859,1368,-509
1,15,11,2,4,808,1620,-812
1,15,12,2,4,954,1726,-772
1,15,13,2,4,1231,1522,-291
1,15,14,2,4,1368,1547,-179
1,15,15,2,4,1620,1414,206
1,15,16,2,4,1726,1255,471
1,16,0,2,4,808,1587,-779
1,16,1,2,4,1018,1596,-578
1,16,2,2,4,1269,1334,-65
1,16,3,2,4,1373,1319,54
1,16,4,2,4,1587,1001,586
1,16,5,2,4,1596,776,820
1,16,6,2,4,1334,793,541
1,16,7,2,4,1319,725,594
1,16,8,2,4,1001,878,123
1,16,9,2,4,776,1164,-388
1,16,10,2,4,793,1300,-507
1,16,11,2,4,725,1405,-680
1,16,12,2,4,878,1468,-590
1,16,13,2,4,1164,1302,-138
1,16,14,2,4,1300,1305,-5
1,16,15,2,4,1405,1251,154
1,16,16,2,4,1468,1169,299
1,17,0,2,4,866,1355,-489
1,17,1,2,4,1081,1218,-137
1,17,2,2,4,1284,992,292
1,17,3,2,4,1326,996,330
1,17,4,2,4,1355,788,567
1,17,5,2,4,1218,670,548
1,17,6,2,4,992,684,308
1,17,7,2,4,996,663,333
1,17,8,2,4,788,734,54
1,17,9,2,4,670,853,-183
1,17,10,2,4,684,1014,-330
1,17,11,2,4,663,998,-335
1,17,12,2,4,734,1061,-327
1,17,13,2,4,853,1126,-273
1,17,14,2,4,1014,1137,-123
1,17,15,2,4,998,1163,-165
1,17,16,2,4,1061,1154,-93
1,18,0,2,4,1092,995,97
1,18,1,2,4,1148,926,222
1,18,2,2,4,1225,863,362
1,18,3,2,4,1186,955,231
1,18,4,2,4,995,943,52
1,18,5,2,4,926,909,17
1,18,6,2,4,863,945,-82
1,18,7,2,4,955,925,30
1,18,8,2,4,943,857,86
1,18,9,2,4,909,847,62
1,18,10,2,4,945,981,-36
1,18,11,2,4,925,910,15
1,18,12,2,4,857,951,-94
1,18,13,2,4,847,1073,-226
1,18,14,2,4,981,950,31
1,18,15,2,4,910,963,-53
1,18,16,2,4,951,1097,-146
1,19,0,2,4,1182,773,409
1,19,1,2,4,1029,977,52
1,19,2,2,4,986,1109,-123
1,19,3,2,4,959,1275,-316
1,19,4,2,4,773,1248,-475
1,19,5,2,4,977,1127,-150
1,19,6,2,4,1109,1175,-66
1,19,7,2,4,1275,1058,217
1,19,8,2,4,1248,947,301
1,19,9,2,4,1127,963,164
1,19,10,2,4,1175,988,187
1,19,11,2,4,1058,911,147
1,19,12,2,4,947,911,36
1,19,13,2,4,963,925,38
1,19,14,2,4,988,721,267
1,19,15,2,4,911,733,178
1,19,16,2,4,911,1005,-94
1,20,0,2,4,1163,628,535
1,20,1,2,4,929,858,71
1,20,2,2,4,856,956,-100
1,20,3,2,4,830,1004,-174
1,20,4,2,4,628,905,-277
1,20,5,2,4,858,756,102
1,20,6,2,4,956,765,191
1,20,7,2,4,1004,694,310
1,20,8,2,4,905,660,245
1,20,9,2,4,756,601,155
1,20,10,2,4,765,609,156
1,20,11,2,4,694,604,90
1,20,12,2,4,660,635,25
1,20,13,2,4,601,718,-117
1,20,14,2,4,609,662,-53
1,20,15,2,4,604,710,-106
1,20,16,2,4,635,933,-298
1,21,0,2,4,966,453,513
1,21,1,2,4,768,647,121
1,21,2,2,4,691,668,23
1,21,3,2,4,629,661,-32
1,21,4,2,4,453,587,-134
1,21,5,2,4,647,495,152
1,21,6,2,4,668,524,144
1,21,7,2,4,661,485,176
1,21,8,2,4,587,533,54
1,21,9,2,4,495,484,11
1,21,10,2,4,524,505,19
1,21,11,2,4,485,523,-38
1,21,12,2,4,533,512,21
1,21,13,2,4,484,506,-22
1,21,14,2,4,505,509,-4
1,21,15,2,4,523,584,-61
1,21,16,2,4,512,671,-159
1,22,0,2,4,670,479,191
1,22,1,2,4,571,647,-76
1,22,2,2,4,530,692,-162
1,22,3,2,4,493,724,-231
1,22,4,2,4,479,670,-191
1,22,5,2,4,647,641,6
1,22,6,2,4,692,667,25
1,22,7,2,4,724,667,57
1,22,8,2,4,670,738,-68
1,22,9,2,4,641,709,-68
1,22,10,2,4,667,673,-6
1,22,11,2,4,667,610,57
1,22,12,2,4,738,546,192
1,22,13,2,4,709,429,280
1,22,14,2,4,673,379,294
1,22,15,2,4,610,445,165
1,22,16,2,4,546,420,126
1,0,0,3,4,1281,1305,-24
1,0,1,3,4,1292,1299,-7
1,0,2,3,4,1286,1294,-8
1,0,3,3,4,1285,1295,-10
1,0,4,3,4,1305,1276,29
1,0,5,3,4,1299,1260,39
1,0,6,3,4,1294,1253,41
1,0,7,3,4,1295,1257,38
1,0,8,3,4,1276,1268,8
1,0,9,3,4,1260,1287,-27
1,0,10,3,4,1253,1290,-37
1,0,11,3,4,1257,1294,-37
1,0,12,3,4,1268,1288,-20
1,0,13,3,4,1287,1260,27
1,0,14,3,4,1290,1266,24
1,0,15,3,4,1294,1281,13
1,0,16,3,4,1288,1274,14
1,1,0,3,4,1314,1327,-13
1,1,1,3,4,1324,1288,36
1,1,2,3,4,1312,1245,67
1,1,3,3,4,1305,1202,103
1,1,4,3,4,1327,1135,192
1,1,5,3,4,1288,1111,177
1,1,6,3,4,1245,1098,147
1,1,7,3,4,1202,1099,103
1,1,8,3,4,1135,1111,24
1,1,9,3,4,1111,1162,-51
1,1,10,3,4,1098,1202,-104
1,1,11,3,4,1099,1252,-153
1,1,12,3,4,1111,1297,-186
1,1,13,3,4,1162,1286,-124
1,1,14,3,4,1202,1296,-94
1,1,15,3,4,1252,1306,-54
1,1,16,3,4,1297,1295,2
1,2,0,3,4,1346,1314,32
1,2,1,3,4,1362,1207,155
1,2,2,3,4,1354,1097,257
1,2,3,3,4,1332,1006,326
1,2,4,3,4,1314,912,402
1,2,5,3,4,1207,883,324
1,2,6,3,4,1097,866,231
1,2,7,3,4,1006,865,141
1,2,8,3,4,912,876,36
1,2,9,3,4,883,930,-47
1,2,10,3,4,866,997,-131
1,2,11,3,4,865,1107,-242
1,2,12,3,4,876,1232,-356
1,2,13,3,4,930,1291,-361
1,2,14,3,4,997,1332,-335
1,2,15,3,4,1107,1339,-232
1,2,16,3,4,1232,1315,-83
1,3,0,3,4,1381,1212,169
1,3,1,3,4,1404,1044,360
1,3,2,3,4,1390,888,502
1,3,3,3,4,1321,794,527
1,3,4,3,4,1212,737,475
1,3,5,3,4,1044,713,331
1,3,6,3,4,888,698,190
1,3,7,3,4,794,694,100
1,3,8,3,4,737,702,35
1,3,9,3,4,713,735,-22
1,3,10,3,4,698,794,-96
1,3,11,3,4,694,921,-227
1,3,12,3,4,702,1091,-389
1,3,13,3,4,735,1225,-490
1,3,14,3,4,794,1326,-532
1,3,15,3,4,921,1364,-443
1,3,16,3,4,1091,1342,-251
1,4,0,3,4,1379,1052,327
1,4,1,3,4,1369,906,463
1,4,2,3,4,1315,783,532
1,4,3,3,4,1202,737,465
1,4,4,3,4,1052,743,309
1,4,5,3,4,906,729,177
1,4,6,3,4,783,720,63
1,4,7,3,4,737,716,21
1,4,8,3,4,743,719,24
1,4,9,3,4,729,732,-3
1,4,10,3,4,720,752,-32
1,4,11,3,4,716,830,-114
1,4,12,3,4,719,965,-246
1,4,13,3,4,732,1102,-370
1,4,14,3,4,752,1239,-487
1,4,15,3,4,830,1328,-498
1,4,16,3,4,965,1344,-379
1,5,0,3,4,1311,920,391
1,5,1,3,4,1199,901,298
1,5,2,3,4,1076,886,190
1,5,3,3,4,975,901,74
1,5,4,3,4,920,932,-12
1,5,5,3,4,901,932,-31
1,5,6,3,4,886,931,-45
1,5,7,3,4,901,928,-27
1,5,8,3,4,932,925,7
1,5,9,3,4,932,923,9
1,5,10,3,4,931,899,32
1,5,11,3,4,928,900,28
1,5,12,3,4,925,941,-16
1,5,13,3,4,923,995,-72
1,5,14,3,4,899,1097,-198
1,5,15,3,4,900,1210,-310
1,5,16,3,4,941,1287,-346
1,6,0,3,4,1302,991,311
1,6,1,3,4,1116,1092,24
1,6,2,3,4,959,1159,-200
1,6,3,3,4,923,1171,-248
1,6,4,3,4,991,1192,-201
1,6,5,3,4,1092,1215,-123
1,6,6,3,4,1159,1228,-69
1,6,7,3,4,1171,1235,-64
1,6,8,3,4,1192,1232,-40
1,6,9,3,4,1215,1228,-13
1,6,10,3,4,1228,1196,32
1,6,11,3,4,1235,1172,63
1,6,12,3,4,1232,1127,105
1,6,13,3,4,1228,1085,143
1,6,14,3,4,1196,1123,73
1,6,15,3,4,1172,1188,-16
1,6,16,3,4,1127,1302,-175
1,7,0,3,4,1147,904,243
1,7,1,3,4,929,1046,-117
1,7,2,3,4,800,1112,-312
1,7,3,3,4,781,1107,-326
1,7,4,3,4,904,1086,-182
1,7,5,3,4,1046,1084,-38
1,7,6,3,4,1112,1084,28
1,7,7,3,4,1107,1090,17
1,7,8,3,4,1086,1105,-19
1,7,9,3,4,1084,1113,-29
1,7,10,3,4,1084,1122,-38
1,7,11,3,4,1090,1126,-36
1,7,12,3,4,1105,1056,49
1,7,13,3,4,1113,986,127
1,7,14,3,4,1122,977,145
1,7,15,3,4,1126,1015,111
1,7,16,3,4,1056,1157,-101
1,8,0,3,4,1037,1166,-129
1,8,1,3,4,953,1247,-294
1,8,2,3,4,966,1284,-318
1,8,3,3,4,1018,1273,-255
1,8,4,3,4,1166,1220,-54
1,8,5,3,4,1247,1197,50
1,8,6,3,4,1284,1199,85
1,8,7,3,4,1273,1197,76
1,8,8,3,4,1220,1225,-5
1,8,9,3,4,1197,1253,-56
1,8,10,3,4,1199,1293,-94
1,8,11,3,4,1197,1303,-106
1,8,12,3,4,1225,1243,-18
1,8,13,3,4,1253,1170,83
1,8,14,3,4,1293,1094,199
1,8,15,3,4,1303,1088,215
1,8,16,3,4,1243,1168,75
1,9,0,3,4,1023,1634,-611
1,9,1,3,4,1116,1614,-498
1,9,2,3,4,1251,1613,-362
1,9,3,3,4,1422,1578,-156
1,9,4,3,4,1634,1457,177
1,9,5,3,4,1614,1390,224
1,9,6,3,4,1613,1403,210
1,9,7,3,4,1578,1383,195
1,9,8,3,4,1457,1421,36
1,9,9,3,4,1390,1512,-122
1,9,10,3,4,1403,1603,-200
1,9,11,3,4,1383,1622,-239
1,9,12,3,4,1421,1629,-208
1,9,13,3,4,1512,1562,-50
1,9,14,3,4,1603,1422,181
1,9,15,3,4,1622,1416,206
1,9,16,3,4,1629,1381,248
1,10,0,3,4,1264,2302,-1038
1,10,1,3,4,1508,2254,-746
1,10,2,3,4,1711,2177,-466
1,10,3,3,4,2016,2058,-42
1,10,4,3,4,2302,1859,443
1,10,5,3,4,2254,1716,538
1,10,6,3,4,2177,1742,435
1,10,7,3,4,2058,1713,345
1,10,8,3,4,1859,1778,81
1,10,9,3,4,1716,1969,-253
1,10,10,3,4,1742,2149,-407
1,10,11,3,4,1713,2234,-521
1,10,12,3,4,1778,2310,-532
1,10,13,3,4,1969,2218,-249
1,10,14,3,4,2149,2043,106
1,10,15,3,4,2234,2018,216
1,10,16,3,4,2310,1836,474
1,11,0,3,4,1518,2599,-1081
1,11,1,3,4,1759,2619,-860
1,11,2,3,4,1982,2379,-397
1,11,3,3,4,2284,2187,97
1,11,4,3,4,2599,1886,713
1,11,5,3,4,2619,1621,998
1,11,6,3,4,2379,1639,740
1,11,7,3,4,2187,1603,584
1,11,8,3,4,1886,1722,164
1,11,9,3,4,1621,2032,-411
1,11,10,3,4,1639,2316,-677
1,11,11,3,4,1603,2540,-937
1,11,12,3,4,1722,2681,-959
1,11,13,3,4,2032,2547,-515
1,11,14,3,4,2316,2410,-94
1,11,15,3,4,2540,2377,163
1,11,16,3,4,2681,2130,551
1,12,0,3,4,1624,2522,-898
1,12,1,3,4,1775,2639,-864
1,12,2,3,4,2008,2242,-234
1,12,3,3,4,2205,2063,142
1,12,4,3,4,2522,1676,846
1,12,5,3,4,2639,1309,1330
1,12,6,3,4,2242,1317,925
1,12,7,3,4,2063,1268,795
1,12,8,3,4,1676,1438,238
1,12,9,3,4,1309,1829,-520
1,12,10,3,4,1317,2145,-828
1,12,11,3,4,1268,2495,-1227
1,12,12,3,4,1438,2672,-1234
1,12,13,3,4,1829,2479,-650
1,12,14,3,4,2145,2424,-279
1,12,15,3,4,2495,2373,122
1,12,16,3,4,2672,2144,528
1,13,0,3,4,1637,2505,-868
1,13,1,3,4,1763,2658,-895
1,13,2,3,4,2023,2184,-161
1,13,3,3,4,2168,2058,110
1,13,4,3,4,2505,1637,868
1,13,5,3,4,2658,1238,1420
1,13,6,3,4,2184,1255,929
1,13,7,3,4,2058,1185,873
1,13,8,3,4,1637,1377,260
1,13,9,3,4,1238,1798,-560
1,13,10,3,4,1255,2066,-811
1,13,11,3,4,1185,2480,-1295
1,13,12,3,4,1377,2657,-1280
1,13,13,3,4,1798,2391,-593
1,13,14,3,4,2066,2404,-338
1,13,15,3,4,2480,2293,187
1,13,16,3,4,2657,2073,584
1,14,0,3,4,1515,2508,-993
1,14,1,3,4,1711,2619,-908
1,14,2,3,4,2012,2156,-144
1,14,3,3,4,2152,2081,71
1,14,4,3,4,2508,1646,862
1,14,5,3,4,2619,1274,1345
1,14,6,3,4,2156,1300,856
1,14,7,3,4,2081,1226,855
1,14,8,3,4,1646,1434,212
1,14,9,3,4,1274,1843,-569
1,14,10,3,4,1300,2048,-748
1,14,11,3,4,1226,2426,-1200
1,14,12,3,4,1434,2590,-1156
1,14,13,3,4,1843,2298,-455
1,14,14,3,4,2048,2338,-290
1,14,15,3,4,2426,2176,250
1,14,16,3,4,2590,1958,632
1,15,0,3,4,1349,2445,-1096
1,15,1,3,4,1620,2485,-865
1,15,2,3,4,1952,2056,-104
1,15,3,3,4,2113,1995,118
1,15,4,3,4,2445,1534,911
1,15,5,3,4,2485,1176,1309
1,15,6,3,4,2056,1202,854
1,15,7,3,4,1995,1102,893
1,15,8,3,4,1534,1321,213
1,15,9,3,4,1176,1757,-581
1,15,10,3,4,1202,1972,-770
1,15,11,3,4,1102,2238,-1136
1,15,12,3,4,1321,2364,-1043
1,15,13,3,4,1757,2092,-335
1,15,14,3,4,1972,2122,-150
1,15,15,3,4,2238,2007,231
1,15,16,3,4,2364,1843,521
1,16,0,3,4,1282,2201,-919
1,16,1,3,4,1608,2084,-476
1,16,2,3,4,1946,1716,230
1,16,3,3,4,2043,1707,336
1,16,4,3,4,2201,1345,856
1,16,5,3,4,2084,1115,969
1,16,6,3,4,1716,1134,582
1,16,7,3,4,1707,1094,613
1,16,8,3,4,1345,1245,100
1,16,9,3,4,1115,1491,-376
1,16,10,3,4,1134,1710,-576
1,16,11,3,4,1094,1785,-691
1,16,12,3,4,1245,1891,-646
1,16,13,3,4,1491,1858,-367
1,16,14,3,4,1710,1867,-157
1,16,15,3,4,1785,1821,-36
1,16,16,3,4,1891,1735,156
1,17,0,3,4,1484,1736,-252
1,17,1,3,4,1639,1656,-17
1,17,2,3,4,1832,1473,359
1,17,3,3,4,1842,1563,279
1,17,4,3,4,1736,1387,349
1,17,5,3,4,1656,1240,416
1,17,6,3,4,1473,1288,185
1,17,7,3,4,1563,1219,344
1,17,8,3,4,1387,1224,163
1,17,9,3,4,1240,1373,-133
1,17,10,3,4,1288,1585,-297
1,17,11,3,4,1219,1528,-309
1,17,12,3,4,1224,1589,-365
1,17,13,3,4,1373,1643,-270
1,17,14,3,4,1585,1525,60
1,17,15,3,4,1528,1556,-28
1,17,16,3,4,1589,1685,-96
1,18,0,3,4,1656,1387,269
1,18,1,3,4,1619,1465,154
1,18,2,3,4,1663,1491,172
1,18,3,3,4,1629,1663,-34
1,18,4,3,4,1387,1592,-205
1,18,5,3,4,1465,1466,-1
1,18,6,3,4,1491,1516,-25
1,18,7,3,4,1663,1427,236
1,18,8,3,4,1592,1314,278
1,18,9,3,4,1466,1290,176
1,18,10,3,4,1516,1398,118
1,18,11,3,4,1427,1291,136
1,18,12,3,4,1314,1334,-20
1,18,13,3,4,1290,1481,-191
1,18,14,3,4,1398,1283,115
1,18,15,3,4,1291,1303,-12
1,18,16,3,4,1334,1571,-237
1,19,0,3,4,1781,1009,772
1,19,1,3,4,1487,1296,191
1,19,2,3,4,1404,1437,-33
1,19,3,3,4,1346,1571,-225
1,19,4,3,4,1009,1504,-495
1,19,5,3,4,1296,1326,-30
1,19,6,3,4,1437,1369,68
1,19,7,3,4,1571,1250,321
1,19,8,3,4,1504,1150,354
1,19,9,3,4,1326,1121,205
1,19,10,3,4,1369,1180,189
1,19,11,3,4,1250,1134,116
1,19,12,3,4,1150,1163,-13
1,19,13,3,4,1121,1235,-114
1,19,14,3,4,1180,1050,130
1,19,15,3,4,1134,1103,31
1,19,16,3,4,1163,1464,-301
1,20,0,3,4,1530,845,685
1,20,1,3,4,1239,1186,53
1,20,2,3,4,1129,1296,-167
1,20,3,3,4,1072,1369,-297
1,20,4,3,4,845,1236,-391
1,20,5,3,4,1186,1052,134
1,20,6,3,4,1296,1095,201
1,20,7,3,4,1369,987,382
1,20,8,3,4,1236,990,246
1,20,9,3,4,1052,927,125
1,20,10,3,4,1095,922,173
1,20,11,3,4,987,904,83
1,20,12,3,4,990,895,95
1,20,13,3,4,927,914,13
1,20,14,3,4,922,842,80
1,20,15,3,4,904,924,-20
1,20,16,3,4,895,1145,-250
1,21,0,3,4,1269,715,554
1,21,1,3,4,1029,966,63
1,21,2,3,4,948,1020,-72
1,21,3,3,4,880,1020,-140
1,21,4,3,4,715,926,-211
1,21,5,3,4,966,840,126
1,21,6,3,4,1020,861,159
1,21,7,3,4,1020,859,161
1,21,8,3,4,926,941,-15
1,21,9,3,4,840,867,-27
1,21,10,3,4,861,865,-4
1,21,11,3,4,859,833,26
1,21,12,3,4,941,798,143
1,21,13,3,4,867,739,128
1,21,14,3,4,865,708,157
1,21,15,3,4,833,815,18
1,21,16,3,4,798,879,-81
1,0,0,4,4,1725,1759,-34
1,0,1,4,4,1736,1713,23
1,0,2,4,4,1728,1662,66
1,0,3,4,4,1729,1617,112
1,0,4,4,4,1759,1546,213
1,0,5,4,4,1713,1520,193
1,0,6,4,4,1662,1507,155
1,0,7,4,4,1617,1510,107
1,0,8,4,4,1546,1525,21
1,0,9,4,4,1520,1572,-52
1,0,10,4,4,1507,1611,-104
1,0,11,4,4,1510,1667,-157
1,0,12,4,4,1525,1715,-190
1,0,13,4,4,1572,1704,-132
1,0,14,4,4,1611,1715,-104
1,0,15,4,4,1667,1724,-57
1,0,16,4,4,1715,1707,8
1,1,0,4,4,1776,1743,33
1,1,1,4,4,1798,1632,166
1,1,2,4,4,1787,1520,267
1,1,3,4,4,1760,1431,329
1,1,4,4,4,1743,1333,410
1,1,5,4,4,1632,1299,333
1,1,6,4,4,1520,1280,240
1,1,7,4,4,1431,1280,151
1,1,8,4,4,1333,1295,38
1,1,9,4,4,1299,1361,-62
1,1,10,4,4,1280,1431,-151
1,1,11,4,4,1280,1540,-260
1,1,12,4,4,1295,1660,-365
1,1,13,4,4,1361,1705,-344
1,1,14,4,4,1431,1750,-319
1,1,15,4,4,1540,1767,-227
1,1,16,4,4,1660,1743,-83
1,2,0,4,4,1821,1656,165
1,2,1,4,4,1848,1493,355
1,2,2,4,4,1827,1342,485
1,2,3,4,4,1754,1249,505
1,2,4,4,4,1656,1181,475
1,2,5,4,4,1493,1148,345
1,2,6,4,4,1342,1128,214
1,2,7,4,4,1249,1125,124
1,2,8,4,4,1181,1137,44
1,2,9,4,4,1148,1181,-33
1,2,10,4,4,1128,1241,-113
1,2,11,4,4,1125,1367,-242
1,2,12,4,4,1137,1533,-396
1,2,13,4,4,1181,1653,-472
1,2,14,4,4,1241,1755,-514
1,2,15,4,4,1367,1799,-432
1,2,16,4,4,1533,1776,-243
1,3,0,4,4,1823,1506,317
1,3,1,4,4,1813,1320,493
1,3,2,4,4,1757,1151,606
1,3,3,4,4,1646,1059,587
1,3,4,4,4,1506,1013,493
1,3,5,4,4,1320,989,331
1,3,6,4,4,1151,974,177
1,3,7,4,4,1059,969,90
1,3,8,4,4,1013,976,37
1,3,9,4,4,989,1017,-28
1,3,10,4,4,974,1073,-99
1,3,11,4,4,969,1203,-234
1,3,12,4,4,976,1392,-416
1,3,13,4,4,1017,1546,-529
1,3,14,4,4,1073,1688,-615
1,3,15,4,4,1203,1771,-568
1,3,16,4,4,1392,1777,-385
1,4,0,4,4,1773,1336,437
1,4,1,4,4,1673,1245,428
1,4,2,4,4,1551,1161,390
1,4,3,4,4,1430,1130,300
1,4,4,4,4,1336,1130,206
1,4,5,4,4,1245,1120,125
1,4,6,4,4,1161,1113,48
1,4,7,4,4,1130,1109,21
1,4,8,4,4,1130,1109,21
1,4,9,4,4,1120,1122,-2
1,4,10,4,4,1113,1128,-15
1,4,11,4,4,1109,1188,-79
1,4,12,4,4,1109,1304,-195
1,4,13,4,4,1122,1414,-292
1,4,14,4,4,1128,1551,-423
1,4,15,4,4,1188,1671,-483
1,4,16,4,4,1304,1735,-431
1,5,0,4,4,1777,1333,444
1,5,1,4,4,1602,1378,224
1,5,2,4,4,1432,1404,28
1,5,3,4,4,1345,1414,-69
1,5,4,4,4,1333,1461,-128
1,5,5,4,4,1378,1480,-102
1,5,6,4,4,1404,1490,-86
1,5,7,4,4,1414,1495,-81
1,5,8,4,4,1461,1493,-32
1,5,9,4,4,1480,1479,1
1,5,10,4,4,1490,1440,50
1,5,11,4,4,1495,1432,63
1,5,12,4,4,1493,1428,65
1,5,13,4,4,1479,1447,32
1,5,14,4,4,1440,1546,-106
1,5,15,4,4,1432,1648,-216
1,5,16,4,4,1428,1763,-335
1,6,0,4,4,1589,1198,391
1,6,1,4,4,1338,1322,16
1,6,2,4,4,1167,1375,-208
1,6,3,4,4,1106,1372,-266
1,6,4,4,4,1198,1362,-164
1,6,5,4,4,1322,1360,-38
1,6,6,4,4,1375,1360,15
1,6,7,4,4,1372,1365,7
1,6,8,4,4,1362,1379,-17
1,6,9,4,4,1360,1395,-35
1,6,10,4,4,1360,1401,-41
1,6,11,4,4,1365,1408,-43
1,6,12,4,4,1379,1357,22
1,6,13,4,4,1395,1307,88
1,6,14,4,4,1401,1339,62
1,6,15,4,4,1408,1422,-14
1,6,16,4,4,1357,1592,-235
1,7,0,4,4,1431,1450,-19
1,7,1,4,4,1257,1586,-329
1,7,2,4,4,1202,1662,-460
1,7,3,4,4,1246,1666,-420
1,7,4,4,4,1450,1607,-157
1,7,5,4,4,1586,1588,-2
1,7,6,4,4,1662,1592,70
1,7,7,4,4,1666,1590,76
1,7,8,4,4,1607,1615,-8
1,7,9,4,4,1588,1643,-55
1,7,10,4,4,1592,1669,-77
1,7,11,4,4,1590,1661,-71
1,7,12,4,4,1615,1582,33
1,7,13,4,4,1643,1482,161
1,7,14,4,4,1669,1406,263
1,7,15,4,4,1661,1431,230
1,7,16,4,4,1582,1559,23
1,8,0,4,4,1489,2047,-558
1,8,1,4,4,1519,2091,-572
1,8,2,4,4,1607,2131,-524
1,8,3,4,4,1792,2091,-299
1,8,4,4,4,2047,1986,61
1,8,5,4,4,2091,1938,153
1,8,6,4,4,2131,1962,169
1,8,7,4,4,2091,1950,141
1,8,8,4,4,1986,1989,-3
1,8,9,4,4,1938,2068,-130
1,8,10,4,4,1962,2144,-182
1,8,11,4,4,1950,2154,-204
1,8,12,4,4,1989,2116,-127
1,8,13,4,4,2068,2014,54
1,8,14,4,4,2144,1871,273
1,8,15,4,4,2154,1854,300
1,8,16,4,4,2116,1857,259
1,9,0,4,4,1551,2509,-958
1,9,1,4,4,1730,2484,-754
1,9,2,4,4,1919,2393,-474
1,9,3,4,4,2199,2259,-60
1,9,4,4,4,2509,2029,480
1,9,5,4,4,2484,1861,623
1,9,6,4,4,2393,1874,519
1,9,7,4,4,2259,1843,416
1,9,8,4,4,2029,1925,104
1,9,9,4,4,1861,2136,-275
1,9,10,4,4,1874,2354,-480
1,9,11,4,4,1843,2470,-627
1,9,12,4,4,1925,2540,-615
1,9,13,4,4,2136,2440,-304
1,9,14,4,4,2354,2259,95
1,9,15,4,4,2470,2252,218
1,9,16,4,4,2540,2126,414
1,10,0,4,4,1802,3145,-1343
1,10,1,4,4,2087,3159,-1072
1,10,2,4,4,2384,2929,-545
1,10,3,4,4,2749,2746,3
1,10,4,4,4,3145,2407,738
1,10,5,4,4,3159,2125,1034
1,10,6,4,4,2929,2147,782
1,10,7,4,4,2746,2103,643
1,10,8,4,4,2407,2232,175
1,10,9,4,4,2125,2562,-437
1,10,10,4,4,2147,2863,-716
1,10,11,4,4,2103,3075,-972
1,10,12,4,4,2232,3207,-975
1,10,13,4,4,2562,3043,-481
1,10,14,4,4,2863,2839,24
1,10,15,4,4,3075,2793,282
1,10,16,4,4,3207,2532,675
1,11,0,4,4,2076,3403,-1327
1,11,1,4,4,2341,3483,-1142
1,11,2,4,4,2649,3089,-440
1,11,3,4,4,2979,2881,98
1,11,4,4,4,3403,2442,961
1,11,5,4,4,3483,2050,1433
1,11,6,4,4,3089,2080,1009
1,11,7,4,4,2881,2021,860
1,11,8,4,4,2442,2202,240
1,11,9,4,4,2050,2644,-594
1,11,10,4,4,2080,2996,-916
1,11,11,4,4,2021,3346,-1325
1,11,12,4,4,2202,3545,-1343
1,11,13,4,4,2644,3323,-679
1,11,14,4,4,2996,3201,-205
1,11,15,4,4,3346,3139,207
1,11,16,4,4,3545,2833,712
1,12,0,4,4,2165,3380,-1215
1,12,1,4,4,2377,3528,-1151
1,12,2,4,4,2691,2964,-273
1,12,3,4,4,2945,2739,206
1,12,4,4,4,3380,2209,1171
1,12,5,4,4,3528,1709,1819
1,12,6,4,4,2964,1726,1238
1,12,7,4,4,2739,1645,1094
1,12,8,4,4,2209,1881,328
1,12,9,4,4,1709,2422,-713
1,12,10,4,4,1726,2817,-1091
1,12,11,4,4,1645,3328,-1683
1,12,12,4,4,1881,3568,-1687
1,12,13,4,4,2422,3269,-847
1,12,14,4,4,2817,3241,-424
1,12,15,4,4,3328,3129,199
1,12,16,4,4,3568,2818,750
1,13,0,4,4,2053,3351,-1298
1,13,1,4,4,2290,3524,-1234
1,13,2,4,4,2685,2908,-223
1,13,3,4,4,2885,2769,116
1,13,4,4,4,3351,2194,1157
1,13,5,4,4,3524,1683,1841
1,13,6,4,4,2908,1705,1203
1,13,7,4,4,2769,1616,1153
1,13,8,4,4,2194,1888,306
1,13,9,4,4,1683,2436,-753
1,13,10,4,4,1705,2762,-1057
1,13,11,4,4,1616,3267,-1651
1,13,12,4,4,1888,3487,-1599
1,13,13,4,4,2436,3123,-687
1,13,14,4,4,2762,3134,-372
1,13,15,4,4,3267,2951,316
1,13,16,4,4,3487,2654,833
1,14,0,4,4,1907,3249,-1342
1,14,1,4,4,2202,3349,-1147
1,14,2,4,4,2619,2766,-147
1,14,3,4,4,2808,2689,119
1,14,4,4,4,3249,2090,1159
1,14,5,4,4,3349,1605,1744
1,14,6,4,4,2766,1643,1123
1,14,7,4,4,2689,1520,1169
1,14,8,4,4,2090,1801,289
1,14,9,4,4,1605,2369,-764
1,14,10,4,4,1643,2652,-1009
1,14,11,4,4,1520,3044,-1524
1,14,12,4,4,1801,3228,-1427
1,14,13,4,4,2369,2868,-499
1,14,14,4,4,2652,2913,-261
1,14,15,4,4,3044,2769,275
1,14,16,4,4,3228,2546,682
1,15,0,4,4,1823,3059,-1236
1,15,1,4,4,2210,2973,-763
1,15,2,4,4,2629,2438,191
1,15,3,4,4,2783,2383,400
1,15,4,4,4,3059,1878,1181
1,15,5,4,4,2973,1515,1458
1,15,6,4,4,2438,1543,895
1,15,7,4,4,2383,1471,912
1,15,8,4,4,1878,1688,190
1,15,9,4,4,1515,2084,-569
1,15,10,4,4,1543,2382,-839
1,15,11,4,4,1471,2618,-1147
1,15,12,4,4,1688,2787,-1099
1,15,13,4,4,2084,2648,-564
1,15,14,4,4,2382,2684,-302
1,15,15,4,4,2618,2577,41
1,15,16,4,4,2787,2409,378
1,16,0,4,4,1900,2582,-682
1,16,1,4,4,2166,2522,-356
1,16,2,4,4,2494,2197,297
1,16,3,4,4,2559,2274,285
1,16,4,4,4,2582,1944,638
1,16,5,4,4,2522,1685,837
1,16,6,4,4,2197,1738,459
1,16,7,4,4,2274,1650,624
1,16,8,4,4,1944,1735,209
1,16,9,4,4,1685,2011,-326
1,16,10,4,4,1738,2281,-543
1,16,11,4,4,1650,2315,-665
1,16,12,4,4,1735,2419,-684
1,16,13,4,4,2011,2375,-364
1,16,14,4,4,2281,2255,26
1,16,15,4,4,2315,2214,101
1,16,16,4,4,2419,2266,153
1,17,0,4,4,2048,2128,-80
1,17,1,4,4,2110,2195,-85
1,17,2,4,4,2270,2101,169
1,17,3,4,4,2285,2271,14
1,17,4,4,4,2128,2036,92
1,17,5,4,4,2195,1797,398
1,17,6,4,4,2101,1859,242
1,17,7,4,4,2271,1721,550
1,17,8,4,4,2036,1681,355
1,17,9,4,4,1797,1816,-19
1,17,10,4,4,1859,2002,-143
1,17,11,4,4,1721,1909,-188
1,17,12,4,4,1681,1972,-291
1,17,13,4,4,1816,2051,-235
1,17,14,4,4,2002,1858,144
1,17,15,4,4,1909,1896,13
1,17,16,4,4,1972,2159,-187
1,18,0,4,4,2255,1623,632
1,18,1,4,4,2077,1784,293
1,18,2,4,4,2081,1819,262
1,18,3,4,4,2016,1959,57
1,18,4,4,4,1623,1848,-225
1,18,5,4,4,1784,1665,119
1,18,6,4,4,1819,1710,109
1,18,7,4,4,1959,1619,340
1,18,8,4,4,1848,1517,331
1,18,9,4,4,1665,1448,217
1,18,10,4,4,1710,1590,120
1,18,11,4,4,1619,1514,105
1,18,12,4,4,1517,1586,-69
1,18,13,4,4,1448,1791,-343
1,18,14,4,4,1590,1612,-22
1,18,15,4,4,1514,1673,-159
1,18,16,4,4,1586,2030,-444
1,19,0,4,4,2148,1226,922
1,19,1,4,4,1797,1624,173
1,19,2,4,4,1677,1777,-100
1,19,3,4,4,1588,1936,-348
1,19,4,4,4,1226,1835,-609
1,19,5,4,4,1624,1622,2
1,19,6,4,4,1777,1699,78
1,19,7,4,4,1936,1543,393
1,19,8,4,4,1835,1480,355
1,19,9,4,4,1622,1447,175
1,19,10,4,4,1699,1493,206
1,19,11,4,4,1543,1434,109
1,19,12,4,4,1480,1423,57
1,19,13,4,4,1447,1431,16
1,19,14,4,4,1493,1230,263
1,19,15,4,4,1434,1317,117
1,19,16,4,4,1423,1676,-253
1,20,0,4,4,1833,1107,726
1,20,1,4,4,1500,1505,-5
1,20,2,4,4,1386,1648,-262
1,20,3,4,4,1323,1728,-405
1,20,4,4,4,1107,1575,-468
1,20,5,4,4,1505,1397,108
1,20,6,4,4,1648,1432,216
1,20,7,4,4,1728,1361,367
1,20,8,4,4,1575,1398,177
1,20,9,4,4,1397,1310,87
1,20,10,4,4,1432,1282,150
1,20,11,4,4,1361,1214,147
1,20,12,4,4,1398,1181,217
1,20,13,4,4,1310,1147,163
1,20,14,4,4,1282,1041,241
1,20,15,4,4,1214,1155,59
1,20,16,4,4,1181,1353,-172
1,0,0,5,4,2187,2175,12
1,0,1,5,4,2210,2057,153
1,0,2,5,4,2203,1937,266
1,0,3,5,4,2184,1846,338
1,0,4,5,4,2175,1744,431
1,0,5,5,4,2057,1708,349
1,0,6,5,4,1937,1689,248
1,0,7,5,4,1846,1691,155
1,0,8,5,4,1744,1709,35
1,0,9,5,4,1708,1771,-63
1,0,10,5,4,1689,1840,-151
1,0,11,5,4,1691,1955,-264
1,0,12,5,4,1709,2078,-369
1,0,13,5,4,1771,2123,-352
1,0,14,5,4,1840,2169,-329
1,0,15,5,4,1955,2185,-230
1,0,16,5,4,2078,2155,-77
1,1,0,5,4,2251,2085,166
1,1,1,5,4,2284,1918,366
1,1,2,5,4,2260,1765,495
1,1,3,5,4,2182,1674,508
1,1,4,5,4,2085,1602,483
1,1,5,5,4,1918,1564,354
1,1,6,5,4,1765,1542,223
1,1,7,5,4,1674,1540,134
1,1,8,5,4,1602,1556,46
1,1,9,5,4,1564,1612,-48
1,1,10,5,4,1542,1675,-133
1,1,11,5,4,1540,1800,-260
1,1,12,5,4,1556,1961,-405
1,1,13,5,4,1612,2067,-455
1,1,14,5,4,1675,2173,-498
1,1,15,5,4,1800,2227,-427
1,1,16,5,4,1961,2204,-243
1,2,0,5,4,2263,1950,313
1,2,1,5,4,2257,1769,488
1,2,2,5,4,2194,1605,589
1,2,3,5,4,2079,1514,565
1,2,4,5,4,1950,1457,493
1,2,5,5,4,1769,1424,345
1,2,6,5,4,1605,1404,201
1,2,7,5,4,1514,1400,114
1,2,8,5,4,1457,1411,46
1,2,9,5,4,1424,1463,-39
1,2,10,5,4,1404,1520,-116
1,2,11,5,4,1400,1649,-249
1,2,12,5,4,1411,1834,-423
1,2,13,5,4,1463,1974,-511
1,2,14,5,4,1520,2117,-597
1,2,15,5,4,1649,2206,-557
1,2,16,5,4,1834,2211,-377
1,3,0,5,4,2217,1790,427
1,3,1,5,4,2117,1659,458
1,3,2,5,4,1993,1529,464
1,3,3,5,4,1874,1452,422
1,3,4,5,4,1790,1400,390
1,3,5,5,4,1659,1380,279
1,3,6,5,4,1529,1367,162
1,3,7,5,4,1452,1362,90
1,3,8,5,4,1400,1366,34
1,3,9,5,4,1380,1407,-27
1,3,10,5,4,1367,1449,-82
1,3,11,5,4,1362,1561,-199
1,3,12,5,4,1366,1731,-365
1,3,13,5,4,1407,1858,-451
1,3,14,5,4,1449,2000,-551
1,3,15,5,4,1561,2114,-553
1,3,16,5,4,1731,2168,-437
1,4,0,5,4,2239,1749,490
1,4,1,5,4,2076,1722,354
1,4,2,5,4,1907,1679,228
1,4,3,5,4,1800,1643,157
1,4,4,5,4,1749,1659,90
1,4,5,5,4,1722,1668,54
1,4,6,5,4,1679,1672,7
1,4,7,5,4,1643,1676,-33
1,4,8,5,4,1659,1677,-18
1,4,9,5,4,1668,1678,-10
1,4,10,5,4,1672,1669,3
1,4,11,5,4,1676,1720,-44
1,4,12,5,4,1677,1791,-114
1,4,13,5,4,1678,1866,-188
1,4,14,5,4,1669,2000,-331
1,4,15,5,4,1720,2109,-389
1,4,16,5,4,1791,2211,-420
1,5,0,5,4,2064,1540,524
1,5,1,5,4,1824,1608,216
1,5,2,5,4,1640,1620,20
1,5,3,5,4,1528,1615,-87
1,5,4,5,4,1540,1631,-91
1,5,5,5,4,1608,1625,-17
1,5,6,5,4,1620,1622,-2
1,5,7,5,4,1615,1625,-10
1,5,8,5,4,1631,1640,-9
1,5,9,5,4,1625,1646,-21
1,5,10,5,4,1622,1645,-23
1,5,11,5,4,1625,1668,-43
1,5,12,5,4,1640,1658,-18
1,5,13,5,4,1646,1669,-23
1,5,14,5,4,1645,1762,-117
1,5,15,5,4,1668,1882,-214
1,5,16,5,4,1658,2053,-395
1,6,0,5,4,1873,1744,129
1,6,1,5,4,1666,1862,-196
1,6,2,5,4,1569,1925,-356
1,6,3,5,4,1571,1931,-360
1,6,4,5,4,1744,1883,-139
1,6,5,5,4,1862,1864,-2
1,6,6,5,4,1925,1868,57
1,6,7,5,4,1931,1865,66
1,6,8,5,4,1883,1889,-6
1,6,9,5,4,1864,1925,-61
1,6,10,5,4,1868,1948,-80
1,6,11,5,4,1865,1943,-78
1,6,12,5,4,1889,1883,6
1,6,13,5,4,1925,1803,122
1,6,14,5,4,1948,1768,180
1,6,15,5,4,1943,1838,105
1,6,16,5,4,1883,1994,-111
1,7,0,5,4,1883,2331,-448
1,7,1,5,4,1823,2430,-607
1,7,2,5,4,1843,2509,-666
1,7,3,5,4,2020,2484,-464
1,7,4,5,4,2331,2373,-42
1,7,5,5,4,2430,2329,101
1,7,6,5,4,2509,2355,154
1,7,7,5,4,2484,2343,141
1,7,8,5,4,2373,2379,-6
1,7,9,5,4,2329,2458,-129
1,7,10,5,4,2355,2520,-165
1,7,11,5,4,2343,2512,-169
1,7,12,5,4,2379,2455,-76
1,7,13,5,4,2458,2326,132
1,7,14,5,4,2520,2183,337
1,7,15,5,4,2512,2197,315
1,7,16,5,4,2455,2248,207
1,8,0,5,4,2017,2922,-905
1,8,1,5,4,2133,2961,-828
1,8,2,5,4,2275,2911,-636
1,8,3,5,4,2569,2772,-203
1,8,4,5,4,2922,2558,364
1,8,5,5,4,2961,2409,552
1,8,6,5,4,2911,2433,478
1,8,7,5,4,2772,2410,362
1,8,8,5,4,2558,2493,65
1,8,9,5,4,2409,2692,-283
1,8,10,5,4,2433,2895,-462
1,8,11,5,4,2410,3002,-592
1,8,12,5,4,2493,3027,-534
1,8,13,5,4,2692,2892,-200
1,8,14,5,4,2895,2708,187
1,8,15,5,4,3002,2690,312
1,8,16,5,4,3027,2602,425
1,9,0,5,4,2089,3352,-1263
1,9,1,5,4,2309,3389,-1080
1,9,2,5,4,2592,3145,-553
1,9,3,5,4,2932,2947,-15
1,9,4,5,4,3352,2577,775
1,9,5,5,4,3389,2270,1119
1,9,6,5,4,3145,2279,866
1,9,7,5,4,2947,2233,714
1,9,8,5,4,2577,2379,198
1,9,9,5,4,2270,2729,-459
1,9,10,5,4,2279,3068,-789
1,9,11,5,4,2233,3311,-1078
1,9,12,5,4,2379,3437,-1058
1,9,13,5,4,2729,3265,-536
1,9,14,5,4,3068,3055,13
1,9,15,5,4,3311,3027,284
1,9,16,5,4,3437,2822,615
1,10,0,5,4,2360,3949,-1589
1,10,1,5,4,2669,4023,-1354
1,10,2,5,4,3051,3639,-588
1,10,3,5,4,3444,3440,4
1,10,4,5,4,3949,2963,986
1,10,5,5,4,4023,2554,1469
1,10,6,5,4,3639,2588,1051
1,10,7,5,4,3440,2521,919
1,10,8,5,4,2963,2712,251
1,10,9,5,4,2554,3174,-620
1,10,10,5,4,2588,3543,-955
1,10,11,5,4,2521,3881,-1360
1,10,12,5,4,2712,4071,-1359
1,10,13,5,4,3174,3819,-645
1,10,14,5,4,3543,3630,-87
1,10,15,5,4,3881,3555,326
1,10,16,5,4,4071,3235,836
1,11,0,5,4,2617,4261,-1644
1,11,1,5,4,2943,4372,-1429
1,11,2,5,4,3332,3811,-479
1,11,3,5,4,3719,3557,162
1,11,4,5,4,4261,2975,1286
1,11,5,5,4,4372,2450,1922
1,11,6,5,4,3811,2489,1322
1,11,7,5,4,3557,2398,1159
1,11,8,5,4,2975,2645,330
1,11,9,5,4,2450,3237,-787
1,11,10,5,4,2489,3668,-1179
1,11,11,5,4,2398,4179,-1781
1,11,12,5,4,2645,4441,-1796
1,11,13,5,4,3237,4113,-876
1,11,14,5,4,3668,4018,-350
1,11,15,5,4,4179,3895,284
1,11,16,5,4,4441,3507,934
1,12,0,5,4,2581,4226,-1645
1,12,1,5,4,2904,4394,-1490
1,12,2,5,4,3353,3688,-335
1,12,3,5,4,3662,3450,212
1,12,4,5,4,4226,2766,1460
1,12,5,5,4,4394,2154,2240
1,12,6,5,4,3688,2176,1512
1,12,7,5,4,3450,2076,1374
1,12,8,5,4,2766,2392,374
1,12,9,5,4,2154,3060,-906
1,12,10,5,4,2176,3513,-1337
1,12,11,5,4,2076,4115,-2039
1,12,12,5,4,2392,4398,-2006
1,12,13,5,4,3060,4001,-941
1,12,14,5,4,3513,3971,-458
1,12,15,5,4,4115,3787,328
1,12,16,5,4,4398,3399,999
1,13,0,5,4,2445,4092,-1647
1,13,1,5,4,2781,4254,-1473
1,13,2,5,4,3292,3518,-226
1,13,3,5,4,3541,3377,164
1,13,4,5,4,4092,2638,1454
1,13,5,5,4,4254,2014,2240
1,13,6,5,4,3518,2048,1470
1,13,7,5,4,3377,1910,1467
1,13,8,5,4,2638,2255,383
1,13,9,5,4,2014,2962,-948
1,13,10,5,4,2048,3366,-1318
1,13,11,5,4,1910,3885,-1975
1,13,12,5,4,2255,4125,-1870
1,13,13,5,4,2962,3693,-731
1,13,14,5,4,3366,3709,-343
1,13,15,5,4,3885,3544,341
1,13,16,5,4,4125,3242,883
1,14,0,5,4,2381,3863,-1482
1,14,1,5,4,2792,3837,-1045
1,14,2,5,4,3296,3148,148
1,14,3,5,4,3478,3077,401
1,14,4,5,4,3863,2434,1429
1,14,5,5,4,3837,1944,1893
1,14,6,5,4,3148,1984,1164
1,14,7,5,4,3077,1889,1188
1,14,8,5,4,2434,2168,266
1,14,9,5,4,1944,2696,-752
1,14,10,5,4,1984,3062,-1078
1,14,11,5,4,1889,3424,-1535
1,14,12,5,4,2168,3651,-1483
1,14,13,5,4,2696,3424,-728
1,14,14,5,4,3062,3475,-413
1,14,15,5,4,3424,3339,85
1,14,16,5,4,3651,3112,539
1,15,0,5,4,2441,3440,-999
1,15,1,5,4,2768,3411,-643
1,15,2,5,4,3177,2919,258
1,15,3,5,4,3299,2950,349
1,15,4,5,4,3440,2477,963
1,15,5,5,4,3411,2085,1326
1,15,6,5,4,2919,2147,772
1,15,7,5,4,2950,2027,923
1,15,8,5,4,2477,2178,299
1,15,9,5,4,2085,2604,-519
1,15,10,5,4,2147,2953,-806
1,15,11,5,4,2027,3148,-1121
1,15,12,5,4,2178,3315,-1137
1,15,13,5,4,2604,3165,-561
1,15,14,5,4,2953,3072,-119
1,15,15,5,4,3148,2970,178
1,15,16,5,4,3315,2940,375
1,16,0,5,4,2464,2974,-510
1,16,1,5,4,2637,3061,-424
1,16,2,5,4,2932,2825,107
1,16,3,5,4,3002,2982,20
1,16,4,5,4,2974,2593,381
1,16,5,5,4,3061,2242,819
1,16,6,5,4,2825,2309,516
1,16,7,5,4,2982,2152,830
1,16,8,5,4,2593,2192,401
1,16,9,5,4,2242,2454,-212
1,16,10,5,4,2309,2698,-389
1,16,11,5,4,2152,2696,-544
1,16,12,5,4,2192,2802,-610
1,16,13,5,4,2454,2783,-329
1,16,14,5,4,2698,2588,110
1,16,15,5,4,2696,2554,142
1,16,16,5,4,2802,2740,62
1,17,0,5,4,2647,2364,283
1,17,1,5,4,2568,2514,54
1,17,2,5,4,2688,2429,259
1,17,3,5,4,2672,2567,105
1,17,4,5,4,2364,2292,72
1,17,5,5,4,2514,1996,518
1,17,6,5,4,2429,2053,376
1,17,7,5,4,2567,1913,654
1,17,8,5,4,2292,1884,408
1,17,9,5,4,1996,1974,22
1,17,10,5,4,2053,2194,-141
1,17,11,5,4,1913,2132,-219
1,17,12,5,4,1884,2224,-340
1,17,13,5,4,1974,2361,-387
1,17,14,5,4,2194,2187,7
1,17,15,5,4,2132,2266,-134
1,17,16,5,4,2224,2618,-394
1,18,0,5,4,2622,1840,782
1,18,1,5,4,2387,2112,275
1,18,2,5,4,2354,2159,195
1,18,3,5,4,2258,2324,-66
1,18,4,5,4,1840,2179,-339
1,18,5,5,4,2112,1961,151
1,18,6,5,4,2159,2040,119
1,18,7,5,4,2324,1912,412
1,18,8,5,4,2179,1847,332
1,18,9,5,4,1961,1774,187
1,18,10,5,4,2040,1903,137
1,18,11,5,4,1912,1814,98
1,18,12,5,4,1847,1846,1
1,18,13,5,4,1774,1987,-213
1,18,14,5,4,1903,1792,111
1,18,15,5,4,1814,1887,-73
1,18,16,5,4,1846,2242,-396
1,19,0,5,4,2451,1488,963
1,19,1,5,4,2058,1943,115
1,19,2,5,4,1934,2129,-195
1,19,3,5,4,1839,2295,-456
1,19,4,5,4,1488,2174,-686
1,19,5,5,4,1943,1967,-24
1,19,6,5,4,2129,2036,93
1,19,7,5,4,2295,1917,378
1,19,8,5,4,2174,1888,286
1,19,9,5,4,1967,1830,137
1,19,10,5,4,2036,1853,183
1,19,11,5,4,1917,1744,173
1,19,12,5,4,1888,1709,179
1,19,13,5,4,1830,1664,166
1,19,14,5,4,1853,1429,424
1,19,15,5,4,1744,1548,196
1,19,16,5,4,1709,1884,-175
1,0,0,6,4,2662,2517,145
1,0,1,6,4,2696,2343,353
1,0,2,6,4,2676,2182,494
1,0,3,6,4,2606,2089,517
1,0,4,6,4,2517,2013,504
1,0,5,6,4,2343,1973,370
1,0,6,6,4,2182,1951,231
1,0,7,6,4,2089,1951,138
1,0,8,6,4,2013,1970,43
1,0,9,6,4,1973,2022,-49
1,0,10,6,4,1951,2084,-133
1,0,11,6,4,1951,2215,-264
1,0,12,6,4,1970,2379,-409
1,0,13,6,4,2022,2485,-463
1,0,14,6,4,2084,2592,-508
1,0,15,6,4,2215,2645,-430
1,0,16,6,4,2379,2616,-237
1,1,0,6,4,2693,2379,314
1,1,1,6,4,2693,2194,499
1,1,2,6,4,2627,2028,599
1,1,3,6,4,2507,1939,568
1,1,4,6,4,2379,1878,501
1,1,5,6,4,2194,1840,354
1,1,6,6,4,2028,1818,210
1,1,7,6,4,1939,1815,124
1,1,8,6,4,1878,1830,48
1,1,9,6,4,1840,1894,-54
1,1,10,6,4,1818,1954,-136
1,1,11,6,4,1815,2082,-267
1,1,12,6,4,1830,2262,-432
1,1,13,6,4,1894,2388,-494
1,1,14,6,4,1954,2535,-581
1,1,15,6,4,2082,2634,-552
1,1,16,6,4,2262,2639,-377
1,2,0,6,4,2657,2234,423
1,2,1,6,4,2561,2108,453
1,2,2,6,4,2430,1983,447
1,2,3,6,4,2307,1907,400
1,2,4,6,4,2234,1844,390
1,2,5,6,4,2108,1815,293
1,2,6,6,4,1983,1797,186
1,2,7,6,4,1907,1793,114
1,2,8,6,4,1844,1801,43
1,2,9,6,4,1815,1853,-38
1,2,10,6,4,1797,1896,-99
1,2,11,6,4,1793,2007,-214
1,2,12,6,4,1801,2173,-372
1,2,13,6,4,1853,2286,-433
1,2,14,6,4,1896,2429,-533
1,2,15,6,4,2007,2549,-542
1,2,16,6,4,2173,2602,-429
1,3,0,6,4,2683,2203,480
1,3,1,6,4,2520,2136,384
1,3,2,6,4,2349,2047,302
1,3,3,6,4,2244,1965,279
1,3,4,6,4,2203,1929,274
1,3,5,6,4,2136,1928,208
1,3,6,6,4,2047,1926,121
1,3,7,6,4,1965,1929,36
1,3,8,6,4,1929,1934,-5
1,3,9,6,4,1928,1963,-35
1,3,10,6,4,1926,1990,-64
1,3,11,6,4,1929,2093,-164
1,3,12,6,4,1934,2218,-284
1,3,13,6,4,1963,2310,-347
1,3,14,6,4,1990,2449,-459
1,3,15,6,4,2093,2552,-459
1,3,16,6,4,2218,2644,-426
1,4,0,6,4,2526,1956,570
1,4,1,6,4,2298,1952,346
1,4,2,6,4,2115,1895,220
1,4,3,6,4,1983,1844,139
1,4,4,6,4,1956,1829,127
1,4,5,6,4,1952,1813,139
1,4,6,6,4,1895,1804,91
1,4,7,6,4,1844,1806,38
1,4,8,6,4,1829,1824,5
1,4,9,6,4,1813,1845,-32
1,4,10,6,4,1804,1874,-70
1,4,11,6,4,1806,1956,-150
1,4,12,6,4,1824,2021,-197
1,4,13,6,4,1845,2088,-243
1,4,14,6,4,1874,2216,-342
1,4,15,6,4,1956,2343,-387
1,4,16,6,4,2021,2501,-480
1,5,0,6,4,2348,2086,262
1,5,1,6,4,2152,2148,4
1,5,2,6,4,2042,2170,-128
1,5,3,6,4,1993,2174,-181
1,5,4,6,4,2086,2152,-66
1,5,5,6,4,2148,2129,19
1,5,6,6,4,2170,2130,40
1,5,7,6,4,2174,2125,49
1,5,8,6,4,2152,2150,2
1,5,9,6,4,2129,2176,-47
1,5,10,6,4,2130,2192,-62
1,5,11,6,4,2125,2203,-78
1,5,12,6,4,2150,2184,-34
1,5,13,6,4,2176,2165,11
1,5,14,6,4,2192,2191,1
1,5,15,6,4,2203,2298,-95
1,5,16,6,4,2184,2455,-271
1,6,0,6,4,2325,2625,-300
1,6,1,6,4,2232,2706,-474
1,6,2,6,4,2210,2772,-562
1,6,3,6,4,2345,2749,-404
1,6,4,6,4,2625,2649,-24
1,6,5,6,4,2706,2605,101
1,6,6,6,4,2772,2631,141
1,6,7,6,4,2749,2618,131
1,6,8,6,4,2649,2653,-4
1,6,9,6,4,2605,2740,-135
1,6,10,6,4,2631,2799,-168
1,6,11,6,4,2618,2794,-176
1,6,12,6,4,2653,2756,-103
1,6,13,6,4,2740,2647,93
1,6,14,6,4,2799,2545,254
1,6,15,6,4,2794,2604,190
1,6,16,6,4,2756,2683,73
1,7,0,6,4,2411,3206,-795
1,7,1,6,4,2437,3300,-863
1,7,2,6,4,2511,3289,-778
1,7,3,6,4,2797,3165,-368
1,7,4,6,4,3206,2945,261
1,7,5,6,4,3300,2800,500
1,7,6,6,4,3289,2826,463
1,7,7,6,4,3165,2803,362
1,7,8,6,4,2945,2883,62
1,7,9,6,4,2800,3082,-282
1,7,10,6,4,2826,3271,-445
1,7,11,6,4,2803,3360,-557
1,7,12,6,4,2883,3366,-483
1,7,13,6,4,3082,3204,-122
1,7,14,6,4,3271,3020,251
1,7,15,6,4,3360,3033,327
1,7,16,6,4,3366,2993,373
1,8,0,6,4,2555,3765,-1210
1,8,1,6,4,2712,3866,-1154
1,8,2,6,4,2948,3663,-715
1,8,3,6,4,3302,3460,-158
1,8,4,6,4,3765,3106,659
1,8,5,6,4,3866,2818,1048
1,8,6,6,4,3663,2838,825
1,8,7,6,4,3460,2800,660
1,8,8,6,4,3106,2947,159
1,8,9,6,4,2818,3285,-467
1,8,10,6,4,2838,3609,-771
1,8,11,6,4,2800,3843,-1043
1,8,12,6,4,2947,3924,-977
1,8,13,6,4,3285,3717,-432
1,8,14,6,4,3609,3504,105
1,8,15,6,4,3843,3465,378
1,8,16,6,4,3924,3298,626
1,9,0,6,4,2647,4156,-1509
1,9,1,6,4,2891,4253,-1362
1,9,2,6,4,3259,3855,-596
1,9,3,6,4,3627,3641,-14
1,9,4,6,4,4156,3133,1023
1,9,5,6,4,4253,2699,1554
1,9,6,6,4,3855,2720,1135
1,9,7,6,4,3641,2651,990
1,9,8,6,4,3133,2859,274
1,9,9,6,4,2699,3341,-642
1,9,10,6,4,2720,3748,-1028
1,9,11,6,4,2651,4117,-1466
1,9,12,6,4,2859,4301,-1442
1,9,13,6,4,3341,4041,-700
1,9,14,6,4,3748,3846,-98
1,9,15,6,4,4117,3789,328
1,9,16,6,4,4301,3525,776
1,10,0,6,4,2901,4807,-1906
1,10,1,6,4,3271,4912,-1641
1,10,2,6,4,3734,4361,-627
1,10,3,6,4,4184,4116,68
1,10,4,6,4,4807,3496,1311
1,10,5,6,4,4912,2954,1958
1,10,6,6,4,4361,2997,1364
1,10,7,6,4,4116,2898,1218
1,10,8,6,4,3496,3155,341
1,10,9,6,4,2954,3767,-813
1,10,10,6,4,2997,4215,-1218
1,10,11,6,4,2898,4714,-1816
1,10,12,6,4,3155,4967,-1812
1,10,13,6,4,3767,4609,-842
1,10,14,6,4,4215,4447,-232
1,10,15,6,4,4714,4311,403
1,10,16,6,4,4967,3909,1058
1,11,0,6,4,3033,5107,-2074
1,11,1,6,4,3470,5238,-1768
1,11,2,6,4,3994,4535,-541
1,11,3,6,4,4436,4268,168
1,11,4,6,4,5107,3532,1575
1,11,5,6,4,5238,2895,2343
1,11,6,6,4,4535,2939,1596
1,11,7,6,4,4268,2829,1439
1,11,8,6,4,3532,3156,376
1,11,9,6,4,2895,3875,-980
1,11,10,6,4,2939,4364,-1425
1,11,11,6,4,2829,4966,-2137
1,11,12,6,4,3156,5271,-2115
1,11,13,6,4,3875,4845,-970
1,11,14,6,4,4364,4748,-384
1,11,15,6,4,4966,4553,413
1,11,16,6,4,5271,4088,1183
1,12,0,6,4,2973,4967,-1994
1,12,1,6,4,3395,5124,-1729
1,12,2,6,4,3960,4298,-338
1,12,3,6,4,4318,4058,260
1,12,4,6,4,4967,3210,1757
1,12,5,6,4,5124,2485,2639
1,12,6,6,4,4298,2519,1779
1,12,7,6,4,4058,2370,1688
1,12,8,6,4,3210,2759,451
1,12,9,6,4,2485,3586,-1101
1,12,10,6,4,2519,4117,-1598
1,12,11,6,4,2370,4733,-2363
1,12,12,6,4,2759,5036,-2277
1,12,13,6,4,3586,4571,-985
1,12,14,6,4,4117,4546,-429
1,12,15,6,4,4733,4380,353
1,12,16,6,4,5036,3987,1049
1,13,0,6,4,2919,4706,-1787
1,13,1,6,4,3371,4742,-1371
1,13,2,6,4,3969,3900,69
1,13,3,6,4,4211,3765,446
1,13,4,6,4,4706,2982,1724
1,13,5,6,4,4742,2353,2389
1,13,6,6,4,3900,2389,1511
1,13,7,6,4,3765,2279,1486
1,13,8,6,4,2982,2622,360
1,13,9,6,4,2353,3289,-936
1,13,10,6,4,2389,3776,-1387
1,13,11,6,4,2279,4265,-1986
1,13,12,6,4,2622,4548,-1926
1,13,13,6,4,3289,4249,-960
1,13,14,6,4,3776,4271,-495
1,13,15,6,4,4265,4114,151
1,13,16,6,4,4548,3808,740
1,14,0,6,4,2999,4244,-1245
1,14,1,6,4,3350,4275,-925
1,14,2,6,4,3844,3629,215
1,14,3,6,4,3994,3644,350
1,14,4,6,4,4244,3033,1211
1,14,5,6,4,4275,2514,1761
1,14,6,6,4,3629,2588,1041
1,14,7,6,4,3644,2445,1199
1,14,8,6,4,3033,2658,375
1,14,9,6,4,2514,3216,-702
1,14,10,6,4,2588,3633,-1045
1,14,11,6,4,2445,3954,-1509
1,14,12,6,4,2658,4179,-1521
1,14,13,6,4,3216,3941,-725
1,14,14,6,4,3633,3863,-230
1,14,15,6,4,3954,3732,222
1,14,16,6,4,4179,3643,536
1,15,0,6,4,3005,3832,-827
1,15,1,6,4,3239,3950,-711
1,15,2,6,4,3615,3547,68
1,15,3,6,4,3742,3658,84
1,15,4,6,4,3832,3126,706
1,15,5,6,4,3950,2642,1308
1,15,6,6,4,3547,2718,829
1,15,7,6,4,3658,2529,1129
1,15,8,6,4,3126,2635,491
1,15,9,6,4,2642,3047,-405
1,15,10,6,4,2718,3370,-652
1,15,11,6,4,2529,3529,-1000
1,15,12,6,4,2635,3698,-1063
1,15,13,6,4,3047,3573,-526
1,15,14,6,4,3370,3405,-35
1,15,15,6,4,3529,3310,219
1,15,16,6,4,3698,3414,284
1,16,0,6,4,3063,3210,-147
1,16,1,6,4,3095,3380,-285
1,16,2,6,4,3350,3153,197
1,16,3,6,4,3389,3278,111
1,16,4,6,4,3210,2849,361
1,16,5,6,4,3380,2441,939
1,16,6,6,4,3153,2503,650
1,16,7,6,4,3278,2344,934
1,16,8,6,4,2849,2395,454
1,16,9,6,4,2441,2612,-171
1,16,10,6,4,2503,2890,-387
1,16,11,6,4,2344,2919,-575
1,16,12,6,4,2395,3054,-659
1,16,13,6,4,2612,3093,-481
1,16,14,6,4,2890,2917,-27
1,16,15,6,4,2919,2924,-5
1,16,16,6,4,3054,3199,-145
1,17,0,6,4,3014,2581,433
1,17,1,6,4,2878,2842,36
1,17,2,6,4,2961,2769,192
1,17,3,6,4,2914,2932,-18
1,17,4,6,4,2581,2623,-42
1,17,5,6,4,2842,2292,550
1,17,6,6,4,2769,2383,386
1,17,7,6,4,2932,2206,726
1,17,8,6,4,2623,2214,409
1,17,9,6,4,2292,2300,-8
1,17,10,6,4,2383,2507,-124
1,17,11,6,4,2206,2432,-226
1,17,12,6,4,2214,2484,-270
1,17,13,6,4,2300,2557,-257
1,17,14,6,4,2507,2367,140
1,17,15,6,4,2432,2480,-48
1,17,16,6,4,2484,2830,-346
1,18,0,6,4,2925,2102,823
1,18,1,6,4,2648,2431,217
1,18,2,6,4,2611,2511,100
1,18,3,6,4,2509,2683,-174
1,18,4,6,4,2102,2518,-416
1,18,5,6,4,2431,2306,125
1,18,6,6,4,2511,2377,134
1,18,7,6,4,2683,2286,397
1,18,8,6,4,2518,2255,263
1,18,9,6,4,2306,2157,149
1,18,10,6,4,2377,2263,114
1,18,11,6,4,2286,2124,162
1,18,12,6,4,2255,2132,123
1,18,13,6,4,2157,2220,-63
1,18,14,6,4,2263,1991,272
1,18,15,6,4,2124,2118,6
1,18,16,6,4,2132,2450,-318
1,0,0,7,4,3104,2811,293
1,0,1,7,4,3105,2619,486
1,0,2,7,4,3043,2445,598
1,0,3,7,4,2931,2354,577
1,0,4,7,4,2811,2289,522
1,0,5,7,4,2619,2249,370
1,0,6,7,4,2445,2227,218
1,0,7,7,4,2354,2226,128
1,0,8,7,4,2289,2244,45
1,0,9,7,4,2249,2304,-55
1,0,10,7,4,2227,2363,-136
1,0,11,7,4,2226,2497,-271
1,0,12,7,4,2244,2680,-436
1,0,13,7,4,2304,2806,-502
1,0,14,7,4,2363,2954,-591
1,0,15,7,4,2497,3052,-555
1,0,16,7,4,2680,3051,-371
1,1,0,7,4,3087,2663,424
1,1,1,7,4,2997,2533,464
1,1,2,7,4,2863,2406,457
1,1,3,7,4,2735,2332,403
1,1,4,7,4,2663,2265,398
1,1,5,7,4,2533,2231,302
1,1,6,7,4,2406,2211,195
1,1,7,7,4,2332,2208,124
1,1,8,7,4,2265,2220,45
1,1,9,7,4,2231,2284,-53
1,1,10,7,4,2211,2330,-119
1,1,11,7,4,2208,2440,-232
1,1,12,7,4,2220,2601,-381
1,1,13,7,4,2284,2700,-416
1,1,14,7,4,2330,2847,-517
1,1,15,7,4,2440,2977,-537
1,1,16,7,4,2601,3030,-429
1,2,0,7,4,3123,2647,476
1,2,1,7,4,2964,2585,379
1,2,2,7,4,2786,2501,285
1,2,3,7,4,2677,2420,257
1,2,4,7,4,2647,2373,274
1,2,5,7,4,2585,2363,222
1,2,6,7,4,2501,2356,145
1,2,7,7,4,2420,2360,60
1,2,8,7,4,2373,2369,4
1,2,9,7,4,2363,2409,-46
1,2,10,7,4,2356,2437,-81
1,2,11,7,4,2360,2539,-179
1,2,12,7,4,2369,2660,-291
1,2,13,7,4,2409,2738,-329
1,2,14,7,4,2437,2878,-441
1,2,15,7,4,2539,2987,-448
1,2,16,7,4,2660,3078,-418
1,3,0,7,4,2970,2410,560
1,3,1,7,4,2742,2366,376
1,3,2,7,4,2557,2263,294
1,3,3,7,4,2427,2166,261
1,3,4,7,4,2410,2099,311
1,3,5,7,4,2366,2073,293
1,3,6,7,4,2263,2058,205
1,3,7,7,4,2166,2059,107
1,3,8,7,4,2099,2081,18
1,3,9,7,4,2073,2130,-57
1,3,10,7,4,2058,2195,-137
1,3,11,7,4,2059,2329,-270
1,3,12,7,4,2081,2448,-367
1,3,13,7,4,2130,2532,-402
1,3,14,7,4,2195,2665,-470
1,3,15,7,4,2329,2786,-457
1,3,16,7,4,2448,2934,-486
1,4,0,7,4,2810,2502,308
1,4,1,7,4,2626,2492,134
1,4,2,7,4,2517,2445,72
1,4,3,7,4,2448,2403,45
1,4,4,7,4,2502,2350,152
1,4,5,7,4,2492,2317,175
1,4,6,7,4,2445,2312,133
1,4,7,7,4,2403,2306,97
1,4,8,7,4,2350,2334,16
1,4,9,7,4,2317,2375,-58
1,4,10,7,4,2312,2421,-109
1,4,11,7,4,2306,2491,-185
1,4,12,7,4,2334,2547,-213
1,4,13,7,4,2375,2584,-209
1,4,14,7,4,2421,2645,-224
1,4,15,7,4,2491,2759,-268
1,4,16,7,4,2547,2903,-356
1,5,0,7,4,2800,2967,-167
1,5,1,7,4,2718,2992,-274
1,5,2,7,4,2683,3017,-334
1,5,3,7,4,2767,2992,-225
1,5,4,7,4,2967,2918,49
1,5,5,7,4,2992,2870,122
1,5,6,7,4,3017,2893,124
1,5,7,7,4,2992,2878,114
1,5,8,7,4,2918,2914,4
1,5,9,7,4,2870,2991,-121
1,5,10,7,4,2893,3043,-150
1,5,11,7,4,2878,3054,-176
1,5,12,7,4,2914,3057,-143
1,5,13,7,4,2991,3009,-18
1,5,14,7,4,3043,2968,75
1,5,15,7,4,3054,3064,-10
1,5,16,7,4,3057,3144,-87
1,6,0,7,4,2853,3500,-647
1,6,1,7,4,2846,3576,-730
1,6,2,7,4,2878,3552,-674
1,6,3,7,4,3122,3430,-308
1,6,4,7,4,3500,3221,279
1,6,5,7,4,3576,3076,500
1,6,6,7,4,3552,3102,450
1,6,7,7,4,3430,3078,352
1,6,8,7,4,3221,3157,64
1,6,9,7,4,3076,3364,-288
1,6,10,7,4,3102,3550,-448
1,6,11,7,4,3078,3642,-564
1,6,12,7,4,3157,3667,-510
1,6,13,7,4,3364,3525,-161
1,6,14,7,4,3550,3382,168
1,6,15,7,4,3642,3440,202
1,6,16,7,4,3667,3428,239
1,7,0,7,4,2949,4049,-1100
1,7,1,7,4,3016,4205,-1189
1,7,2,7,4,3184,4041,-857
1,7,3,7,4,3530,3853,-323
1,7,4,7,4,4049,3493,556
1,7,5,7,4,4205,3209,996
1,7,6,7,4,4041,3231,810
1,7,7,7,4,3853,3193,660
1,7,8,7,4,3493,3337,156
1,7,9,7,4,3209,3675,-466
1,7,10,7,4,3231,3985,-754
1,7,11,7,4,3193,4201,-1008
1,7,12,7,4,3337,4263,-926
1,7,13,7,4,3675,4029,-354
1,7,14,7,4,3985,3816,169
1,7,15,7,4,4201,3808,393
1,7,16,7,4,4263,3689,574
1,8,0,7,4,3113,4569,-1456
1,8,1,7,4,3294,4730,-1436
1,8,2,7,4,3615,4373,-758
1,8,3,7,4,3997,4154,-157
1,8,4,7,4,4569,3662,907
1,8,5,7,4,4730,3247,1483
1,8,6,7,4,4373,3279,1094
1,8,7,7,4,4154,3218,936
1,8,8,7,4,3662,3427,235
1,8,9,7,4,3247,3897,-650
1,8,10,7,4,3279,4289,-1010
1,8,11,7,4,3218,4649,-1431
1,8,12,7,4,3427,4788,-1361
1,8,13,7,4,3897,4493,-596
1,8,14,7,4,4289,4295,-6
1,8,15,7,4,4649,4227,422
1,8,16,7,4,4788,4001,787
1,9,0,7,4,3188,5014,-1826
1,9,1,7,4,3493,5142,-1649
1,9,2,7,4,3942,4577,-635
1,9,3,7,4,4367,4317,50
1,9,4,7,4,5014,3666,1348
1,9,5,7,4,5142,3099,2043
1,9,6,7,4,4577,3129,1448
1,9,7,7,4,4317,3028,1289
1,9,8,7,4,3666,3302,364
1,9,9,7,4,3099,3934,-835
1,9,10,7,4,3129,4420,-1291
1,9,11,7,4,3028,4950,-1922
1,9,12,7,4,3302,5197,-1895
1,9,13,7,4,3934,4831,-897
1,9,14,7,4,4420,4663,-243
1,9,15,7,4,4950,4545,405
1,9,16,7,4,5197,4199,998
1,10,0,7,4,3317,5653,-2336
1,10,1,7,4,3798,5778,-1980
1,10,2,7,4,4396,5085,-689
1,10,3,7,4,4901,4827,74
1,10,4,7,4,5653,4053,1600
1,10,5,7,4,5778,3399,2379
1,10,6,7,4,5085,3447,1638
1,10,7,7,4,4827,3329,1498
1,10,8,7,4,4053,3666,387
1,10,9,7,4,3399,4405,-1006
1,10,10,7,4,3447,4911,-1464
1,10,11,7,4,3329,5501,-2172
1,10,12,7,4,3666,5797,-2131
1,10,13,7,4,4405,5341,-936
1,10,14,7,4,4911,5177,-266
1,10,15,7,4,5501,4969,532
1,10,16,7,4,5797,4490,1307
1,11,0,7,4,3425,5848,-2423
1,11,1,7,4,3961,5968,-2007
1,11,2,7,4,4601,5145,-544
1,11,3,7,4,5092,4876,216
1,11,4,7,4,5848,3976,1872
1,11,5,7,4,5968,3226,2742
1,11,6,7,4,5145,3282,1863
1,11,7,7,4,4876,3123,1753
1,11,8,7,4,3976,3523,453
1,11,9,7,4,3226,4401,-1175
1,11,10,7,4,3282,4968,-1686
1,11,11,7,4,3123,5584,-2461
1,11,12,7,4,3523,5909,-2386
1,11,13,7,4,4401,5415,-1014
1,11,14,7,4,4968,5323,-355
1,11,15,7,4,5584,5146,438
1,11,16,7,4,5909,4676,1233
1,12,0,7,4,3447,5581,-2134
1,12,1,7,4,3985,5612,-1627
1,12,2,7,4,4637,4680,-43
1,12,3,7,4,4988,4446,542
1,12,4,7,4,5581,3554,2027
1,12,5,7,4,5612,2824,2788
1,12,6,7,4,4680,2860,1820
1,12,7,7,4,4446,2739,1707
1,12,8,7,4,3554,3126,428
1,12,9,7,4,2824,3913,-1089
1,12,10,7,4,2860,4527,-1667
1,12,11,7,4,2739,5113,-2374
1,12,12,7,4,3126,5459,-2333
1,12,13,7,4,3913,5127,-1214
1,12,14,7,4,4527,5108,-581
1,12,15,7,4,5113,4950,163
1,12,16,7,4,5459,4553,906
1,13,0,7,4,3537,5087,-1550
1,13,1,7,4,3929,5180,-1251
1,13,2,7,4,4517,4381,136
1,13,3,7,4,4727,4332,395
1,13,4,7,4,5087,3581,1506
1,13,5,7,4,5180,2923,2257
1,13,6,7,4,4381,2993,1388
1,13,7,7,4,4332,2835,1497
1,13,8,7,4,3581,3112,469
1,13,9,7,4,2923,3809,-886
1,13,10,7,4,2993,4347,-1354
1,13,11,7,4,2835,4795,-1960
1,13,12,7,4,3112,5076,-1964
1,13,13,7,4,3809,4766,-957
1,13,14,7,4,4347,4659,-312
1,13,15,7,4,4795,4507,288
1,13,16,7,4,5076,4339,737
1,14,0,7,4,3563,4636,-1073
1,14,1,7,4,3821,4814,-993
1,14,2,7,4,4282,4257,25
1,14,3,7,4,4437,4352,85
1,14,4,7,4,4636,3682,954
1,14,5,7,4,4814,3071,1743
1,14,6,7,4,4257,3159,1098
1,14,7,7,4,4352,2947,1405
1,14,8,7,4,3682,3115,567
1,14,9,7,4,3071,3659,-588
1,14,10,7,4,3159,4050,-891
1,14,11,7,4,2947,4335,-1388
1,14,12,7,4,3115,4562,-1447
1,14,13,7,4,3659,4349,-690
1,14,14,7,4,4050,4196,-146
1,14,15,7,4,4335,4072,263
1,14,16,7,4,4562,4117,445
1,15,0,7,4,3604,4068,-464
1,15,1,7,4,3697,4269,-572
1,15,2,7,4,4033,3875,158
1,15,3,7,4,4129,3954,175
1,15,4,7,4,4068,3382,686
1,15,5,7,4,4269,2841,1428
1,15,6,7,4,3875,2912,963
1,15,7,7,4,3954,2721,1233
1,15,8,7,4,3382,2838,544
1,15,9,7,4,2841,3205,-364
1,15,10,7,4,2912,3562,-650
1,15,11,7,4,2721,3752,-1031
1,15,12,7,4,2838,3950,-1112
1,15,13,7,4,3205,3883,-678
1,15,14,7,4,3562,3734,-172
1,15,15,7,4,3752,3680,72
1,15,16,7,4,3950,3873,77
1,16,0,7,4,3430,3427,3
1,16,1,7,4,3405,3708,-303
1,16,2,7,4,3623,3493,130
1,16,3,7,4,3631,3643,-12
1,16,4,7,4,3427,3180,247
1,16,5,7,4,3708,2737,971
1,16,6,7,4,3493,2833,660
1,16,7,7,4,3643,2637,1006
1,16,8,7,4,3180,2725,455
1,16,9,7,4,2737,2938,-201
1,16,10,7,4,2833,3203,-370
1,16,11,7,4,2637,3219,-582
1,16,12,7,4,2725,3314,-589
1,16,13,7,4,2938,3289,-351
1,16,14,7,4,3203,3097,106
1,16,15,7,4,3219,3138,81
1,16,16,7,4,3314,3411,-97
1,17,0,7,4,3317,2843,474
1,17,1,7,4,3139,3161,-22
1,17,2,7,4,3218,3121,97
1,17,3,7,4,3165,3291,-126
1,17,4,7,4,2843,2962,-119
1,17,5,7,4,3161,2637,524
1,17,6,7,4,3121,2720,401
1,17,7,7,4,3291,2580,711
1,17,8,7,4,2962,2622,340
1,17,9,7,4,2637,2683,-46
1,17,10,7,4,2720,2867,-147
1,17,11,7,4,2580,2742,-162
1,17,12,7,4,2622,2770,-148
1,17,13,7,4,2683,2790,-107
1,17,14,7,4,2867,2566,301
1,17,15,7,4,2742,2711,31
1,17,16,7,4,2770,3038,-268
1,0,0,8,4,3498,3095,403
1,0,1,8,4,3409,2958,451
1,0,2,8,4,3279,2823,456
1,0,3,8,4,3159,2747,412
1,0,4,8,4,3095,2676,419
1,0,5,8,4,2958,2640,318
1,0,6,8,4,2823,2620,203
1,0,7,8,4,2747,2619,128
1,0,8,8,4,2676,2634,42
1,0,9,8,4,2640,2694,-54
1,0,10,8,4,2620,2739,-119
1,0,11,8,4,2619,2855,-236
1,0,12,8,4,2634,3019,-385
1,0,13,8,4,2694,3118,-424
1,0,14,8,4,2739,3266,-527
1,0,15,8,4,2855,3395,-540
1,0,16,8,4,3019,3442,-423
1,1,0,8,4,3553,3076,477
1,1,1,8,4,3400,3010,390
1,1,2,8,4,3219,2924,295
1,1,3,8,4,3105,2845,260
1,1,4,8,4,3076,2794,282
1,1,5,8,4,3010,2779,231
1,1,6,8,4,2924,2770,154
1,1,7,8,4,2845,2775,70
1,1,8,8,4,2794,2788,6
1,1,9,8,4,2779,2840,-61
1,1,10,8,4,2770,2871,-101
1,1,11,8,4,2775,2972,-197
1,1,12,8,4,2788,3088,-300
1,1,13,8,4,2840,3152,-312
1,1,14,8,4,2871,3296,-425
1,1,15,8,4,2972,3415,-443
1,1,16,8,4,3088,3506,-418
1,2,0,8,4,3410,2854,556
1,2,1,8,4,3186,2815,371
1,2,2,8,4,2994,2717,277
1,2,3,8,4,2860,2621,239
1,2,4,8,4,2854,2543,311
1,2,5,8,4,2815,2508,307
1,2,6,8,4,2717,2488,229
1,2,7,8,4,2621,2490,131
1,2,8,8,4,2543,2516,27
1,2,9,8,4,2508,2576,-68
1,2,10,8,4,2488,2642,-154
1,2,11,8,4,2490,2775,-285
1,2,12,8,4,2516,2890,-374
1,2,13,8,4,2576,2960,-384
1,2,14,8,4,2642,3094,-452
1,2,15,8,4,2775,3221,-446
1,2,16,8,4,2890,3368,-478
1,3,0,8,4,3254,2956,298
1,3,1,8,4,3070,2906,164
1,3,2,8,4,2959,2813,146
1,3,3,8,4,2892,2725,167
1,3,4,8,4,2956,2620,336
1,3,5,8,4,2906,2577,329
1,3,6,8,4,2813,2566,247
1,3,7,8,4,2725,2559,166
1,3,8,8,4,2620,2591,29
1,3,9,8,4,2577,2660,-83
1,3,10,8,4,2566,2742,-176
1,3,11,8,4,2559,2864,-305
1,3,12,8,4,2591,2974,-383
1,3,13,8,4,2660,3028,-368
1,3,14,8,4,2742,3094,-352
1,3,15,8,4,2864,3202,-338
1,3,16,8,4,2974,3336,-362
1,4,0,8,4,3262,3383,-121
1,4,1,8,4,3192,3336,-144
1,4,2,8,4,3158,3292,-134
1,4,3,8,4,3222,3221,1
1,4,4,8,4,3383,3116,267
1,4,5,8,4,3336,3058,278
1,4,6,8,4,3292,3075,217
1,4,7,8,4,3221,3059,162
1,4,8,8,4,3116,3098,18
1,4,9,8,4,3058,3190,-132
1,4,10,8,4,3075,3272,-197
1,4,11,8,4,3059,3342,-283
1,4,12,8,4,3098,3420,-322
1,4,13,8,4,3190,3428,-238
1,4,14,8,4,3272,3422,-150
1,4,15,8,4,3342,3525,-183
1,4,16,8,4,3420,3592,-172
1,5,0,8,4,3328,3842,-514
1,5,1,8,4,3332,3862,-530
1,5,2,8,4,3351,3797,-446
1,5,3,8,4,3544,3673,-129
1,5,4,8,4,3842,3490,352
1,5,5,8,4,3862,3341,521
1,5,6,8,4,3797,3364,433
1,5,7,8,4,3673,3338,335
1,5,8,8,4,3490,3418,72
1,5,9,8,4,3341,3615,-274
1,5,10,8,4,3364,3794,-430
1,5,11,8,4,3338,3902,-564
1,5,12,8,4,3418,3968,-550
1,5,13,8,4,3615,3887,-272
1,5,14,8,4,3794,3805,-11
1,5,15,8,4,3902,3900,2
1,5,16,8,4,3968,3889,79
1,6,0,8,4,3391,4343,-952
1,6,1,8,4,3425,4481,-1056
1,6,2,8,4,3551,4304,-753
1,6,3,8,4,3855,4118,-263
1,6,4,8,4,4343,3769,574
1,6,5,8,4,4481,3485,996
1,6,6,8,4,4304,3507,797
1,6,7,8,4,4118,3468,650
1,6,8,8,4,3769,3611,158
1,6,9,8,4,3485,3957,-472
1,6,10,8,4,3507,4264,-757
1,6,11,8,4,3468,4483,-1015
1,6,12,8,4,3611,4564,-953
1,6,13,8,4,3957,4350,-393
1,6,14,8,4,4264,4178,86
1,6,15,8,4,4483,4215,268
1,6,16,8,4,4564,4124,440
1,7,0,8,4,3507,4853,-1346
1,7,1,8,4,3598,5069,-1471
1,7,2,8,4,3851,4751,-900
1,7,3,8,4,4225,4547,-322
1,7,4,8,4,4853,4049,804
1,7,5,8,4,5069,3638,1431
1,7,6,8,4,4751,3672,1079
1,7,7,8,4,4547,3611,936
1,7,8,8,4,4049,3817,232
1,7,9,8,4,3638,4287,-649
1,7,10,8,4,3672,4665,-993
1,7,11,8,4,3611,5007,-1396
1,7,12,8,4,3817,5127,-1310
1,7,13,8,4,4287,4805,-518
1,7,14,8,4,4665,4607,58
1,7,15,8,4,5007,4570,437
1,7,16,8,4,5127,4392,735
1,8,0,8,4,3654,5427,-1773
1,8,1,8,4,3896,5619,-1723
1,8,2,8,4,4298,5095,-797
1,8,3,8,4,4737,4830,-93
1,8,4,8,4,5427,4195,1232
1,8,5,8,4,5619,3647,1972
1,8,6,8,4,5095,3688,1407
1,8,7,8,4,4830,3595,1235
1,8,8,8,4,4195,3870,325
1,8,9,8,4,3647,4490,-843
1,8,10,8,4,3688,4961,-1273
1,8,11,8,4,3595,5482,-1887
1,8,12,8,4,3870,5684,-1814
1,8,13,8,4,4490,5283,-793
1,8,14,8,4,4961,5112,-151
1,8,15,8,4,5482,4983,499
1,8,16,8,4,5684,4675,1009
1,9,0,8,4,3604,5860,-2256
1,9,1,8,4,4020,6008,-1988
1,9,2,8,4,4604,5301,-697
1,9,3,8,4,5084,5028,56
1,9,4,8,4,5860,4223,1637
1,9,5,8,4,6008,3544,2464
1,9,6,8,4,5301,3579,1722
1,9,7,8,4,5028,3459,1569
1,9,8,8,4,4223,3813,410
1,9,9,8,4,3544,4572,-1028
1,9,10,8,4,3579,5116,-1537
1,9,11,8,4,3459,5737,-2278
1,9,12,8,4,3813,6027,-2214
1,9,13,8,4,4572,5563,-991
1,9,14,8,4,5116,5393,-277
1,9,15,8,4,5737,5203,534
1,9,16,8,4,6027,4780,1247
1,10,0,8,4,3709,6394,-2685
1,10,1,8,4,4289,6508,-2219
1,10,2,8,4,5003,5695,-692
1,10,3,8,4,5557,5435,122
1,10,4,8,4,6394,4497,1897
1,10,5,8,4,6508,3730,2778
1,10,6,8,4,5695,3790,1905
1,10,7,8,4,5435,3623,1812
1,10,8,8,4,4497,4033,464
1,10,9,8,4,3730,4931,-1201
1,10,10,8,4,3790,5515,-1725
1,10,11,8,4,3623,6119,-2496
1,10,12,8,4,4033,6435,-2402
1,10,13,8,4,4931,5911,-980
1,10,14,8,4,5515,5752,-237
1,10,15,8,4,6119,5562,557
1,10,16,8,4,6435,5078,1357
1,11,0,8,4,3899,6462,-2563
1,11,1,8,4,4551,6456,-1905
1,11,2,8,4,5278,5527,-249
1,11,3,8,4,5762,5264,498
1,11,4,8,4,6462,4320,2142
1,11,5,8,4,6456,3565,2891
1,11,6,8,4,5527,3623,1904
1,11,7,8,4,5264,3492,1772
1,11,8,8,4,4320,3890,430
1,11,9,8,4,3565,4728,-1163
1,11,10,8,4,3623,5378,-1755
1,11,11,8,4,3492,5964,-2472
1,11,12,8,4,3890,6332,-2442
1,11,13,8,4,4728,5971,-1243
1,11,14,8,4,5378,5885,-507
1,11,15,8,4,5964,5716,248
1,11,16,8,4,6332,5242,1090
1,12,0,8,4,4065,5962,-1897
1,12,1,8,4,4543,6050,-1507
1,12,2,8,4,5185,5161,24
1,12,3,8,4,5504,5013,491
1,12,4,8,4,5962,4153,1809
1,12,5,8,4,6050,3394,2656
1,12,6,8,4,5161,3464,1697
1,12,7,8,4,5013,3295,1718
1,12,8,8,4,4153,3616,537
1,12,9,8,4,3394,4433,-1039
1,12,10,8,4,3464,5098,-1634
1,12,11,8,4,3295,5643,-2348
1,12,12,8,4,3616,5987,-2371
1,12,13,8,4,4433,5644,-1211
1,12,14,8,4,5098,5496,-398
1,12,15,8,4,5643,5343,300
1,12,16,8,4,5987,5084,903
1,13,0,8,4,4101,5479,-1378
1,13,1,8,4,4400,5719,-1319
1,13,2,8,4,4955,5009,-54
1,13,3,8,4,5170,5040,130
1,13,4,8,4,5479,4230,1249
1,13,5,8,4,5719,3480,2239
1,13,6,8,4,5009,3564,1445
1,13,7,8,4,5040,3337,1703
1,13,8,8,4,4230,3569,661
1,13,9,8,4,3480,4252,-772
1,13,10,8,4,3564,4764,-1200
1,13,11,8,4,3337,5176,-1839
1,13,12,8,4,3569,5459,-1890
1,13,13,8,4,4252,5174,-922
1,13,14,8,4,4764,4992,-228
1,13,15,8,4,5176,4847,329
1,13,16,8,4,5459,4813,646
1,14,0,8,4,4162,4872,-710
1,14,1,8,4,4279,5133,-854
1,14,2,8,4,4700,4585,115
1,14,3,8,4,4824,4648,176
1,14,4,8,4,4872,3938,934
1,14,5,8,4,5133,3270,1863
1,14,6,8,4,4585,3353,1232
1,14,7,8,4,4648,3139,1509
1,14,8,8,4,3938,3318,620
1,14,9,8,4,3270,3817,-547
1,14,10,8,4,3353,4242,-889
1,14,11,8,4,3139,4558,-1419
1,14,12,8,4,3318,4814,-1496
1,14,13,8,4,3817,4659,-842
1,14,14,8,4,4242,4525,-283
1,14,15,8,4,4558,4442,116
1,14,16,8,4,4814,4576,238
1,15,0,8,4,3971,4285,-314
1,15,1,8,4,4007,4597,-590
1,15,2,8,4,4306,4215,91
1,15,3,8,4,4371,4319,52
1,15,4,8,4,4285,3713,572
1,15,5,8,4,4597,3137,1460
1,15,6,8,4,4215,3242,973
1,15,7,8,4,4319,3014,1305
1,15,8,8,4,3713,3168,545
1,15,9,8,4,3137,3531,-394
1,15,10,8,4,3242,3875,-633
1,15,11,8,4,3014,4052,-1038
1,15,12,8,4,3168,4210,-1042
1,15,13,8,4,3531,4079,-548
1,15,14,8,4,3875,3914,-39
1,15,15,8,4,4052,3894,158
1,15,16,8,4,4210,4085,125
1,16,0,8,4,3733,3689,44
1,16,1,8,4,3666,4027,-361
1,16,2,8,4,3880,3845,35
1,16,3,8,4,3882,4002,-120
1,16,4,8,4,3689,3519,170
1,16,5,8,4,4027,3082,945
1,16,6,8,4,3845,3170,675
1,16,7,8,4,4002,3011,991
1,16,8,8,4,3519,3133,386
1,16,9,8,4,3082,3321,-239
1,16,10,8,4,3170,3563,-393
1,16,11,8,4,3011,3529,-518
1,16,12,8,4,3133,3600,-467
1,16,13,8,4,3321,3522,-201
1,16,14,8,4,3563,3296,267
1,16,15,8,4,3529,3369,160
1,16,16,8,4,3600,3619,-19
1,0,0,9,4,3964,3508,456
1,0,1,9,4,3812,3435,377
1,0,2,9,4,3635,3341,294
1,0,3,9,4,3529,3260,269
1,0,4,9,4,3508,3205,303
1,0,5,9,4,3435,3188,247
1,0,6,9,4,3341,3179,162
1,0,7,9,4,3260,3186,74
1,0,8,9,4,3205,3202,3
1,0,9,9,4,3188,3250,-62
1,0,10,9,4,3179,3280,-101
1,0,11,9,4,3186,3387,-201
1,0,12,9,4,3202,3506,-304
1,0,13,9,4,3250,3570,-320
1,0,14,9,4,3280,3715,-435
1,0,15,9,4,3387,3833,-446
1,0,16,9,4,3506,3918,-412
1,1,0,9,4,3840,3283,557
1,1,1,9,4,3622,3240,382
1,1,2,9,4,3427,3140,287
1,1,3,9,4,3288,3046,242
1,1,4,9,4,3283,2964,319
1,1,5,9,4,3240,2924,316
1,1,6,9,4,3140,2902,238
1,1,7,9,4,3046,2905,141
1,1,8,9,4,2964,2935,29
1,1,9,9,4,2924,3007,-83
1,1,10,9,4,2902,3076,-174
1,1,11,9,4,2905,3208,-303
1,1,12,9,4,2935,3318,-383
1,1,13,9,4,3007,3374,-367
1,1,14,9,4,3076,3512,-436
1,1,15,9,4,3208,3649,-441
1,1,16,9,4,3318,3796,-478
1,2,0,9,4,3694,3400,294
1,2,1,9,4,3514,3355,159
1,2,2,9,4,3396,3267,129
1,2,3,9,4,3325,3180,145
1,2,4,9,4,3400,3064,336
1,2,5,9,4,3355,3012,343
1,2,6,9,4,3267,2996,271
1,2,7,9,4,3180,2990,190
1,2,8,9,4,3064,3026,38
1,2,9,9,4,3012,3106,-94
1,2,10,9,4,2996,3189,-193
1,2,11,9,4,2990,3310,-320
1,2,12,9,4,3026,3416,-390
1,2,13,9,4,3106,3456,-350
1,2,14,9,4,3189,3523,-334
1,2,15,9,4,3310,3637,-327
1,2,16,9,4,3416,3770,-354
1,3,0,9,4,3706,3837,-131
1,3,1,9,4,3636,3750,-114
1,3,2,9,4,3600,3660,-60
1,3,3,9,4,3666,3543,123
1,3,4,9,4,3837,3386,451
1,3,5,9,4,3750,3318,432
1,3,6,9,4,3660,3329,331
1,3,7,9,4,3543,3312,231
1,3,8,9,4,3386,3355,31
1,3,9,9,4,3318,3475,-157
1,3,10,9,4,3329,3593,-264
1,3,11,9,4,3312,3715,-403
1,3,12,9,4,3355,3847,-492
1,3,13,9,4,3475,3872,-397
1,3,14,9,4,3593,3871,-278
1,3,15,9,4,3715,3968,-253
1,3,16,9,4,3847,4025,-178
1,4,0,9,4,3790,4258,-468
1,4,1,9,4,3806,4206,-400
1,4,2,9,4,3826,4072,-246
1,4,3,9,4,3999,3902,97
1,4,4,9,4,4258,3688,570
1,4,5,9,4,4206,3529,677
1,4,6,9,4,4072,3546,526
1,4,7,9,4,3902,3519,383
1,4,8,9,4,3688,3602,86
1,4,9,9,4,3529,3814,-285
1,4,10,9,4,3546,4023,-477
1,4,11,9,4,3519,4190,-671
1,4,12,9,4,3602,4331,-729
1,4,13,9,4,3814,4306,-492
1,4,14,9,4,4023,4259,-236
1,4,15,9,4,4190,4361,-171
1,4,16,9,4,4331,4337,-6
1,5,0,9,4,3866,4685,-819
1,5,1,9,4,3911,4767,-856
1,5,2,9,4,4024,4549,-525
1,5,3,9,4,4277,4361,-84
1,5,4,9,4,4685,4038,647
1,5,5,9,4,4767,3750,1017
1,5,6,9,4,4549,3769,780
1,5,7,9,4,4361,3728,633
1,5,8,9,4,4038,3872,166
1,5,9,9,4,3750,4208,-458
1,5,10,9,4,3769,4508,-739
1,5,11,9,4,3728,4743,-1015
1,5,12,9,4,3872,4865,-993
1,5,13,9,4,4208,4712,-504
1,5,14,9,4,4508,4601,-93
1,5,15,9,4,4743,4675,68
1,5,16,9,4,4865,4585,280
1,6,0,9,4,3949,5147,-1198
1,6,1,9,4,4007,5345,-1338
1,6,2,9,4,4218,5014,-796
1,6,3,9,4,4550,4812,-262
1,6,4,9,4,5147,4325,822
1,6,5,9,4,5345,3914,1431
1,6,6,9,4,5014,3948,1066
1,6,7,9,4,4812,3886,926
1,6,8,9,4,4325,4091,234
1,6,9,9,4,3914,4569,-655
1,6,10,9,4,3948,4944,-996
1,6,11,9,4,3886,5289,-1403
1,6,12,9,4,4091,5428,-1337
1,6,13,9,4,4569,5126,-557
1,6,14,9,4,4944,4969,-25
1,6,15,9,4,5289,4977,312
1,6,16,9,4,5428,4827,601
1,7,0,9,4,4048,5711,-1663
1,7,1,9,4,4200,5958,-1758
1,7,2,9,4,4534,5473,-939
1,7,3,9,4,4965,5223,-258
1,7,4,9,4,5711,4582,1129
1,7,5,9,4,5958,4038,1920
1,7,6,9,4,5473,4081,1392
1,7,7,9,4,5223,3988,1235
1,7,8,9,4,4582,4260,322
1,7,9,9,4,4038,4880,-842
1,7,10,9,4,4081,5337,-1256
1,7,11,9,4,3988,5840,-1852
1,7,12,9,4,4260,6023,-1763
1,7,13,9,4,4880,5595,-715
1,7,14,9,4,5337,5424,-87
1,7,15,9,4,5840,5326,514
1,7,16,9,4,6023,5066,957
1,8,0,9,4,4070,6273,-2203
1,8,1,9,4,4423,6485,-2062
1,8,2,9,4,4960,5819,-859
1,8,3,9,4,5454,5541,-87
1,8,4,9,4,6273,4752,1521
1,8,5,9,4,6485,4092,2393
1,8,6,9,4,5819,4138,1681
1,8,7,9,4,5541,4026,1515
1,8,8,9,4,4752,4381,371
1,8,9,9,4,4092,5128,-1036
1,8,10,9,4,4138,5657,-1519
1,8,11,9,4,4026,6269,-2243
1,8,12,9,4,4381,6514,-2133
1,8,13,9,4,5128,6015,-887
1,8,14,9,4,5657,5842,-185
1,8,15,9,4,6269,5641,628
1,8,16,9,4,6514,5256,1258
1,9,0,9,4,3996,6601,-2605
1,9,1,9,4,4511,6738,-2227
1,9,2,9,4,5211,5911,-700
1,9,3,9,4,5740,5636,104
1,9,4,9,4,6601,4667,1934
1,9,5,9,4,6738,3875,2863
1,9,6,9,4,5911,3922,1989
1,9,7,9,4,5636,3753,1883
1,9,8,9,4,4667,4180,487
1,9,9,9,4,3875,5098,-1223
1,9,10,9,4,3922,5720,-1798
1,9,11,9,4,3753,6355,-2602
1,9,12,9,4,4180,6665,-2485
1,9,13,9,4,5098,6133,-1035
1,9,14,9,4,5720,5968,-248
1,9,15,9,4,6355,5796,559
1,9,16,9,4,6665,5368,1297
1,10,0,9,4,4183,7008,-2825
1,10,1,9,4,4879,6996,-2117
1,10,2,9,4,5680,6077,-397
1,10,3,9,4,6227,5823,404
1,10,4,9,4,7008,4841,2167
1,10,5,9,4,6996,4069,2927
1,10,6,9,4,6077,4131,1946
1,10,7,9,4,5823,3992,1831
1,10,8,9,4,4841,4400,441
1,10,9,9,4,4069,5258,-1189
1,10,10,9,4,4131,5925,-1794
1,10,11,9,4,3992,6499,-2507
1,10,12,9,4,4400,6858,-2458
1,10,13,9,4,5258,6467,-1209
1,10,14,9,4,5925,6314,-389
1,10,15,9,4,6499,6132,367
1,10,16,9,4,6858,5644,1214
1,11,0,9,4,4517,6843,-2326
1,11,1,9,4,5109,6894,-1785
1,11,2,9,4,5826,6008,-182
1,11,3,9,4,6278,5831,447
1,11,4,9,4,6843,4919,1924
1,11,5,9,4,6894,4135,2759
1,11,6,9,4,6008,4227,1781
1,11,7,9,4,5831,4048,1783
1,11,8,9,4,4919,4380,539
1,11,9,9,4,4135,5248,-1113
1,11,10,9,4,4227,5949,-1722
1,11,11,9,4,4048,6494,-2446
1,11,12,9,4,4380,6860,-2480
1,11,13,9,4,5248,6488,-1240
1,11,14,9,4,5949,6273,-324
1,11,15,9,4,6494,6109,385
1,11,16,9,4,6860,5773,1087
1,12,0,9,4,4629,6354,-1725
1,12,1,9,4,5014,6589,-1575
1,12,2,9,4,5623,5789,-166
1,12,3,9,4,5947,5721,226
1,12,4,9,4,6354,4802,1552
1,12,5,9,4,6589,3951,2638
1,12,6,9,4,5789,4035,1754
1,12,7,9,4,5721,3797,1924
1,12,8,9,4,4802,4073,729
1,12,9,9,4,3951,4876,-925
1,12,10,9,4,4035,5515,-1480
1,12,11,9,4,3797,6024,-2227
1,12,12,9,4,4073,6370,-2297
1,12,13,9,4,4876,6052,-1176
1,12,14,9,4,5515,5829,-314
1,12,15,9,4,6024,5683,341
1,12,16,9,4,6370,5558,812
1,13,0,9,4,4700,5715,-1015
1,13,1,9,4,4858,6038,-1180
1,13,2,9,4,5373,5337,36
1,13,3,9,4,5557,5336,221
1,13,4,9,4,5715,4486,1229
1,13,5,9,4,6038,3679,2359
1,13,6,9,4,5337,3758,1579
1,13,7,9,4,5336,3529,1807
1,13,8,9,4,4486,3772,714
1,13,9,9,4,3679,4410,-731
1,13,10,9,4,3758,4956,-1198
1,13,11,9,4,3529,5399,-1870
1,13,12,9,4,3772,5711,-1939
1,13,13,9,4,4410,5484,-1074
1,13,14,9,4,4956,5321,-365
1,13,15,9,4,5399,5217,182
1,13,16,9,4,5711,5272,439
1,14,0,9,4,4529,5089,-560
1,14,1,9,4,4589,5461,-872
1,14,2,9,4,4973,4925,48
1,14,3,9,4,5066,5013,53
1,14,4,9,4,5089,4269,820
1,14,5,9,4,5461,3566,1895
1,14,6,9,4,4925,3683,1242
1,14,7,9,4,5013,3432,1581
1,14,8,9,4,4269,3648,621
1,14,9,9,4,3566,4143,-577
1,14,10,9,4,3683,4555,-872
1,14,11,9,4,3432,4858,-1426
1,14,12,9,4,3648,5074,-1426
1,14,13,9,4,4143,4855,-712
1,14,14,9,4,4555,4705,-150
1,14,15,9,4,4858,4656,202
1,14,16,9,4,5074,4788,286
1,15,0,9,4,4274,4547,-273
1,15,1,9,4,4268,4916,-648
1,15,2,9,4,4563,4567,-4
1,15,3,9,4,4622,4678,-56
1,15,4,9,4,4547,4052,495
1,15,5,9,4,4916,3482,1434
1,15,6,9,4,4567,3579,988
1,15,7,9,4,4678,3388,1290
1,15,8,9,4,4052,3576,476
1,15,9,9,4,3482,3914,-432
1,15,10,9,4,3579,4235,-656
1,15,11,9,4,3388,4362,-974
1,15,12,9,4,3576,4496,-920
1,15,13,9,4,3914,4312,-398
1,15,14,9,4,4235,4113,122
1,15,15,9,4,4362,4125,237
1,15,16,9,4,4496,4293,203
1,0,0,10,4,4251,3715,536
1,0,1,10,4,4034,3665,369
1,0,2,10,4,3843,3557,286
1,0,3,10,4,3712,3461,251
1,0,4,10,4,3715,3375,340
1,0,5,10,4,3665,3333,332
1,0,6,10,4,3557,3311,246
1,0,7,10,4,3461,3316,145
1,0,8,10,4,3375,3349,26
1,0,9,10,4,3333,3417,-84
1,0,10,10,4,3311,3485,-174
1,0,11,10,4,3316,3623,-307
1,0,12,10,4,3349,3736,-387
1,0,13,10,4,3417,3792,-375
1,0,14,10,4,3485,3931,-446
1,0,15,10,4,3623,4067,-444
1,0,16,10,4,3736,4208,-472
1,1,0,10,4,4124,3829,295
1,1,1,10,4,3950,3780,170
1,1,2,10,4,3829,3690,139
1,1,3,10,4,3753,3605,148
1,1,4,10,4,3829,3485,344
1,1,5,10,4,3780,3428,352
1,1,6,10,4,3690,3410,280
1,1,7,10,4,3605,3405,200
1,1,8,10,4,3485,3445,40
1,1,9,10,4,3428,3537,-109
1,1,10,10,4,3410,3623,-213
1,1,11,10,4,3405,3743,-338
1,1,12,10,4,3445,3844,-399
1,1,13,10,4,3537,3870,-333
1,1,14,10,4,3623,3941,-318
1,1,15,10,4,3743,4065,-322
1,1,16,10,4,3844,4198,-354
1,2,0,10,4,4146,4281,-135
1,2,1,10,4,4080,4199,-119
1,2,2,10,4,4037,4114,-77
1,2,3,10,4,4099,3998,101
1,2,4,10,4,4281,3830,451
1,2,5,10,4,4199,3753,446
1,2,6,10,4,4114,3759,355
1,2,7,10,4,3998,3743,255
1,2,8,10,4,3830,3790,40
1,2,9,10,4,3753,3921,-168
1,2,10,10,4,3759,4040,-281
1,2,11,10,4,3743,4161,-418
1,2,12,10,4,3790,4289,-499
1,2,13,10,4,3921,4300,-379
1,2,14,10,4,4040,4300,-260
1,2,15,10,4,4161,4403,-242
1,2,16,10,4,4289,4459,-170
1,3,0,10,4,4234,4712,-478
1,3,1,10,4,4250,4620,-370
1,3,2,10,4,4268,4440,-172
1,3,3,10,4,4443,4224,219
1,3,4,10,4,4712,3958,754
1,3,5,10,4,4620,3789,831
1,3,6,10,4,4440,3800,640
1,3,7,10,4,4224,3772,452
1,3,8,10,4,3958,3859,99
1,3,9,10,4,3789,4099,-310
1,3,10,10,4,3800,4344,-544
1,3,11,10,4,3772,4563,-791
1,3,12,10,4,3859,4758,-899
1,3,13,10,4,4099,4750,-651
1,3,14,10,4,4344,4708,-364
1,3,15,10,4,4563,4804,-241
1,3,16,10,4,4758,4770,-12
1,4,0,10,4,4328,5101,-773
1,4,1,10,4,4385,5111,-726
1,4,2,10,4,4499,4824,-325
1,4,3,10,4,4732,4590,142
1,4,4,10,4,5101,4236,865
1,4,5,10,4,5111,3938,1173
1,4,6,10,4,4824,3951,873
1,4,7,10,4,4590,3909,681
1,4,8,10,4,4236,4056,180
1,4,9,10,4,3938,4407,-469
1,4,10,10,4,3951,4737,-786
1,4,11,10,4,3909,5031,-1122
1,4,12,10,4,4056,5228,-1172
1,4,13,10,4,4407,5131,-724
1,4,14,10,4,4737,5055,-318
1,4,15,10,4,5031,5136,-105
1,4,16,10,4,5228,5033,195
1,5,0,10,4,4424,5489,-1065
1,5,1,10,4,4493,5631,-1138
1,5,2,10,4,4691,5259,-568
1,5,3,10,4,4972,5055,-83
1,5,4,10,4,5489,4594,895
1,5,5,10,4,5631,4179,1452
1,5,6,10,4,5259,4210,1049
1,5,7,10,4,5055,4146,909
1,5,8,10,4,4594,4352,242
1,5,9,10,4,4179,4820,-641
1,5,10,10,4,4210,5188,-978
1,5,11,10,4,4146,5549,-1403
1,5,12,10,4,4352,5729,-1377
1,5,13,10,4,4820,5488,-668
1,5,14,10,4,5188,5392,-204
1,5,15,10,4,5549,5437,112
1,5,16,10,4,5729,5288,441
1,6,0,10,4,4490,6005,-1515
1,6,1,10,4,4609,6234,-1625
1,6,2,10,4,4901,5736,-835
1,6,3,10,4,5290,5488,-198
1,6,4,10,4,6005,4858,1147
1,6,5,10,4,6234,4314,1920
1,6,6,10,4,5736,4357,1379
1,6,7,10,4,5488,4263,1225
1,6,8,10,4,4858,4534,324
1,6,9,10,4,4314,5162,-848
1,6,10,10,4,4357,5616,-1259
1,6,11,10,4,4263,6122,-1859
1,6,12,10,4,4534,6324,-1790
1,6,13,10,4,5162,5916,-754
1,6,14,10,4,5616,5786,-170
1,6,15,10,4,6122,5733,389
1,6,16,10,4,6324,5501,823
1,7,0,10,4,4464,6557,-2093
1,7,1,10,4,4727,6824,-2097
1,7,2,10,4,5196,6197,-1001
1,7,3,10,4,5682,5934,-252
1,7,4,10,4,6557,5139,1418
1,7,5,10,4,6824,4483,2341
1,7,6,10,4,6197,4531,1666
1,7,7,10,4,5934,4419,1515
1,7,8,10,4,5139,4771,368
1,7,9,10,4,4483,5518,-1035
1,7,10,10,4,4531,6033,-1502
1,7,11,10,4,4419,6627,-2208
1,7,12,10,4,4771,6853,-2082
1,7,13,10,4,5518,6327,-809
1,7,14,10,4,6033,6154,-121
1,7,15,10,4,6627,5984,643
1,7,16,10,4,6853,5647,1206
1,8,0,10,4,4462,7014,-2552
1,8,1,10,4,4914,7215,-2301
1,8,2,10,4,5567,6429,-862
1,8,3,10,4,6110,6149,-39
1,8,4,10,4,7014,5196,1818
1,8,5,10,4,7215,4423,2792
1,8,6,10,4,6429,4481,1948
1,8,7,10,4,6149,4320,1829
1,8,8,10,4,5196,4748,448
1,8,9,10,4,4423,5654,-1231
1,8,10,10,4,4481,6261,-1780
1,8,11,10,4,4320,6887,-2567
1,8,12,10,4,4748,7152,-2404
1,8,13,10,4,5654,6585,-931
1,8,14,10,4,6261,6417,-156
1,8,15,10,4,6887,6234,653
1,8,16,10,4,7152,5844,1308
1,9,0,10,4,4470,7215,-2745
1,9,1,10,4,5101,7226,-2125
1,9,2,10,4,5888,6293,-405
1,9,3,10,4,6410,6024,386
1,9,4,10,4,7215,5011,2204
1,9,5,10,4,7226,4214,3012
1,9,6,10,4,6293,4263,2030
1,9,7,10,4,6024,4122,1902
1,9,8,10,4,5011,4547,464
1,9,9,10,4,4214,5425,-1211
1,9,10,10,4,4263,6130,-1867
1,9,11,10,4,4122,6735,-2613
1,9,12,10,4,4547,7088,-2541
1,9,13,10,4,5425,6689,-1264
1,9,14,10,4,6130,6530,-400
1,9,15,10,4,6735,6366,369
1,9,16,10,4,7088,5934,1154
1,10,0,10,4,4801,7389,-2588
1,10,1,10,4,5437,7434,-1997
1,10,2,10,4,6228,6558,-330
1,10,3,10,4,6743,6390,353
1,10,4,10,4,7389,5440,1949
1,10,5,10,4,7434,4639,2795
1,10,6,10,4,6558,4735,1823
1,10,7,10,4,6390,4548,1842
1,10,8,10,4,5440,4890,550
1,10,9,10,4,4639,5778,-1139
1,10,10,10,4,4735,6496,-1761
1,10,11,10,4,4548,7029,-2481
1,10,12,10,4,4890,7386,-2496
1,10,13,10,4,5778,6984,-1206
1,10,14,10,4,6496,6702,-206
1,10,15,10,4,7029,6525,504
1,10,16,10,4,7386,6175,1211
1,11,0,10,4,5081,7235,-2154
1,11,1,10,4,5580,7433,-1853
1,11,2,10,4,6264,6636,-372
1,11,3,10,4,6721,6539,182
1,11,4,10,4,7235,5568,1667
1,11,5,10,4,7433,4692,2741
1,11,6,10,4,6636,4798,1838
1,11,7,10,4,6539,4550,1989
1,11,8,10,4,5568,4837,731
1,11,9,10,4,4692,5691,-999
1,11,10,10,4,4798,6366,-1568
1,11,11,10,4,4550,6875,-2325
1,11,12,10,4,4837,7243,-2406
1,11,13,10,4,5691,6896,-1205
1,11,14,10,4,6366,6606,-240
1,11,15,10,4,6875,6449,426
1,11,16,10,4,7243,6247,996
1,12,0,10,4,5228,6590,-1362
1,12,1,10,4,5472,6908,-1436
1,12,2,10,4,6041,6117,-76
1,12,3,10,4,6334,6017,317
1,12,4,10,4,6590,5058,1532
1,12,5,10,4,6908,4150,2758
1,12,6,10,4,6117,4229,1888
1,12,7,10,4,6017,3989,2028
1,12,8,10,4,5058,4276,782
1,12,9,10,4,4150,5034,-884
1,12,10,10,4,4229,5707,-1478
1,12,11,10,4,3989,6247,-2258
1,12,12,10,4,4276,6622,-2346
1,12,13,10,4,5034,6362,-1328
1,12,14,10,4,5707,6158,-451
1,12,15,10,4,6247,6053,194
1,12,16,10,4,6622,6017,605
1,13,0,10,4,5067,5932,-865
1,13,1,10,4,5168,6366,-1198
1,13,2,10,4,5646,5677,-31
1,13,3,10,4,5799,5701,98
1,13,4,10,4,5932,4817,1115
1,13,5,10,4,6366,3975,2391
1,13,6,10,4,5677,4088,1589
1,13,7,10,4,5701,3822,1879
1,13,8,10,4,4817,4102,715
1,13,9,10,4,3975,4736,-761
1,13,10,10,4,4088,5269,-1181
1,13,11,10,4,3822,5699,-1877
1,13,12,10,4,4102,5971,-1869
1,13,13,10,4,4736,5680,-944
1,13,14,10,4,5269,5501,-232
1,13,15,10,4,5699,5431,268
1,13,16,10,4,5971,5484,487
1,14,0,10,4,4832,5351,-519
1,14,1,10,4,4850,5780,-930
1,14,2,10,4,5230,5277,-47
1,14,3,10,4,5317,5372,-55
1,14,4,10,4,5351,4608,743
1,14,5,10,4,5780,3911,1869
1,14,6,10,4,5277,4020,1257
1,14,7,10,4,5372,3806,1566
1,14,8,10,4,4608,4056,552
1,14,9,10,4,3911,4526,-615
1,14,10,10,4,4020,4915,-895
1,14,11,10,4,3806,5168,-1362
1,14,12,10,4,4056,5360,-1304
1,14,13,10,4,4526,5088,-562
1,14,14,10,4,4915,4904,11
1,14,15,10,4,5168,4887,281
1,14,16,10,4,5360,4996,364
1,0,0,11,4,4535,4261,274
1,0,1,11,4,4362,4205,157
1,0,2,11,4,4245,4107,138
1,0,3,11,4,4177,4020,157
1,0,4,11,4,4261,3896,365
1,0,5,11,4,4205,3837,368
1,0,6,11,4,4107,3819,288
1,0,7,11,4,4020,3816,204
1,0,8,11,4,3896,3859,37
1,0,9,11,4,3837,3947,-110
1,0,10,11,4,3819,4032,-213
1,0,11,11,4,3816,4158,-342
1,0,12,11,4,3859,4262,-403
1,0,13,11,4,3947,4288,-341
1,0,14,11,4,4032,4360,-328
1,0,15,11,4,4158,4483,-325
1,0,16,11,4,4262,4610,-348
1,1,0,11,4,4576,4710,-134
1,1,1,11,4,4516,4624,-108
1,1,2,11,4,4470,4537,-67
1,1,3,11,4,4527,4423,104
1,1,4,11,4,4710,4251,459
1,1,5,11,4,4624,4169,455
1,1,6,11,4,4537,4173,364
1,1,7,11,4,4423,4158,265
1,1,8,11,4,4251,4209,42
1,1,9,11,4,4169,4352,-183
1,1,10,11,4,4173,4474,-301
1,1,11,11,4,4158,4594,-436
1,1,12,11,4,4209,4717,-508
1,1,13,11,4,4352,4714,-362
1,1,14,11,4,4474,4718,-244
1,1,15,11,4,4594,4831,-237
1,1,16,11,4,4717,4887,-170
1,2,0,11,4,4674,5156,-482
1,2,1,11,4,4694,5069,-375
1,2,2,11,4,4705,4894,-189
1,2,3,11,4,4876,4679,197
1,2,4,11,4,5156,4402,754
1,2,5,11,4,5069,4224,845
1,2,6,11,4,4894,4230,664
1,2,7,11,4,4679,4203,476
1,2,8,11,4,4402,4294,108
1,2,9,11,4,4224,4545,-321
1,2,10,11,4,4230,4791,-561
1,2,11,11,4,4203,5009,-806
1,2,12,11,4,4294,5200,-906
1,2,13,11,4,4545,5178,-633
1,2,14,11,4,4791,5137,-346
1,2,15,11,4,5009,5239,-230
1,2,16,11,4,5200,5204,-4
1,3,0,11,4,4772,5555,-783
1,3,1,11,4,4829,5525,-696
1,3,2,11,4,4941,5192,-251
1,3,3,11,4,5176,4912,264
1,3,4,11,4,5555,4506,1049
1,3,5,11,4,5525,4198,1327
1,3,6,11,4,5192,4205,987
1,3,7,11,4,4912,4162,750
1,3,8,11,4,4506,4313,193
1,3,9,11,4,4198,4692,-494
1,3,10,11,4,4205,5058,-853
1,3,11,11,4,4162,5404,-1242
1,3,12,11,4,4313,5655,-1342
1,3,13,11,4,4692,5575,-883
1,3,14,11,4,5058,5504,-446
1,3,15,11,4,5404,5579,-175
1,3,16,11,4,5655,5466,189
1,4,0,11,4,4886,5905,-1019
1,4,1,11,4,4967,5975,-1008
1,4,2,11,4,5166,5534,-368
1,4,3,11,4,5427,5284,143
1,4,4,11,4,5905,4792,1113
1,4,5,11,4,5975,4367,1608
1,4,6,11,4,5534,4392,1142
1,4,7,11,4,5284,4327,957
1,4,8,11,4,4792,4536,256
1,4,9,11,4,4367,5019,-652
1,4,10,11,4,4392,5417,-1025
1,4,11,11,4,4327,5837,-1510
1,4,12,11,4,4536,6092,-1556
1,4,13,11,4,5019,5907,-888
1,4,14,11,4,5417,5846,-429
1,4,15,11,4,5837,5898,-61
1,4,16,11,4,6092,5736,356
1,5,0,11,4,4965,6347,-1382
1,5,1,11,4,5095,6520,-1425
1,5,2,11,4,5374,5981,-607
1,5,3,11,4,5712,5731,-19
1,5,4,11,4,6347,5127,1220
1,5,5,11,4,6520,4579,1941
1,5,6,11,4,5981,4619,1362
1,5,7,11,4,5731,4523,1208
1,5,8,11,4,5127,4795,332
1,5,9,11,4,4579,5413,-834
1,5,10,11,4,4619,5860,-1241
1,5,11,11,4,4523,6382,-1859
1,5,12,11,4,4795,6625,-1830
1,5,13,11,4,5413,6278,-865
1,5,14,11,4,5860,6209,-349
1,5,15,11,4,6382,6193,189
1,5,16,11,4,6625,5962,663
1,6,0,11,4,4906,6851,-1945
1,6,1,11,4,5136,7100,-1964
1,6,2,11,4,5563,6460,-897
1,6,3,11,4,6007,6199,-192
1,6,4,11,4,6851,5415,1436
1,6,5,11,4,7100,4759,2341
1,6,6,11,4,6460,4807,1653
1,6,7,11,4,6199,4694,1505
1,6,8,11,4,5415,5045,370
1,6,9,11,4,4759,5800,-1041
1,6,10,11,4,4807,6312,-1505
1,6,11,11,4,4694,6909,-2215
1,6,12,11,4,5045,7154,-2109
1,6,13,11,4,5800,6648,-848
1,6,14,11,4,6312,6516,-204
1,6,15,11,4,6909,6391,518
1,6,16,11,4,7154,6082,1072
1,7,0,11,4,4856,7298,-2442
1,7,1,11,4,5218,7554,-2336
1,7,2,11,4,5803,6807,-1004
1,7,3,11,4,6338,6542,-204
1,7,4,11,4,7298,5583,1715
1,7,5,11,4,7554,4814,2740
1,7,6,11,4,6807,4874,1933
1,7,7,11,4,6542,4713,1829
1,7,8,11,4,5583,5138,445
1,7,9,11,4,4814,6044,-1230
1,7,10,11,4,4874,6637,-1763
1,7,11,11,4,4713,7245,-2532
1,7,12,11,4,5138,7491,-2353
1,7,13,11,4,6044,6897,-853
1,7,14,11,4,6637,6729,-92
1,7,15,11,4,7245,6577,668
1,7,16,11,4,7491,6235,1256
1,8,0,11,4,4936,7628,-2692
1,8,1,11,4,5504,7703,-2199
1,8,2,11,4,6244,6811,-567
1,8,3,11,4,6780,6537,243
1,8,4,11,4,7628,5540,2088
1,8,5,11,4,7703,4762,2941
1,8,6,11,4,6811,4822,1989
1,8,7,11,4,6537,4689,1848
1,8,8,11,4,5540,5115,425
1,8,9,11,4,4762,5981,-1219
1,8,10,11,4,4822,6671,-1849
1,8,11,11,4,4689,7267,-2578
1,8,12,11,4,5115,7575,-2460
1,8,13,11,4,5981,7141,-1160
1,8,14,11,4,6671,6979,-308
1,8,15,11,4,7267,6804,463
1,8,16,11,4,7575,6410,1165
1,9,0,11,4,5088,7596,-2508
1,9,1,11,4,5659,7664,-2005
1,9,2,11,4,6436,6774,-338
1,9,3,11,4,6926,6591,335
1,9,4,11,4,7596,5610,1986
1,9,5,11,4,7664,4784,2880
1,9,6,11,4,6774,4867,1907
1,9,7,11,4,6591,4678,1913
1,9,8,11,4,5610,5037,573
1,9,9,11,4,4784,5945,-1161
1,9,10,11,4,4867,6701,-1834
1,9,11,11,4,4678,7265,-2587
1,9,12,11,4,5037,7616,-2579
1,9,13,11,4,5945,7206,-1261
1,9,14,11,4,6701,6918,-217
1,9,15,11,4,7265,6759,506
1,9,16,11,4,7616,6465,1151
1,10,0,11,4,5365,7781,-2416
1,10,1,11,4,5908,7973,-2065
1,10,2,11,4,6666,7186,-520
1,10,3,11,4,7186,7098,88
1,10,4,11,4,7781,6089,1692
1,10,5,11,4,7973,5196,2777
1,10,6,11,4,7186,5306,1880
1,10,7,11,4,7098,5050,2048
1,10,8,11,4,6089,5347,742
1,10,9,11,4,5196,6221,-1025
1,10,10,11,4,5306,6913,-1607
1,10,11,11,4,5050,7410,-2360
1,10,12,11,4,5347,7769,-2422
1,10,13,11,4,6221,7392,-1171
1,10,14,11,4,6913,7035,-122
1,10,15,11,4,7410,6865,545
1,10,16,11,4,7769,6649,1120
1,11,0,11,4,5680,7471,-1791
1,11,1,11,4,6038,7752,-1714
1,11,2,11,4,6682,6964,-282
1,11,3,11,4,7108,6835,273
1,11,4,11,4,7471,5824,1647
1,11,5,11,4,7752,4891,2861
1,11,6,11,4,6964,4992,1972
1,11,7,11,4,6835,4742,2093
1,11,8,11,4,5824,5040,784
1,11,9,11,4,4891,5849,-958
1,11,10,11,4,4992,6558,-1566
1,11,11,11,4,4742,7098,-2356
1,11,12,11,4,5040,7495,-2455
1,11,13,11,4,5849,7206,-1357
1,11,14,11,4,6558,6935,-377
1,11,15,11,4,7098,6819,279
1,11,16,11,4,7495,6706,789
1,12,0,11,4,5595,6807,-1212
1,12,1,11,4,5782,7236,-1454
1,12,2,11,4,6314,6457,-143
1,12,3,11,4,6576,6382,194
1,12,4,11,4,6807,5389,1418
1,12,5,11,4,7236,4446,2790
1,12,6,11,4,6457,4559,1898
1,12,7,11,4,6382,4282,2100
1,12,8,11,4,5389,4606,783
1,12,9,11,4,4446,5360,-914
1,12,10,11,4,4559,6020,-1461
1,12,11,11,4,4282,6547,-2265
1,12,12,11,4,4606,6882,-2276
1,12,13,11,4,5360,6558,-1198
1,12,14,11,4,6020,6338,-318
1,12,15,11,4,6547,6267,280
1,12,16,11,4,6882,6229,653
1,13,0,11,4,5370,6194,-824
1,13,1,11,4,5429,6685,-1256
1,13,2,11,4,5903,6029,-126
1,13,3,11,4,6050,6060,-10
1,13,4,11,4,6194,5156,1038
1,13,5,11,4,6685,4320,2365
1,13,6,11,4,6029,4425,1604
1,13,7,11,4,6060,4196,1864
1,13,8,11,4,5156,4510,646
1,13,9,11,4,4320,5119,-799
1,13,10,11,4,4425,5629,-1204
1,13,11,11,4,4196,6009,-1813
1,13,12,11,4,4510,6257,-1747
1,13,13,11,4,5119,5913,-794
1,13,14,11,4,5629,5700,-71
1,13,15,11,4,6009,5662,347
1,13,16,11,4,6257,5692,565
1,0,0,12,4,4987,5142,-155
1,0,1,12,4,4928,5049,-121
1,0,2,12,4,4886,4954,-68
1,0,3,12,4,4951,4838,113
1,0,4,12,4,5142,4662,480
1,0,5,12,4,5049,4578,471
1,0,6,12,4,4954,4582,372
1,0,7,12,4,4838,4569,269
1,0,8,12,4,4662,4623,39
1,0,9,12,4,4578,4762,-184
1,0,10,12,4,4582,4883,-301
1,0,11,12,4,4569,5009,-440
1,0,12,12,4,4623,5135,-512
1,0,13,12,4,4762,5132,-370
1,0,14,12,4,4883,5137,-254
1,0,15,12,4,5009,5249,-240
1,0,16,12,4,5135,5299,-164
1,1,0,12,4,5104,5585,-481
1,1,1,12,4,5130,5494,-364
1,1,2,12,4,5138,5317,-179
1,1,3,12,4,5304,5104,200
1,1,4,12,4,5585,4823,762
1,1,5,12,4,5494,4640,854
1,1,6,12,4,5317,4644,673
1,1,7,12,4,5104,4618,486
1,1,8,12,4,4823,4713,110
1,1,9,12,4,4640,4976,-336
1,1,10,12,4,4644,5225,-581
1,1,11,12,4,4618,5442,-824
1,1,12,12,4,4713,5628,-915
1,1,13,12,4,4976,5592,-616
1,1,14,12,4,5225,5555,-330
1,1,15,12,4,5442,5667,-225
1,1,16,12,4,5628,5632,-4
1,2,0,12,4,5212,5999,-787
1,2,1,12,4,5273,5974,-701
1,2,2,12,4,5378,5646,-268
1,2,3,12,4,5609,5367,242
1,2,4,12,4,5999,4950,1049
1,2,5,12,4,5974,4633,1341
1,2,6,12,4,5646,4635,1011
1,2,7,12,4,5367,4593,774
1,2,8,12,4,4950,4748,202
1,2,9,12,4,4633,5138,-505
1,2,10,12,4,4635,5505,-870
1,2,11,12,4,4593,5850,-1257
1,2,12,12,4,4748,6097,-1349
1,2,13,12,4,5138,6003,-865
1,2,14,12,4,5505,5933,-428
1,2,15,12,4,5850,6014,-164
1,2,16,12,4,6097,5900,197
1,3,0,12,4,5330,6359,-1029
1,3,1,12,4,5411,6389,-978
1,3,2,12,4,5608,5902,-294
1,3,3,12,4,5871,5606,265
1,3,4,12,4,6359,5062,1297
1,3,5,12,4,6389,4627,1762
1,3,6,12,4,5902,4646,1256
1,3,7,12,4,5606,4580,1026
1,3,8,12,4,5062,4793,269
1,3,9,12,4,4627,5304,-677
1,3,10,12,4,4646,5738,-1092
1,3,11,12,4,4580,6210,-1630
1,3,12,12,4,4793,6519,-1726
1,3,13,12,4,5304,6351,-1047
1,3,14,12,4,5738,6295,-557
1,3,15,12,4,6210,6341,-131
1,3,16,12,4,6519,6169,350
1,4,0,12,4,5427,6763,-1336
1,4,1,12,4,5569,6864,-1295
1,4,2,12,4,5849,6256,-407
1,4,3,12,4,6167,5960,207
1,4,4,12,4,6763,5325,1438
1,4,5,12,4,6864,4767,2097
1,4,6,12,4,6256,4801,1455
1,4,7,12,4,5960,4704,1256
1,4,8,12,4,5325,4979,346
1,4,9,12,4,4767,5612,-845
1,4,10,12,4,4801,6089,-1288
1,4,11,12,4,4704,6670,-1966
1,4,12,12,4,4979,6988,-2009
1,4,13,12,4,5612,6697,-1085
1,4,14,12,4,6089,6663,-574
1,4,15,12,4,6670,6654,16
1,4,16,12,4,6988,6410,578
1,5,0,12,4,5381,7193,-1812
1,5,1,12,4,5622,7386,-1764
1,5,2,12,4,6036,6705,-669
1,5,3,12,4,6429,6442,-13
1,5,4,12,4,7193,5684,1509
1,5,5,12,4,7386,5024,2362
1,5,6,12,4,6705,5069,1636
1,5,7,12,4,6442,4954,1488
1,5,8,12,4,5684,5306,378
1,5,9,12,4,5024,6051,-1027
1,5,10,12,4,5069,6556,-1487
1,5,11,12,4,4954,7169,-2215
1,5,12,12,4,5306,7455,-2149
1,5,13,12,4,6051,7010,-959
1,5,14,12,4,6556,6939,-383
1,5,15,12,4,7169,6851,318
1,5,16,12,4,7455,6543,912
1,6,0,12,4,5298,7592,-2294
1,6,1,12,4,5627,7830,-2203
1,6,2,12,4,6170,7070,-900
1,6,3,12,4,6663,6807,-144
1,6,4,12,4,7592,5859,1733
1,6,5,12,4,7830,5090,2740
1,6,6,12,4,7070,5150,1920
1,6,7,12,4,6807,4988,1819
1,6,8,12,4,5859,5412,447
1,6,9,12,4,5090,6326,-1236
1,6,10,12,4,5150,6916,-1766
1,6,11,12,4,4988,7527,-2539
1,6,12,12,4,5412,7792,-2380
1,6,13,12,4,6326,7218,-892
1,6,14,12,4,6916,7091,-175
1,6,15,12,4,7527,6984,543
1,6,16,12,4,7792,6670,1122
1,7,0,12,4,5330,7912,-2582
1,7,1,12,4,5808,8042,-2234
1,7,2,12,4,6480,7189,-709
1,7,3,12,4,7008,6930,78
1,7,4,12,4,7912,5927,1985
1,7,5,12,4,8042,5153,2889
1,7,6,12,4,7189,5215,1974
1,7,7,12,4,6930,5082,1848
1,7,8,12,4,5927,5505,422
1,7,9,12,4,5153,6371,-1218
1,7,10,12,4,5215,7047,-1832
1,7,11,12,4,5082,7625,-2543
1,7,12,12,4,5505,7914,-2409
1,7,13,12,4,6371,7453,-1082
1,7,14,12,4,7047,7291,-244
1,7,15,12,4,7625,7147,478
1,7,16,12,4,7914,6801,1113
1,8,0,12,4,5554,8009,-2455
1,8,1,12,4,6062,8141,-2079
1,8,2,12,4,6792,7292,-500
1,8,3,12,4,7296,7104,192
1,8,4,12,4,8009,6139,1870
1,8,5,12,4,8141,5332,2809
1,8,6,12,4,7292,5426,1866
1,8,7,12,4,7104,5245,1859
1,8,8,12,4,6139,5605,534
1,8,9,12,4,5332,6501,-1169
1,8,10,12,4,5426,7242,-1816
1,8,11,12,4,5245,7797,-2552
1,8,12,12,4,5605,8103,-2498
1,8,13,12,4,6501,7658,-1157
1,8,14,12,4,7242,7367,-125
1,8,15,12,4,7797,7197,600
1,8,16,12,4,8103,6941,1162
1,9,0,12,4,5652,7988,-2336
1,9,1,12,4,6130,8203,-2073
1,9,2,12,4,6874,7402,-528
1,9,3,12,4,7369,7299,70
1,9,4,12,4,7988,6259,1729
1,9,5,12,4,8203,5341,2862
1,9,6,12,4,7402,5438,1964
1,9,7,12,4,7299,5180,2119
1,9,8,12,4,6259,5494,765
1,9,9,12,4,5341,6388,-1047
1,9,10,12,4,5438,7118,-1680
1,9,11,12,4,5180,7646,-2466
1,9,12,12,4,5494,7999,-2505
1,9,13,12,4,6388,7614,-1226
1,9,14,12,4,7118,7251,-133
1,9,15,12,4,7646,7099,547
1,9,16,12,4,7999,6939,1060
1,10,0,12,4,5964,8017,-2053
1,10,1,12,4,6366,8292,-1926
1,10,2,12,4,7084,7514,-430
1,10,3,12,4,7573,7394,179
1,10,4,12,4,8017,6345,1672
1,10,5,12,4,8292,5395,2897
1,10,6,12,4,7514,5500,2014
1,10,7,12,4,7394,5242,2152
1,10,8,12,4,6345,5550,795
1,10,9,12,4,5395,6379,-984
1,10,10,12,4,5500,7105,-1605
1,10,11,12,4,5242,7633,-2391
1,10,12,12,4,5550,8021,-2471
1,10,13,12,4,6379,7702,-1323
1,10,14,12,4,7105,7364,-259
1,10,15,12,4,7633,7235,398
1,10,16,12,4,8021,7108,913
1,11,0,12,4,6047,7688,-1641
1,11,1,12,4,6348,8080,-1732
1,11,2,12,4,6955,7304,-349
1,11,3,12,4,7350,7200,150
1,11,4,12,4,7688,6155,1533
1,11,5,12,4,8080,5187,2893
1,11,6,12,4,7304,5322,1982
1,11,7,12,4,7200,5035,2165
1,11,8,12,4,6155,5370,785
1,11,9,12,4,5187,6175,-988
1,11,10,12,4,5322,6871,-1549
1,11,11,12,4,5035,7398,-2363
1,11,12,12,4,5370,7755,-2385
1,11,13,12,4,6175,7402,-1227
1,11,14,12,4,6871,7115,-244
1,11,15,12,4,7398,7033,365
1,11,16,12,4,7755,6918,837
1,12,0,12,4,5898,7069,-1171
1,12,1,12,4,6043,7555,-1512
1,12,2,12,4,6571,6809,-238
1,12,3,12,4,6827,6741,86
1,12,4,12,4,7069,5728,1341
1,12,5,12,4,7555,4791,2764
1,12,6,12,4,6809,4896,1913
1,12,7,12,4,6741,4656,2085
1,12,8,12,4,5728,5014,714
1,12,9,12,4,4791,5743,-952
1,12,10,12,4,4896,6380,-1484
1,12,11,12,4,4656,6857,-2201
1,12,12,12,4,5014,7168,-2154
1,12,13,12,4,5743,6791,-1048
1,12,14,12,4,6380,6537,-157
1,12,15,12,4,6857,6498,359
1,12,16,12,4,7168,6437,731
1,0,0,13,4,5515,6017,-502
1,0,1,13,4,5542,5919,-377
1,0,2,13,4,5554,5734,-180
1,0,3,13,4,5728,5519,209
1,0,4,13,4,6017,5234,783
1,0,5,13,4,5919,5049,870
1,0,6,13,4,5734,5053,681
1,0,7,13,4,5519,5029,490
1,0,8,13,4,5234,5127,107
1,0,9,13,4,5049,5386,-337
1,0,10,13,4,5053,5634,-581
1,0,11,13,4,5029,5857,-828
1,0,12,13,4,5127,6046,-919
1,0,13,13,4,5386,6010,-624
1,0,14,13,4,5634,5974,-340
1,0,15,13,4,5857,6085,-228
1,0,16,13,4,6046,6044,2
1,1,0,13,4,5642,6428,-786
1,1,1,13,4,5709,6399,-690
1,1,2,13,4,5811,6069,-258
1,1,3,13,4,6037,5792,245
1,1,4,13,4,6428,5371,1057
1,1,5,13,4,6399,5049,1350
1,1,6,13,4,6069,5049,1020
1,1,7,13,4,5792,5008,784
1,1,8,13,4,5371,5167,204
1,1,9,13,4,5049,5569,-520
1,1,10,13,4,5049,5939,-890
1,1,11,13,4,5008,6283,-1275
1,1,12,13,4,5167,6525,-1358
1,1,13,13,4,5569,6417,-848
1,1,14,13,4,5939,6351,-412
1,1,15,13,4,6283,6442,-159
1,1,16,13,4,6525,6328,197
1,2,0,13,4,5770,6803,-1033
1,2,1,13,4,5855,6838,-983
1,2,2,13,4,6045,6356,-311
1,2,3,13,4,6304,6061,243
1,2,4,13,4,6803,5506,1297
1,2,5,13,4,6838,5062,1776
1,2,6,13,4,6356,5076,1280
1,2,7,13,4,6061,5011,1050
1,2,8,13,4,5506,5228,278
1,2,9,13,4,5062,5750,-688
1,2,10,13,4,5076,6185,-1109
1,2,11,13,4,5011,6656,-1645
1,2,12,13,4,5228,6961,-1733
1,2,13,13,4,5750,6779,-1029
1,2,14,13,4,6185,6724,-539
1,2,15,13,4,6656,6776,-120
1,2,16,13,4,6961,6603,358
1,3,0,13,4,5871,7217,-1346
1,3,1,13,4,6013,7278,-1265
1,3,2,13,4,6291,6624,-333
1,3,3,13,4,6611,6282,329
1,3,4,13,4,7217,5595,1622
1,3,5,13,4,7278,5027,2251
1,3,6,13,4,6624,5055,1569
1,3,7,13,4,6282,4957,1325
1,3,8,13,4,5595,5236,359
1,3,9,13,4,5027,5897,-870
1,3,10,13,4,5055,6410,-1355
1,3,11,13,4,4957,7043,-2086
1,3,12,13,4,5236,7415,-2179
1,3,13,13,4,5897,7141,-1244
1,3,14,13,4,6410,7112,-702
1,3,15,13,4,7043,7097,-54
1,3,16,13,4,7415,6843,572
1,4,0,13,4,5843,7609,-1766
1,4,1,13,4,6096,7730,-1634
1,4,2,13,4,6511,6980,-469
1,4,3,13,4,6884,6671,213
1,4,4,13,4,7609,5882,1727
1,4,5,13,4,7730,5212,2518
1,4,6,13,4,6980,5251,1729
1,4,7,13,4,6671,5135,1536
1,4,8,13,4,5882,5490,392
1,4,9,13,4,5212,6250,-1038
1,4,10,13,4,5251,6785,-1534
1,4,11,13,4,5135,7457,-2322
1,4,12,13,4,5490,7818,-2328
1,4,13,13,4,6250,7429,-1179
1,4,14,13,4,6785,7393,-608
1,4,15,13,4,7457,7312,145
1,4,16,13,4,7818,6991,827
1,5,0,13,4,5773,7934,-2161
1,5,1,13,4,6113,8116,-2003
1,5,2,13,4,6643,7315,-672
1,5,3,13,4,7085,7050,35
1,5,4,13,4,7934,6128,1806
1,5,5,13,4,8116,5355,2761
1,5,6,13,4,7315,5412,1903
1,5,7,13,4,7050,5248,1802
1,5,8,13,4,6128,5673,455
1,5,9,13,4,5355,6577,-1222
1,5,10,13,4,5412,7160,-1748
1,5,11,13,4,5248,7787,-2539
1,5,12,13,4,5673,8093,-2420
1,5,13,13,4,6577,7580,-1003
1,5,14,13,4,7160,7514,-354
1,5,15,13,4,7787,7444,343
1,5,16,13,4,8093,7131,962
1,6,0,13,4,5772,8206,-2434
1,6,1,13,4,6217,8318,-2101
1,6,2,13,4,6847,7452,-605
1,6,3,13,4,7333,7195,138
1,6,4,13,4,8206,6203,2003
1,6,5,13,4,8318,5429,2889
1,6,6,13,4,7452,5491,1961
1,6,7,13,4,7195,5357,1838
1,6,8,13,4,6203,5779,424
1,6,9,13,4,5429,6653,-1224
1,6,10,13,4,5491,7326,-1835
1,6,11,13,4,5357,7907,-2550
1,6,12,13,4,5779,8215,-2436
1,6,13,13,4,6653,7774,-1121
1,6,14,13,4,7326,7653,-327
1,6,15,13,4,7907,7554,353
1,6,16,13,4,8215,7236,979
1,7,0,13,4,5948,8293,-2345
1,7,1,13,4,6366,8480,-2114
1,7,2,13,4,7028,7670,-642
1,7,3,13,4,7524,7497,27
1,7,4,13,4,8293,6526,1767
1,7,5,13,4,8480,5723,2757
1,7,6,13,4,7670,5819,1851
1,7,7,13,4,7497,5638,1859
1,7,8,13,4,6526,5995,531
1,7,9,13,4,5723,6891,-1168
1,7,10,13,4,5819,7618,-1799
1,7,11,13,4,5638,8155,-2517
1,7,12,13,4,5995,8442,-2447
1,7,13,13,4,6891,7970,-1079
1,7,14,13,4,7618,7679,-61
1,7,15,13,4,8155,7540,615
1,7,16,13,4,8442,7332,1110
1,8,0,13,4,6118,8401,-2283
1,8,1,13,4,6533,8680,-2147
1,8,2,13,4,7230,7920,-690
1,8,3,13,4,7739,7812,-73
1,8,4,13,4,8401,6788,1613
1,8,5,13,4,8680,5889,2791
1,8,6,13,4,7920,5997,1923
1,8,7,13,4,7812,5747,2065
1,8,8,13,4,6788,6062,726
1,8,9,13,4,5889,6944,-1055
1,8,10,13,4,5997,7659,-1662
1,8,11,13,4,5747,8178,-2431
1,8,12,13,4,6062,8486,-2424
1,8,13,13,4,6944,8066,-1122
1,8,14,13,4,7659,7700,-41
1,8,15,13,4,8178,7537,641
1,8,16,13,4,8486,7415,1071
1,9,0,13,4,6251,8224,-1973
1,9,1,13,4,6588,8522,-1934
1,9,2,13,4,7292,7730,-438
1,9,3,13,4,7756,7595,161
1,9,4,13,4,8224,6515,1709
1,9,5,13,4,8522,5540,2982
1,9,6,13,4,7730,5632,2098
1,9,7,13,4,7595,5372,2223
1,9,8,13,4,6515,5697,818
1,9,9,13,4,5540,6546,-1006
1,9,10,13,4,5632,7310,-1678
1,9,11,13,4,5372,7869,-2497
1,9,12,13,4,5697,8251,-2554
1,9,13,13,4,6546,7924,-1378
1,9,14,13,4,7310,7580,-270
1,9,15,13,4,7869,7469,400
1,9,16,13,4,8251,7398,853
1,10,0,13,4,6331,8234,-1903
1,10,1,13,4,6676,8620,-1944
1,10,2,13,4,7357,7854,-497
1,10,3,13,4,7815,7759,56
1,10,4,13,4,8234,6676,1558
1,10,5,13,4,8620,5691,2929
1,10,6,13,4,7854,5830,2024
1,10,7,13,4,7759,5535,2224
1,10,8,13,4,6676,5880,796
1,10,9,13,4,5691,6705,-1014
1,10,10,13,4,5830,7418,-1588
1,10,11,13,4,5535,7933,-2398
1,10,12,13,4,5880,8281,-2401
1,10,13,13,4,6705,7898,-1193
1,10,14,13,4,7418,7544,-126
1,10,15,13,4,7933,7449,484
1,10,16,13,4,8281,7320,961
1,11,0,13,4,6350,7950,-1600
1,11,1,13,4,6609,8399,-1790
1,11,2,13,4,7212,7656,-444
1,11,3,13,4,7601,7559,42
1,11,4,13,4,7950,6494,1456
1,11,5,13,4,8399,5532,2867
1,11,6,13,4,7656,5659,1997
1,11,7,13,4,7559,5409,2150
1,11,8,13,4,6494,5778,716
1,11,9,13,4,5532,6558,-1026
1,11,10,13,4,5659,7231,-1572
1,11,11,13,4,5409,7708,-2299
1,11,12,13,4,5778,8041,-2263
1,11,13,13,4,6558,7635,-1077
1,11,14,13,4,7231,7314,-83
1,11,15,13,4,7708,7264,444
1,11,16,13,4,8041,7126,915
1,0,0,14,4,6053,6860,-807
1,0,1,14,4,6121,6824,-703
1,0,2,14,4,6227,6486,-259
1,0,3,14,4,6461,6207,254
1,0,4,14,4,6860,5782,1078
1,0,5,14,4,6824,5458,1366
1,0,6,14,4,6486,5458,1028
1,0,7,14,4,6207,5419,788
1,0,8,14,4,5782,5581,201
1,0,9,14,4,5458,5979,-521
1,0,10,14,4,5458,6348,-890
1,0,11,14,4,5419,6698,-1279
1,0,12,14,4,5581,6943,-1362
1,0,13,14,4,5979,6835,-856
1,0,14,14,4,6348,6770,-422
1,0,15,14,4,6698,6860,-162
1,0,16,14,4,6943,6740,203
1,1,0,14,4,6200,7232,-1032
1,1,1,14,4,6291,7263,-972
1,1,2,14,4,6478,6779,-301
1,1,3,14,4,6732,6486,246
1,1,4,14,4,7232,5927,1305
1,1,5,14,4,7263,5478,1785
1,1,6,14,4,6779,5490,1289
1,1,7,14,4,6486,5426,1060
1,1,8,14,4,5927,5647,280
1,1,9,14,4,5478,6181,-703
1,1,10,14,4,5490,6619,-1129
1,1,11,14,4,5426,7089,-1663
1,1,12,14,4,5647,7389,-1742
1,1,13,14,4,6181,7193,-1012
1,1,14,14,4,6619,7142,-523
1,1,15,14,4,7089,7204,-115
1,1,16,14,4,7389,7031,358
1,2,0,14,4,6311,7661,-1350
1,2,1,14,4,6457,7727,-1270
1,2,2,14,4,6728,7078,-350
1,2,3,14,4,7044,6737,307
1,2,4,14,4,7661,6039,1622
1,2,5,14,4,7727,5462,2265
1,2,6,14,4,7078,5485,1593
1,2,7,14,4,6737,5388,1349
1,2,8,14,4,6039,5671,368
1,2,9,14,4,5462,6343,-881
1,2,10,14,4,5485,6857,-1372
1,2,11,14,4,5388,7489,-2101
1,2,12,14,4,5671,7857,-2186
1,2,13,14,4,6343,7569,-1226
1,2,14,14,4,6857,7541,-684
1,2,15,14,4,7489,7532,-43
1,2,16,14,4,7857,7277,580
1,3,0,14,4,6287,8063,-1776
1,3,1,14,4,6540,8144,-1604
1,3,2,14,4,6953,7348,-395
1,3,3,14,4,7328,6993,335
1,3,4,14,4,8063,6152,1911
1,3,5,14,4,8144,5472,2672
1,3,6,14,4,7348,5505,1843
1,3,7,14,4,6993,5388,1605
1,3,8,14,4,6152,5747,405
1,3,9,14,4,5472,6535,-1063
1,3,10,14,4,5505,7106,-1601
1,3,11,14,4,5388,7830,-2442
1,3,12,14,4,5747,8245,-2498
1,3,13,14,4,6535,7873,-1338
1,3,14,14,4,7106,7842,-736
1,3,15,14,4,7830,7755,75
1,3,16,14,4,8245,7424,821
1,4,0,14,4,6235,8350,-2115
1,4,1,14,4,6587,8460,-1873
1,4,2,14,4,7118,7590,-472
1,4,3,14,4,7540,7279,261
1,4,4,14,4,8350,6326,2024
1,4,5,14,4,8460,5543,2917
1,4,6,14,4,7590,5594,1996
1,4,7,14,4,7279,5429,1850
1,4,8,14,4,6326,5857,469
1,4,9,14,4,5543,6776,-1233
1,4,10,14,4,5594,7389,-1795
1,4,11,14,4,5429,8075,-2646
1,4,12,14,4,5857,8456,-2599
1,4,13,14,4,6776,7999,-1223
1,4,14,14,4,7389,7968,-579
1,4,15,14,4,8075,7905,170
1,4,16,14,4,8456,7579,877
1,5,0,14,4,6247,8548,-2301
1,5,1,14,4,6703,8604,-1901
1,5,2,14,4,7320,7697,-377
1,5,3,14,4,7755,7438,317
1,5,4,14,4,8548,6472,2076
1,5,5,14,4,8604,5694,2910
1,5,6,14,4,7697,5753,1944
1,5,7,14,4,7438,5617,1821
1,5,8,14,4,6472,6040,432
1,5,9,14,4,5694,6904,-1210
1,5,10,14,4,5753,7570,-1817
1,5,11,14,4,5617,8167,-2550
1,5,12,14,4,6040,8516,-2476
1,5,13,14,4,6904,8136,-1232
1,5,14,14,4,7570,8076,-506
1,5,15,14,4,8167,8014,153
1,5,16,14,4,8516,7697,819
1,6,0,14,4,6390,8587,-2197
1,6,1,14,4,6775,8756,-1981
1,6,2,14,4,7395,7933,-538
1,6,3,14,4,7849,7762,87
1,6,4,14,4,8587,6802,1785
1,6,5,14,4,8756,5999,2757
1,6,6,14,4,7933,6095,1838
1,6,7,14,4,7762,5913,1849
1,6,8,14,4,6802,6269,533
1,6,9,14,4,5999,7173,-1174
1,6,10,14,4,6095,7897,-1802
1,6,11,14,4,5913,8437,-2524
1,6,12,14,4,6269,8743,-2474
1,6,13,14,4,7173,8291,-1118
1,6,14,14,4,7897,8041,-144
1,6,15,14,4,8437,7947,490
1,6,16,14,4,8743,7767,976
1,7,0,14,4,6512,8685,-2173
1,7,1,14,4,6837,9019,-2182
1,7,2,14,4,7466,8298,-832
1,7,3,14,4,7967,8205,-238
1,7,4,14,4,8685,7175,1510
1,7,5,14,4,9019,6280,2739
1,7,6,14,4,8298,6390,1908
1,7,7,14,4,8205,6140,2065
1,7,8,14,4,7175,6452,723
1,7,9,14,4,6280,7334,-1054
1,7,10,14,4,6390,8035,-1645
1,7,11,14,4,6140,8536,-2396
1,7,12,14,4,6452,8825,-2373
1,7,13,14,4,7334,8378,-1044
1,7,14,14,4,8035,8012,23
1,7,15,14,4,8536,7880,656
1,7,16,14,4,8825,7806,1019
1,8,0,14,4,6717,8637,-1920
1,8,1,14,4,6991,8999,-2008
1,8,2,14,4,7648,8248,-600
1,8,3,14,4,8126,8108,18
1,8,4,14,4,8637,7044,1593
1,8,5,14,4,8999,6088,2911
1,8,6,14,4,8248,6191,2057
1,8,7,14,4,8108,5939,2169
1,8,8,14,4,7044,6265,779
1,8,9,14,4,6088,7102,-1014
1,8,10,14,4,6191,7851,-1660
1,8,11,14,4,5939,8401,-2462
1,8,12,14,4,6265,8738,-2473
1,8,13,14,4,7102,8376,-1274
1,8,14,14,4,7851,8029,-178
1,8,15,14,4,8401,7907,494
1,8,16,14,4,8738,7874,864
1,9,0,14,4,6618,8441,-1823
1,9,1,14,4,6898,8850,-1952
1,9,2,14,4,7565,8070,-505
1,9,3,14,4,7998,7960,38
1,9,4,14,4,8441,6846,1595
1,9,5,14,4,8850,5836,3014
1,9,6,14,4,8070,5962,2108
1,9,7,14,4,7960,5665,2295
1,9,8,14,4,6846,6027,819
1,9,9,14,4,5836,6872,-1036
1,9,10,14,4,5962,7623,-1661
1,9,11,14,4,5665,8169,-2504
1,9,12,14,4,6027,8511,-2484
1,9,13,14,4,6872,8120,-1248
1,9,14,14,4,7623,7760,-137
1,9,15,14,4,8169,7683,486
1,9,16,14,4,8511,7610,901
1,10,0,14,4,6634,8496,-1862
1,10,1,14,4,6937,8939,-2002
1,10,2,14,4,7614,8206,-592
1,10,3,14,4,8066,8118,-52
1,10,4,14,4,8496,7015,1481
1,10,5,14,4,8939,6036,2903
1,10,6,14,4,8206,6167,2039
1,10,7,14,4,8118,5909,2209
1,10,8,14,4,7015,6288,727
1,10,9,14,4,6036,7088,-1052
1,10,10,14,4,6167,7778,-1611
1,10,11,14,4,5909,8243,-2334
1,10,12,14,4,6288,8567,-2279
1,10,13,14,4,7088,8131,-1043
1,10,14,14,4,7778,7743,35
1,10,15,14,4,8243,7680,563
1,10,16,14,4,8567,7528,1039
1,0,0,15,4,6611,7664,-1053
1,0,1,15,4,6703,7688,-985
1,0,2,15,4,6894,7196,-302
1,0,3,15,4,7156,6901,255
1,0,4,15,4,7664,6338,1326
1,0,5,15,4,7688,5887,1801
1,0,6,15,4,7196,5899,1297
1,0,7,15,4,6901,5837,1064
1,0,8,15,4,6338,6061,277
1,0,9,15,4,5887,6591,-704
1,0,10,15,4,5899,7028,-1129
1,0,11,15,4,5837,7504,-1667
1,0,12,15,4,6061,7807,-1746
1,0,13,15,4,6591,7611,-1020
1,0,14,15,4,7028,7561,-533
1,0,15,15,4,7504,7622,-118
1,0,16,15,4,7807,7443,364
1,1,0,15,4,6741,8090,-1349
1,1,1,15,4,6893,8152,-1259
1,1,2,15,4,7161,7501,-340
1,1,3,15,4,7472,7162,310
1,1,4,15,4,8090,6460,1630
1,1,5,15,4,8152,5878,2274
1,1,6,15,4,7501,5899,1602
1,1,7,15,4,7162,5803,1359
1,1,8,15,4,6460,6090,370
1,1,9,15,4,5878,6774,-896
1,1,10,15,4,5899,7291,-1392
1,1,11,15,4,5803,7922,-2119
1,1,12,15,4,6090,8285,-2195
1,1,13,15,4,6774,7983,-1209
1,1,14,15,4,7291,7959,-668
1,1,15,15,4,7922,7960,-38
1,1,16,15,4,8285,7705,580
1,2,0,15,4,6727,8507,-1780
1,2,1,15,4,6984,8593,-1609
1,2,2,15,4,7390,7802,-412
1,2,3,15,4,7761,7448,313
1,2,4,15,4,8507,6596,1911
1,2,5,15,4,8593,5907,2686
1,2,6,15,4,7802,5935,1867
1,2,7,15,4,7448,5819,1629
1,2,8,15,4,6596,6182,414
1,2,9,15,4,5907,6981,-1074
1,2,10,15,4,5935,7553,-1618
1,2,11,15,4,5819,8276,-2457
1,2,12,15,4,6182,8687,-2505
1,2,13,15,4,6981,8301,-1320
1,2,14,15,4,7553,8271,-718
1,2,15,15,4,8276,8190,86
1,2,16,15,4,8687,7858,829
1,3,0,15,4,6679,8804,-2125
1,3,1,15,4,7031,8874,-1843
1,3,2,15,4,7560,7958,-398
1,3,3,15,4,7984,7601,383
1,3,4,15,4,8804,6596,2208
1,3,5,15,4,8874,5803,3071
1,3,6,15,4,7958,5848,2110
1,3,7,15,4,7601,5682,1919
1,3,8,15,4,6596,6114,482
1,3,9,15,4,5803,7061,-1258
1,3,10,15,4,5848,7710,-1862
1,3,11,15,4,5682,8448,-2766
1,3,12,15,4,6114,8883,-2769
1,3,13,15,4,7061,8443,-1382
1,3,14,15,4,7710,8417,-707
1,3,15,15,4,8448,8348,100
1,3,16,15,4,8883,8012,871
1,4,0,15,4,6709,8964,-2255
1,4,1,15,4,7177,8948,-1771
1,4,2,15,4,7795,7972,-177
1,4,3,15,4,8210,7667,543
1,4,4,15,4,8964,6670,2294
1,4,5,15,4,8948,5882,3066
1,4,6,15,4,7972,5935,2037
1,4,7,15,4,7667,5798,1869
1,4,8,15,4,6670,6224,446
1,4,9,15,4,5882,7103,-1221
1,4,10,15,4,5935,7799,-1864
1,4,11,15,4,5798,8455,-2657
1,4,12,15,4,6224,8879,-2655
1,4,13,15,4,7103,8555,-1452
1,4,14,15,4,7799,8530,-731
1,4,15,15,4,8455,8475,-20
1,4,16,15,4,8879,8145,734
1,5,0,15,4,6865,8929,-2064
1,5,1,15,4,7261,9042,-1781
1,5,2,15,4,7868,8178,-310
1,5,3,15,4,8271,8005,266
1,5,4,15,4,8929,7071,1858
1,5,5,15,4,9042,6264,2778
1,5,6,15,4,8178,6357,1821
1,5,7,15,4,8005,6173,1832
1,5,8,15,4,7071,6530,541
1,5,9,15,4,6264,7424,-1160
1,5,10,15,4,6357,8141,-1784
1,5,11,15,4,6173,8697,-2524
1,5,12,15,4,6530,9044,-2514
1,5,13,15,4,7424,8653,-1229
1,5,14,15,4,8141,8464,-323
1,5,15,15,4,8697,8407,290
1,5,16,15,4,9044,8228,816
1,6,0,15,4,6954,8979,-2025
1,6,1,15,4,7246,9295,-2049
1,6,2,15,4,7833,8561,-728
1,6,3,15,4,8292,8470,-178
1,6,4,15,4,8979,7451,1528
1,6,5,15,4,9295,6556,2739
1,6,6,15,4,8561,6666,1895
1,6,7,15,4,8470,6415,2055
1,6,8,15,4,7451,6726,725
1,6,9,15,4,6556,7616,-1060
1,6,10,15,4,6666,8314,-1648
1,6,11,15,4,6415,8818,-2403
1,6,12,15,4,6726,9126,-2400
1,6,13,15,4,7616,8699,-1083
1,6,14,15,4,8314,8374,-60
1,6,15,15,4,8818,8287,531
1,6,16,15,4,9126,8241,885
1,7,0,15,4,7111,8921,-1810
1,7,1,15,4,7295,9338,-2043
1,7,2,15,4,7884,8626,-742
1,7,3,15,4,8354,8501,-147
1,7,4,15,4,8921,7431,1490
1,7,5,15,4,9338,6479,2859
1,7,6,15,4,8626,6584,2042
1,7,7,15,4,8501,6332,2169
1,7,8,15,4,7431,6655,776
1,7,9,15,4,6479,7492,-1013
1,7,10,15,4,6584,8227,-1643
1,7,11,15,4,6332,8759,-2427
1,7,12,15,4,6655,9077,-2422
1,7,13,15,4,7492,8688,-1196
1,7,14,15,4,8227,8341,-114
1,7,15,15,4,8759,8250,509
1,7,16,15,4,9077,8265,812
1,8,0,15,4,7084,8854,-1770
1,8,1,15,4,7301,9327,-2026
1,8,2,15,4,7921,8588,-667
1,8,3,15,4,8368,8473,-105
1,8,4,15,4,8854,7375,1479
1,8,5,15,4,9327,6384,2943
1,8,6,15,4,8588,6521,2067
1,8,7,15,4,8473,6232,2241
1,8,8,15,4,7375,6595,780
1,8,9,15,4,6384,7428,-1044
1,8,10,15,4,6521,8164,-1643
1,8,11,15,4,6232,8701,-2469
1,8,12,15,4,6595,8998,-2403
1,8,13,15,4,7428,8572,-1144
1,8,14,15,4,8164,8209,-45
1,8,15,15,4,8701,8121,580
1,8,16,15,4,8998,8086,912
1,9,0,15,4,6921,8703,-1782
1,9,1,15,4,7159,9169,-2010
1,9,2,15,4,7822,8422,-600
1,9,3,15,4,8249,8319,-70
1,9,4,15,4,8703,7185,1518
1,9,5,15,4,9169,6181,2988
1,9,6,15,4,8422,6299,2123
1,9,7,15,4,8319,6039,2280
1,9,8,15,4,7185,6435,750
1,9,9,15,4,6181,7255,-1074
1,9,10,15,4,6299,7983,-1684
1,9,11,15,4,6039,8479,-2440
1,9,12,15,4,6435,8797,-2362
1,9,13,15,4,7255,8353,-1098
1,9,14,15,4,7983,7959,24
1,9,15,15,4,8479,7914,565
1,9,16,15,4,8797,7818,979
1,0,0,16,4,7152,8522,-1370
1,0,1,16,4,7305,8577,-1272
1,0,2,16,4,7577,7918,-341
1,0,3,16,4,7896,7577,319
1,0,4,16,4,8522,6871,1651
1,0,5,16,4,8577,6287,2290
1,0,6,16,4,7918,6308,1610
1,0,7,16,4,7577,6214,1363
1,0,8,16,4,6871,6504,367
1,0,9,16,4,6287,7184,-897
1,0,10,16,4,6308,7700,-1392
1,0,11,16,4,6214,8337,-2123
1,0,12,16,4,6504,8703,-2199
1,0,13,16,4,7184,8401,-1217
1,0,14,16,4,7700,8378,-678
1,0,15,16,4,8337,8378,-41
1,0,16,16,4,8703,8117,586
1,1,0,16,4,7157,8936,-1779
1,1,1,16,4,7420,9018,-1598
1,1,2,16,4,7823,8225,-402
1,1,3,16,4,8189,7873,316
1,1,4,16,4,8936,7017,1919
1,1,5,16,4,9018,6323,2695
1,1,6,16,4,8225,6349,1876
1,1,7,16,4,7873,6234,1639
1,1,8,16,4,7017,6601,416
1,1,9,16,4,6323,7412,-1089
1,1,10,16,4,6349,7987,-1638
1,1,11,16,4,6234,8709,-2475
1,1,12,16,4,6601,9115,-2514
1,1,13,16,4,7412,8715,-1303
1,1,14,16,4,7987,8689,-702
1,1,15,16,4,8709,8618,91
1,1,16,16,4,9115,8286,829
1,2,0,16,4,7119,9248,-2129
1,2,1,16,4,7475,9323,-1848
1,2,2,16,4,7997,8412,-415
1,2,3,16,4,8417,8056,361
1,2,4,16,4,9248,7040,2208
1,2,5,16,4,9323,6238,3085
1,2,6,16,4,8412,6278,2134
1,2,7,16,4,8056,6113,1943
1,2,8,16,4,7040,6549,491
1,2,9,16,4,6238,7507,-1269
1,2,10,16,4,6278,8157,-1879
1,2,11,16,4,6113,8894,-2781
1,2,12,16,4,6549,9325,-2776
1,2,13,16,4,7507,8871,-1364
1,2,14,16,4,8157,8846,-689
1,2,15,16,4,8894,8783,111
1,2,16,16,4,9325,8446,879
1,3,0,16,4,7153,9418,-2265
1,3,1,16,4,7621,9362,-1741
1,3,2,16,4,8237,8340,-103
1,3,3,16,4,8654,7989,665
1,3,4,16,4,9418,6940,2478
1,3,5,16,4,9362,6142,3220
1,3,6,16,4,8340,6189,2151
1,3,7,16,4,7989,6051,1938
1,3,8,16,4,6940,6481,459
1,3,9,16,4,6142,7388,-1246
1,3,10,16,4,6189,8120,-1931
1,3,11,16,4,6051,8828,-2777
1,3,12,16,4,6481,9306,-2825
1,3,13,16,4,7388,8999,-1611
1,3,14,16,4,8120,8979,-859
1,3,15,16,4,8828,8918,-90
1,3,16,16,4,9306,8578,728
1,4,0,16,4,7327,9345,-2018
1,4,1,16,4,7735,9386,-1651
1,4,2,16,4,8343,8453,-110
1,4,3,16,4,8726,8234,492
1,4,4,16,4,9345,7269,2076
1,4,5,16,4,9386,6452,2934
1,4,6,16,4,8453,6539,1914
1,4,7,16,4,8234,6354,1880
1,4,8,16,4,7269,6714,555
1,4,9,16,4,6452,7623,-1171
1,4,10,16,4,6539,8370,-1831
1,4,11,16,4,6354,8985,-2631
1,4,12,16,4,6714,9407,-2693
1,4,13,16,4,7623,9072,-1449
1,4,14,16,4,8370,8918,-548
1,4,15,16,4,8985,8868,117
1,4,16,16,4,9407,8676,731
1,5,0,16,4,7429,9321,-1892
1,5,1,16,4,7732,9581,-1849
1,5,2,16,4,8306,8806,-500
1,5,3,16,4,8714,8713,1
1,5,4,16,4,9321,7720,1601
1,5,5,16,4,9581,6821,2760
1,5,6,16,4,8806,6928,1878
1,5,7,16,4,8713,6675,2038
1,5,8,16,4,7720,6987,733
1,5,9,16,4,6821,7867,-1046
1,5,10,16,4,6928,8558,-1630
1,5,11,16,4,6675,9078,-2403
1,5,12,16,4,6987,9427,-2440
1,5,13,16,4,7867,9061,-1194
1,5,14,16,4,8558,8797,-239
1,5,15,16,4,9078,8747,331
1,5,16,16,4,9427,8702,725
1,6,0,16,4,7553,9215,-1662
1,6,1,16,4,7704,9614,-1910
1,6,2,16,4,8251,8889,-638
1,6,3,16,4,8679,8766,-87
1,6,4,16,4,9215,7707,1508
1,6,5,16,4,9614,6755,2859
1,6,6,16,4,8889,6860,2029
1,6,7,16,4,8766,6607,2159
1,6,8,16,4,7707,6929,778
1,6,9,16,4,6755,7774,-1019
1,6,10,16,4,6860,8506,-1646
1,6,11,16,4,6607,9041,-2434
1,6,12,16,4,6929,9378,-2449
1,6,13,16,4,7774,9009,-1235
1,6,14,16,4,8506,8703,-197
1,6,15,16,4,9041,8657,384
1,6,16,16,4,9378,8700,678
1,7,0,16,4,7478,9138,-1660
1,7,1,16,4,7605,9666,-2061
1,7,2,16,4,8157,8966,-809
1,7,3,16,4,8596,8866,-270
1,7,4,16,4,9138,7762,1376
1,7,5,16,4,9666,6775,2891
1,7,6,16,4,8966,6914,2052
1,7,7,16,4,8866,6625,2241
1,7,8,16,4,7762,6985,777
1,7,9,16,4,6775,7818,-1043
1,7,10,16,4,6914,8540,-1626
1,7,11,16,4,6625,9059,-2434
1,7,12,16,4,6985,9337,-2352
1,7,13,16,4,7818,8884,-1066
1,7,14,16,4,8540,8521,19
1,7,15,16,4,9059,8464,595
1,7,16,16,4,9337,8477,860
1,8,0,16,4,7387,9116,-1729
1,8,1,16,4,7562,9646,-2084
1,8,2,16,4,8178,8940,-762
1,8,3,16,4,8619,8832,-213
1,8,4,16,4,9116,7714,1402
1,8,5,16,4,9646,6729,2917
1,8,6,16,4,8940,6858,2082
1,8,7,16,4,8832,6606,2226
1,8,8,16,4,7714,7003,711
1,8,9,16,4,6729,7811,-1082
1,8,10,16,4,6858,8524,-1666
1,8,11,16,4,6606,9011,-2405
1,8,12,16,4,7003,9284,-2281
1,8,13,16,4,7811,8805,-994
1,8,14,16,4,8524,8408,116
1,8,15,16,4,9011,8352,659
1,8,16,16,4,9284,8294,990
1,0,0,17,4,7568,9368,-1800
1,0,1,17,4,7832,9443,-1611
1,0,2,17,4,8239,8642,-403
1,0,3,17,4,8613,8288,325
1,0,4,17,4,9368,7428,1940
1,0,5,17,4,9443,6732,2711
1,0,6,17,4,8642,6758,1884
1,0,7,17,4,8288,6645,1643
1,0,8,17,4,7428,7015,413
1,0,9,17,4,6732,7822,-1090
1,0,10,17,4,6758,8396,-1638
1,0,11,17,4,6645,9124,-2479
1,0,12,17,4,7015,9533,-2518
1,0,13,17,4,7822,9133,-1311
1,0,14,17,4,8396,9108,-712
1,0,15,17,4,9124,9036,88
1,0,16,17,4,9533,8698,835
1,1,0,17,4,7549,9677,-2128
1,1,1,17,4,7911,9748,-1837
1,1,2,17,4,8430,8835,-405
1,1,3,17,4,8845,8481,364
1,1,4,17,4,9677,7461,2216
1,1,5,17,4,9748,6654,3094
1,1,6,17,4,8835,6692,2143
1,1,7,17,4,8481,6528,1953
1,1,8,17,4,7461,6968,493
1,1,9,17,4,6654,7938,-1284
1,1,10,17,4,6692,8591,-1899
1,1,11,17,4,6528,9327,-2799
1,1,12,17,4,6968,9753,-2785
1,1,13,17,4,7938,9285,-1347
1,1,14,17,4,8591,9264,-673
1,1,15,17,4,9327,9211,116
1,1,16,17,4,9753,8874,879
1,2,0,17,4,7593,9862,-2269
1,2,1,17,4,8065,9811,-1746
1,2,2,17,4,8674,8794,-120
1,2,3,17,4,9087,8444,643
1,2,4,17,4,9862,7384,2478
1,2,5,17,4,9811,6577,3234
1,2,6,17,4,8794,6619,2175
1,2,7,17,4,8444,6482,1962
1,2,8,17,4,7384,6916,468
1,2,9,17,4,6577,7834,-1257
1,2,10,17,4,6619,8567,-1948
1,2,11,17,4,6482,9274,-2792
1,2,12,17,4,6916,9748,-2832
1,2,13,17,4,7834,9427,-1593
1,2,14,17,4,8567,9408,-841
1,2,15,17,4,9274,9353,-79
1,2,16,17,4,9748,9012,736
1,3,0,17,4,7771,9799,-2028
1,3,1,17,4,8179,9800,-1621
1,3,2,17,4,8785,8821,-36
1,3,3,17,4,9170,8556,614
1,3,4,17,4,9799,7539,2260
1,3,5,17,4,9800,6712,3088
1,3,6,17,4,8821,6793,2028
1,3,7,17,4,8556,6607,1949
1,3,8,17,4,7539,6971,568
1,3,9,17,4,6712,7908,-1196
1,3,10,17,4,6793,8691,-1898
1,3,11,17,4,6607,9358,-2751
1,3,12,17,4,6971,9834,-2863
1,3,13,17,4,7908,9516,-1608
1,3,14,17,4,8691,9367,-676
1,3,15,17,4,9358,9311,47
1,3,16,17,4,9834,9109,725
1,4,0,17,4,7891,9737,-1846
1,4,1,17,4,8206,9925,-1719
1,4,2,17,4,8781,9081,-300
1,4,3,17,4,9169,8942,227
1,4,4,17,4,9737,7918,1819
1,4,5,17,4,9925,7009,2916
1,4,6,17,4,9081,7110,1971
1,4,7,17,4,8942,6856,2086
1,4,8,17,4,7918,7171,747
1,4,9,17,4,7009,8066,-1057
1,4,10,17,4,7110,8787,-1677
1,4,11,17,4,6856,9366,-2510
1,4,12,17,4,7171,9790,-2619
1,4,13,17,4,8066,9480,-1414
1,4,14,17,4,8787,9251,-464
1,4,15,17,4,9366,9208,158
1,4,16,17,4,9790,9150,640
1,5,0,17,4,8028,9557,-1529
1,5,1,17,4,8190,9900,-1710
1,5,2,17,4,8724,9134,-410
1,5,3,17,4,9101,9009,92
1,5,4,17,4,9557,7976,1581
1,5,5,17,4,9900,7020,2880
1,5,6,17,4,9134,7122,2012
1,5,7,17,4,9009,6867,2142
1,5,8,17,4,7976,7190,786
1,5,9,17,4,7020,8025,-1005
1,5,10,17,4,7122,8750,-1628
1,5,11,17,4,6867,9301,-2434
1,5,12,17,4,7190,9679,-2489
1,5,13,17,4,8025,9371,-1346
1,5,14,17,4,8750,9126,-376
1,5,15,17,4,9301,9117,184
1,5,16,17,4,9679,9161,518
1,6,0,17,4,7920,9432,-1512
1,6,1,17,4,8014,9942,-1928
1,6,2,17,4,8524,9229,-705
1,6,3,17,4,8921,9131,-210
1,6,4,17,4,9432,8038,1394
1,6,5,17,4,9942,7051,2891
1,6,6,17,4,9229,7190,2039
1,6,7,17,4,9131,6900,2231
1,6,8,17,4,8038,7259,779
1,6,9,17,4,7051,8100,-1049
1,6,10,17,4,7190,8819,-1629
1,6,11,17,4,6900,9341,-2441
1,6,12,17,4,7259,9638,-2379
1,6,13,17,4,8100,9205,-1105
1,6,14,17,4,8819,8883,-64
1,6,15,17,4,9341,8871,470
1,6,16,17,4,9638,8912,726
1,7,0,17,4,7781,9400,-1619
1,7,1,17,4,7866,9985,-2119
1,7,2,17,4,8414,9318,-904
1,7,3,17,4,8847,9225,-378
1,7,4,17,4,9400,8101,1299
1,7,5,17,4,9985,7120,2865
1,7,6,17,4,9318,7251,2067
1,7,7,17,4,9225,6999,2226
1,7,8,17,4,8101,7393,708
1,7,9,17,4,7120,8201,-1081
1,7,10,17,4,7251,8900,-1649
1,7,11,17,4,6999,9369,-2370
1,7,12,17,4,7393,9623,-2230
1,7,13,17,4,8201,9117,-916
1,7,14,17,4,8900,8720,180
1,7,15,17,4,9369,8695,674
1,7,16,17,4,9623,8685,938
1,0,0,18,4,7960,10109,-2149
1,0,1,18,4,8323,10173,-1850
1,0,2,18,4,8846,9252,-406
1,0,3,18,4,9269,8896,373
1,0,4,18,4,10109,7872,2237
1,0,5,18,4,10173,7063,3110
1,0,6,18,4,9252,7101,2151
1,0,7,18,4,8896,6939,1957
1,0,8,18,4,7872,7382,490
1,0,9,18,4,7063,8348,-1285
1,0,10,18,4,7101,9000,-1899
1,0,11,18,4,6939,9742,-2803
1,0,12,18,4,7382,10171,-2789
1,0,13,18,4,8348,9703,-1355
1,0,14,18,4,9000,9683,-683
1,0,15,18,4,9742,9629,113
1,0,16,18,4,10171,9286,885
1,1,0,18,4,8023,10291,-2268
1,1,1,18,4,8501,10236,-1735
1,1,2,18,4,9107,9217,-110
1,1,3,18,4,9515,8869,646
1,1,4,18,4,10291,7805,2486
1,1,5,18,4,10236,6993,3243
1,1,6,18,4,9217,7033,2184
1,1,7,18,4,8869,6897,1972
1,1,8,18,4,7805,7335,470
1,1,9,18,4,6993,8265,-1272
1,1,10,18,4,7033,9001,-1968
1,1,11,18,4,6897,9707,-2810
1,1,12,18,4,7335,10176,-2841
1,1,13,18,4,8265,9841,-1576
1,1,14,18,4,9001,9826,-825
1,1,15,18,4,9707,9781,-74
1,1,16,18,4,10176,9440,736
1,2,0,18,4,8211,10243,-2032
1,2,1,18,4,8623,10249,-1626
1,2,2,18,4,9222,9275,-53
1,2,3,18,4,9603,9011,592
1,2,4,18,4,10243,7983,2260
1,2,5,18,4,10249,7147,3102
1,2,6,18,4,9275,7223,2052
1,2,7,18,4,9011,7038,1973
1,2,8,18,4,7983,7406,577
1,2,9,18,4,7147,8354,-1207
1,2,10,18,4,7223,9138,-1915
1,2,11,18,4,7038,9804,-2766
1,2,12,18,4,7406,10276,-2870
1,2,13,18,4,8354,9944,-1590
1,2,14,18,4,9138,9796,-658
1,2,15,18,4,9804,9746,58
1,2,16,18,4,10276,9543,733
1,3,0,18,4,8335,10191,-1856
1,3,1,18,4,8650,10339,-1689
1,3,2,18,4,9223,9449,-226
1,3,3,18,4,9613,9264,349
1,3,4,18,4,10191,8188,2003
1,3,5,18,4,10339,7269,3070
1,3,6,18,4,9449,7364,2085
1,3,7,18,4,9264,7109,2155
1,3,8,18,4,8188,7428,760
1,3,9,18,4,7269,8351,-1082
1,3,10,18,4,7364,9108,-1744
1,3,11,18,4,7109,9739,-2630
1,3,12,18,4,7428,10217,-2789
1,3,13,18,4,8351,9924,-1573
1,3,14,18,4,9108,9700,-592
1,3,15,18,4,9739,9651,88
1,3,16,18,4,10217,9583,634
1,4,0,18,4,8490,9973,-1483
1,4,1,18,4,8664,10244,-1580
1,4,2,18,4,9199,9409,-210
1,4,3,18,4,9556,9238,318
1,4,4,18,4,9973,8174,1799
1,4,5,18,4,10244,7208,3036
1,4,6,18,4,9409,7304,2105
1,4,7,18,4,9238,7048,2190
1,4,8,18,4,8174,7374,800
1,4,9,18,4,7208,8224,-1016
1,4,10,18,4,7304,8979,-1675
1,4,11,18,4,7048,9589,-2541
1,4,12,18,4,7374,10042,-2668
1,4,13,18,4,8224,9790,-1566
1,4,14,18,4,8979,9580,-601
1,4,15,18,4,9589,9578,11
1,4,16,18,4,10042,9609,433
1,5,0,18,4,8395,9774,-1379
1,5,1,18,4,8500,10228,-1728
1,5,2,18,4,8997,9474,-477
1,5,3,18,4,9343,9374,-31
1,5,4,18,4,9774,8307,1467
1,5,5,18,4,10228,7316,2912
1,5,6,18,4,9474,7452,2022
1,5,7,18,4,9374,7160,2214
1,5,8,18,4,8307,7520,787
1,5,9,18,4,7316,8351,-1035
1,5,10,18,4,7452,9063,-1611
1,5,11,18,4,7160,9601,-2441
1,5,12,18,4,7520,9939,-2419
1,5,13,18,4,8351,9567,-1216
1,5,14,18,4,9063,9306,-243
1,5,15,18,4,9601,9331,270
1,5,16,18,4,9939,9373,566
1,6,0,18,4,8223,9694,-1471
1,6,1,18,4,8275,10261,-1986
1,6,2,18,4,8781,9581,-800
1,6,3,18,4,9172,9490,-318
1,6,4,18,4,9694,8377,1317
1,6,5,18,4,10261,7396,2865
1,6,6,18,4,9581,7527,2054
1,6,7,18,4,9490,7274,2216
1,6,8,18,4,8377,7667,710
1,6,9,18,4,7396,8483,-1087
1,6,10,18,4,7527,9179,-1652
1,6,11,18,4,7274,9651,-2377
1,6,12,18,4,7667,9924,-2257
1,6,13,18,4,8483,9438,-955
1,6,14,18,4,9179,9082,97
1,6,15,18,4,9651,9102,549
1,6,16,18,4,9924,9120,804
1,0,0,19,4,8434,10723,-2289
1,0,1,19,4,8913,10661,-1748
1,0,2,19,4,9523,9634,-111
1,0,3,19,4,9939,9284,655
1,0,4,19,4,10723,8216,2507
1,0,5,19,4,10661,7402,3259
1,0,6,19,4,9634,7442,2192
1,0,7,19,4,9284,7308,1976
1,0,8,19,4,8216,7749,467
1,0,9,19,4,7402,8675,-1273
1,0,10,19,4,7442,9410,-1968
1,0,11,19,4,7308,10122,-2814
1,0,12,19,4,7749,10594,-2845
1,0,13,19,4,8675,10259,-1584
1,0,14,19,4,9410,10245,-835
1,0,15,19,4,10122,10199,-77
1,0,16,19,4,10594,9852,742
1,1,0,19,4,8641,10672,-2031
1,1,1,19,4,9059,10674,-1615
1,1,2,19,4,9655,9698,-43
1,1,3,19,4,10031,9436,595
1,1,4,19,4,10672,8404,2268
1,1,5,19,4,10674,7563,3111
1,1,6,19,4,9698,7637,2061
1,1,7,19,4,9436,7453,1983
1,1,8,19,4,8404,7825,579
1,1,9,19,4,7563,8785,-1222
1,1,10,19,4,7637,9572,-1935
1,1,11,19,4,7453,10237,-2784
1,1,12,19,4,7825,10704,-2879
1,1,13,19,4,8785,10358,-1573
1,1,14,19,4,9572,10214,-642
1,1,15,19,4,10237,10174,63
1,1,16,19,4,10704,9971,733
1,2,0,19,4,8775,10635,-1860
1,2,1,19,4,9094,10788,-1694
1,2,2,19,4,9660,9903,-243
1,2,3,19,4,10046,9719,327
1,2,4,19,4,10635,8632,2003
1,2,5,19,4,10788,7704,3084
1,2,6,19,4,9903,7794,2109
1,2,7,19,4,9719,7540,2179
1,2,8,19,4,8632,7863,769
1,2,9,19,4,7704,8797,-1093
1,2,10,19,4,7794,9555,-1761
1,2,11,19,4,7540,10185,-2645
1,2,12,19,4,7863,10659,-2796
1,2,13,19,4,8797,10352,-1555
1,2,14,19,4,9555,10129,-574
1,2,15,19,4,10185,10086,99
1,2,16,19,4,10659,10017,642
1,3,0,19,4,8934,10427,-1493
1,3,1,19,4,9108,10658,-1550
1,3,2,19,4,9641,9777,-136
1,3,3,19,4,10000,9560,440
1,3,4,19,4,10427,8444,1983
1,3,5,19,4,10658,7468,3190
1,3,6,19,4,9777,7558,2219
1,3,7,19,4,9560,7301,2259
1,3,8,19,4,8444,7631,813
1,3,9,19,4,7468,8509,-1041
1,3,10,19,4,7558,9300,-1742
1,3,11,19,4,7301,9962,-2661
1,3,12,19,4,7631,10469,-2838
1,3,13,19,4,8509,10234,-1725
1,3,14,19,4,9300,10029,-729
1,3,15,19,4,9962,10021,-59
1,3,16,19,4,10469,10042,427
1,4,0,19,4,8857,10190,-1333
1,4,1,19,4,8974,10572,-1598
1,4,2,19,4,9472,9749,-277
1,4,3,19,4,9798,9603,195
1,4,4,19,4,10190,8505,1685
1,4,5,19,4,10572,7504,3068
1,4,6,19,4,9749,7634,2115
1,4,7,19,4,9603,7341,2262
1,4,8,19,4,8505,7704,801
1,4,9,19,4,7504,8550,-1046
1,4,10,19,4,7634,9292,-1658
1,4,11,19,4,7341,9889,-2548
1,4,12,19,4,7704,10302,-2598
1,4,13,19,4,8550,9986,-1436
1,4,14,19,4,9292,9760,-468
1,4,15,19,4,9889,9792,97
1,4,16,19,4,10302,9821,481
1,5,0,19,4,8698,10036,-1338
1,5,1,19,4,8761,10547,-1786
1,5,2,19,4,9254,9826,-572
1,5,3,19,4,9594,9733,-139
1,5,4,19,4,10036,8646,1390
1,5,5,19,4,10547,7661,2886
1,5,6,19,4,9826,7789,2037
1,5,7,19,4,9733,7534,2199
1,5,8,19,4,8646,7928,718
1,5,9,19,4,7661,8734,-1073
1,5,10,19,4,7789,9423,-1634
1,5,11,19,4,7534,9911,-2377
1,5,12,19,4,7928,10225,-2297
1,5,13,19,4,8734,9800,-1066
1,5,14,19,4,9423,9505,-82
1,5,15,19,4,9911,9562,349
1,5,16,19,4,10225,9581,644
1,0,0,20,4,9052,11104,-2052
1,0,1,20,4,9471,11099,-1628
1,0,2,20,4,10071,10115,-44
1,0,3,20,4,10455,9851,604
1,0,4,20,4,11104,8815,2289
1,0,5,20,4,11099,7972,3127
1,0,6,20,4,10115,8046,2069
1,0,7,20,4,9851,7864,1987
1,0,8,20,4,8815,8239,576
1,0,9,20,4,7972,9195,-1223
1,0,10,20,4,8046,9981,-1935
1,0,11,20,4,7864,10652,-2788
1,0,12,20,4,8239,11122,-2883
1,0,13,20,4,9195,10776,-1581
1,0,14,20,4,9981,10633,-652
1,0,15,20,4,10652,10592,60
1,0,16,20,4,11122,10383,739
1,1,0,20,4,9205,11064,-1859
1,1,1,20,4,9530,11213,-1683
1,1,2,20,4,10093,10326,-233
1,1,3,20,4,10474,10144,330
1,1,4,20,4,11064,9053,2011
1,1,5,20,4,11213,8120,3093
1,1,6,20,4,10326,8208,2118
1,1,7,20,4,10144,7955,2189
1,1,8,20,4,9053,8282,771
1,1,9,20,4,8120,9228,-1108
1,1,10,20,4,8208,9989,-1781
1,1,11,20,4,7955,10618,-2663
1,1,12,20,4,8282,11087,-2805
1,1,13,20,4,9228,10766,-1538
1,1,14,20,4,9989,10547,-558
1,1,15,20,4,10618,10514,104
1,1,16,20,4,11087,10445,642
1,2,0,20,4,9374,10871,-1497
1,2,1,20,4,9552,11107,-1555
1,2,2,20,4,10078,10231,-153
1,2,3,20,4,10433,10015,418
1,2,4,20,4,10871,8888,1983
1,2,5,20,4,11107,7903,3204
1,2,6,20,4,10231,7988,2243
1,2,7,20,4,10015,7732,2283
1,2,8,20,4,8888,8066,822
1,2,9,20,4,7903,8955,-1052
1,2,10,20,4,7988,9747,-1759
1,2,11,20,4,7732,10408,-2676
1,2,12,20,4,8066,10911,-2845
1,2,13,20,4,8955,10662,-1707
1,2,14,20,4,9747,10458,-711
1,2,15,20,4,10408,10456,-48
1,2,16,20,4,10911,10476,435
1,3,0,20,4,9301,10644,-1343
1,3,1,20,4,9418,10986,-1568
1,3,2,20,4,9914,10117,-203
1,3,3,20,4,10242,9925,317
1,3,4,20,4,10644,8775,1869
1,3,5,20,4,10986,7764,3222
1,3,6,20,4,10117,7888,2229
1,3,7,20,4,9925,7594,2331
1,3,8,20,4,8775,7961,814
1,3,9,20,4,7764,8835,-1071
1,3,10,20,4,7888,9613,-1725
1,3,11,20,4,7594,10262,-2668
1,3,12,20,4,7961,10729,-2768
1,3,13,20,4,8835,10430,-1595
1,3,14,20,4,9613,10209,-596
1,3,15,20,4,10262,10235,27
1,3,16,20,4,10729,10254,475
1,4,0,20,4,9160,10452,-1292
1,4,1,20,4,9235,10891,-1656
1,4,2,20,4,9729,10101,-372
1,4,3,20,4,10049,9962,87
1,4,4,20,4,10452,8844,1608
1,4,5,20,4,10891,7849,3042
1,4,6,20,4,10101,7971,2130
1,4,7,20,4,9962,7715,2247
1,4,8,20,4,8844,8112,732
1,4,9,20,4,7849,8933,-1084
1,4,10,20,4,7971,9652,-1681
1,4,11,20,4,7715,10199,-2484
1,4,12,20,4,8112,10588,-2476
1,4,13,20,4,8933,10219,-1286
1,4,14,20,4,9652,9959,-307
1,4,15,20,4,10199,10023,176
1,4,16,20,4,10588,10029,559
1,0,0,21,4,9616,11496,-1880
1,0,1,21,4,9942,11638,-1696
1,0,2,21,4,10509,10743,-234
1,0,3,21,4,10898,10559,339
1,0,4,21,4,11496,9464,2032
1,0,5,21,4,11638,8529,3109
1,0,6,21,4,10743,8617,2126
1,0,7,21,4,10559,8366,2193
1,0,8,21,4,9464,8696,768
1,0,9,21,4,8529,9638,-1109
1,0,10,21,4,8617,10398,-1781
1,0,11,21,4,8366,11033,-2667
1,0,12,21,4,8696,11505,-2809
1,0,13,21,4,9638,11184,-1546
1,0,14,21,4,10398,10966,-568
1,0,15,21,4,11033,10932,101
1,0,16,21,4,11505,10857,648
1,1,0,21,4,9804,11300,-1496
1,1,1,21,4,9988,11532,-1544
1,1,2,21,4,10511,10654,-143
1,1,3,21,4,10861,10440,421
1,1,4,21,4,11300,9309,1991
1,1,5,21,4,11532,8319,3213
1,1,6,21,4,10654,8402,2252
1,1,7,21,4,10440,8147,2293
1,1,8,21,4,9309,8485,824
1,1,9,21,4,8319,9386,-1067
1,1,10,21,4,8402,10181,-1779
1,1,11,21,4,8147,10841,-2694
1,1,12,21,4,8485,11339,-2854
1,1,13,21,4,9386,11076,-1690
1,1,14,21,4,10181,10876,-695
1,1,15,21,4,10841,10884,-43
1,1,16,21,4,11339,10904,435
1,2,0,21,4,9741,11088,-1347
1,2,1,21,4,9862,11435,-1573
1,2,2,21,4,10351,10571,-220
1,2,3,21,4,10675,10380,295
1,2,4,21,4,11088,9219,1869
1,2,5,21,4,11435,8199,3236
1,2,6,21,4,10571,8318,2253
1,2,7,21,4,10380,8025,2355
1,2,8,21,4,9219,8396,823
1,2,9,21,4,8199,9281,-1082
1,2,10,21,4,8318,10060,-1742
1,2,11,21,4,8025,10708,-2683
1,2,12,21,4,8396,11171,-2775
1,2,13,21,4,9281,10858,-1577
1,2,14,21,4,10060,10638,-578
1,2,15,21,4,10708,10670,38
1,2,16,21,4,11171,10688,483
1,3,0,21,4,9604,10906,-1302
1,3,1,21,4,9679,11305,-1626
1,3,2,21,4,10171,10469,-298
1,3,3,21,4,10493,10284,209
1,3,4,21,4,10906,9114,1792
1,3,5,21,4,11305,8109,3196
1,3,6,21,4,10469,8225,2244
1,3,7,21,4,10284,7968,2316
1,3,8,21,4,9114,8369,745
1,3,9,21,4,8109,9218,-1109
1,3,10,21,4,8225,9973,-1748
1,3,11,21,4,7968,10572,-2604
1,3,12,21,4,8369,11015,-2646
1,3,13,21,4,9218,10663,-1445
1,3,14,21,4,9973,10408,-435
1,3,15,21,4,10572,10466,106
1,3,16,21,4,11015,10462,553
1,0,0,22,4,10215,11732,-1517
1,0,1,22,4,10400,11957,-1557
1,0,2,22,4,10927,11071,-144
1,0,3,22,4,11285,10855,430
1,0,4,22,4,11732,9720,2012
1,0,5,22,4,11957,8728,3229
1,0,6,22,4,11071,8811,2260
1,0,7,22,4,10855,8558,2297
1,0,8,22,4,9720,8899,821
1,0,9,22,4,8728,9796,-1068
1,0,10,22,4,8811,10590,-1779
1,0,11,22,4,8558,11256,-2698
1,0,12,22,4,8899,11757,-2858
1,0,13,22,4,9796,11494,-1698
1,0,14,22,4,10590,11295,-705
1,0,15,22,4,11256,11302,-46
1,0,16,22,4,11757,11316,441
1,1,0,22,4,10171,11517,-1346
1,1,1,22,4,10298,11860,-1562
1,1,2,22,4,10784,10994,-210
1,1,3,22,4,11103,10805,298
1,1,4,22,4,11517,9640,1877
1,1,5,22,4,11860,8615,3245
1,1,6,22,4,10994,8732,2262
1,1,7,22,4,10805,8440,2365
1,1,8,22,4,9640,8815,825
1,1,9,22,4,8615,9712,-1097
1,1,10,22,4,8732,10494,-1762
1,1,11,22,4,8440,11141,-2701
1,1,12,22,4,8815,11599,-2784
1,1,13,22,4,9712,11272,-1560
1,1,14,22,4,10494,11056,-562
1,1,15,22,4,11141,11098,43
1,1,16,22,4,11599,11116,483
1,2,0,22,4,10044,11350,-1306
1,2,1,22,4,10123,11754,-1631
1,2,2,22,4,10608,10923,-315
1,2,3,22,4,10926,10739,187
1,2,4,22,4,11350,9558,1792
1,2,5,22,4,11754,8544,3210
1,2,6,22,4,10923,8655,2268
1,2,7,22,4,10739,8399,2340
1,2,8,22,4,9558,8804,754
1,2,9,22,4,8544,9664,-1120
1,2,10,22,4,8655,10420,-1765
1,2,11,22,4,8399,11018,-2619
1,2,12,22,4,8804,11457,-2653
1,2,13,22,4,9664,11091,-1427
1,2,14,22,4,10420,10837,-417
1,2,15,22,4,11018,10901,117
1,2,16,22,4,11457,10896,561
1,0,0,23,4,10582,11949,-1367
1,0,1,23,4,10710,12285,-1575
1,0,2,23,4,11200,11411,-211
1,0,3,23,4,11527,11220,307
1,0,4,23,4,11949,10051,1898
1,0,5,23,4,12285,9024,3261
1,0,6,23,4,11411,9141,2270
1,0,7,23,4,11220,8851,2369
1,0,8,23,4,10051,9229,822
1,0,9,23,4,9024,10122,-1098
1,0,10,23,4,9141,10903,-1762
1,0,11,23,4,8851,11556,-2705
1,0,12,23,4,9229,12017,-2788
1,0,13,23,4,10122,11690,-1568
1,0,14,23,4,10903,11475,-572
1,0,15,23,4,11556,11516,40
1,0,16,23,4,12017,11528,489
1,1,0,23,4,10474,11779,-1305
1,1,1,23,4,10559,12179,-1620
1,1,2,23,4,11041,11346,-305
1,1,3,23,4,11354,11164,190
1,1,4,23,4,11779,9979,1800
1,1,5,23,4,12179,8960,3219
1,1,6,23,4,11346,9069,2277
1,1,7,23,4,11164,8814,2350
1,1,8,23,4,9979,9223,756
1,1,9,23,4,8960,10095,-1135
1,1,10,23,4,9069,10854,-1785
1,1,11,23,4,8814,11451,-2637
1,1,12,23,4,9223,11885,-2662
1,1,13,23,4,10095,11505,-1410
1,1,14,23,4,10854,11255,-401
1,1,15,23,4,11451,11329,122
1,1,16,23,4,11885,11324,561
1,0,0,24,4,10885,12211,-1326
1,0,1,24,4,10971,12604,-1633
1,0,2,24,4,11457,11763,-306
1,0,3,24,4,11778,11579,199
1,0,4,24,4,12211,10390,1821
1,0,5,24,4,12604,9369,3235
1,0,6,24,4,11763,9478,2285
1,0,7,24,4,11579,9225,2354
1,0,8,24,4,10390,9637,753
1,0,9,24,4,9369,10505,-1136
1,0,10,24,4,9478,11263,-1785
1,0,11,24,4,9225,11866,-2641
1,0,12,24,4,9637,12303,-2666
1,0,13,24,4,10505,11923,-1418
1,0,14,24,4,11263,11674,-411
1,0,15,24,4,11866,11747,119
1,0,16,24,4,12303,11736,567
1,0,0,1,5,522,528,-6
1,0,1,1,5,523,519,4
1,0,2,1,5,520,517,3
1,0,3,1,5,530,513,17
1,0,4,1,5,536,512,24
1,0,5,1,5,528,513,15
1,0,6,1,5,519,516,3
1,0,7,1,5,517,512,5
1,0,8,1,5,513,512,1
1,0,9,1,5,512,519,-7
1,0,10,1,5,513,523,-10
1,0,11,1,5,516,516,0
1,0,12,1,5,512,521,-9
1,0,13,1,5,512,528,-16
1,0,14,1,5,519,520,-1
1,1,0,1,5,542,531,11
1,1,1,1,5,544,527,17
1,1,2,1,5,535,528,7
1,1,3,1,5,535,524,11
1,1,4,1,5,537,520,17
1,1,5,1,5,531,519,12
1,1,6,1,5,527,522,5
1,1,7,1,5,528,534,-6
1,1,8,1,5,524,538,-14
1,1,9,1,5,520,538,-18
1,1,10,1,5,519,535,-16
1,1,11,1,5,522,529,-7
1,1,12,1,5,534,525,9
1,1,13,1,5,538,532,6
1,1,14,1,5,538,530,8
1,2,0,1,5,550,562,-12
1,2,1,1,5,552,563,-11
1,2,2,1,5,545,562,-17
1,2,3,1,5,551,550,1
1,2,4,1,5,559,543,16
1,2,5,1,5,562,540,22
1,2,6,1,5,563,542,21
1,2,7,1,5,562,552,10
1,2,8,1,5,550,555,-5
1,2,9,1,5,543,556,-13
1,2,10,1,5,540,553,-13
1,2,11,1,5,542,545,-3
1,2,12,1,5,552,538,14
1,2,13,1,5,555,544,11
1,2,14,1,5,556,541,15
1,3,0,1,5,556,483,73
1,3,1,1,5,559,434,125
1,3,2,1,5,554,385,169
1,3,3,1,5,559,332,227
1,3,4,1,5,526,323,203
1,3,5,1,5,483,319,164
1,3,6,1,5,434,320,114
1,3,7,1,5,385,347,38
1,3,8,1,5,332,384,-52
1,3,9,1,5,323,438,-115
1,3,10,1,5,319,494,-175
1,3,11,1,5,320,534,-214
1,3,12,1,5,347,548,-201
1,3,13,1,5,384,560,-176
1,3,14,1,5,438,554,-116
1,4,0,1,5,588,395,193
1,4,1,1,5,594,323,271
1,4,2,1,5,569,274,295
1,4,3,1,5,531,242,289
1,4,4,1,5,470,233,237
1,4,5,1,5,395,229,166
1,4,6,1,5,323,229,94
1,4,7,1,5,274,243,31
1,4,8,1,5,242,274,-32
1,4,9,1,5,233,335,-102
1,4,10,1,5,229,411,-182
1,4,11,1,5,229,478,-249
1,4,12,1,5,243,529,-286
1,4,13,1,5,274,567,-293
1,4,14,1,5,335,571,-236
1,5,0,1,5,600,354,246
1,5,1,1,5,595,312,283
1,5,2,1,5,542,308,234
1,5,3,1,5,461,334,127
1,5,4,1,5,411,330,81
1,5,5,1,5,354,327,27
1,5,6,1,5,312,326,-14
1,5,7,1,5,308,316,-8
1,5,8,1,5,334,309,25
1,5,9,1,5,330,325,5
1,5,10,1,5,327,367,-40
1,5,11,1,5,326,417,-91
1,5,12,1,5,316,481,-165
1,5,13,1,5,309,541,-232
1,5,14,1,5,325,568,-243
1,6,0,1,5,529,345,184
1,6,1,1,5,491,332,159
1,6,2,1,5,434,334,100
1,6,3,1,5,383,345,38
1,6,4,1,5,363,345,18
1,6,5,1,5,345,344,1
1,6,6,1,5,332,343,-11
1,6,7,1,5,334,351,-17
1,6,8,1,5,345,348,-3
1,6,9,1,5,345,350,-5
1,6,10,1,5,344,369,-25
1,6,11,1,5,343,398,-55
1,6,12,1,5,351,428,-77
1,6,13,1,5,348,478,-130
1,6,14,1,5,350,522,-172
1,7,0,1,5,434,435,-1
1,7,1,1,5,361,475,-114
1,7,2,1,5,318,492,-174
1,7,3,1,5,333,486,-153
1,7,4,1,5,379,489,-110
1,7,5,1,5,435,490,-55
1,7,6,1,5,475,489,-14
1,7,7,1,5,492,489,3
1,7,8,1,5,486,474,12
1,7,9,1,5,489,455,34
1,7,10,1,5,490,435,55
1,7,11,1,5,489,411,78
1,7,12,1,5,489,396,93
1,7,13,1,5,474,422,52
1,7,14,1,5,455,468,-13
1,8,0,1,5,529,612,-83
1,8,1,1,5,497,648,-151
1,8,2,1,5,491,650,-159
1,8,3,1,5,491,675,-184
1,8,4,1,5,540,694,-154
1,8,5,1,5,612,697,-85
1,8,6,1,5,648,705,-57
1,8,7,1,5,650,702,-52
1,8,8,1,5,675,687,-12
1,8,9,1,5,694,670,24
1,8,10,1,5,697,625,72
1,8,11,1,5,705,586,119
1,8,12,1,5,702,580,122
1,8,13,1,5,687,567,120
1,8,14,1,5,670,569,101
1,9,0,1,5,328,271,57
1,9,1,1,5,277,245,32
1,9,2,1,5,252,237,15
1,9,3,1,5,250,209,41
1,9,4,1,5,271,173,98
1,9,5,1,5,271,159,112
1,9,6,1,5,245,183,62
1,9,7,1,5,237,206,31
1,9,8,1,5,209,233,-24
1,9,9,1,5,173,263,-90
1,9,10,1,5,159,283,-124
1,9,11,1,5,183,281,-98
1,9,12,1,5,206,282,-76
1,9,13,1,5,233,292,-59
1,9,14,1,5,263,337,-74
1,10,0,1,5,432,668,-236
1,10,1,1,5,446,682,-236
1,10,2,1,5,525,678,-153
1,10,3,1,5,622,646,-24
1,10,4,1,5,688,636,52
1,10,5,1,5,668,632,36
1,10,6,1,5,682,629,53
1,10,7,1,5,678,655,23
1,10,8,1,5,646,679,-33
1,10,9,1,5,636,659,-23
1,10,10,1,5,632,655,-23
1,10,11,1,5,629,641,-12
1,10,12,1,5,655,578,77
1,10,13,1,5,679,528,151
1,10,14,1,5,659,522,137
1,11,0,1,5,705,1022,-317
1,11,1,1,5,741,1041,-300
1,11,2,1,5,864,996,-132
1,11,3,1,5,1004,957,47
1,11,4,1,5,1097,941,156
1,11,5,1,5,1022,947,75
1,11,6,1,5,1041,942,99
1,11,7,1,5,996,1006,-10
1,11,8,1,5,957,1051,-94
1,11,9,1,5,941,1035,-94
1,11,10,1,5,947,1062,-115
1,11,11,1,5,942,1086,-144
1,11,12,1,5,1006,1013,-7
1,11,13,1,5,1051,950,101
1,11,14,1,5,1035,900,135
1,12,0,1,5,765,981,-216
1,12,1,1,5,815,894,-79
1,12,2,1,5,881,796,85
1,12,3,1,5,1001,703,298
1,12,4,1,5,1107,582,525
1,12,5,1,5,981,574,407
1,12,6,1,5,894,619,275
1,12,7,1,5,796,755,41
1,12,8,1,5,703,862,-159
1,12,9,1,5,582,951,-369
1,12,10,1,5,574,1070,-496
1,12,11,1,5,619,1129,-510
1,12,12,1,5,755,1075,-320
1,12,13,1,5,862,1036,-174
1,12,14,1,5,951,967,-16
1,13,0,1,5,725,1005,-280
1,13,1,1,5,832,858,-26
1,13,2,1,5,843,781,62
1,13,3,1,5,966,658,308
1,13,4,1,5,1092,505,587
1,13,5,1,5,1005,496,509
1,13,6,1,5,858,547,311
1,13,7,1,5,781,703,78
1,13,8,1,5,658,810,-152
1,13,9,1,5,505,932,-427
1,13,10,1,5,496,1054,-558
1,13,11,1,5,547,1074,-527
1,13,12,1,5,703,1013,-310
1,13,13,1,5,810,993,-183
1,13,14,1,5,932,909,23
1,14,0,1,5,734,964,-230
1,14,1,1,5,836,837,-1
1,14,2,1,5,810,787,23
1,14,3,1,5,926,665,261
1,14,4,1,5,1040,541,499
1,14,5,1,5,964,545,419
1,14,6,1,5,837,573,264
1,14,7,1,5,787,721,66
1,14,8,1,5,665,792,-127
1,14,9,1,5,541,910,-369
1,14,10,1,5,545,1019,-474
1,14,11,1,5,573,1017,-444
1,14,12,1,5,721,971,-250
1,14,13,1,5,792,992,-200
1,14,14,1,5,910,916,-6
1,15,0,1,5,748,972,-224
1,15,1,1,5,852,840,12
1,15,2,1,5,847,770,77
1,15,3,1,5,977,638,339
1,15,4,1,5,1096,492,604
1,15,5,1,5,972,495,477
1,15,6,1,5,840,537,303
1,15,7,1,5,770,698,72
1,15,8,1,5,638,764,-126
1,15,9,1,5,492,919,-427
1,15,10,1,5,495,1056,-561
1,15,11,1,5,537,1045,-508
1,15,12,1,5,698,988,-290
1,15,13,1,5,764,1003,-239
1,15,14,1,5,919,897,22
1,16,0,1,5,635,973,-338
1,16,1,1,5,776,841,-65
1,16,2,1,5,792,805,-13
1,16,3,1,5,965,684,281
1,16,4,1,5,1085,557,528
1,16,5,1,5,973,548,425
1,16,6,1,5,841,605,236
1,16,7,1,5,805,765,40
1,16,8,1,5,684,808,-124
1,16,9,1,5,557,885,-328
1,16,10,1,5,548,1004,-456
1,16,11,1,5,605,986,-381
1,16,12,1,5,765,900,-135
1,16,13,1,5,808,847,-39
1,16,14,1,5,885,798,87
1,17,0,1,5,599,801,-202
1,17,1,1,5,682,720,-38
1,17,2,1,5,719,675,44
1,17,3,1,5,887,527,360
1,17,4,1,5,937,414,523
1,17,5,1,5,801,404,397
1,17,6,1,5,720,434,286
1,17,7,1,5,675,609,66
1,17,8,1,5,527,687,-160
1,17,9,1,5,414,679,-265
1,17,10,1,5,404,778,-374
1,17,11,1,5,434,812,-378
1,17,12,1,5,609,736,-127
1,17,13,1,5,687,668,19
1,17,14,1,5,679,748,-69
1,18,0,1,5,712,561,151
1,18,1,1,5,769,457,312
1,18,2,1,5,746,472,274
1,18,3,1,5,798,451,347
1,18,4,1,5,726,414,312
1,18,5,1,5,561,444,117
1,18,6,1,5,457,451,6
1,18,7,1,5,472,434,38
1,18,8,1,5,451,485,-34
1,18,9,1,5,414,483,-69
1,18,10,1,5,444,505,-61
1,18,11,1,5,451,623,-172
1,18,12,1,5,434,720,-286
1,18,13,1,5,485,643,-158
1,18,14,1,5,483,691,-208
1,19,0,1,5,748,561,187
1,19,1,1,5,638,639,-1
1,19,2,1,5,620,698,-78
1,19,3,1,5,615,757,-142
1,19,4,1,5,568,727,-159
1,19,5,1,5,561,714,-153
1,19,6,1,5,639,621,18
1,19,7,1,5,698,678,20
1,19,8,1,5,757,728,29
1,19,9,1,5,727,640,87
1,19,10,1,5,714,593,121
1,19,11,1,5,621,705,-84
1,19,12,1,5,678,596,82
1,19,13,1,5,728,462,266
1,19,14,1,5,640,594,46
1,20,0,1,5,661,671,-10
1,20,1,1,5,514,781,-267
1,20,2,1,5,511,828,-317
1,20,3,1,5,622,801,-179
1,20,4,1,5,636,703,-67
1,20,5,1,5,671,655,16
1,20,6,1,5,781,577,204
1,20,7,1,5,828,595,233
1,20,8,1,5,801,563,238
1,20,9,1,5,703,465,238
1,20,10,1,5,655,458,197
1,20,11,1,5,577,546,31
1,20,12,1,5,595,453,142
1,20,13,1,5,563,388,175
1,20,14,1,5,465,551,-86
1,21,0,1,5,661,360,301
1,21,1,1,5,490,354,136
1,21,2,1,5,476,340,136
1,21,3,1,5,471,344,127
1,21,4,1,5,381,235,146
1,21,5,1,5,360,218,142
1,21,6,1,5,354,247,107
1,21,7,1,5,340,246,94
1,21,8,1,5,344,228,116
1,21,9,1,5,235,247,-12
1,21,10,1,5,218,307,-89
1,21,11,1,5,247,353,-106
1,21,12,1,5,246,399,-153
1,21,13,1,5,228,425,-197
1,21,14,1,5,247,543,-296
1,22,0,1,5,407,377,30
1,22,1,1,5,347,410,-63
1,22,2,1,5,318,426,-108
1,22,3,1,5,337,447,-110
1,22,4,1,5,368,379,-11
1,22,5,1,5,377,363,14
1,22,6,1,5,410,391,19
1,22,7,1,5,426,442,-16
1,22,8,1,5,447,396,51
1,22,9,1,5,379,333,46
1,22,10,1,5,363,358,5
1,22,11,1,5,391,308,83
1,22,12,1,5,442,250,192
1,22,13,1,5,396,234,162
1,22,14,1,5,333,270,63
1,23,0,1,5,372,417,-45
1,23,1,1,5,326,407,-81
1,23,2,1,5,305,419,-114
1,23,3,1,5,331,471,-140
1,23,4,1,5,388,435,-47
1,23,5,1,5,417,429,-12
1,23,6,1,5,407,468,-61
1,23,7,1,5,419,515,-96
1,23,8,1,5,471,450,21
1,23,9,1,5,435,402,33
1,23,10,1,5,429,380,49
1,23,11,1,5,468,340,128
1,23,12,1,5,515,266,249
1,23,13,1,5,450,273,177
1,23,14,1,5,402,278,124
1,0,0,2,5,1064,1059,5
1,0,1,2,5,1067,1046,21
1,0,2,2,5,1055,1045,10
1,0,3,2,5,1065,1037,28
1,0,4,2,5,1073,1032,41
1,0,5,2,5,1059,1032,27
1,0,6,2,5,1046,1038,8
1,0,7,2,5,1045,1046,-1
1,0,8,2,5,1037,1050,-13
1,0,9,2,5,1032,1057,-25
1,0,10,2,5,1032,1058,-26
1,0,11,2,5,1038,1045,-7
1,0,12,2,5,1046,1046,0
1,0,13,2,5,1050,1060,-10
1,0,14,2,5,1057,1050,7
1,1,0,2,5,1092,1093,-1
1,1,1,2,5,1096,1090,6
1,1,2,2,5,1080,1090,-10
1,1,3,2,5,1086,1074,12
1,1,4,2,5,1096,1063,33
1,1,5,2,5,1093,1059,34
1,1,6,2,5,1090,1064,26
1,1,7,2,5,1090,1086,4
1,1,8,2,5,1074,1093,-19
1,1,9,2,5,1063,1094,-31
1,1,10,2,5,1059,1088,-29
1,1,11,2,5,1064,1074,-10
1,1,12,2,5,1086,1063,23
1,1,13,2,5,1093,1076,17
1,1,14,2,5,1094,1071,23
1,2,0,2,5,1106,1045,61
1,2,1,2,5,1111,997,114
1,2,2,2,5,1099,947,152
1,2,3,2,5,1110,882,228
1,2,4,2,5,1085,866,219
1,2,5,2,5,1045,859,186
1,2,6,2,5,997,862,135
1,2,7,2,5,947,899,48
1,2,8,2,5,882,939,-57
1,2,9,2,5,866,994,-128
1,2,10,2,5,859,1047,-188
1,2,11,2,5,862,1079,-217
1,2,12,2,5,899,1086,-187
1,2,13,2,5,939,1104,-165
1,2,14,2,5,994,1095,-101
1,3,0,2,5,1144,878,266
1,3,1,2,5,1153,757,396
1,3,2,2,5,1123,659,464
1,3,3,2,5,1090,574,516
1,3,4,2,5,996,556,440
1,3,5,2,5,878,548,330
1,3,6,2,5,757,549,208
1,3,7,2,5,659,590,69
1,3,8,2,5,574,658,-84
1,3,9,2,5,556,773,-217
1,3,10,2,5,548,905,-357
1,3,11,2,5,549,1012,-463
1,3,12,2,5,590,1077,-487
1,3,13,2,5,658,1127,-469
1,3,14,2,5,773,1125,-352
1,4,0,2,5,1188,749,439
1,4,1,2,5,1189,635,554
1,4,2,2,5,1111,582,529
1,4,3,2,5,992,576,416
1,4,4,2,5,881,563,318
1,4,5,2,5,749,556,193
1,4,6,2,5,635,555,80
1,4,7,2,5,582,559,23
1,4,8,2,5,576,583,-7
1,4,9,2,5,563,660,-97
1,4,10,2,5,556,778,-222
1,4,11,2,5,555,895,-340
1,4,12,2,5,559,1010,-451
1,4,13,2,5,583,1108,-525
1,4,14,2,5,660,1139,-479
1,5,0,2,5,1129,699,430
1,5,1,2,5,1086,644,442
1,5,2,2,5,976,642,334
1,5,3,2,5,844,679,165
1,5,4,2,5,774,675,99
1,5,5,2,5,699,671,28
1,5,6,2,5,644,669,-25
1,5,7,2,5,642,667,-25
1,5,8,2,5,679,657,22
1,5,9,2,5,675,675,0
1,5,10,2,5,671,736,-65
1,5,11,2,5,669,815,-146
1,5,12,2,5,667,909,-242
1,5,13,2,5,657,1019,-362
1,5,14,2,5,675,1090,-415
1,6,0,2,5,963,780,183
1,6,1,2,5,852,807,45
1,6,2,2,5,752,826,-74
1,6,3,2,5,716,831,-115
1,6,4,2,5,742,834,-92
1,6,5,2,5,780,834,-54
1,6,6,2,5,807,832,-25
1,6,7,2,5,826,840,-14
1,6,8,2,5,831,822,9
1,6,9,2,5,834,805,29
1,6,10,2,5,834,804,30
1,6,11,2,5,832,809,23
1,6,12,2,5,840,824,16
1,6,13,2,5,822,900,-78
1,6,14,2,5,805,990,-185
1,7,0,2,5,963,1047,-84
1,7,1,2,5,858,1123,-265
1,7,2,2,5,809,1142,-333
1,7,3,2,5,824,1161,-337
1,7,4,2,5,919,1183,-264
1,7,5,2,5,1047,1187,-140
1,7,6,2,5,1123,1194,-71
1,7,7,2,5,1142,1191,-49
1,7,8,2,5,1161,1161,0
1,7,9,2,5,1183,1125,58
1,7,10,2,5,1187,1060,127
1,7,11,2,5,1194,997,197
1,7,12,2,5,1191,976,215
1,7,13,2,5,1161,989,172
1,7,14,2,5,1125,1037,88
1,8,0,2,5,857,883,-26
1,8,1,2,5,774,893,-119
1,8,2,2,5,743,887,-144
1,8,3,2,5,741,884,-143
1,8,4,2,5,811,867,-56
1,8,5,2,5,883,856,27
1,8,6,2,5,893,888,5
1,8,7,2,5,887,908,-21
1,8,8,2,5,884,920,-36
1,8,9,2,5,867,933,-66
1,8,10,2,5,856,908,-52
1,8,11,2,5,888,867,21
1,8,12,2,5,908,862,46
1,8,13,2,5,920,859,61
1,8,14,2,5,933,906,27
1,9,0,2,5,760,939,-179
1,9,1,2,5,723,927,-204
1,9,2,2,5,777,915,-138
1,9,3,2,5,872,855,17
1,9,4,2,5,959,809,150
1,9,5,2,5,939,791,148
1,9,6,2,5,927,812,115
1,9,7,2,5,915,861,54
1,9,8,2,5,855,912,-57
1,9,9,2,5,809,922,-113
1,9,10,2,5,791,938,-147
1,9,11,2,5,812,922,-110
1,9,12,2,5,861,860,1
1,9,13,2,5,912,820,92
1,9,14,2,5,922,859,63
1,10,0,2,5,1137,1690,-553
1,10,1,2,5,1187,1723,-536
1,10,2,2,5,1389,1674,-285
1,10,3,2,5,1626,1603,23
1,10,4,2,5,1785,1577,208
1,10,5,2,5,1690,1579,111
1,10,6,2,5,1723,1571,152
1,10,7,2,5,1674,1661,13
1,10,8,2,5,1603,1730,-127
1,10,9,2,5,1577,1694,-117
1,10,10,2,5,1579,1717,-138
1,10,11,2,5,1571,1727,-156
1,10,12,2,5,1661,1591,70
1,10,13,2,5,1730,1478,252
1,10,14,2,5,1694,1422,272
1,11,0,2,5,1470,2003,-533
1,11,1,2,5,1556,1935,-379
1,11,2,2,5,1745,1792,-47
1,11,3,2,5,2005,1660,345
1,11,4,2,5,2204,1523,681
1,11,5,2,5,2003,1521,482
1,11,6,2,5,1935,1561,374
1,11,7,2,5,1792,1761,31
1,11,8,2,5,1660,1913,-253
1,11,9,2,5,1523,1986,-463
1,11,10,2,5,1521,2132,-611
1,11,11,2,5,1561,2215,-654
1,11,12,2,5,1761,2088,-327
1,11,13,2,5,1913,1986,-73
1,11,14,2,5,1986,1867,119
1,12,0,2,5,1490,1986,-496
1,12,1,2,5,1647,1752,-105
1,12,2,2,5,1724,1577,147
1,12,3,2,5,1967,1361,606
1,12,4,2,5,2199,1087,1112
1,12,5,2,5,1986,1070,916
1,12,6,2,5,1752,1166,586
1,12,7,2,5,1577,1458,119
1,12,8,2,5,1361,1672,-311
1,12,9,2,5,1087,1883,-796
1,12,10,2,5,1070,2124,-1054
1,12,11,2,5,1166,2203,-1037
1,12,12,2,5,1458,2088,-630
1,12,13,2,5,1672,2029,-357
1,12,14,2,5,1883,1876,7
1,13,0,2,5,1459,1969,-510
1,13,1,2,5,1668,1695,-27
1,13,2,2,5,1653,1568,85
1,13,3,2,5,1892,1323,569
1,13,4,2,5,2132,1046,1086
1,13,5,2,5,1969,1041,928
1,13,6,2,5,1695,1120,575
1,13,7,2,5,1568,1424,144
1,13,8,2,5,1323,1602,-279
1,13,9,2,5,1046,1842,-796
1,13,10,2,5,1041,2073,-1032
1,13,11,2,5,1120,2091,-971
1,13,12,2,5,1424,1984,-560
1,13,13,2,5,1602,1985,-383
1,13,14,2,5,1842,1825,17
1,14,0,2,5,1482,1936,-454
1,14,1,2,5,1688,1677,11
1,14,2,2,5,1657,1557,100
1,14,3,2,5,1903,1303,600
1,14,4,2,5,2136,1033,1103
1,14,5,2,5,1936,1040,896
1,14,6,2,5,1677,1110,567
1,14,7,2,5,1557,1419,138
1,14,8,2,5,1303,1556,-253
1,14,9,2,5,1033,1829,-796
1,14,10,2,5,1040,2075,-1035
1,14,11,2,5,1110,2062,-952
1,14,12,2,5,1419,1959,-540
1,14,13,2,5,1556,1995,-439
1,14,14,2,5,1829,1813,16
1,15,0,2,5,1383,1945,-562
1,15,1,2,5,1628,1681,-53
1,15,2,2,5,1639,1575,64
1,15,3,2,5,1942,1322,620
1,15,4,2,5,2181,1049,1132
1,15,5,2,5,1945,1043,902
1,15,6,2,5,1681,1142,539
1,15,7,2,5,1575,1463,112
1,15,8,2,5,1322,1572,-250
1,15,9,2,5,1049,1804,-755
1,15,10,2,5,1043,2060,-1017
1,15,11,2,5,1142,2031,-889
1,15,12,2,5,1463,1888,-425
1,15,13,2,5,1572,1850,-278
1,15,14,2,5,1804,1695,109
1,16,0,2,5,1234,1774,-540
1,16,1,2,5,1458,1561,-103
1,16,2,2,5,1511,1480,31
1,16,3,2,5,1852,1211,641
1,16,4,2,5,2022,971,1051
1,16,5,2,5,1774,952,822
1,16,6,2,5,1561,1039,522
1,16,7,2,5,1480,1374,106
1,16,8,2,5,1211,1495,-284
1,16,9,2,5,971,1564,-593
1,16,10,2,5,952,1782,-830
1,16,11,2,5,1039,1798,-759
1,16,12,2,5,1374,1636,-262
1,16,13,2,5,1495,1515,-20
1,16,14,2,5,1564,1546,18
1,17,0,2,5,1311,1362,-51
1,17,1,2,5,1451,1177,274
1,17,2,2,5,1465,1147,318
1,17,3,2,5,1685,978,707
1,17,4,2,5,1663,828,835
1,17,5,2,5,1362,848,514
1,17,6,2,5,1177,885,292
1,17,7,2,5,1147,1043,104
1,17,8,2,5,978,1172,-194
1,17,9,2,5,828,1162,-334
1,17,10,2,5,848,1283,-435
1,17,11,2,5,885,1435,-550
1,17,12,2,5,1043,1456,-413
1,17,13,2,5,1172,1311,-139
1,17,14,2,5,1162,1439,-277
1,18,0,2,5,1460,1122,338
1,18,1,2,5,1407,1096,311
1,18,2,2,5,1366,1170,196
1,18,3,2,5,1413,1208,205
1,18,4,2,5,1294,1141,153
1,18,5,2,5,1122,1158,-36
1,18,6,2,5,1096,1072,24
1,18,7,2,5,1170,1112,58
1,18,8,2,5,1208,1213,-5
1,18,9,2,5,1141,1123,18
1,18,10,2,5,1158,1098,60
1,18,11,2,5,1072,1328,-256
1,18,12,2,5,1112,1316,-204
1,18,13,2,5,1213,1105,108
1,18,14,2,5,1123,1285,-162
1,19,0,2,5,1409,1232,177
1,19,1,2,5,1152,1420,-268
1,19,2,2,5,1131,1526,-395
1,19,3,2,5,1237,1558,-321
1,19,4,2,5,1204,1430,-226
1,19,5,2,5,1232,1369,-137
1,19,6,2,5,1420,1198,222
1,19,7,2,5,1526,1273,253
1,19,8,2,5,1558,1291,267
1,19,9,2,5,1430,1105,325
1,19,10,2,5,1369,1051,318
1,19,11,2,5,1198,1251,-53
1,19,12,2,5,1273,1049,224
1,19,13,2,5,1291,850,441
1,19,14,2,5,1105,1145,-40
1,20,0,2,5,1322,1031,291
1,20,1,2,5,1004,1135,-131
1,20,2,2,5,987,1168,-181
1,20,3,2,5,1093,1145,-52
1,20,4,2,5,1017,938,79
1,20,5,2,5,1031,873,158
1,20,6,2,5,1135,824,311
1,20,7,2,5,1168,841,327
1,20,8,2,5,1145,791,354
1,20,9,2,5,938,712,226
1,20,10,2,5,873,765,108
1,20,11,2,5,824,899,-75
1,20,12,2,5,841,852,-11
1,20,13,2,5,791,813,-22
1,20,14,2,5,712,1094,-382
1,21,0,2,5,1068,737,331
1,21,1,2,5,837,764,73
1,21,2,2,5,794,766,28
1,21,3,2,5,808,791,17
1,21,4,2,5,749,614,135
1,21,5,2,5,737,581,156
1,21,6,2,5,764,638,126
1,21,7,2,5,766,688,78
1,21,8,2,5,791,624,167
1,21,9,2,5,614,580,34
1,21,10,2,5,581,665,-84
1,21,11,2,5,638,661,-23
1,21,12,2,5,688,649,39
1,21,13,2,5,624,659,-35
1,21,14,2,5,580,813,-233
1,22,0,2,5,779,794,-15
1,22,1,2,5,673,817,-144
1,22,2,2,5,623,845,-222
1,22,3,2,5,668,918,-250
1,22,4,2,5,756,814,-58
1,22,5,2,5,794,792,2
1,22,6,2,5,817,859,-42
1,22,7,2,5,845,957,-112
1,22,8,2,5,918,846,72
1,22,9,2,5,814,735,79
1,22,10,2,5,792,738,54
1,22,11,2,5,859,648,211
1,22,12,2,5,957,516,441
1,22,13,2,5,846,507,339
1,22,14,2,5,735,548,187
1,0,0,3,5,1614,1621,-7
1,0,1,3,5,1619,1609,10
1,0,2,3,5,1600,1607,-7
1,0,3,3,5,1616,1587,29
1,0,4,3,5,1632,1575,57
1,0,5,3,5,1621,1572,49
1,0,6,3,5,1609,1580,29
1,0,7,3,5,1607,1598,9
1,0,8,3,5,1587,1605,-18
1,0,9,3,5,1575,1613,-38
1,0,10,3,5,1572,1611,-39
1,0,11,3,5,1580,1590,-10
1,0,12,3,5,1598,1584,14
1,0,13,3,5,1605,1604,1
1,0,14,3,5,1613,1591,22
1,1,0,3,5,1648,1576,72
1,1,1,3,5,1655,1524,131
1,1,2,3,5,1634,1475,159
1,1,3,3,5,1645,1406,239
1,1,4,3,5,1622,1386,236
1,1,5,3,5,1576,1378,198
1,1,6,3,5,1524,1384,140
1,1,7,3,5,1475,1433,42
1,1,8,3,5,1406,1477,-71
1,1,9,3,5,1386,1532,-146
1,1,10,3,5,1378,1582,-204
1,1,11,3,5,1384,1608,-224
1,1,12,3,5,1433,1611,-178
1,1,13,3,5,1477,1636,-159
1,1,14,3,5,1532,1625,-93
1,2,0,3,5,1694,1440,254
1,2,1,3,5,1705,1320,385
1,2,2,3,5,1668,1221,447
1,2,3,3,5,1641,1124,517
1,2,4,3,5,1555,1099,456
1,2,5,3,5,1440,1088,352
1,2,6,3,5,1320,1091,229
1,2,7,3,5,1221,1142,79
1,2,8,3,5,1124,1213,-89
1,2,9,3,5,1099,1329,-230
1,2,10,3,5,1088,1458,-370
1,2,11,3,5,1091,1557,-466
1,2,12,3,5,1142,1615,-473
1,2,13,3,5,1213,1671,-458
1,2,14,3,5,1329,1666,-337
1,3,0,3,5,1744,1232,512
1,3,1,3,5,1748,1069,679
1,3,2,3,5,1665,967,698
1,3,3,3,5,1551,908,643
1,3,4,3,5,1407,886,521
1,3,5,3,5,1232,875,357
1,3,6,3,5,1069,875,194
1,3,7,3,5,967,906,61
1,3,8,3,5,908,967,-59
1,3,9,3,5,886,1098,-212
1,3,10,3,5,875,1272,-397
1,3,11,3,5,875,1429,-554
1,3,12,3,5,906,1558,-652
1,3,13,3,5,967,1668,-701
1,3,14,3,5,1098,1693,-595
1,4,0,3,5,1717,1094,623
1,4,1,3,5,1680,967,713
1,4,2,3,5,1545,916,629
1,4,3,3,5,1375,921,454
1,4,4,3,5,1244,908,336
1,4,5,3,5,1094,900,194
1,4,6,3,5,967,898,69
1,4,7,3,5,916,910,6
1,4,8,3,5,921,931,-10
1,4,9,3,5,908,1010,-102
1,4,10,3,5,900,1147,-247
1,4,11,3,5,898,1293,-395
1,4,12,3,5,910,1438,-528
1,4,13,3,5,931,1586,-655
1,4,14,3,5,1010,1661,-651
1,5,0,3,5,1563,1134,429
1,5,1,3,5,1447,1119,328
1,5,2,3,5,1294,1134,160
1,5,3,3,5,1177,1165,12
1,5,4,3,5,1153,1164,-11
1,5,5,3,5,1134,1161,-27
1,5,6,3,5,1119,1158,-39
1,5,7,3,5,1134,1156,-22
1,5,8,3,5,1165,1131,34
1,5,9,3,5,1164,1130,34
1,5,10,3,5,1161,1171,-10
1,5,11,3,5,1158,1226,-68
1,5,12,3,5,1156,1305,-149
1,5,13,3,5,1131,1441,-310
1,5,14,3,5,1130,1558,-428
1,6,0,3,5,1492,1392,100
1,6,1,3,5,1349,1455,-106
1,6,2,3,5,1243,1476,-233
1,6,3,3,5,1207,1506,-299
1,6,4,3,5,1282,1528,-246
1,6,5,3,5,1392,1531,-139
1,6,6,3,5,1455,1537,-82
1,6,7,3,5,1476,1542,-66
1,6,8,3,5,1506,1509,-3
1,6,9,3,5,1528,1475,53
1,6,10,3,5,1531,1429,102
1,6,11,3,5,1537,1395,142
1,6,12,3,5,1542,1404,138
1,6,13,3,5,1509,1467,42
1,6,14,3,5,1475,1559,-84
1,7,0,3,5,1291,1318,-27
1,7,1,3,5,1135,1368,-233
1,7,2,3,5,1061,1379,-318
1,7,3,3,5,1074,1370,-296
1,7,4,3,5,1190,1356,-166
1,7,5,3,5,1318,1346,-28
1,7,6,3,5,1368,1377,-9
1,7,7,3,5,1379,1397,-18
1,7,8,3,5,1370,1394,-24
1,7,9,3,5,1356,1388,-32
1,7,10,3,5,1346,1343,3
1,7,11,3,5,1377,1278,99
1,7,12,3,5,1397,1258,139
1,7,13,3,5,1394,1281,113
1,7,14,3,5,1388,1374,14
1,8,0,3,5,1289,1551,-262
1,8,1,3,5,1220,1575,-355
1,8,2,3,5,1268,1565,-297
1,8,3,3,5,1363,1530,-167
1,8,4,3,5,1499,1503,-4
1,8,5,3,5,1551,1488,63
1,8,6,3,5,1575,1517,58
1,8,7,3,5,1565,1563,2
1,8,8,3,5,1530,1599,-69
1,8,9,3,5,1503,1592,-89
1,8,10,3,5,1488,1563,-75
1,8,11,3,5,1517,1508,9
1,8,12,3,5,1563,1440,123
1,8,13,3,5,1599,1387,212
1,8,14,3,5,1592,1428,164
1,9,0,3,5,1465,1961,-496
1,9,1,3,5,1464,1968,-504
1,9,2,3,5,1641,1911,-270
1,9,3,3,5,1876,1812,64
1,9,4,3,5,2056,1750,306
1,9,5,3,5,1961,1738,223
1,9,6,3,5,1968,1754,214
1,9,7,3,5,1911,1867,44
1,9,8,3,5,1812,1963,-151
1,9,9,3,5,1750,1957,-207
1,9,10,3,5,1738,2000,-262
1,9,11,3,5,1754,2008,-254
1,9,12,3,5,1867,1873,-6
1,9,13,3,5,1963,1770,193
1,9,14,3,5,1957,1759,198
1,10,0,3,5,1902,2671,-769
1,10,1,3,5,2002,2617,-615
1,10,2,3,5,2270,2470,-200
1,10,3,3,5,2627,2306,321
1,10,4,3,5,2892,2159,733
1,10,5,3,5,2671,2153,518
1,10,6,3,5,2617,2190,427
1,10,7,3,5,2470,2416,54
1,10,8,3,5,2306,2592,-286
1,10,9,3,5,2159,2645,-486
1,10,10,3,5,2153,2787,-634
1,10,11,3,5,2190,2856,-666
1,10,12,3,5,2416,2666,-250
1,10,13,3,5,2592,2514,78
1,10,14,3,5,2645,2389,256
1,11,0,3,5,2195,3008,-813
1,11,1,3,5,2388,2793,-405
1,11,2,3,5,2588,2573,15
1,11,3,3,5,2971,2318,653
1,11,4,3,5,3296,2028,1268
1,11,5,3,5,3008,2017,991
1,11,6,3,5,2793,2108,685
1,11,7,3,5,2573,2464,109
1,11,8,3,5,2318,2723,-405
1,11,9,3,5,2028,2918,-890
1,11,10,3,5,2017,3186,-1169
1,11,11,3,5,2108,3289,-1181
1,11,12,3,5,2464,3101,-637
1,11,13,3,5,2723,2979,-256
1,11,14,3,5,2918,2776,142
1,12,0,3,5,2224,2950,-726
1,12,1,3,5,2483,2589,-106
1,12,2,3,5,2534,2364,170
1,12,3,3,5,2893,2026,867
1,12,4,3,5,3239,1628,1611
1,12,5,3,5,2950,1615,1335
1,12,6,3,5,2589,1739,850
1,12,7,3,5,2364,2179,185
1,12,8,3,5,2026,2464,-438
1,12,9,3,5,1628,2793,-1165
1,12,10,3,5,1615,3143,-1528
1,12,11,3,5,1739,3220,-1481
1,12,12,3,5,2179,3059,-880
1,12,13,3,5,2464,3021,-557
1,12,14,3,5,2793,2792,1
1,13,0,3,5,2207,2941,-734
1,13,1,3,5,2520,2535,-15
1,13,2,3,5,2500,2338,162
1,13,3,3,5,2869,1961,908
1,13,4,3,5,3228,1538,1690
1,13,5,3,5,2941,1536,1405
1,13,6,3,5,2535,1657,878
1,13,7,3,5,2338,2122,216
1,13,8,3,5,1961,2366,-405
1,13,9,3,5,1538,2761,-1223
1,13,10,3,5,1536,3129,-1593
1,13,11,3,5,1657,3136,-1479
1,13,12,3,5,2122,2972,-850
1,13,13,3,5,2366,2988,-622
1,13,14,3,5,2761,2722,39
1,14,0,3,5,2117,2909,-792
1,14,1,3,5,2464,2518,-54
1,14,2,3,5,2449,2362,87
1,14,3,3,5,2868,1987,881
1,14,4,3,5,3221,1590,1631
1,14,5,3,5,2909,1588,1321
1,14,6,3,5,2518,1715,803
1,14,7,3,5,2362,2184,178
1,14,8,3,5,1987,2364,-377
1,14,9,3,5,1590,2714,-1124
1,14,10,3,5,1588,3079,-1491
1,14,11,3,5,1715,3048,-1333
1,14,12,3,5,2184,2859,-675
1,14,13,3,5,2364,2842,-478
1,14,14,3,5,2714,2611,103
1,15,0,3,5,1982,2746,-764
1,15,1,3,5,2310,2401,-91
1,15,2,3,5,2358,2250,108
1,15,3,3,5,2829,1849,980
1,15,4,3,5,3118,1463,1655
1,15,5,3,5,2746,1447,1299
1,15,6,3,5,2401,1576,825
1,15,7,3,5,2250,2072,178
1,15,8,3,5,1849,2259,-410
1,15,9,3,5,1463,2483,-1020
1,15,10,3,5,1447,2838,-1391
1,15,11,3,5,1576,2843,-1267
1,15,12,3,5,2072,2624,-552
1,15,13,3,5,2259,2518,-259
1,15,14,3,5,2483,2443,40
1,16,0,3,5,1946,2335,-389
1,16,1,3,5,2227,2018,209
1,16,2,3,5,2257,1952,305
1,16,3,3,5,2650,1662,988
1,16,4,3,5,2748,1385,1363
1,16,5,3,5,2335,1396,939
1,16,6,3,5,2018,1490,528
1,16,7,3,5,1952,1808,144
1,16,8,3,5,1662,1980,-318
1,16,9,3,5,1385,2047,-662
1,16,10,3,5,1396,2287,-891
1,16,11,3,5,1490,2421,-931
1,16,12,3,5,1808,2356,-548
1,16,13,3,5,1980,2158,-178
1,16,14,3,5,2047,2237,-190
1,17,0,3,5,2059,1923,136
1,17,1,3,5,2089,1816,273
1,17,2,3,5,2085,1845,240
1,17,3,3,5,2300,1735,565
1,17,4,3,5,2231,1555,676
1,17,5,3,5,1923,1562,361
1,17,6,3,5,1816,1506,310
1,17,7,3,5,1845,1721,124
1,17,8,3,5,1735,1900,-165
1,17,9,3,5,1555,1802,-247
1,17,10,3,5,1562,1876,-314
1,17,11,3,5,1506,2140,-634
1,17,12,3,5,1721,2052,-331
1,17,13,3,5,1900,1773,127
1,17,14,3,5,1802,2033,-231
1,18,0,3,5,2121,1793,328
1,18,1,3,5,1921,1877,44
1,18,2,3,5,1877,1998,-121
1,18,3,3,5,2035,2009,26
1,18,4,3,5,1930,1844,86
1,18,5,3,5,1793,1813,-20
1,18,6,3,5,1877,1649,228
1,18,7,3,5,1998,1707,291
1,18,8,3,5,2009,1776,233
1,18,9,3,5,1844,1588,256
1,18,10,3,5,1813,1556,257
1,18,11,3,5,1649,1874,-225
1,18,12,3,5,1707,1769,-62
1,18,13,3,5,1776,1493,283
1,18,14,3,5,1588,1836,-248
1,19,0,3,5,2070,1592,478
1,19,1,3,5,1642,1774,-132
1,19,2,3,5,1607,1866,-259
1,19,3,3,5,1708,1902,-194
1,19,4,3,5,1585,1665,-80
1,19,5,3,5,1592,1587,5
1,19,6,3,5,1774,1445,329
1,19,7,3,5,1866,1519,347
1,19,8,3,5,1902,1519,383
1,19,9,3,5,1665,1352,313
1,19,10,3,5,1587,1358,229
1,19,11,3,5,1445,1604,-159
1,19,12,3,5,1519,1448,71
1,19,13,3,5,1519,1275,244
1,19,14,3,5,1352,1688,-336
1,20,0,3,5,1729,1408,321
1,20,1,3,5,1351,1545,-194
1,20,2,3,5,1305,1594,-289
1,20,3,3,5,1430,1592,-162
1,20,4,3,5,1385,1317,68
1,20,5,3,5,1408,1236,172
1,20,6,3,5,1545,1215,330
1,20,7,3,5,1594,1283,311
1,20,8,3,5,1592,1187,405
1,20,9,3,5,1317,1045,272
1,20,10,3,5,1236,1123,113
1,20,11,3,5,1215,1207,8
1,20,12,3,5,1283,1102,181
1,20,13,3,5,1187,1047,140
1,20,14,3,5,1045,1364,-319
1,21,0,3,5,1440,1154,286
1,21,1,3,5,1163,1171,-8
1,21,2,3,5,1099,1185,-86
1,21,3,3,5,1139,1262,-123
1,21,4,3,5,1137,1049,88
1,21,5,3,5,1154,1010,144
1,21,6,3,5,1171,1106,65
1,21,7,3,5,1185,1203,-18
1,21,8,3,5,1262,1074,188
1,21,9,3,5,1049,982,67
1,21,10,3,5,1010,1045,-35
1,21,11,3,5,1106,1001,105
1,21,12,3,5,1203,915,288
1,21,13,3,5,1074,932,142
1,21,14,3,5,982,1091,-109
1,0,0,4,5,2170,2104,66
1,0,1,4,5,2178,2043,135
1,0,2,4,5,2154,1992,162
1,0,3,4,5,2175,1919,256
1,0,4,4,5,2158,1898,260
1,0,5,4,5,2104,1891,213
1,0,6,4,5,2043,1900,143
1,0,7,4,5,1992,1945,47
1,0,8,4,5,1919,1989,-70
1,0,9,4,5,1898,2051,-153
1,0,10,4,5,1891,2105,-214
1,0,11,4,5,1900,2124,-224
1,0,12,4,5,1945,2132,-187
1,0,13,4,5,1989,2164,-175
1,0,14,4,5,2051,2145,-94
1,1,0,4,5,2236,1971,265
1,1,1,4,5,2249,1847,402
1,1,2,4,5,2203,1749,454
1,1,3,4,5,2176,1648,528
1,1,4,4,5,2092,1619,473
1,1,5,4,5,1971,1607,364
1,1,6,4,5,1847,1613,234
1,1,7,4,5,1749,1676,73
1,1,8,4,5,1648,1751,-103
1,1,9,4,5,1619,1867,-248
1,1,10,4,5,1607,1993,-386
1,1,11,4,5,1613,2086,-473
1,1,12,4,5,1676,2140,-464
1,1,13,4,5,1751,2203,-452
1,1,14,4,5,1867,2196,-329
1,2,0,4,5,2294,1794,500
1,2,1,4,5,2300,1632,668
1,2,2,4,5,2210,1529,681
1,2,3,4,5,2102,1458,644
1,2,4,4,5,1966,1429,537
1,2,5,4,5,1794,1415,379
1,2,6,4,5,1632,1417,215
1,2,7,4,5,1529,1458,71
1,2,8,4,5,1458,1522,-64
1,2,9,4,5,1429,1654,-225
1,2,10,4,5,1415,1825,-410
1,2,11,4,5,1417,1974,-557
1,2,12,4,5,1458,2096,-638
1,2,13,4,5,1522,2212,-690
1,2,14,4,5,1654,2234,-580
1,3,0,4,5,2273,1577,696
1,3,1,4,5,2239,1401,838
1,3,2,4,5,2099,1301,798
1,3,3,4,5,1934,1253,681
1,3,4,4,5,1770,1231,539
1,3,5,4,5,1577,1219,358
1,3,6,4,5,1401,1218,183
1,3,7,4,5,1301,1257,44
1,3,8,4,5,1253,1315,-62
1,3,9,4,5,1231,1448,-217
1,3,10,4,5,1219,1641,-422
1,3,11,4,5,1218,1827,-609
1,3,12,4,5,1257,1986,-729
1,3,13,4,5,1315,2146,-831
1,3,14,4,5,1448,2215,-767
1,4,0,4,5,2151,1529,622
1,4,1,4,5,2041,1442,599
1,4,2,4,5,1863,1408,455
1,4,3,4,5,1708,1407,301
1,4,4,4,5,1623,1397,226
1,4,5,4,5,1529,1390,139
1,4,6,4,5,1442,1387,55
1,4,7,4,5,1408,1399,9
1,4,8,4,5,1407,1405,2
1,4,9,4,5,1397,1465,-68
1,4,10,4,5,1390,1582,-192
1,4,11,4,5,1387,1704,-317
1,4,12,4,5,1399,1834,-435
1,4,13,4,5,1405,2008,-603
1,4,14,4,5,1465,2129,-664
1,5,0,4,5,2092,1746,346
1,5,1,4,5,1944,1767,177
1,5,2,4,5,1785,1784,1
1,5,3,4,5,1668,1840,-172
1,5,4,4,5,1693,1858,-165
1,5,5,4,5,1746,1858,-112
1,5,6,4,5,1767,1863,-96
1,5,7,4,5,1784,1858,-74
1,5,8,4,5,1840,1818,22
1,5,9,4,5,1858,1800,58
1,5,10,4,5,1858,1796,62
1,5,11,4,5,1863,1812,51
1,5,12,4,5,1858,1885,-27
1,5,13,4,5,1818,2008,-190
1,5,14,4,5,1800,2127,-327
1,6,0,4,5,1820,1663,157
1,6,1,4,5,1626,1700,-74
1,6,2,4,5,1495,1713,-218
1,6,3,4,5,1457,1715,-258
1,6,4,4,5,1553,1701,-148
1,6,5,4,5,1663,1690,-27
1,6,6,4,5,1700,1720,-20
1,6,7,4,5,1713,1748,-35
1,6,8,4,5,1715,1742,-27
1,6,9,4,5,1701,1738,-37
1,6,10,4,5,1690,1712,-22
1,6,11,4,5,1720,1676,44
1,6,12,4,5,1748,1686,62
1,6,13,4,5,1742,1759,-17
1,6,14,4,5,1738,1896,-158
1,7,0,4,5,1723,1986,-263
1,7,1,4,5,1581,2050,-469
1,7,2,4,5,1586,2057,-471
1,7,3,4,5,1696,2016,-320
1,7,4,4,5,1878,1992,-114
1,7,5,4,5,1986,1978,8
1,7,6,4,5,2050,2006,44
1,7,7,4,5,2057,2052,5
1,7,8,4,5,2016,2073,-57
1,7,9,4,5,1992,2047,-55
1,7,10,4,5,1978,1998,-20
1,7,11,4,5,2006,1919,87
1,7,12,4,5,2052,1836,216
1,7,13,4,5,2073,1809,264
1,7,14,4,5,2047,1896,151
1,8,0,4,5,1994,2573,-579
1,8,1,4,5,1961,2616,-655
1,8,2,4,5,2132,2561,-429
1,8,3,4,5,2367,2487,-120
1,8,4,4,5,2596,2444,152
1,8,5,4,5,2573,2435,138
1,8,6,4,5,2616,2459,157
1,8,7,4,5,2561,2569,-8
1,8,8,4,5,2487,2650,-163
1,8,9,4,5,2444,2627,-183
1,8,10,4,5,2435,2625,-190
1,8,11,4,5,2459,2594,-135
1,8,12,4,5,2569,2453,116
1,8,13,4,5,2650,2337,313
1,8,14,4,5,2627,2328,299
1,9,0,4,5,2230,2942,-712
1,9,1,4,5,2279,2862,-583
1,9,2,4,5,2522,2707,-185
1,9,3,4,5,2877,2515,362
1,9,4,4,5,3163,2332,831
1,9,5,4,5,2942,2312,630
1,9,6,4,5,2862,2373,489
1,9,7,4,5,2707,2622,85
1,9,8,4,5,2515,2825,-310
1,9,9,4,5,2332,2908,-576
1,9,10,4,5,2312,3070,-758
1,9,11,4,5,2373,3137,-764
1,9,12,4,5,2622,2948,-326
1,9,13,4,5,2825,2806,19
1,9,14,4,5,2908,2726,182
1,10,0,4,5,2627,3676,-1049
1,10,1,4,5,2834,3475,-641
1,10,2,4,5,3113,3251,-138
1,10,3,4,5,3593,2964,629
1,10,4,4,5,3984,2664,1320
1,10,5,4,5,3676,2649,1027
1,10,6,4,5,3475,2737,738
1,10,7,4,5,3251,3119,132
1,10,8,4,5,2964,3402,-438
1,10,9,4,5,2664,3577,-913
1,10,10,4,5,2649,3841,-1192
1,10,11,4,5,2737,3930,-1193
1,10,12,4,5,3119,3679,-560
1,10,13,4,5,3402,3507,-105
1,10,14,4,5,3577,3298,279
1,11,0,4,5,2929,3972,-1043
1,11,1,4,5,3224,3630,-406
1,11,2,4,5,3398,3360,38
1,11,3,4,5,3897,2983,914
1,11,4,4,5,4336,2569,1767
1,11,5,4,5,3972,2562,1410
1,11,6,4,5,3630,2681,949
1,11,7,4,5,3360,3185,175
1,11,8,4,5,2983,3515,-532
1,11,9,4,5,2569,3828,-1259
1,11,10,4,5,2562,4205,-1643
1,11,11,4,5,2681,4306,-1625
1,11,12,4,5,3185,4072,-887
1,11,13,4,5,3515,3971,-456
1,11,14,4,5,3828,3692,136
1,12,0,4,5,2972,3922,-950
1,12,1,4,5,3335,3429,-94
1,12,2,4,5,3381,3134,247
1,12,3,4,5,3870,2664,1206
1,12,4,4,5,4335,2120,2215
1,12,5,4,5,3922,2110,1812
1,12,6,4,5,3429,2276,1153
1,12,7,4,5,3134,2877,257
1,12,8,4,5,2664,3228,-564
1,12,9,4,5,2120,3712,-1592
1,12,10,4,5,2110,4199,-2089
1,12,11,4,5,2276,4265,-1989
1,12,12,4,5,2877,4047,-1170
1,12,13,4,5,3228,4024,-796
1,12,14,4,5,3712,3689,23
1,13,0,4,5,2842,3914,-1072
1,13,1,4,5,3296,3376,-80
1,13,2,4,5,3292,3143,149
1,13,3,4,5,3834,2645,1189
1,13,4,4,5,4313,2095,2218
1,13,5,4,5,3914,2084,1830
1,13,6,4,5,3376,2262,1114
1,13,7,4,5,3143,2887,256
1,13,8,4,5,2645,3174,-529
1,13,9,4,5,2095,3646,-1551
1,13,10,4,5,2084,4133,-2049
1,13,11,4,5,2262,4122,-1860
1,13,12,4,5,2887,3872,-985
1,13,13,4,5,3174,3835,-661
1,13,14,4,5,3646,3520,126
1,14,0,4,5,2716,3710,-994
1,14,1,4,5,3146,3238,-92
1,14,2,4,5,3168,3037,131
1,14,3,4,5,3755,2514,1241
1,14,4,4,5,4158,2004,2154
1,14,5,4,5,3710,1992,1718
1,14,6,4,5,3238,2149,1089
1,14,7,4,5,3037,2793,244
1,14,8,4,5,2514,3051,-537
1,14,9,4,5,2004,3393,-1389
1,14,10,4,5,1992,3857,-1865
1,14,11,4,5,2149,3860,-1711
1,14,12,4,5,2793,3595,-802
1,14,13,4,5,3051,3510,-459
1,14,14,4,5,3393,3359,34
1,15,0,4,5,2694,3307,-613
1,15,1,4,5,3079,2858,221
1,15,2,4,5,3104,2722,382
1,15,3,4,5,3627,2300,1327
1,15,4,4,5,3844,1877,1967
1,15,5,4,5,3307,1891,1416
1,15,6,4,5,2858,2027,831
1,15,7,4,5,2722,2506,216
1,15,8,4,5,2300,2744,-444
1,15,9,4,5,1877,2966,-1089
1,15,10,4,5,1891,3343,-1452
1,15,11,4,5,2027,3466,-1439
1,15,12,4,5,2506,3344,-838
1,15,13,4,5,2744,3161,-417
1,15,14,4,5,2966,3134,-168
1,16,0,4,5,2694,2896,-202
1,16,1,4,5,2865,2657,208
1,16,2,4,5,2877,2650,227
1,16,3,4,5,3265,2419,846
1,16,4,4,5,3316,2112,1204
1,16,5,4,5,2896,2110,786
1,16,6,4,5,2657,2111,546
1,16,7,4,5,2650,2486,164
1,16,8,4,5,2419,2708,-289
1,16,9,4,5,2112,2687,-575
1,16,10,4,5,2110,2880,-770
1,16,11,4,5,2111,3126,-1015
1,16,12,4,5,2486,2952,-466
1,16,13,4,5,2708,2620,88
1,16,14,4,5,2687,2831,-144
1,17,0,4,5,2720,2594,126
1,17,1,4,5,2603,2597,6
1,17,2,4,5,2596,2673,-77
1,17,3,4,5,2922,2536,386
1,17,4,4,5,2867,2258,609
1,17,5,4,5,2594,2217,377
1,17,6,4,5,2597,2083,514
1,17,7,4,5,2673,2316,357
1,17,8,4,5,2536,2463,73
1,17,9,4,5,2258,2267,-9
1,17,10,4,5,2217,2334,-117
1,17,11,4,5,2083,2686,-603
1,17,12,4,5,2316,2505,-189
1,17,13,4,5,2463,2161,302
1,17,14,4,5,2267,2584,-317
1,18,0,4,5,2782,2153,629
1,18,1,4,5,2411,2231,180
1,18,2,4,5,2353,2338,15
1,18,3,4,5,2506,2353,153
1,18,4,4,5,2311,2079,232
1,18,5,4,5,2153,2031,122
1,18,6,4,5,2231,1896,335
1,18,7,4,5,2338,1953,385
1,18,8,4,5,2353,2004,349
1,18,9,4,5,2079,1835,244
1,18,10,4,5,2031,1863,168
1,18,11,4,5,1896,2227,-331
1,18,12,4,5,1953,2168,-215
1,18,13,4,5,2004,1918,86
1,18,14,4,5,1835,2379,-544
1,19,0,4,5,2477,1969,508
1,19,1,4,5,1989,2184,-195
1,19,2,4,5,1925,2292,-367
1,19,3,4,5,2045,2349,-304
1,19,4,4,5,1953,2044,-91
1,19,5,4,5,1969,1950,19
1,19,6,4,5,2184,1836,348
1,19,7,4,5,2292,1961,331
1,19,8,4,5,2349,1915,434
1,19,9,4,5,2044,1685,359
1,19,10,4,5,1950,1716,234
1,19,11,4,5,1836,1912,-76
1,19,12,4,5,1961,1698,263
1,19,13,4,5,1915,1509,406
1,19,14,4,5,1685,1958,-273
1,20,0,4,5,2101,1825,276
1,20,1,4,5,1677,1952,-275
1,20,2,4,5,1610,2013,-403
1,20,3,4,5,1761,2063,-302
1,20,4,4,5,1773,1752,21
1,20,5,4,5,1825,1665,160
1,20,6,4,5,1952,1683,269
1,20,7,4,5,2013,1798,215
1,20,8,4,5,2063,1637,426
1,20,9,4,5,1752,1447,305
1,20,10,4,5,1665,1503,162
1,20,11,4,5,1683,1547,136
1,20,12,4,5,1798,1368,430
1,20,13,4,5,1637,1320,317
1,20,14,4,5,1447,1642,-195
1,0,0,5,5,2758,2499,259
1,0,1,5,5,2772,2366,406
1,0,2,5,5,2723,2266,457
1,0,3,5,5,2706,2161,545
1,0,4,5,5,2628,2131,497
1,0,5,5,5,2499,2120,379
1,0,6,5,5,2366,2129,237
1,0,7,5,5,2266,2188,78
1,0,8,5,5,2161,2263,-102
1,0,9,5,5,2131,2386,-255
1,0,10,5,5,2120,2516,-396
1,0,11,5,5,2129,2602,-473
1,0,12,5,5,2188,2661,-473
1,0,13,5,5,2263,2731,-468
1,0,14,5,5,2386,2716,-330
1,1,0,5,5,2836,2325,511
1,1,1,5,5,2844,2159,685
1,1,2,5,5,2745,2057,688
1,1,3,5,5,2637,1982,655
1,1,4,5,5,2503,1949,554
1,1,5,5,5,2325,1934,391
1,1,6,5,5,2159,1939,220
1,1,7,5,5,2057,1992,65
1,1,8,5,5,1982,2060,-78
1,1,9,5,5,1949,2192,-243
1,1,10,5,5,1934,2360,-426
1,1,11,5,5,1939,2503,-564
1,1,12,5,5,1992,2621,-629
1,1,13,5,5,2060,2744,-684
1,1,14,5,5,2192,2764,-572
1,2,0,5,5,2823,2139,684
1,2,1,5,5,2791,1964,827
1,2,2,5,5,2644,1863,781
1,2,3,5,5,2485,1803,682
1,2,4,5,5,2329,1774,555
1,2,5,5,5,2139,1759,380
1,2,6,5,5,1964,1760,204
1,2,7,5,5,1863,1809,54
1,2,8,5,5,1803,1870,-67
1,2,9,5,5,1774,2004,-230
1,2,10,5,5,1759,2194,-435
1,2,11,5,5,1760,2372,-612
1,2,12,5,5,1809,2524,-715
1,2,13,5,5,1870,2690,-820
1,2,14,5,5,2004,2756,-752
1,3,0,5,5,2707,2012,695
1,3,1,5,5,2600,1876,724
1,3,2,5,5,2417,1793,624
1,3,3,5,5,2267,1739,528
1,3,4,5,5,2149,1720,429
1,3,5,5,5,2012,1709,303
1,3,6,5,5,1876,1707,169
1,3,7,5,5,1793,1746,47
1,3,8,5,5,1739,1789,-50
1,3,9,5,5,1720,1903,-183
1,3,10,5,5,1709,2076,-367
1,3,11,5,5,1707,2238,-531
1,3,12,5,5,1746,2382,-636
1,3,13,5,5,1789,2568,-779
1,3,14,5,5,1903,2683,-780
1,4,0,5,5,2680,2141,539
1,4,1,5,5,2538,2090,448
1,4,2,5,5,2354,2058,296
1,4,3,5,5,2199,2082,117
1,4,4,5,5,2163,2091,72
1,4,5,5,5,2141,2087,54
1,4,6,5,5,2090,2092,-2
1,4,7,5,5,2058,2101,-43
1,4,8,5,5,2082,2092,-10
1,4,9,5,5,2091,2135,-44
1,4,10,5,5,2087,2207,-120
1,4,11,5,5,2092,2290,-198
1,4,12,5,5,2101,2414,-313
1,4,13,5,5,2092,2575,-483
1,4,14,5,5,2135,2698,-563
1,5,0,5,5,2420,2017,403
1,5,1,5,5,2221,2012,209
1,5,2,5,5,2037,2021,16
1,5,3,5,5,1918,2049,-131
1,5,4,5,5,1964,2031,-67
1,5,5,5,5,2017,2017,0
1,5,6,5,5,2012,2046,-34
1,5,7,5,5,2021,2064,-43
1,5,8,5,5,2049,2051,-2
1,5,9,5,5,2031,2063,-32
1,5,10,5,5,2017,2079,-62
1,5,11,5,5,2046,2093,-47
1,5,12,5,5,2064,2167,-103
1,5,13,5,5,2051,2300,-249
1,5,14,5,5,2063,2464,-401
1,6,0,5,5,2252,2331,-79
1,6,1,5,5,2072,2382,-310
1,6,2,5,5,2020,2391,-371
1,6,3,5,5,2079,2361,-282
1,6,4,5,5,2241,2337,-96
1,6,5,5,5,2331,2322,9
1,6,6,5,5,2382,2349,33
1,6,7,5,5,2391,2403,-12
1,6,8,5,5,2361,2421,-60
1,6,9,5,5,2337,2397,-60
1,6,10,5,5,2322,2367,-45
1,6,11,5,5,2349,2317,32
1,6,12,5,5,2403,2264,139
1,6,13,5,5,2421,2287,134
1,6,14,5,5,2397,2418,-21
1,7,0,5,5,2428,3008,-580
1,7,1,5,5,2322,3091,-769
1,7,2,5,5,2450,3053,-603
1,7,3,5,5,2700,2973,-273
1,7,4,5,5,2975,2933,42
1,7,5,5,5,3008,2925,83
1,7,6,5,5,3091,2948,143
1,7,7,5,5,3053,3058,-5
1,7,8,5,5,2973,3124,-151
1,7,9,5,5,2933,3082,-149
1,7,10,5,5,2925,3060,-135
1,7,11,5,5,2948,3005,-57
1,7,12,5,5,3058,2849,209
1,7,13,5,5,3124,2759,365
1,7,14,5,5,3082,2796,286
1,8,0,5,5,2759,3554,-795
1,8,1,5,5,2776,3510,-734
1,8,2,5,5,3013,3357,-344
1,8,3,5,5,3368,3190,178
1,8,4,5,5,3703,3026,677
1,8,5,5,5,3554,3009,545
1,8,6,5,5,3510,3078,432
1,8,7,5,5,3357,3324,33
1,8,8,5,5,3190,3512,-322
1,8,9,5,5,3026,3578,-552
1,8,10,5,5,3009,3695,-686
1,8,11,5,5,3078,3723,-645
1,8,12,5,5,3324,3528,-204
1,8,13,5,5,3512,3373,139
1,8,14,5,5,3578,3295,283
1,9,0,5,5,2955,3947,-992
1,9,1,5,5,3111,3720,-609
1,9,2,5,5,3365,3488,-123
1,9,3,5,5,3843,3173,670
1,9,4,5,5,4255,2837,1418
1,9,5,5,5,3947,2808,1139
1,9,6,5,5,3720,2920,800
1,9,7,5,5,3488,3325,163
1,9,8,5,5,3173,3635,-462
1,9,9,5,5,2837,3840,-1003
1,9,10,5,5,2808,4124,-1316
1,9,11,5,5,2920,4211,-1291
1,9,12,5,5,3325,3961,-636
1,9,13,5,5,3635,3799,-164
1,9,14,5,5,3840,3635,205
1,10,0,5,5,3361,4640,-1279
1,10,1,5,5,3670,4312,-642
1,10,2,5,5,3923,4038,-115
1,10,3,5,5,4519,3629,890
1,10,4,5,5,5024,3205,1819
1,10,5,5,5,4640,3194,1446
1,10,6,5,5,4312,3310,1002
1,10,7,5,5,4038,3840,198
1,10,8,5,5,3629,4194,-565
1,10,9,5,5,3205,4487,-1282
1,10,10,5,5,3194,4860,-1666
1,10,11,5,5,3310,4947,-1637
1,10,12,5,5,3840,4650,-810
1,10,13,5,5,4194,4499,-305
1,10,14,5,5,4487,4214,273
1,11,0,5,5,3677,4944,-1267
1,11,1,5,5,4076,4470,-394
1,11,2,5,5,4245,4130,115
1,11,3,5,5,4874,3621,1253
1,11,4,5,5,5432,3061,2371
1,11,5,5,5,4944,3057,1887
1,11,6,5,5,4470,3218,1252
1,11,7,5,5,4130,3883,247
1,11,8,5,5,3621,4279,-658
1,11,9,5,5,3061,4747,-1686
1,11,10,5,5,3057,5261,-2204
1,11,11,5,5,3218,5351,-2133
1,11,12,5,5,3883,5060,-1177
1,11,13,5,5,4279,4974,-695
1,11,14,5,5,4747,4589,158
1,12,0,5,5,3607,4895,-1288
1,12,1,5,5,4111,4270,-159
1,12,2,5,5,4173,3939,234
1,12,3,5,5,4835,3348,1487
1,12,4,5,5,5420,2677,2743
1,12,5,5,5,4895,2658,2237
1,12,6,5,5,4270,2881,1389
1,12,7,5,5,3939,3642,297
1,12,8,5,5,3348,4036,-688
1,12,9,5,5,2677,4597,-1920
1,12,10,5,5,2658,5203,-2545
1,12,11,5,5,2881,5251,-2370
1,12,12,5,5,3642,4947,-1305
1,12,13,5,5,4036,4871,-835
1,12,14,5,5,4597,4487,110
1,13,0,5,5,3441,4715,-1274
1,13,1,5,5,3978,4096,-118
1,13,2,5,5,4011,3818,193
1,13,3,5,5,4721,3172,1549
1,13,4,5,5,5250,2509,2741
1,13,5,5,5,4715,2488,2227
1,13,6,5,5,4096,2696,1400
1,13,7,5,5,3818,3496,322
1,13,8,5,5,3172,3861,-689
1,13,9,5,5,2509,4325,-1816
1,13,10,5,5,2488,4911,-2423
1,13,11,5,5,2696,4934,-2238
1,13,12,5,5,3496,4608,-1112
1,13,13,5,5,3861,4503,-642
1,13,14,5,5,4325,4268,57
1,14,0,5,5,3428,4271,-843
1,14,1,5,5,3915,3695,220
1,14,2,5,5,3914,3509,405
1,14,3,5,5,4553,2965,1588
1,14,4,5,5,4884,2418,2466
1,14,5,5,5,4271,2436,1835
1,14,6,5,5,3695,2600,1095
1,14,7,5,5,3509,3227,282
1,14,8,5,5,2965,3536,-571
1,14,9,5,5,2418,3876,-1458
1,14,10,5,5,2436,4362,-1926
1,14,11,5,5,2600,4483,-1883
1,14,12,5,5,3227,4315,-1088
1,14,13,5,5,3536,4153,-617
1,14,14,5,5,3876,4050,-174
1,15,0,5,5,3442,3868,-426
1,15,1,5,5,3717,3497,220
1,15,2,5,5,3724,3420,304
1,15,3,5,5,4242,3057,1185
1,15,4,5,5,4412,2604,1808
1,15,5,5,5,3868,2605,1263
1,15,6,5,5,3497,2648,849
1,15,7,5,5,3420,3184,236
1,15,8,5,5,3057,3472,-415
1,15,9,5,5,2604,3606,-1002
1,15,10,5,5,2605,3936,-1331
1,15,11,5,5,2648,4171,-1523
1,15,12,5,5,3184,3940,-756
1,15,13,5,5,3472,3623,-151
1,15,14,5,5,3606,3728,-122
1,16,0,5,5,3355,3567,-212
1,16,1,5,5,3379,3438,-59
1,16,2,5,5,3388,3478,-90
1,16,3,5,5,3887,3220,667
1,16,4,5,5,3952,2815,1137
1,16,5,5,5,3567,2765,802
1,16,6,5,5,3438,2688,750
1,16,7,5,5,3478,3081,397
1,16,8,5,5,3220,3271,-51
1,16,9,5,5,2815,3152,-337
1,16,10,5,5,2765,3338,-573
1,16,11,5,5,2688,3672,-984
1,16,12,5,5,3081,3405,-324
1,16,13,5,5,3271,3008,263
1,16,14,5,5,3152,3382,-230
1,17,0,5,5,3381,2954,427
1,17,1,5,5,3093,2951,142
1,17,2,5,5,3072,3013,59
1,17,3,5,5,3393,2880,513
1,17,4,5,5,3248,2493,755
1,17,5,5,5,2954,2435,519
1,17,6,5,5,2951,2330,621
1,17,7,5,5,3013,2562,451
1,17,8,5,5,2880,2691,189
1,17,9,5,5,2493,2514,-21
1,17,10,5,5,2435,2641,-206
1,17,11,5,5,2330,3039,-709
1,17,12,5,5,2562,2904,-342
1,17,13,5,5,2691,2586,105
1,17,14,5,5,2514,3127,-613
1,18,0,5,5,3189,2530,659
1,18,1,5,5,2758,2641,117
1,18,2,5,5,2671,2764,-93
1,18,3,5,5,2843,2800,43
1,18,4,5,5,2679,2458,221
1,18,5,5,5,2530,2394,136
1,18,6,5,5,2641,2287,354
1,18,7,5,5,2764,2395,369
1,18,8,5,5,2800,2400,400
1,18,9,5,5,2458,2168,290
1,18,10,5,5,2394,2221,173
1,18,11,5,5,2287,2535,-248
1,18,12,5,5,2395,2418,-23
1,18,13,5,5,2400,2152,248
1,18,14,5,5,2168,2649,-481
1,19,0,5,5,2849,2386,463
1,19,1,5,5,2315,2591,-276
1,19,2,5,5,2230,2711,-481
1,19,3,5,5,2376,2820,-444
1,19,4,5,5,2341,2479,-138
1,19,5,5,5,2386,2379,7
1,19,6,5,5,2591,2304,287
1,19,7,5,5,2711,2476,235
1,19,8,5,5,2820,2365,455
1,19,9,5,5,2479,2087,392
1,19,10,5,5,2379,2096,283
1,19,11,5,5,2304,2252,52
1,19,12,5,5,2476,1964,512
1,19,13,5,5,2365,1782,583
1,19,14,5,5,2087,2236,-149
1,0,0,6,5,3358,2853,505
1,0,1,6,5,3367,2678,689
1,0,2,6,5,3265,2574,691
1,0,3,6,5,3167,2495,672
1,0,4,6,5,3039,2461,578
1,0,5,6,5,2853,2447,406
1,0,6,6,5,2678,2455,223
1,0,7,6,5,2574,2504,70
1,0,8,6,5,2495,2572,-77
1,0,9,6,5,2461,2711,-250
1,0,10,6,5,2447,2883,-436
1,0,11,6,5,2455,3019,-564
1,0,12,6,5,2504,3142,-638
1,0,13,6,5,2572,3272,-700
1,0,14,6,5,2711,3284,-573
1,1,0,6,5,3365,2670,695
1,1,1,6,5,3335,2491,844
1,1,2,6,5,3179,2391,788
1,1,3,6,5,3020,2327,693
1,1,4,6,5,2866,2294,572
1,1,5,6,5,2670,2278,392
1,1,6,6,5,2491,2282,209
1,1,7,6,5,2391,2343,48
1,1,8,6,5,2327,2408,-81
1,1,9,6,5,2294,2542,-248
1,1,10,6,5,2278,2729,-451
1,1,11,6,5,2282,2901,-619
1,1,12,6,5,2343,3049,-706
1,1,13,6,5,2408,3222,-814
1,1,14,6,5,2542,3286,-744
1,2,0,6,5,3257,2574,683
1,2,1,6,5,3152,2439,713
1,2,2,6,5,2962,2355,607
1,2,3,6,5,2818,2289,529
1,2,4,6,5,2708,2263,445
1,2,5,6,5,2574,2249,325
1,2,6,6,5,2439,2249,190
1,2,7,6,5,2355,2298,57
1,2,8,6,5,2289,2344,-55
1,2,9,6,5,2263,2459,-196
1,2,10,6,5,2249,2629,-380
1,2,11,6,5,2249,2783,-534
1,2,12,6,5,2298,2920,-622
1,2,13,6,5,2344,3112,-768
1,2,14,6,5,2459,3224,-765
1,3,0,6,5,3236,2624,612
1,3,1,6,5,3097,2524,573
1,3,2,6,5,2908,2443,465
1,3,3,6,5,2758,2414,344
1,3,4,6,5,2689,2414,275
1,3,5,6,5,2624,2406,218
1,3,6,6,5,2524,2412,112
1,3,7,6,5,2443,2448,-5
1,3,8,6,5,2414,2476,-62
1,3,9,6,5,2414,2573,-159
1,3,10,6,5,2406,2701,-295
1,3,11,6,5,2412,2824,-412
1,3,12,6,5,2448,2962,-514
1,3,13,6,5,2476,3135,-659
1,3,14,6,5,2573,3252,-679
1,4,0,6,5,3008,2412,596
1,4,1,6,5,2815,2335,480
1,4,2,6,5,2606,2295,311
1,4,3,6,5,2449,2291,158
1,4,4,6,5,2434,2264,170
1,4,5,6,5,2412,2246,166
1,4,6,6,5,2335,2275,60
1,4,7,6,5,2295,2307,-12
1,4,8,6,5,2291,2325,-34
1,4,9,6,5,2264,2398,-134
1,4,10,6,5,2246,2490,-244
1,4,11,6,5,2275,2571,-296
1,4,12,6,5,2307,2696,-389
1,4,13,6,5,2325,2867,-542
1,4,14,6,5,2398,3035,-637
1,5,0,6,5,2852,2685,167
1,5,1,6,5,2667,2694,-27
1,5,2,6,5,2562,2699,-137
1,5,3,6,5,2540,2695,-155
1,5,4,6,5,2652,2667,-15
1,5,5,6,5,2685,2649,36
1,5,6,6,5,2694,2675,19
1,5,7,6,5,2699,2719,-20
1,5,8,6,5,2695,2730,-35
1,5,9,6,5,2667,2722,-55
1,5,10,6,5,2649,2734,-85
1,5,11,6,5,2675,2734,-59
1,5,12,6,5,2719,2745,-26
1,5,13,6,5,2730,2828,-98
1,5,14,6,5,2722,2986,-264
1,6,0,6,5,2957,3353,-396
1,6,1,6,5,2813,3423,-610
1,6,2,6,5,2884,3387,-503
1,6,3,6,5,3083,3318,-235
1,6,4,6,5,3338,3278,60
1,6,5,6,5,3353,3269,84
1,6,6,6,5,3423,3291,132
1,6,7,6,5,3387,3409,-22
1,6,8,6,5,3318,3472,-154
1,6,9,6,5,3278,3432,-154
1,6,10,6,5,3269,3429,-160
1,6,11,6,5,3291,3403,-112
1,6,12,6,5,3409,3277,132
1,6,13,6,5,3472,3237,235
1,6,14,6,5,3432,3318,114
1,7,0,6,5,3193,3989,-796
1,7,1,6,5,3137,3985,-848
1,7,2,6,5,3331,3849,-518
1,7,3,6,5,3701,3676,25
1,7,4,6,5,4082,3515,567
1,7,5,6,5,3989,3499,490
1,7,6,6,5,3985,3567,418
1,7,7,6,5,3849,3813,36
1,7,8,6,5,3676,3986,-310
1,7,9,6,5,3515,4033,-518
1,7,10,6,5,3499,4130,-631
1,7,11,6,5,3567,4134,-567
1,7,12,6,5,3813,3924,-111
1,7,13,6,5,3986,3795,191
1,7,14,6,5,4033,3763,270
1,8,0,6,5,3484,4559,-1075
1,8,1,6,5,3608,4368,-760
1,8,2,6,5,3856,4138,-282
1,8,3,6,5,4334,3848,486
1,8,4,6,5,4795,3531,1264
1,8,5,6,5,4559,3505,1054
1,8,6,6,5,4368,3625,743
1,8,7,6,5,4138,4027,111
1,8,8,6,5,3848,4322,-474
1,8,9,6,5,3531,4510,-979
1,8,10,6,5,3505,4749,-1244
1,8,11,6,5,3625,4797,-1172
1,8,12,6,5,4027,4541,-514
1,8,13,6,5,4322,4366,-44
1,8,14,6,5,4510,4204,306
1,9,0,6,5,3689,4911,-1222
1,9,1,6,5,3947,4557,-610
1,9,2,6,5,4175,4275,-100
1,9,3,6,5,4769,3838,931
1,9,4,6,5,5295,3378,1917
1,9,5,6,5,4911,3353,1558
1,9,6,6,5,4557,3493,1064
1,9,7,6,5,4275,4046,229
1,9,8,6,5,3838,4427,-589
1,9,9,6,5,3378,4750,-1372
1,9,10,6,5,3353,5143,-1790
1,9,11,6,5,3493,5228,-1735
1,9,12,6,5,4046,4932,-886
1,9,13,6,5,4427,4791,-364
1,9,14,6,5,4750,4551,199
1,10,0,6,5,4109,5612,-1503
1,10,1,6,5,4522,5152,-630
1,10,2,6,5,4770,4808,-38
1,10,3,6,5,5496,4267,1229
1,10,4,6,5,6120,3697,2423
1,10,5,6,5,5612,3689,1923
1,10,6,6,5,5152,3847,1305
1,10,7,6,5,4808,4538,270
1,10,8,6,5,4267,4958,-691
1,10,9,6,5,3697,5406,-1709
1,10,10,6,5,3689,5916,-2227
1,10,11,6,5,3847,5992,-2145
1,10,12,6,5,4538,5638,-1100
1,10,13,6,5,4958,5502,-544
1,10,14,6,5,5406,5111,295
1,11,0,6,5,4312,5917,-1605
1,11,1,6,5,4852,5311,-459
1,11,2,6,5,5037,4935,102
1,11,3,6,5,5839,4305,1534
1,11,4,6,5,6517,3618,2899
1,11,5,6,5,5917,3605,2312
1,11,6,6,5,5311,3823,1488
1,11,7,6,5,4935,4648,287
1,11,8,6,5,4305,5087,-782
1,11,9,6,5,3618,5632,-2014
1,11,10,6,5,3605,6265,-2660
1,11,11,6,5,3823,6337,-2514
1,11,12,6,5,4648,5960,-1312
1,11,13,6,5,5087,5821,-734
1,11,14,6,5,5632,5387,245
1,12,0,6,5,4206,5696,-1490
1,12,1,6,5,4793,4990,-197
1,12,2,6,5,4892,4614,278
1,12,3,6,5,5722,3875,1847
1,12,4,6,5,6357,3091,3266
1,12,5,6,5,5696,3062,2634
1,12,6,6,5,4990,3315,1675
1,12,7,6,5,4614,4251,363
1,12,8,6,5,3875,4723,-848
1,12,9,6,5,3091,5276,-2185
1,12,10,6,5,3062,5981,-2919
1,12,11,6,5,3315,6063,-2748
1,12,12,6,5,4251,5683,-1432
1,12,13,6,5,4723,5539,-816
1,12,14,6,5,5276,5235,41
1,13,0,6,5,4153,5276,-1123
1,13,1,6,5,4747,4553,194
1,13,2,6,5,4757,4290,467
1,13,3,6,5,5519,3623,1896
1,13,4,6,5,5976,2923,3053
1,13,5,6,5,5276,2932,2344
1,13,6,6,5,4553,3147,1406
1,13,7,6,5,4290,3930,360
1,13,8,6,5,3623,4346,-723
1,13,9,6,5,2923,4808,-1885
1,13,10,6,5,2932,5416,-2484
1,13,11,6,5,3147,5557,-2410
1,13,12,6,5,3930,5328,-1398
1,13,13,6,5,4346,5146,-800
1,13,14,6,5,4808,4959,-151
1,14,0,6,5,4176,4832,-656
1,14,1,6,5,4553,4334,219
1,14,2,6,5,4534,4207,327
1,14,3,6,5,5168,3722,1446
1,14,4,6,5,5452,3145,2307
1,14,5,6,5,4832,3150,1682
1,14,6,6,5,4334,3221,1113
1,14,7,6,5,4207,3905,302
1,14,8,6,5,3722,4264,-542
1,14,9,6,5,3145,4516,-1371
1,14,10,6,5,3150,4955,-1805
1,14,11,6,5,3221,5188,-1967
1,14,12,6,5,3905,4911,-1006
1,14,13,6,5,4264,4615,-351
1,14,14,6,5,4516,4644,-128
1,15,0,6,5,4103,4539,-436
1,15,1,6,5,4231,4278,-47
1,15,2,6,5,4235,4248,-13
1,15,3,6,5,4864,3858,1006
1,15,4,6,5,5048,3307,1741
1,15,5,6,5,4539,3260,1279
1,15,6,6,5,4278,3225,1053
1,15,7,6,5,4248,3779,469
1,15,8,6,5,3858,4035,-177
1,15,9,6,5,3307,4071,-764
1,15,10,6,5,3260,4394,-1134
1,15,11,6,5,3225,4717,-1492
1,15,12,6,5,3779,4393,-614
1,15,13,6,5,4035,4011,24
1,15,14,6,5,4071,4279,-208
1,16,0,6,5,4016,3927,89
1,16,1,6,5,3869,3792,77
1,16,2,6,5,3864,3818,46
1,16,3,6,5,4358,3564,794
1,16,4,6,5,4333,3050,1283
1,16,5,6,5,3927,2983,944
1,16,6,6,5,3792,2935,857
1,16,7,6,5,3818,3327,491
1,16,8,6,5,3564,3499,65
1,16,9,6,5,3050,3399,-349
1,16,10,6,5,2983,3645,-662
1,16,11,6,5,2935,4025,-1090
1,16,12,6,5,3327,3804,-477
1,16,13,6,5,3499,3433,66
1,16,14,6,5,3399,3925,-526
1,17,0,6,5,3788,3331,457
1,17,1,6,5,3440,3361,79
1,17,2,6,5,3390,3439,-49
1,17,3,6,5,3730,3327,403
1,17,4,6,5,3616,2872,744
1,17,5,6,5,3331,2798,533
1,17,6,6,5,3361,2721,640
1,17,7,6,5,3439,3004,435
1,17,8,6,5,3327,3087,240
1,17,9,6,5,2872,2847,25
1,17,10,6,5,2798,2999,-201
1,17,11,6,5,2721,3347,-626
1,17,12,6,5,3004,3154,-150
1,17,13,6,5,3087,2820,267
1,17,14,6,5,2847,3397,-550
1,18,0,6,5,3561,2947,614
1,18,1,6,5,3084,3048,36
1,18,2,6,5,2976,3183,-207
1,18,3,6,5,3174,3271,-97
1,18,4,6,5,3067,2893,174
1,18,5,6,5,2947,2823,124
1,18,6,6,5,3048,2755,293
1,18,7,6,5,3183,2910,273
1,18,8,6,5,3271,2850,421
1,18,9,6,5,2893,2570,323
1,18,10,6,5,2823,2601,222
1,18,11,6,5,2755,2875,-120
1,18,12,6,5,2910,2684,226
1,18,13,6,5,2850,2425,425
1,18,14,6,5,2570,2927,-357
1,0,0,7,5,3887,3198,689
1,0,1,7,5,3858,3010,848
1,0,2,7,5,3699,2908,791
1,0,3,7,5,3550,2840,710
1,0,4,7,5,3402,2806,596
1,0,5,7,5,3198,2791,407
1,0,6,7,5,3010,2798,212
1,0,7,7,5,2908,2855,53
1,0,8,7,5,2840,2920,-80
1,0,9,7,5,2806,3061,-255
1,0,10,7,5,2791,3252,-461
1,0,11,7,5,2798,3417,-619
1,0,12,7,5,2855,3570,-715
1,0,13,7,5,2920,3750,-830
1,0,14,7,5,3061,3806,-745
1,1,0,7,5,3799,3105,694
1,1,1,7,5,3696,2966,730
1,1,2,7,5,3497,2883,614
1,1,3,7,5,3353,2813,540
1,1,4,7,5,3245,2783,462
1,1,5,7,5,3105,2768,337
1,1,6,7,5,2966,2771,195
1,1,7,7,5,2883,2832,51
1,1,8,7,5,2813,2882,-69
1,1,9,7,5,2783,2997,-214
1,1,10,7,5,2768,3164,-396
1,1,11,7,5,2771,3312,-541
1,1,12,7,5,2832,3445,-613
1,1,13,7,5,2882,3644,-762
1,1,14,7,5,2997,3754,-757
1,2,0,7,5,3786,3186,600
1,2,1,7,5,3649,3087,562
1,2,2,7,5,3453,3005,448
1,2,3,7,5,3309,2964,345
1,2,4,7,5,3248,2957,291
1,2,5,7,5,3186,2946,240
1,2,6,7,5,3087,2954,133
1,2,7,7,5,3005,3000,5
1,2,8,7,5,2964,3031,-67
1,2,9,7,5,2957,3129,-172
1,2,10,7,5,2946,3254,-308
1,2,11,7,5,2954,3369,-415
1,2,12,7,5,3000,3500,-500
1,2,13,7,5,3031,3679,-648
1,2,14,7,5,3129,3793,-664
1,3,0,7,5,3564,2895,669
1,3,1,7,5,3374,2769,605
1,3,2,7,5,3160,2680,480
1,3,3,7,5,3008,2623,385
1,3,4,7,5,2960,2587,373
1,3,5,7,5,2895,2565,330
1,3,6,7,5,2769,2595,174
1,3,7,7,5,2680,2654,26
1,3,8,7,5,2623,2709,-86
1,3,9,7,5,2587,2836,-249
1,3,10,7,5,2565,2984,-419
1,3,11,7,5,2595,3105,-510
1,3,12,7,5,2654,3244,-590
1,3,13,7,5,2709,3427,-718
1,3,14,7,5,2836,3589,-753
1,4,0,7,5,3440,3080,360
1,4,1,7,5,3261,3017,244
1,4,2,7,5,3131,2973,158
1,4,3,7,5,3071,2937,134
1,4,4,7,5,3122,2900,222
1,4,5,7,5,3080,2878,202
1,4,6,7,5,3017,2904,113
1,4,7,7,5,2973,2962,11
1,4,8,7,5,2937,3004,-67
1,4,9,7,5,2900,3057,-157
1,4,10,7,5,2878,3145,-267
1,4,11,7,5,2904,3212,-308
1,4,12,7,5,2962,3274,-312
1,4,13,7,5,3004,3395,-391
1,4,14,7,5,3057,3557,-500
1,5,0,7,5,3557,3707,-150
1,5,1,7,5,3408,3735,-327
1,5,2,7,5,3426,3695,-269
1,5,3,7,5,3544,3652,-108
1,5,4,7,5,3749,3608,141
1,5,5,7,5,3707,3596,111
1,5,6,7,5,3735,3617,118
1,5,7,7,5,3695,3725,-30
1,5,8,7,5,3652,3781,-129
1,5,9,7,5,3608,3757,-149
1,5,10,7,5,3596,3796,-200
1,5,11,7,5,3617,3820,-203
1,5,12,7,5,3725,3758,-33
1,5,13,7,5,3781,3778,3
1,5,14,7,5,3757,3886,-129
1,6,0,7,5,3722,4334,-612
1,6,1,7,5,3628,4317,-689
1,6,2,7,5,3765,4183,-418
1,6,3,7,5,4084,4021,63
1,6,4,7,5,4445,3860,585
1,6,5,7,5,4334,3843,491
1,6,6,7,5,4317,3910,407
1,6,7,7,5,4183,4164,19
1,6,8,7,5,4021,4334,-313
1,6,9,7,5,3860,4383,-523
1,6,10,7,5,3843,4499,-656
1,6,11,7,5,3910,4532,-622
1,6,12,7,5,4164,4352,-188
1,6,13,7,5,4334,4273,61
1,6,14,7,5,4383,4285,98
1,7,0,7,5,3918,4994,-1076
1,7,1,7,5,3969,4843,-874
1,7,2,7,5,4174,4630,-456
1,7,3,7,5,4667,4334,333
1,7,4,7,5,5174,4020,1154
1,7,5,7,5,4994,3995,999
1,7,6,7,5,4843,4114,729
1,7,7,7,5,4630,4516,114
1,7,8,7,5,4334,4796,-462
1,7,9,7,5,4020,4965,-945
1,7,10,7,5,3995,5184,-1189
1,7,11,7,5,4114,5208,-1094
1,7,12,7,5,4516,4937,-421
1,7,13,7,5,4796,4788,8
1,7,14,7,5,4965,4672,293
1,8,0,7,5,4218,5523,-1305
1,8,1,7,5,4444,5205,-761
1,8,2,7,5,4666,4925,-259
1,8,3,7,5,5260,4513,747
1,8,4,7,5,5835,4072,1763
1,8,5,7,5,5523,4050,1473
1,8,6,7,5,5205,4198,1007
1,8,7,7,5,4925,4748,177
1,8,8,7,5,4513,5114,-601
1,8,9,7,5,4072,5420,-1348
1,8,10,7,5,4050,5768,-1718
1,8,11,7,5,4198,5814,-1616
1,8,12,7,5,4748,5512,-764
1,8,13,7,5,5114,5358,-244
1,8,14,7,5,5420,5120,300
1,9,0,7,5,4437,5883,-1446
1,9,1,7,5,4799,5397,-598
1,9,2,7,5,5022,5045,-23
1,9,3,7,5,5746,4476,1270
1,9,4,7,5,6391,3870,2521
1,9,5,7,5,5883,3848,2035
1,9,6,7,5,5397,4030,1367
1,9,7,7,5,5045,4744,301
1,9,8,7,5,4476,5191,-715
1,9,9,7,5,3870,5669,-1799
1,9,10,7,5,3848,6199,-2351
1,9,11,7,5,4030,6273,-2243
1,9,12,7,5,4744,5920,-1176
1,9,13,7,5,5191,5794,-603
1,9,14,7,5,5669,5448,221
1,10,0,7,5,4744,6585,-1841
1,10,1,7,5,5298,5993,-695
1,10,2,7,5,5562,5613,-51
1,10,3,7,5,6461,4951,1510
1,10,4,7,5,7205,4254,2951
1,10,5,7,5,6585,4237,2348
1,10,6,7,5,5993,4452,1541
1,10,7,7,5,5613,5303,310
1,10,8,7,5,4951,5766,-815
1,10,9,7,5,4254,6291,-2037
1,10,10,7,5,4237,6920,-2683
1,10,11,7,5,4452,6978,-2526
1,10,12,7,5,5303,6538,-1235
1,10,13,7,5,5766,6349,-583
1,10,14,7,5,6291,5909,382
1,11,0,7,5,4911,6718,-1807
1,11,1,7,5,5534,6031,-497
1,11,2,7,5,5756,5610,146
1,11,3,7,5,6726,4832,1894
1,11,4,7,5,7454,4032,3422
1,11,5,7,5,6718,4009,2709
1,11,6,7,5,6031,4257,1774
1,11,7,7,5,5610,5257,353
1,11,8,7,5,4832,5774,-942
1,11,9,7,5,4032,6311,-2279
1,11,10,7,5,4009,7043,-3034
1,11,11,7,5,4257,7149,-2892
1,11,12,7,5,5257,6696,-1439
1,11,13,7,5,5774,6489,-715
1,11,14,7,5,6311,6135,176
1,12,0,7,5,4918,6257,-1339
1,12,1,7,5,5562,5447,115
1,12,2,7,5,5638,5086,552
1,12,3,7,5,6520,4326,2194
1,12,4,7,5,7083,3505,3578
1,12,5,7,5,6257,3506,2751
1,12,6,7,5,5447,3766,1681
1,12,7,7,5,5086,4685,401
1,12,8,7,5,4326,5208,-882
1,12,9,7,5,3505,5759,-2254
1,12,10,7,5,3506,6486,-2980
1,12,11,7,5,3766,6686,-2920
1,12,12,7,5,4685,6403,-1718
1,12,13,7,5,5208,6182,-974
1,12,14,7,5,5759,5926,-167
1,13,0,7,5,4901,5837,-936
1,13,1,7,5,5385,5192,193
1,13,2,7,5,5377,4988,389
1,13,3,7,5,6134,4380,1754
1,13,4,7,5,6544,3650,2894
1,13,5,7,5,5837,3646,2191
1,13,6,7,5,5192,3768,1424
1,13,7,7,5,4988,4608,380
1,13,8,7,5,4380,5074,-694
1,13,9,7,5,3650,5448,-1798
1,13,10,7,5,3646,6009,-2363
1,13,11,7,5,3768,6262,-2494
1,13,12,7,5,4608,5924,-1316
1,13,13,7,5,5074,5608,-534
1,13,14,7,5,5448,5553,-105
1,14,0,7,5,4837,5503,-666
1,14,1,7,5,5067,5115,-48
1,14,2,7,5,5045,5035,10
1,14,3,7,5,5790,4523,1267
1,14,4,7,5,6088,3848,2240
1,14,5,7,5,5503,3805,1698
1,14,6,7,5,5115,3798,1317
1,14,7,7,5,5035,4500,535
1,14,8,7,5,4523,4827,-304
1,14,9,7,5,3848,4981,-1133
1,14,10,7,5,3805,5413,-1608
1,14,11,7,5,3798,5734,-1936
1,14,12,7,5,4500,5364,-864
1,14,13,7,5,4827,5003,-176
1,14,14,7,5,4981,5195,-214
1,15,0,7,5,4764,4899,-135
1,15,1,7,5,4721,4632,89
1,15,2,7,5,4711,4588,123
1,15,3,7,5,5335,4202,1133
1,15,4,7,5,5429,3542,1887
1,15,5,7,5,4899,3478,1421
1,15,6,7,5,4632,3472,1160
1,15,7,7,5,4588,4025,563
1,15,8,7,5,4202,4263,-61
1,15,9,7,5,3542,4318,-776
1,15,10,7,5,3478,4701,-1223
1,15,11,7,5,3472,5070,-1598
1,15,12,7,5,4025,4792,-767
1,15,13,7,5,4263,4436,-173
1,15,14,7,5,4318,4822,-504
1,16,0,7,5,4423,4304,119
1,16,1,7,5,4216,4202,14
1,16,2,7,5,4182,4244,-62
1,16,3,7,5,4695,4011,684
1,16,4,7,5,4701,3429,1272
1,16,5,7,5,4304,3346,958
1,16,6,7,5,4202,3326,876
1,16,7,7,5,4244,3769,475
1,16,8,7,5,4011,3895,116
1,16,9,7,5,3429,3732,-303
1,16,10,7,5,3346,4003,-657
1,16,11,7,5,3326,4333,-1007
1,16,12,7,5,3769,4054,-285
1,16,13,7,5,3895,3667,228
1,16,14,7,5,3732,4195,-463
1,17,0,7,5,4160,3748,412
1,17,1,7,5,3766,3768,-2
1,17,2,7,5,3695,3858,-163
1,17,3,7,5,4061,3798,263
1,17,4,7,5,4004,3307,697
1,17,5,7,5,3748,3227,521
1,17,6,7,5,3768,3189,579
1,17,7,7,5,3858,3519,339
1,17,8,7,5,3798,3537,261
1,17,9,7,5,3307,3249,58
1,17,10,7,5,3227,3379,-152
1,17,11,7,5,3189,3687,-498
1,17,12,7,5,3519,3420,99
1,17,13,7,5,3537,3093,444
1,17,14,7,5,3249,3675,-426
1,0,0,8,5,4321,3633,688
1,0,1,8,5,4219,3485,734
1,0,2,8,5,4017,3400,617
1,0,3,8,5,3883,3326,557
1,0,4,8,5,3781,3295,486
1,0,5,8,5,3633,3281,352
1,0,6,8,5,3485,3287,198
1,0,7,8,5,3400,3344,56
1,0,8,8,5,3326,3394,-68
1,0,9,8,5,3295,3516,-221
1,0,10,8,5,3281,3687,-406
1,0,11,8,5,3287,3828,-541
1,0,12,8,5,3344,3966,-622
1,0,13,8,5,3394,4172,-778
1,0,14,8,5,3516,4274,-758
1,1,0,8,5,4328,3717,611
1,1,1,8,5,4193,3614,579
1,1,2,8,5,3988,3533,455
1,1,3,8,5,3844,3488,356
1,1,4,8,5,3785,3477,308
1,1,5,8,5,3717,3465,252
1,1,6,8,5,3614,3476,138
1,1,7,8,5,3533,3534,-1
1,1,8,8,5,3488,3569,-81
1,1,9,8,5,3477,3667,-190
1,1,10,8,5,3465,3789,-324
1,1,11,8,5,3476,3898,-422
1,1,12,8,5,3534,4025,-491
1,1,13,8,5,3569,4211,-642
1,1,14,8,5,3667,4323,-656
1,2,0,8,5,4114,3457,657
1,2,1,8,5,3926,3332,594
1,2,2,8,5,3705,3242,463
1,2,3,8,5,3559,3173,386
1,2,4,8,5,3519,3130,389
1,2,5,8,5,3457,3105,352
1,2,6,8,5,3332,3137,195
1,2,7,8,5,3242,3206,36
1,2,8,8,5,3173,3264,-91
1,2,9,8,5,3130,3392,-262
1,2,10,8,5,3105,3537,-432
1,2,11,8,5,3137,3650,-513
1,2,12,8,5,3206,3782,-576
1,2,13,8,5,3264,3971,-707
1,2,14,8,5,3392,4130,-738
1,3,0,8,5,3996,3563,433
1,3,1,8,5,3820,3451,369
1,3,2,8,5,3685,3358,327
1,3,3,8,5,3630,3269,361
1,3,4,8,5,3648,3223,425
1,3,5,8,5,3563,3197,366
1,3,6,8,5,3451,3224,227
1,3,7,8,5,3358,3309,49
1,3,8,8,5,3269,3388,-119
1,3,9,8,5,3223,3495,-272
1,3,10,8,5,3197,3639,-442
1,3,11,8,5,3224,3746,-522
1,3,12,8,5,3309,3822,-513
1,3,13,8,5,3388,3955,-567
1,3,14,8,5,3495,4111,-616
1,4,0,8,5,4145,4102,43
1,4,1,8,5,4002,4058,-56
1,4,2,8,5,3995,3969,26
1,4,3,8,5,4075,3894,181
1,4,4,8,5,4219,3841,378
1,4,5,8,5,4102,3825,277
1,4,6,8,5,4058,3846,212
1,4,7,8,5,3969,3968,1
1,4,8,8,5,3894,4055,-161
1,4,9,8,5,3841,4092,-251
1,4,10,8,5,3825,4207,-382
1,4,11,8,5,3846,4298,-452
1,4,12,8,5,3968,4287,-319
1,4,13,8,5,4055,4345,-290
1,4,14,8,5,4092,4457,-365
1,5,0,8,5,4322,4688,-366
1,5,1,8,5,4223,4629,-406
1,5,2,8,5,4307,4491,-184
1,5,3,8,5,4545,4355,190
1,5,4,8,5,4856,4190,666
1,5,5,8,5,4688,4170,518
1,5,6,8,5,4629,4236,393
1,5,7,8,5,4491,4480,11
1,5,8,8,5,4355,4643,-288
1,5,9,8,5,4190,4708,-518
1,5,10,8,5,4170,4866,-696
1,5,11,8,5,4236,4949,-713
1,5,12,8,5,4480,4833,-353
1,5,13,8,5,4643,4814,-171
1,5,14,8,5,4708,4853,-145
1,6,0,8,5,4447,5339,-892
1,6,1,8,5,4460,5175,-715
1,6,2,8,5,4608,4964,-356
1,6,3,8,5,5050,4679,371
1,6,4,8,5,5537,4365,1172
1,6,5,8,5,5339,4339,1000
1,6,6,8,5,5175,4457,718
1,6,7,8,5,4964,4867,97
1,6,8,8,5,4679,5144,-465
1,6,9,8,5,4365,5315,-950
1,6,10,8,5,4339,5553,-1214
1,6,11,8,5,4457,5606,-1149
1,6,12,8,5,4867,5365,-498
1,6,13,8,5,5144,5266,-122
1,6,14,8,5,5315,5194,121
1,7,0,8,5,4652,5958,-1306
1,7,1,8,5,4805,5680,-875
1,7,2,8,5,4984,5417,-433
1,7,3,8,5,5593,4999,594
1,7,4,8,5,6214,4561,1653
1,7,5,8,5,5958,4540,1418
1,7,6,8,5,5680,4687,993
1,7,7,8,5,5417,5237,180
1,7,8,8,5,4999,5588,-589
1,7,9,8,5,4561,5875,-1314
1,7,10,8,5,4540,6203,-1663
1,7,11,8,5,4687,6225,-1538
1,7,12,8,5,5237,5908,-671
1,7,13,8,5,5588,5780,-192
1,7,14,8,5,5875,5588,287
1,8,0,8,5,4966,6495,-1529
1,8,1,8,5,5296,6045,-749
1,8,2,8,5,5513,5695,-182
1,8,3,8,5,6237,5151,1086
1,8,4,8,5,6931,4564,2367
1,8,5,8,5,6495,4545,1950
1,8,6,8,5,6045,4735,1310
1,8,7,8,5,5695,5446,249
1,8,8,8,5,5151,5878,-727
1,8,9,8,5,4564,6339,-1775
1,8,10,8,5,4545,6824,-2279
1,8,11,8,5,4735,6859,-2124
1,8,12,8,5,5446,6500,-1054
1,8,13,8,5,5878,6361,-483
1,8,14,8,5,6339,6017,322
1,9,0,8,5,5072,6856,-1784
1,9,1,8,5,5575,6238,-663
1,9,2,8,5,5814,5850,-36
1,9,3,8,5,6711,5160,1551
1,9,4,8,5,7476,4427,3049
1,9,5,8,5,6856,4396,2460
1,9,6,8,5,6238,4635,1603
1,9,7,8,5,5850,5509,341
1,9,8,8,5,5160,5999,-839
1,9,9,8,5,4427,6554,-2127
1,9,10,8,5,4396,7203,-2807
1,9,11,8,5,4635,7259,-2624
1,9,12,8,5,5509,6820,-1311
1,9,13,8,5,5999,6641,-642
1,9,14,8,5,6554,6246,308
1,10,0,8,5,5343,7386,-2043
1,10,1,8,5,5980,6713,-733
1,10,2,8,5,6281,6288,-7
1,10,3,8,5,7348,5478,1870
1,10,4,8,5,8142,4668,3474
1,10,5,8,5,7386,4641,2745
1,10,6,8,5,6713,4886,1827
1,10,7,8,5,6288,5912,376
1,10,8,8,5,5478,6453,-975
1,10,9,8,5,4668,6970,-2302
1,10,10,8,5,4641,7698,-3057
1,10,11,8,5,4886,7790,-2904
1,10,12,8,5,5912,7274,-1362
1,10,13,8,5,6453,7017,-564
1,10,14,8,5,6970,6657,313
1,11,0,8,5,5623,7279,-1656
1,11,1,8,5,6303,6488,-185
1,11,2,8,5,6502,6082,420
1,11,3,8,5,7524,5283,2241
1,11,4,8,5,8180,4446,3734
1,11,5,8,5,7279,4453,2826
1,11,6,8,5,6488,4708,1780
1,11,7,8,5,6082,5691,391
1,11,8,8,5,5283,6259,-976
1,11,9,8,5,4446,6794,-2348
1,11,10,8,5,4453,7548,-3095
1,11,11,8,5,4708,7772,-3064
1,11,12,8,5,5691,7416,-1725
1,11,13,8,5,6259,7132,-873
1,11,14,8,5,6794,6826,-32
1,12,0,8,5,5666,6818,-1152
1,12,1,8,5,6200,6086,114
1,12,2,8,5,6258,5784,474
1,12,3,8,5,7135,5083,2052
1,12,4,8,5,7651,4232,3419
1,12,5,8,5,6818,4220,2598
1,12,6,8,5,6086,4387,1699
1,12,7,8,5,5784,5363,421
1,12,8,8,5,5083,5936,-853
1,12,9,8,5,4232,6399,-2167
1,12,10,8,5,4220,7079,-2859
1,12,11,8,5,4387,7391,-3004
1,12,12,8,5,5363,6999,-1636
1,12,13,8,5,5936,6644,-708
1,12,14,8,5,6399,6520,-121
1,13,0,8,5,5562,6508,-946
1,13,1,8,5,5899,5973,-74
1,13,2,8,5,5888,5816,72
1,13,3,8,5,6756,5181,1575
1,13,4,8,5,7180,4353,2827
1,13,5,8,5,6508,4301,2207
1,13,6,8,5,5973,4345,1628
1,13,7,8,5,5816,5203,613
1,13,8,8,5,5181,5637,-456
1,13,9,8,5,4353,5913,-1560
1,13,10,8,5,4301,6467,-2166
1,13,11,8,5,4345,6808,-2463
1,13,12,8,5,5203,6377,-1174
1,13,13,8,5,5637,5996,-359
1,13,14,8,5,5913,6104,-191
1,14,0,8,5,5498,5863,-365
1,14,1,8,5,5557,5469,88
1,14,2,8,5,5521,5375,146
1,14,3,8,5,6261,4867,1394
1,14,4,8,5,6469,4083,2386
1,14,5,8,5,5863,4023,1840
1,14,6,8,5,5469,4045,1424
1,14,7,8,5,5375,4746,629
1,14,8,8,5,4867,5055,-188
1,14,9,8,5,4083,5228,-1145
1,14,10,8,5,4023,5720,-1697
1,14,11,8,5,4045,6087,-2042
1,14,12,8,5,4746,5763,-1017
1,14,13,8,5,5055,5428,-373
1,14,14,8,5,5228,5738,-510
1,15,0,8,5,5171,5276,-105
1,15,1,8,5,5068,5042,26
1,15,2,8,5,5029,5014,15
1,15,3,8,5,5672,4649,1023
1,15,4,8,5,5797,3921,1876
1,15,5,8,5,5276,3841,1435
1,15,6,8,5,5042,3863,1179
1,15,7,8,5,5014,4467,547
1,15,8,8,5,4649,4659,-10
1,15,9,8,5,3921,4651,-730
1,15,10,8,5,3841,5059,-1218
1,15,11,8,5,3863,5378,-1515
1,15,12,8,5,4467,5042,-575
1,15,13,8,5,4659,4670,-11
1,15,14,8,5,4651,5092,-441
1,16,0,8,5,4795,4721,74
1,16,1,8,5,4542,4609,-67
1,16,2,8,5,4487,4663,-176
1,16,3,8,5,5026,4482,544
1,16,4,8,5,5089,3864,1225
1,16,5,8,5,4721,3775,946
1,16,6,8,5,4609,3794,815
1,16,7,8,5,4663,4284,379
1,16,8,8,5,4482,4345,137
1,16,9,8,5,3864,4134,-270
1,16,10,8,5,3775,4383,-608
1,16,11,8,5,3794,4673,-879
1,16,12,8,5,4284,4320,-36
1,16,13,8,5,4345,3940,405
1,16,14,8,5,4134,4473,-339
1,0,0,9,5,4850,4245,605
1,0,1,9,5,4716,4133,583
1,0,2,9,5,4508,4050,458
1,0,3,9,5,4374,4001,373
1,0,4,9,5,4321,3989,332
1,0,5,9,5,4245,3978,267
1,0,6,9,5,4133,3992,141
1,0,7,9,5,4050,4046,4
1,0,8,9,5,4001,4081,-80
1,0,9,9,5,3989,4186,-197
1,0,10,9,5,3978,4312,-334
1,0,11,9,5,3992,4414,-422
1,0,12,9,5,4046,4546,-500
1,0,13,9,5,4081,4739,-658
1,0,14,9,5,4186,4843,-657
1,1,0,9,5,4656,3988,668
1,1,1,9,5,4470,3859,611
1,1,2,9,5,4240,3770,470
1,1,3,9,5,4094,3697,397
1,1,4,9,5,4056,3650,406
1,1,5,9,5,3988,3624,364
1,1,6,9,5,3859,3659,200
1,1,7,9,5,3770,3740,30
1,1,8,9,5,3697,3802,-105
1,1,9,9,5,3650,3930,-280
1,1,10,9,5,3624,4072,-448
1,1,11,9,5,3659,4179,-520
1,1,12,9,5,3740,4307,-567
1,1,13,9,5,3802,4503,-701
1,1,14,9,5,3930,4660,-730
1,2,0,9,5,4546,4125,421
1,2,1,9,5,4372,4014,358
1,2,2,9,5,4230,3920,310
1,2,3,9,5,4181,3819,362
1,2,4,9,5,4207,3766,441
1,2,5,9,5,4125,3737,388
1,2,6,9,5,4014,3766,248
1,2,7,9,5,3920,3861,59
1,2,8,9,5,3819,3943,-124
1,2,9,9,5,3766,4051,-285
1,2,10,9,5,3737,4192,-455
1,2,11,9,5,3766,4291,-525
1,2,12,9,5,3861,4360,-499
1,2,13,9,5,3943,4499,-556
1,2,14,9,5,4051,4652,-601
1,3,0,9,5,4701,4585,116
1,3,1,9,5,4561,4492,69
1,3,2,9,5,4549,4354,195
1,3,3,9,5,4634,4226,408
1,3,4,9,5,4745,4164,581
1,3,5,9,5,4585,4144,441
1,3,6,9,5,4492,4166,326
1,3,7,9,5,4354,4315,39
1,3,8,9,5,4226,4439,-213
1,3,9,9,5,4164,4530,-366
1,3,10,9,5,4144,4701,-557
1,3,11,9,5,4166,4832,-666
1,3,12,9,5,4315,4835,-520
1,3,13,9,5,4439,4905,-466
1,3,14,9,5,4530,5011,-481
1,4,0,9,5,4910,5083,-173
1,4,1,9,5,4817,4952,-135
1,4,2,9,5,4876,4765,111
1,4,3,9,5,5076,4597,479
1,4,4,9,5,5326,4423,903
1,4,5,9,5,5083,4399,684
1,4,6,9,5,4952,4465,487
1,4,7,9,5,4765,4723,42
1,4,8,9,5,4597,4917,-320
1,4,9,9,5,4423,5043,-620
1,4,10,9,5,4399,5277,-878
1,4,11,9,5,4465,5427,-962
1,4,12,9,5,4723,5362,-639
1,4,13,9,5,4917,5381,-464
1,4,14,9,5,5043,5424,-381
1,5,0,9,5,5047,5693,-646
1,5,1,9,5,5055,5487,-432
1,5,2,9,5,5150,5272,-122
1,5,3,9,5,5511,5013,498
1,5,4,9,5,5948,4695,1253
1,5,5,9,5,5693,4666,1027
1,5,6,9,5,5487,4783,704
1,5,7,9,5,5272,5183,89
1,5,8,9,5,5013,5453,-440
1,5,9,9,5,4695,5640,-945
1,5,10,9,5,4666,5920,-1254
1,5,11,9,5,4783,6023,-1240
1,5,12,9,5,5183,5846,-663
1,5,13,9,5,5453,5807,-354
1,5,14,9,5,5640,5762,-122
1,6,0,9,5,5181,6303,-1122
1,6,1,9,5,5296,6012,-716
1,6,2,9,5,5418,5751,-333
1,6,3,9,5,5976,5344,632
1,6,4,9,5,6577,4906,1671
1,6,5,9,5,6303,4884,1419
1,6,6,9,5,6012,5030,982
1,6,7,9,5,5751,5588,163
1,6,8,9,5,5344,5936,-592
1,6,9,9,5,4906,6225,-1319
1,6,10,9,5,4884,6572,-1688
1,6,11,9,5,5030,6623,-1593
1,6,12,9,5,5588,6336,-748
1,6,13,9,5,5936,6258,-322
1,6,14,9,5,6225,6110,115
1,7,0,9,5,5400,6930,-1530
1,7,1,9,5,5657,6520,-863
1,7,2,9,5,5831,6187,-356
1,7,3,9,5,6570,5637,933
1,7,4,9,5,7310,5053,2257
1,7,5,9,5,6930,5035,1895
1,7,6,9,5,6520,5224,1296
1,7,7,9,5,6187,5935,252
1,7,8,9,5,5637,6352,-715
1,7,9,9,5,5053,6794,-1741
1,7,10,9,5,5035,7259,-2224
1,7,11,9,5,5224,7270,-2046
1,7,12,9,5,5935,6896,-961
1,7,13,9,5,6352,6783,-431
1,7,14,9,5,6794,6485,309
1,8,0,9,5,5601,7468,-1867
1,8,1,9,5,6072,6886,-814
1,8,2,9,5,6305,6500,-195
1,8,3,9,5,7202,5835,1367
1,8,4,9,5,8016,5121,2895
1,8,5,9,5,7468,5093,2375
1,8,6,9,5,6886,5340,1546
1,8,7,9,5,6500,6211,289
1,8,8,9,5,5835,6686,-851
1,8,9,9,5,5121,7224,-2103
1,8,10,9,5,5093,7828,-2735
1,8,11,9,5,5340,7845,-2505
1,8,12,9,5,6211,7400,-1189
1,8,13,9,5,6686,7208,-522
1,8,14,9,5,7224,6815,409
1,9,0,9,5,5671,7657,-1986
1,9,1,9,5,6257,6958,-701
1,9,2,9,5,6533,6525,8
1,9,3,9,5,7598,5687,1911
1,9,4,9,5,8413,4841,3572
1,9,5,9,5,7657,4800,2857
1,9,6,9,5,6958,5069,1889
1,9,7,9,5,6525,6118,407
1,9,8,9,5,5687,6686,-999
1,9,9,9,5,4841,7233,-2392
1,9,10,9,5,4800,7981,-3181
1,9,11,9,5,5069,8071,-3002
1,9,12,9,5,6118,7556,-1438
1,9,13,9,5,6686,7309,-623
1,9,14,9,5,7233,6994,239
1,10,0,9,5,6055,7947,-1892
1,10,1,9,5,6749,7170,-421
1,10,2,9,5,7027,6760,267
1,10,3,9,5,8146,5929,2217
1,10,4,9,5,8868,5082,3786
1,10,5,9,5,7947,5085,2862
1,10,6,9,5,7170,5337,1833
1,10,7,9,5,6760,6346,414
1,10,8,9,5,5929,6938,-1009
1,10,9,9,5,5082,7453,-2371
1,10,10,9,5,5085,8203,-3118
1,10,11,9,5,5337,8413,-3076
1,10,12,9,5,6346,7994,-1648
1,10,13,9,5,6938,7660,-722
1,10,14,9,5,7453,7348,105
1,11,0,9,5,6371,7840,-1469
1,11,1,9,5,6941,7127,-186
1,11,2,9,5,7122,6780,342
1,11,3,9,5,8139,6040,2099
1,11,4,9,5,8748,5173,3575
1,11,5,9,5,7840,5167,2673
1,11,6,9,5,7127,5329,1798
1,11,7,9,5,6780,6369,411
1,11,8,9,5,6040,6987,-947
1,11,9,9,5,5173,7434,-2261
1,11,10,9,5,5167,8141,-2974
1,11,11,9,5,5329,8477,-3148
1,11,12,9,5,6369,8012,-1643
1,11,13,9,5,6987,7594,-607
1,11,14,9,5,7434,7420,14
1,12,0,9,5,6327,7489,-1162
1,12,1,9,5,6714,6867,-153
1,12,2,9,5,6769,6612,157
1,12,3,9,5,7757,5884,1873
1,12,4,9,5,8287,4935,3352
1,12,5,9,5,7489,4875,2614
1,12,6,9,5,6867,4964,1903
1,12,7,9,5,6612,5958,654
1,12,8,9,5,5884,6499,-615
1,12,9,9,5,4935,6864,-1929
1,12,10,9,5,4875,7537,-2662
1,12,11,9,5,4964,7937,-2973
1,12,12,9,5,5958,7452,-1494
1,12,13,9,5,6499,7032,-533
1,12,14,9,5,6864,7071,-207
1,13,0,9,5,6223,6868,-645
1,13,1,9,5,6389,6327,62
1,13,2,9,5,6364,6156,208
1,13,3,9,5,7227,5525,1702
1,13,4,9,5,7561,4588,2973
1,13,5,9,5,6868,4519,2349
1,13,6,9,5,6327,4592,1735
1,13,7,9,5,6156,5449,707
1,13,8,9,5,5525,5865,-340
1,13,9,9,5,4588,6160,-1572
1,13,10,9,5,4519,6774,-2255
1,13,11,9,5,4592,7161,-2569
1,13,12,9,5,5449,6776,-1327
1,13,13,9,5,5865,6421,-556
1,13,14,9,5,6160,6647,-487
1,14,0,9,5,5905,6240,-335
1,14,1,9,5,5904,5879,25
1,14,2,9,5,5839,5801,38
1,14,3,9,5,6598,5314,1284
1,14,4,9,5,6837,4462,2375
1,14,5,9,5,6240,4386,1854
1,14,6,9,5,5879,4436,1443
1,14,7,9,5,5801,5188,613
1,14,8,9,5,5314,5451,-137
1,14,9,9,5,4462,5561,-1099
1,14,10,9,5,4386,6078,-1692
1,14,11,9,5,4436,6395,-1959
1,14,12,9,5,5188,6013,-825
1,14,13,9,5,5451,5662,-211
1,14,14,9,5,5561,6008,-447
1,15,0,9,5,5543,5693,-150
1,15,1,9,5,5394,5449,-55
1,15,2,9,5,5334,5433,-99
1,15,3,9,5,6003,5120,883
1,15,4,9,5,6185,4356,1829
1,15,5,9,5,5693,4270,1423
1,15,6,9,5,5449,4331,1118
1,15,7,9,5,5433,4982,451
1,15,8,9,5,5120,5109,11
1,15,9,9,5,4356,5053,-697
1,15,10,9,5,4270,5439,-1169
1,15,11,9,5,4331,5718,-1387
1,15,12,9,5,4982,5308,-326
1,15,13,9,5,5109,4943,166
1,15,14,9,5,5053,5370,-317
1,0,0,10,5,5178,4516,662
1,0,1,10,5,4993,4378,615
1,0,2,10,5,4760,4287,473
1,0,3,10,5,4624,4210,414
1,0,4,10,5,4592,4162,430
1,0,5,10,5,4516,4137,379
1,0,6,10,5,4378,4175,203
1,0,7,10,5,4287,4252,35
1,0,8,10,5,4210,4314,-104
1,0,9,10,5,4162,4449,-287
1,0,10,10,5,4137,4595,-458
1,0,11,10,5,4175,4695,-520
1,0,12,10,5,4252,4828,-576
1,0,13,10,5,4314,5031,-717
1,0,14,10,5,4449,5180,-731
1,1,0,10,5,5088,4656,432
1,1,1,10,5,4916,4541,375
1,1,2,10,5,4765,4448,317
1,1,3,10,5,4716,4343,373
1,1,4,10,5,4744,4286,458
1,1,5,10,5,4656,4256,400
1,1,6,10,5,4541,4288,253
1,1,7,10,5,4448,4395,53
1,1,8,10,5,4343,4481,-138
1,1,9,10,5,4286,4589,-303
1,1,10,10,5,4256,4727,-471
1,1,11,10,5,4288,4820,-532
1,1,12,10,5,4395,4885,-490
1,1,13,10,5,4481,5031,-550
1,1,14,10,5,4589,5182,-593
1,2,0,10,5,5251,5147,104
1,2,1,10,5,5113,5055,58
1,2,2,10,5,5094,4916,178
1,2,3,10,5,5185,4776,409
1,2,4,10,5,5304,4707,597
1,2,5,10,5,5147,4684,463
1,2,6,10,5,5055,4708,347
1,2,7,10,5,4916,4867,49
1,2,8,10,5,4776,4994,-218
1,2,9,10,5,4707,5086,-379
1,2,10,10,5,4684,5254,-570
1,2,11,10,5,4708,5377,-669
1,2,12,10,5,4867,5373,-506
1,2,13,10,5,4994,5449,-455
1,2,14,10,5,5086,5552,-466
1,3,0,10,5,5466,5566,-100
1,3,1,10,5,5376,5386,-10
1,3,2,10,5,5430,5150,280
1,3,3,10,5,5635,4929,706
1,3,4,10,5,5852,4746,1106
1,3,5,10,5,5566,4718,848
1,3,6,10,5,5386,4785,601
1,3,7,10,5,5150,5070,80
1,3,8,10,5,4929,5301,-372
1,3,9,10,5,4746,5481,-735
1,3,10,10,5,4718,5771,-1053
1,3,11,10,5,4785,5961,-1176
1,3,12,10,5,5070,5910,-840
1,3,13,10,5,5301,5941,-640
1,3,14,10,5,5481,5978,-497
1,4,0,10,5,5635,6088,-453
1,4,1,10,5,5649,5810,-161
1,4,2,10,5,5719,5546,173
1,4,3,10,5,6042,5255,787
1,4,4,10,5,6418,4928,1490
1,4,5,10,5,6088,4895,1193
1,4,6,10,5,5810,5012,798
1,4,7,10,5,5546,5426,120
1,4,8,10,5,5255,5727,-472
1,4,9,10,5,4928,5975,-1047
1,4,10,10,5,4895,6331,-1436
1,4,11,10,5,5012,6501,-1489
1,4,12,10,5,5426,6375,-949
1,4,13,10,5,5727,6374,-647
1,4,14,10,5,5975,6333,-358
1,5,0,10,5,5781,6657,-876
1,5,1,10,5,5891,6324,-433
1,5,2,10,5,5960,6059,-99
1,5,3,10,5,6437,5678,759
1,5,4,10,5,6988,5236,1752
1,5,5,10,5,6657,5211,1446
1,5,6,10,5,6324,5356,968
1,5,7,10,5,6059,5904,155
1,5,8,10,5,5678,6245,-567
1,5,9,10,5,5236,6550,-1314
1,5,10,10,5,5211,6939,-1728
1,5,11,10,5,5356,7040,-1684
1,5,12,10,5,5904,6817,-913
1,5,13,10,5,6245,6799,-554
1,5,14,10,5,6550,6678,-128
1,6,0,10,5,5929,7275,-1346
1,6,1,10,5,6148,6852,-704
1,6,2,10,5,6265,6521,-256
1,6,3,10,5,6953,5982,971
1,6,4,10,5,7673,5398,2275
1,6,5,10,5,7275,5379,1896
1,6,6,10,5,6852,5567,1285
1,6,7,10,5,6521,6286,235
1,6,8,10,5,5982,6700,-718
1,6,9,10,5,5398,7144,-1746
1,6,10,10,5,5379,7628,-2249
1,6,11,10,5,5567,7668,-2101
1,6,12,10,5,6286,7324,-1038
1,6,13,10,5,6700,7261,-561
1,6,14,10,5,7144,7007,137
1,7,0,10,5,6035,7903,-1868
1,7,1,10,5,6433,7361,-928
1,7,2,10,5,6623,6992,-369
1,7,3,10,5,7535,6321,1214
1,7,4,10,5,8395,5610,2785
1,7,5,10,5,7903,5583,2320
1,7,6,10,5,7361,5829,1532
1,7,7,10,5,6992,6700,292
1,7,8,10,5,6321,7160,-839
1,7,9,10,5,5610,7679,-2069
1,7,10,10,5,5583,8263,-2680
1,7,11,10,5,5829,8256,-2427
1,7,12,10,5,6700,7796,-1096
1,7,13,10,5,7160,7630,-470
1,7,14,10,5,7679,7283,396
1,8,0,10,5,6200,8269,-2069
1,8,1,10,5,6754,7606,-852
1,8,2,10,5,7024,7175,-151
1,8,3,10,5,8089,6362,1727
1,8,4,10,5,8953,5535,3418
1,8,5,10,5,8269,5497,2772
1,8,6,10,5,7606,5774,1832
1,8,7,10,5,7175,6820,355
1,8,8,10,5,6362,7373,-1011
1,8,9,10,5,5535,7903,-2368
1,8,10,10,5,5497,8606,-3109
1,8,11,10,5,5774,8657,-2883
1,8,12,10,5,6820,8136,-1316
1,8,13,10,5,7373,7876,-503
1,8,14,10,5,7903,7563,340
1,9,0,10,5,6383,8218,-1835
1,9,1,10,5,7026,7415,-389
1,9,2,10,5,7279,6997,282
1,9,3,10,5,8396,6138,2258
1,9,4,10,5,9139,5255,3884
1,9,5,10,5,8218,5244,2974
1,9,6,10,5,7415,5520,1895
1,9,7,10,5,6997,6552,445
1,9,8,10,5,6138,7171,-1033
1,9,9,10,5,5255,7716,-2461
1,9,10,10,5,5244,8486,-3242
1,9,11,10,5,5520,8694,-3174
1,9,12,10,5,6552,8276,-1724
1,9,13,10,5,7171,7952,-781
1,9,14,10,5,7716,7685,31
1,10,0,10,5,6803,8508,-1705
1,10,1,10,5,7387,7809,-422
1,10,2,10,5,7647,7458,189
1,10,3,10,5,8761,6686,2075
1,10,4,10,5,9436,5809,3627
1,10,5,10,5,8508,5799,2709
1,10,6,10,5,7809,5958,1851
1,10,7,10,5,7458,7024,434
1,10,8,10,5,6686,7666,-980
1,10,9,10,5,5809,8093,-2284
1,10,10,10,5,5799,8796,-2997
1,10,11,10,5,5958,9118,-3160
1,10,12,10,5,7024,8590,-1566
1,10,13,10,5,7666,8122,-456
1,10,14,10,5,8093,7942,151
1,11,0,10,5,7032,8511,-1479
1,11,1,10,5,7455,7908,-453
1,11,2,10,5,7633,7608,25
1,11,3,10,5,8761,6841,1920
1,11,4,10,5,9384,5876,3508
1,11,5,10,5,8511,5822,2689
1,11,6,10,5,7908,5906,2002
1,11,7,10,5,7608,6964,644
1,11,8,10,5,6841,7550,-709
1,11,9,10,5,5876,7899,-2023
1,11,10,10,5,5822,8599,-2777
1,11,11,10,5,5906,9023,-3117
1,11,12,10,5,6964,8465,-1501
1,11,13,10,5,7550,7982,-432
1,11,14,10,5,7899,7971,-72
1,12,0,10,5,6988,7849,-861
1,12,1,10,5,7204,7221,-17
1,12,2,10,5,7245,6952,293
1,12,3,10,5,8228,6228,2000
1,12,4,10,5,8668,5170,3498
1,12,5,10,5,7849,5093,2756
1,12,6,10,5,7221,5211,2010
1,12,7,10,5,6952,6204,748
1,12,8,10,5,6228,6727,-499
1,12,9,10,5,5170,7111,-1941
1,12,10,10,5,5093,7844,-2751
1,12,11,10,5,5211,8290,-3079
1,12,12,10,5,6204,7851,-1647
1,12,13,10,5,6727,7457,-730
1,12,14,10,5,7111,7614,-503
1,13,0,10,5,6630,7245,-615
1,13,1,10,5,6736,6737,-1
1,13,2,10,5,6682,6582,100
1,13,3,10,5,7564,5972,1592
1,13,4,10,5,7929,4967,2962
1,13,5,10,5,7245,4882,2363
1,13,6,10,5,6737,4983,1754
1,13,7,10,5,6582,5891,691
1,13,8,10,5,5972,6261,-289
1,13,9,10,5,4967,6493,-1526
1,13,10,10,5,4882,7132,-2250
1,13,11,10,5,4983,7469,-2486
1,13,12,10,5,5891,7026,-1135
1,13,13,10,5,6261,6655,-394
1,13,14,10,5,6493,6917,-424
1,14,0,10,5,6277,6657,-380
1,14,1,10,5,6230,6286,-56
1,14,2,10,5,6144,6220,-76
1,14,3,10,5,6929,5785,1144
1,14,4,10,5,7225,4897,2328
1,14,5,10,5,6657,4815,1842
1,14,6,10,5,6286,4904,1382
1,14,7,10,5,6220,5703,517
1,14,8,10,5,5785,5901,-116
1,14,9,10,5,4897,5963,-1066
1,14,10,10,5,4815,6458,-1643
1,14,11,10,5,4904,6735,-1831
1,14,12,10,5,5703,6279,-576
1,14,13,10,5,5901,5935,-34
1,14,14,10,5,5963,6286,-323
1,0,0,11,5,5610,5184,426
1,0,1,11,5,5439,5060,379
1,0,2,11,5,5285,4965,320
1,0,3,11,5,5246,4856,390
1,0,4,11,5,5280,4798,482
1,0,5,11,5,5184,4769,415
1,0,6,11,5,5060,4804,256
1,0,7,11,5,4965,4907,58
1,0,8,11,5,4856,4993,-137
1,0,9,11,5,4798,5108,-310
1,0,10,11,5,4769,5250,-481
1,0,11,11,5,4804,5336,-532
1,0,12,11,5,4907,5406,-499
1,0,13,11,5,4993,5559,-566
1,0,14,11,5,5108,5702,-594
1,1,0,11,5,5793,5678,115
1,1,1,11,5,5657,5582,75
1,1,2,11,5,5629,5444,185
1,1,3,11,5,5720,5300,420
1,1,4,11,5,5841,5227,614
1,1,5,11,5,5678,5203,475
1,1,6,11,5,5582,5230,352
1,1,7,11,5,5444,5401,43
1,1,8,11,5,5300,5532,-232
1,1,9,11,5,5227,5624,-397
1,1,10,11,5,5203,5789,-586
1,1,11,11,5,5230,5906,-676
1,1,12,11,5,5401,5898,-497
1,1,13,11,5,5532,5981,-449
1,1,14,11,5,5624,6082,-458
1,2,0,11,5,6016,6128,-112
1,2,1,11,5,5928,5949,-21
1,2,2,11,5,5975,5712,263
1,2,3,11,5,6186,5479,707
1,2,4,11,5,6411,5289,1122
1,2,5,11,5,6128,5258,870
1,2,6,11,5,5949,5327,622
1,2,7,11,5,5712,5622,90
1,2,8,11,5,5479,5856,-377
1,2,9,11,5,5289,6037,-748
1,2,10,11,5,5258,6324,-1066
1,2,11,11,5,5327,6506,-1179
1,2,12,11,5,5622,6448,-826
1,2,13,11,5,5856,6485,-629
1,2,14,11,5,6037,6519,-482
1,3,0,11,5,6191,6571,-380
1,3,1,11,5,6208,6244,-36
1,3,2,11,5,6273,5931,342
1,3,3,11,5,6601,5587,1014
1,3,4,11,5,6944,5251,1693
1,3,5,11,5,6571,5214,1357
1,3,6,11,5,6244,5332,912
1,3,7,11,5,5931,5773,158
1,3,8,11,5,5587,6111,-524
1,3,9,11,5,5251,6413,-1162
1,3,10,11,5,5214,6825,-1611
1,3,11,11,5,5332,7035,-1703
1,3,12,11,5,5773,6923,-1150
1,3,13,11,5,6111,6934,-823
1,3,14,11,5,6413,6887,-474
1,4,0,11,5,6369,7052,-683
1,4,1,11,5,6485,6647,-162
1,4,2,11,5,6529,6333,196
1,4,3,11,5,6968,5920,1048
1,4,4,11,5,7458,5469,1989
1,4,5,11,5,7052,5440,1612
1,4,6,11,5,6647,5585,1062
1,4,7,11,5,6333,6147,186
1,4,8,11,5,5920,6519,-599
1,4,9,11,5,5469,6885,-1416
1,4,10,11,5,5440,7350,-1910
1,4,11,11,5,5585,7518,-1933
1,4,12,11,5,6147,7346,-1199
1,4,13,11,5,6519,7366,-847
1,4,14,11,5,6885,7249,-364
1,5,0,11,5,6529,7629,-1100
1,5,1,11,5,6743,7164,-421
1,5,2,11,5,6807,6829,-22
1,5,3,11,5,7414,6316,1098
1,5,4,11,5,8084,5728,2356
1,5,5,11,5,7629,5706,1923
1,5,6,11,5,7164,5893,1271
1,5,7,11,5,6829,6602,227
1,5,8,11,5,6316,7009,-693
1,5,9,11,5,5728,7469,-1741
1,5,10,11,5,5706,7995,-2289
1,5,11,11,5,5893,8085,-2192
1,5,12,11,5,6602,7805,-1203
1,5,13,11,5,7009,7802,-793
1,5,14,11,5,7469,7575,-106
1,6,0,11,5,6564,8248,-1684
1,6,1,11,5,6924,7693,-769
1,6,2,11,5,7057,7326,-269
1,6,3,11,5,7918,6666,1252
1,6,4,11,5,8758,5955,2803
1,6,5,11,5,8248,5927,2321
1,6,6,11,5,7693,6172,1521
1,6,7,11,5,7326,7051,275
1,6,8,11,5,6666,7508,-842
1,6,9,11,5,5955,8029,-2074
1,6,10,11,5,5927,8632,-2705
1,6,11,11,5,6172,8654,-2482
1,6,12,11,5,7051,8224,-1173
1,6,13,11,5,7508,8108,-600
1,6,14,11,5,8029,7805,224
1,7,0,11,5,6634,8704,-2070
1,7,1,11,5,7115,8081,-966
1,7,2,11,5,7342,7667,-325
1,7,3,11,5,8422,6848,1574
1,7,4,11,5,9332,6024,3308
1,7,5,11,5,8704,5987,2717
1,7,6,11,5,8081,6263,1818
1,7,7,11,5,7667,7309,358
1,7,8,11,5,6848,7847,-999
1,7,9,11,5,6024,8358,-2334
1,7,10,11,5,5987,9041,-3054
1,7,11,11,5,6263,9068,-2805
1,7,12,11,5,7309,8532,-1223
1,7,13,11,5,7847,8298,-451
1,7,14,11,5,8358,8031,327
1,8,0,11,5,6912,8830,-1918
1,8,1,11,5,7523,8063,-540
1,8,2,11,5,7770,7647,123
1,8,3,11,5,8887,6813,2074
1,8,4,11,5,9679,5949,3730
1,8,5,11,5,8830,5941,2889
1,8,6,11,5,8063,6225,1838
1,8,7,11,5,7647,7254,393
1,8,8,11,5,6813,7858,-1045
1,8,9,11,5,5949,8386,-2437
1,8,10,11,5,5941,9111,-3170
1,8,11,11,5,6225,9280,-3055
1,8,12,11,5,7254,8856,-1602
1,8,13,11,5,7858,8519,-661
1,8,14,11,5,8386,8254,132
1,9,0,11,5,7131,8779,-1648
1,9,1,11,5,7664,8054,-390
1,9,2,11,5,7899,7695,204
1,9,3,11,5,9011,6895,2116
1,9,4,11,5,9707,5982,3725
1,9,5,11,5,8779,5958,2821
1,9,6,11,5,8054,6141,1913
1,9,7,11,5,7695,7230,465
1,9,8,11,5,6895,7899,-1004
1,9,9,11,5,5982,8356,-2374
1,9,10,11,5,5958,9079,-3121
1,9,11,11,5,6141,9399,-3258
1,9,12,11,5,7230,8872,-1642
1,9,13,11,5,7899,8414,-515
1,9,14,11,5,8356,8279,77
1,10,0,11,5,7464,9179,-1715
1,10,1,11,5,7901,8590,-689
1,10,2,11,5,8158,8286,-128
1,10,3,11,5,9383,7487,1896
1,10,4,11,5,10072,6512,3560
1,10,5,11,5,9179,6454,2725
1,10,6,11,5,8590,6535,2055
1,10,7,11,5,8286,7619,667
1,10,8,11,5,7487,8229,-742
1,10,9,11,5,6512,8558,-2046
1,10,10,11,5,6454,9254,-2800
1,10,11,11,5,6535,9664,-3129
1,10,12,11,5,7619,9043,-1424
1,10,13,11,5,8229,8510,-281
1,10,14,11,5,8558,8493,65
1,11,0,11,5,7693,8871,-1178
1,11,1,11,5,7945,8262,-317
1,11,2,11,5,8109,7948,161
1,11,3,11,5,9232,7185,2047
1,11,4,11,5,9765,6111,3654
1,11,5,11,5,8871,6040,2831
1,11,6,11,5,8262,6153,2109
1,11,7,11,5,7948,7210,738
1,11,8,11,5,7185,7778,-593
1,11,9,11,5,6111,8146,-2035
1,11,10,11,5,6040,8906,-2866
1,11,11,11,5,6153,9376,-3223
1,11,12,11,5,7210,8864,-1654
1,11,13,11,5,7778,8407,-629
1,11,14,11,5,8146,8514,-368
1,12,0,11,5,7395,8226,-831
1,12,1,11,5,7551,7631,-80
1,12,2,11,5,7563,7378,185
1,12,3,11,5,8565,6675,1890
1,12,4,11,5,9036,5549,3487
1,12,5,11,5,8226,5456,2770
1,12,6,11,5,7631,5602,2029
1,12,7,11,5,7378,6646,732
1,12,8,11,5,6675,7123,-448
1,12,9,11,5,5549,7444,-1895
1,12,10,11,5,5456,8202,-2746
1,12,11,11,5,5602,8598,-2996
1,12,12,11,5,6646,8101,-1455
1,12,13,11,5,7123,7691,-568
1,12,14,11,5,7444,7884,-440
1,13,0,11,5,7002,7662,-660
1,13,1,11,5,7062,7144,-82
1,13,2,11,5,6987,7001,-14
1,13,3,11,5,7895,6443,1452
1,13,4,11,5,8317,5402,2915
1,13,5,11,5,7662,5311,2351
1,13,6,11,5,7144,5451,1693
1,13,7,11,5,7001,6406,595
1,13,8,11,5,6443,6711,-268
1,13,9,11,5,5402,6895,-1493
1,13,10,11,5,5311,7512,-2201
1,13,11,11,5,5451,7809,-2358
1,13,12,11,5,6406,7292,-886
1,13,13,11,5,6711,6928,-217
1,13,14,11,5,6895,7195,-300
1,0,0,12,5,6315,6206,109
1,0,1,12,5,6180,6101,79
1,0,2,12,5,6149,5961,188
1,0,3,12,5,6250,5813,437
1,0,4,12,5,6377,5739,638
1,0,5,12,5,6206,5716,490
1,0,6,12,5,6101,5746,355
1,0,7,12,5,5961,5913,48
1,0,8,12,5,5813,6044,-231
1,0,9,12,5,5739,6143,-404
1,0,10,12,5,5716,6312,-596
1,0,11,12,5,5746,6422,-676
1,0,12,12,5,5913,6419,-506
1,0,13,12,5,6044,6509,-465
1,0,14,12,5,6143,6602,-459
1,1,0,12,5,6558,6659,-101
1,1,1,12,5,6472,6476,-4
1,1,2,12,5,6510,6240,270
1,1,3,12,5,6721,6003,718
1,1,4,12,5,6948,5809,1139
1,1,5,12,5,6659,5777,882
1,1,6,12,5,6476,5849,627
1,1,7,12,5,6240,6156,84
1,1,8,12,5,6003,6394,-391
1,1,9,12,5,5809,6575,-766
1,1,10,12,5,5777,6859,-1082
1,1,11,12,5,5849,7035,-1186
1,1,12,12,5,6156,6973,-817
1,1,13,12,5,6394,7017,-623
1,1,14,12,5,6575,7049,-474
1,2,0,12,5,6741,7133,-392
1,2,1,12,5,6760,6807,-47
1,2,2,12,5,6818,6493,325
1,2,3,12,5,7152,6137,1015
1,2,4,12,5,7503,5794,1709
1,2,5,12,5,7133,5754,1379
1,2,6,12,5,6807,5874,933
1,2,7,12,5,6493,6325,168
1,2,8,12,5,6137,6666,-529
1,2,9,12,5,5794,6969,-1175
1,2,10,12,5,5754,7378,-1624
1,2,11,12,5,5874,7580,-1706
1,2,12,12,5,6325,7461,-1136
1,2,13,12,5,6666,7478,-812
1,2,14,12,5,6969,7428,-459
1,3,0,12,5,6925,7535,-610
1,3,1,12,5,7044,7081,-37
1,3,2,12,5,7083,6718,365
1,3,3,12,5,7527,6252,1275
1,3,4,12,5,7984,5792,2192
1,3,5,12,5,7535,5759,1776
1,3,6,12,5,7081,5905,1176
1,3,7,12,5,6718,6494,224
1,3,8,12,5,6252,6903,-651
1,3,9,12,5,5792,7323,-1531
1,3,10,12,5,5759,7844,-2085
1,3,11,12,5,5905,8052,-2147
1,3,12,12,5,6494,7894,-1400
1,3,13,12,5,6903,7926,-1023
1,3,14,12,5,7323,7803,-480
1,4,0,12,5,7117,8024,-907
1,4,1,12,5,7337,7487,-150
1,4,2,12,5,7376,7103,273
1,4,3,12,5,7945,6558,1387
1,4,4,12,5,8554,5961,2593
1,4,5,12,5,8024,5935,2089
1,4,6,12,5,7487,6122,1365
1,4,7,12,5,7103,6845,258
1,4,8,12,5,6558,7283,-725
1,4,9,12,5,5961,7804,-1843
1,4,10,12,5,5935,8406,-2471
1,4,11,12,5,6122,8563,-2441
1,4,12,12,5,6845,8334,-1489
1,4,13,12,5,7283,8369,-1086
1,4,14,12,5,7804,8146,-342
1,5,0,12,5,7164,8602,-1438
1,5,1,12,5,7519,8005,-486
1,5,2,12,5,7599,7634,-35
1,5,3,12,5,8379,7000,1379
1,5,4,12,5,9169,6285,2884
1,5,5,12,5,8602,6254,2348
1,5,6,12,5,8005,6498,1507
1,5,7,12,5,7634,7367,267
1,5,8,12,5,7000,7817,-817
1,5,9,12,5,6285,8354,-2069
1,5,10,12,5,6254,8999,-2745
1,5,11,12,5,6498,9071,-2573
1,5,12,12,5,7367,8705,-1338
1,5,13,12,5,7817,8649,-832
1,5,14,12,5,8354,8373,-19
1,6,0,12,5,7163,9049,-1886
1,6,1,12,5,7606,8413,-807
1,6,2,12,5,7776,8001,-225
1,6,3,12,5,8805,7193,1612
1,6,4,12,5,9695,6369,3326
1,6,5,12,5,9049,6331,2718
1,6,6,12,5,8413,6606,1807
1,6,7,12,5,8001,7660,341
1,6,8,12,5,7193,8195,-1002
1,6,9,12,5,6369,8708,-2339
1,6,10,12,5,6331,9410,-3079
1,6,11,12,5,6606,9466,-2860
1,6,12,12,5,7660,8960,-1300
1,6,13,12,5,8195,8776,-581
1,6,14,12,5,8708,8553,155
1,7,0,12,5,7346,9265,-1919
1,7,1,12,5,7884,8538,-654
1,7,2,12,5,8088,8139,-51
1,7,3,12,5,9220,7299,1921
1,7,4,12,5,10058,6438,3620
1,7,5,12,5,9265,6431,2834
1,7,6,12,5,8538,6714,1824
1,7,7,12,5,8139,7743,396
1,7,8,12,5,7299,8332,-1033
1,7,9,12,5,6438,8841,-2403
1,7,10,12,5,6431,9546,-3115
1,7,11,12,5,6714,9691,-2977
1,7,12,12,5,7743,9252,-1509
1,7,13,12,5,8332,8941,-609
1,7,14,12,5,8841,8722,119
1,8,0,12,5,7660,9391,-1731
1,8,1,12,5,8161,8702,-541
1,8,2,12,5,8390,8345,45
1,8,3,12,5,9502,7570,1932
1,8,4,12,5,10247,6676,3571
1,8,5,12,5,9391,6655,2736
1,8,6,12,5,8702,6846,1856
1,8,7,12,5,8345,7932,413
1,8,8,12,5,7570,8586,-1016
1,8,9,12,5,6676,9026,-2350
1,8,10,12,5,6655,9704,-3049
1,8,11,12,5,6846,9985,-3139
1,8,12,12,5,7932,9452,-1520
1,8,13,12,5,8586,8981,-395
1,8,14,12,5,9026,8848,178
1,9,0,12,5,7792,9450,-1658
1,9,1,12,5,8178,8835,-657
1,9,2,12,5,8410,8523,-113
1,9,3,12,5,9633,7696,1937
1,9,4,12,5,10343,6685,3658
1,9,5,12,5,9450,6613,2837
1,9,6,12,5,8835,6718,2117
1,9,7,12,5,8523,7825,698
1,9,8,12,5,7696,8462,-766
1,9,9,12,5,6685,8821,-2136
1,9,10,12,5,6613,9537,-2924
1,9,11,12,5,6718,9945,-3227
1,9,12,12,5,7825,9325,-1500
1,9,13,12,5,8462,8802,-340
1,9,14,12,5,8821,8830,-9
1,10,0,12,5,8125,9539,-1414
1,10,1,12,5,8391,8944,-553
1,10,2,12,5,8634,8626,8
1,10,3,12,5,9854,7831,2023
1,10,4,12,5,10453,6747,3706
1,10,5,12,5,9539,6672,2867
1,10,6,12,5,8944,6782,2162
1,10,7,12,5,8626,7865,761
1,10,8,12,5,7831,8457,-626
1,10,9,12,5,6747,8805,-2058
1,10,10,12,5,6672,9561,-2889
1,10,11,12,5,6782,10017,-3235
1,10,12,12,5,7865,9442,-1577
1,10,13,12,5,8457,8935,-478
1,10,14,12,5,8805,9036,-231
1,11,0,12,5,8100,9248,-1148
1,11,1,12,5,8292,8672,-380
1,11,2,12,5,8427,8374,53
1,11,3,12,5,9569,7632,1937
1,11,4,12,5,10133,6490,3643
1,11,5,12,5,9248,6403,2845
1,11,6,12,5,8672,6544,2128
1,11,7,12,5,8374,7652,722
1,11,8,12,5,7632,8174,-542
1,11,9,12,5,6490,8479,-1989
1,11,10,12,5,6403,9264,-2861
1,11,11,12,5,6544,9684,-3140
1,11,12,12,5,7652,9114,-1462
1,11,13,12,5,8174,8641,-467
1,11,14,12,5,8479,8784,-305
1,12,0,12,5,7767,8643,-876
1,12,1,12,5,7877,8038,-161
1,12,2,12,5,7868,7797,71
1,12,3,12,5,8896,7146,1750
1,12,4,12,5,9424,5984,3440
1,12,5,12,5,8643,5885,2758
1,12,6,12,5,8038,6070,1968
1,12,7,12,5,7797,7161,636
1,12,8,12,5,7146,7573,-427
1,12,9,12,5,5984,7846,-1862
1,12,10,12,5,5885,8582,-2697
1,12,11,12,5,6070,8938,-2868
1,12,12,12,5,7161,8367,-1206
1,12,13,12,5,7573,7964,-391
1,12,14,12,5,7846,8162,-316
1,0,0,13,5,7080,7187,-107
1,0,1,13,5,6995,6995,0
1,0,2,13,5,7030,6757,273
1,0,3,13,5,7251,6516,735
1,0,4,13,5,7484,6321,1163
1,0,5,13,5,7187,6290,897
1,0,6,13,5,6995,6365,630
1,0,7,13,5,6757,6668,89
1,0,8,13,5,6516,6906,-390
1,0,9,13,5,6321,7094,-773
1,0,10,13,5,6290,7382,-1092
1,0,11,13,5,6365,7551,-1186
1,0,12,13,5,6668,7494,-826
1,0,13,13,5,6906,7545,-639
1,0,14,13,5,7094,7569,-475
1,1,0,13,5,7283,7664,-381
1,1,1,13,5,7304,7334,-30
1,1,2,13,5,7353,7021,332
1,1,3,13,5,7687,6661,1026
1,1,4,13,5,8040,6314,1726
1,1,5,13,5,7664,6273,1391
1,1,6,13,5,7334,6396,938
1,1,7,13,5,7021,6859,162
1,1,8,13,5,6661,7204,-543
1,1,9,13,5,6314,7507,-1193
1,1,10,13,5,6273,7913,-1640
1,1,11,13,5,6396,8109,-1713
1,1,12,13,5,6859,7986,-1127
1,1,13,13,5,7204,8010,-806
1,1,14,13,5,7507,7958,-451
1,2,0,13,5,7475,8097,-622
1,2,1,13,5,7596,7644,-48
1,2,2,13,5,7628,7280,348
1,2,3,13,5,8078,6802,1276
1,2,4,13,5,8543,6335,2208
1,2,5,13,5,8097,6299,1798
1,2,6,13,5,7644,6447,1197
1,2,7,13,5,7280,7046,234
1,2,8,13,5,6802,7458,-656
1,2,9,13,5,6335,7879,-1544
1,2,10,13,5,6299,8397,-2098
1,2,11,13,5,6447,8597,-2150
1,2,12,13,5,7046,8432,-1386
1,2,13,13,5,7458,8470,-1012
1,2,14,13,5,7879,8344,-465
1,3,0,13,5,7673,8507,-834
1,3,1,13,5,7896,7921,-25
1,3,2,13,5,7930,7488,442
1,3,3,13,5,8504,6890,1614
1,3,4,13,5,9080,6284,2796
1,3,5,13,5,8507,6254,2253
1,3,6,13,5,7921,6442,1479
1,3,7,13,5,7488,7192,296
1,3,8,13,5,6890,7667,-777
1,3,9,13,5,6284,8242,-1958
1,3,10,13,5,6254,8900,-2646
1,3,11,13,5,6442,9097,-2655
1,3,12,13,5,7192,8882,-1690
1,3,13,13,5,7667,8929,-1262
1,3,14,13,5,8242,8700,-458
1,4,0,13,5,7752,8997,-1245
1,4,1,13,5,8113,8328,-215
1,4,2,13,5,8168,7908,260
1,4,3,13,5,8910,7242,1668
1,4,4,13,5,9639,6518,3121
1,4,5,13,5,8997,6483,2514
1,4,6,13,5,8328,6727,1601
1,4,7,13,5,7908,7610,298
1,4,8,13,5,7242,8091,-849
1,4,9,13,5,6518,8689,-2171
1,4,10,13,5,6483,9410,-2927
1,4,11,13,5,6727,9549,-2822
1,4,12,13,5,7610,9234,-1624
1,4,13,13,5,8091,9216,-1125
1,4,14,13,5,8689,8944,-255
1,5,0,13,5,7763,9403,-1640
1,5,1,13,5,8201,8725,-524
1,5,2,13,5,8318,8309,9
1,5,3,13,5,9266,7527,1739
1,5,4,13,5,10106,6699,3407
1,5,5,13,5,9403,6658,2745
1,5,6,13,5,8725,6932,1793
1,5,7,13,5,8309,7976,333
1,5,8,13,5,7527,8504,-977
1,5,9,13,5,6699,9033,-2334
1,5,10,13,5,6658,9777,-3119
1,5,11,13,5,6932,9883,-2951
1,5,12,13,5,7976,9441,-1465
1,5,13,13,5,8504,9317,-813
1,5,14,13,5,9033,9121,-88
1,6,0,13,5,7875,9610,-1735
1,6,1,13,5,8375,8870,-495
1,6,2,13,5,8522,8473,49
1,6,3,13,5,9603,7644,1959
1,6,4,13,5,10421,6783,3638
1,6,5,13,5,9610,6775,2835
1,6,6,13,5,8870,7057,1813
1,6,7,13,5,8473,8094,379
1,6,8,13,5,7644,8680,-1036
1,6,9,13,5,6783,9191,-2408
1,6,10,13,5,6775,9915,-3140
1,6,11,13,5,7057,10089,-3032
1,6,12,13,5,8094,9680,-1586
1,6,13,13,5,8680,9419,-739
1,6,14,13,5,9191,9244,-53
1,7,0,13,5,8094,9826,-1732
1,7,1,13,5,8522,9177,-655
1,7,2,13,5,8708,8837,-129
1,7,3,13,5,9835,8056,1779
1,7,4,13,5,10626,7165,3461
1,7,5,13,5,9826,7145,2681
1,7,6,13,5,9177,7335,1842
1,7,7,13,5,8837,8421,416
1,7,8,13,5,8056,9060,-1004
1,7,9,13,5,7165,9481,-2316
1,7,10,13,5,7145,10139,-2994
1,7,11,13,5,7335,10396,-3061
1,7,12,13,5,8421,9848,-1427
1,7,13,13,5,9060,9403,-343
1,7,14,13,5,9481,9316,165
1,8,0,13,5,8321,10062,-1741
1,8,1,13,5,8675,9483,-808
1,8,2,13,5,8901,9173,-272
1,8,3,13,5,10124,8371,1753
1,8,4,13,5,10883,7379,3504
1,8,5,13,5,10062,7310,2752
1,8,6,13,5,9483,7423,2060
1,8,7,13,5,9173,8527,646
1,8,8,13,5,8371,9149,-778
1,8,9,13,5,7379,9491,-2112
1,8,10,13,5,7310,10162,-2852
1,8,11,13,5,7423,10531,-3108
1,8,12,13,5,8527,9905,-1378
1,8,13,13,5,9149,9369,-220
1,8,14,13,5,9491,9399,92
1,9,0,13,5,8453,9810,-1357
1,9,1,13,5,8668,9189,-521
1,9,2,13,5,8886,8863,23
1,9,3,13,5,10104,8040,2064
1,9,4,13,5,10724,6920,3804
1,9,5,13,5,9810,6831,2979
1,9,6,13,5,9189,6965,2224
1,9,7,13,5,8863,8071,792
1,9,8,13,5,8040,8690,-650
1,9,9,13,5,6920,9068,-2148
1,9,10,13,5,6831,9844,-3013
1,9,11,13,5,6965,10298,-3333
1,9,12,13,5,8071,9724,-1653
1,9,13,13,5,8690,9227,-537
1,9,14,13,5,9068,9373,-305
1,10,0,13,5,8532,9916,-1384
1,10,1,13,5,8738,9354,-616
1,10,2,13,5,8952,9052,-100
1,10,3,13,5,10191,8278,1913
1,10,4,13,5,10821,7126,3695
1,10,5,13,5,9916,7035,2881
1,10,6,13,5,9354,7173,2181
1,10,7,13,5,9052,8307,745
1,10,8,13,5,8278,8853,-575
1,10,9,13,5,7126,9138,-2012
1,10,10,13,5,7035,9919,-2884
1,10,11,13,5,7173,10325,-3152
1,10,12,13,5,8307,9692,-1385
1,10,13,13,5,8853,9169,-316
1,10,14,13,5,9138,9306,-168
1,11,0,13,5,8472,9665,-1193
1,11,1,13,5,8618,9079,-461
1,11,2,13,5,8732,8793,-61
1,11,3,13,5,9900,8103,1797
1,11,4,13,5,10521,6925,3596
1,11,5,13,5,9665,6832,2833
1,11,6,13,5,9079,7012,2067
1,11,7,13,5,8793,8167,626
1,11,8,13,5,8103,8624,-521
1,11,9,13,5,6925,8881,-1956
1,11,10,13,5,6832,9644,-2812
1,11,11,13,5,7012,10024,-3012
1,11,12,13,5,8167,9380,-1213
1,11,13,13,5,8624,8914,-290
1,11,14,13,5,8881,9062,-181
1,0,0,14,5,7805,8192,-387
1,0,1,14,5,7827,7853,-26
1,0,2,14,5,7873,7538,335
1,0,3,14,5,8217,7174,1043
1,0,4,14,5,8576,6826,1750
1,0,5,14,5,8192,6786,1406
1,0,6,14,5,7853,6912,941
1,0,7,14,5,7538,7371,167
1,0,8,14,5,7174,7716,-542
1,0,9,14,5,6826,8026,-1200
1,0,10,14,5,6786,8436,-1650
1,0,11,14,5,6912,8625,-1713
1,0,12,14,5,7371,8507,-1136
1,0,13,14,5,7716,8538,-822
1,0,14,14,5,8026,8478,-452
1,1,0,14,5,8017,8628,-611
1,1,1,14,5,8140,8171,-31
1,1,2,14,5,8163,7808,355
1,1,3,14,5,8613,7326,1287
1,1,4,14,5,9080,6855,2225
1,1,5,14,5,8628,6818,1810
1,1,6,14,5,8171,6969,1202
1,1,7,14,5,7808,7580,228
1,1,8,14,5,7326,7996,-670
1,1,9,14,5,6855,8417,-1562
1,1,10,14,5,6818,8932,-2114
1,1,11,14,5,6969,9126,-2157
1,1,12,14,5,7580,8957,-1377
1,1,13,14,5,7996,9002,-1006
1,1,14,14,5,8417,8874,-457
1,2,0,14,5,8223,9069,-846
1,2,1,14,5,8448,8484,-36
1,2,2,14,5,8475,8050,425
1,2,3,14,5,9055,7440,1615
1,2,4,14,5,9639,6827,2812
1,2,5,14,5,9069,6794,2275
1,2,6,14,5,8484,6984,1500
1,2,7,14,5,8050,7744,306
1,2,8,14,5,7440,8222,-782
1,2,9,14,5,6827,8798,-1971
1,2,10,14,5,6794,9453,-2659
1,2,11,14,5,6984,9642,-2658
1,2,12,14,5,7744,9420,-1676
1,2,13,14,5,8222,9473,-1251
1,2,14,14,5,8798,9241,-443
1,3,0,14,5,8308,9480,-1172
1,3,1,14,5,8672,8762,-90
1,3,2,14,5,8722,8293,429
1,3,3,14,5,9469,7574,1895
1,3,4,14,5,10165,6841,3324
1,3,5,14,5,9480,6802,2678
1,3,6,14,5,8762,7047,1715
1,3,7,14,5,8293,7957,336
1,3,8,14,5,7574,8475,-901
1,3,9,14,5,6841,9127,-2286
1,3,10,14,5,6802,9904,-3102
1,3,11,14,5,7047,10083,-3036
1,3,12,14,5,7957,9782,-1825
1,3,13,14,5,8475,9776,-1301
1,3,14,14,5,9127,9498,-371
1,4,0,14,5,8351,9798,-1447
1,4,1,14,5,8795,9048,-253
1,4,2,14,5,8887,8583,304
1,4,3,14,5,9797,7769,2028
1,4,4,14,5,10576,6932,3644
1,4,5,14,5,9798,6887,2911
1,4,6,14,5,9048,7161,1887
1,4,7,14,5,8583,8219,364
1,4,8,14,5,7769,8778,-1009
1,4,9,14,5,6932,9368,-2436
1,4,10,14,5,6887,10188,-3301
1,4,11,14,5,7161,10361,-3200
1,4,12,14,5,8219,9970,-1751
1,4,13,14,5,8778,9884,-1106
1,4,14,14,5,9368,9692,-324
1,5,0,14,5,8475,9964,-1489
1,5,1,14,5,8970,9182,-212
1,5,2,14,5,9064,8781,283
1,5,3,14,5,10064,7978,2086
1,5,4,14,5,10832,7113,3719
1,5,5,14,5,9964,7102,2862
1,5,6,14,5,9182,7383,1799
1,5,7,14,5,8781,8410,371
1,5,8,14,5,7978,8989,-1011
1,5,9,14,5,7113,9516,-2403
1,5,10,14,5,7102,10282,-3180
1,5,11,14,5,7383,10506,-3123
1,5,12,14,5,8410,10161,-1751
1,5,13,14,5,8989,9960,-971
1,5,14,14,5,9516,9812,-296
1,6,0,14,5,8623,10171,-1548
1,6,1,14,5,9013,9509,-496
1,6,2,14,5,9142,9171,-29
1,6,3,14,5,10218,8401,1817
1,6,4,14,5,10989,7510,3479
1,6,5,14,5,10171,7489,2682
1,6,6,14,5,9509,7678,1831
1,6,7,14,5,9171,8772,399
1,6,8,14,5,8401,9408,-1007
1,6,9,14,5,7510,9831,-2321
1,6,10,14,5,7489,10508,-3019
1,6,11,14,5,7678,10794,-3116
1,6,12,14,5,8772,10276,-1504
1,6,13,14,5,9408,9881,-473
1,6,14,14,5,9831,9838,-7
1,7,0,14,5,8755,10497,-1742
1,7,1,14,5,9036,9958,-922
1,7,2,14,5,9219,9665,-446
1,7,3,14,5,10457,8857,1600
1,7,4,14,5,11262,7868,3394
1,7,5,14,5,10497,7800,2697
1,7,6,14,5,9958,7912,2046
1,7,7,14,5,9665,9016,649
1,7,8,14,5,8857,9623,-766
1,7,9,14,5,7868,9946,-2078
1,7,10,14,5,7800,10597,-2797
1,7,11,14,5,7912,10942,-3030
1,7,12,14,5,9016,10301,-1285
1,7,13,14,5,9623,9791,-168
1,7,14,14,5,9946,9867,79
1,8,0,14,5,8982,10422,-1440
1,8,1,14,5,9165,9837,-672
1,8,2,14,5,9377,9513,-136
1,8,3,14,5,10595,8715,1880
1,8,4,14,5,11264,7614,3650
1,8,5,14,5,10422,7528,2894
1,8,6,14,5,9837,7670,2167
1,8,7,14,5,9513,8773,740
1,8,8,14,5,8715,9377,-662
1,8,9,14,5,7614,9738,-2124
1,8,10,14,5,7528,10469,-2941
1,8,11,14,5,7670,10884,-3214
1,8,12,14,5,8773,10304,-1531
1,8,13,14,5,9377,9794,-417
1,8,14,14,5,9738,9942,-204
1,9,0,14,5,8860,10187,-1327
1,9,1,14,5,9015,9599,-584
1,9,2,14,5,9204,9289,-85
1,9,3,14,5,10441,8487,1954
1,9,4,14,5,11092,7299,3793
1,9,5,14,5,10187,7194,2993
1,9,6,14,5,9599,7356,2243
1,9,7,14,5,9289,8513,776
1,9,8,14,5,8487,9086,-599
1,9,9,14,5,7299,9401,-2102
1,9,10,14,5,7194,10202,-3008
1,9,11,14,5,7356,10606,-3250
1,9,12,14,5,8513,9974,-1461
1,9,13,14,5,9086,9461,-375
1,9,14,14,5,9401,9643,-242
1,10,0,14,5,8904,10333,-1429
1,10,1,14,5,9064,9761,-697
1,10,2,14,5,9257,9471,-214
1,10,3,14,5,10522,8749,1773
1,10,4,14,5,11209,7561,3648
1,10,5,14,5,10333,7464,2869
1,10,6,14,5,9761,7641,2120
1,10,7,14,5,9471,8822,649
1,10,8,14,5,8749,9303,-554
1,10,9,14,5,7561,9540,-1979
1,10,10,14,5,7464,10299,-2835
1,10,11,14,5,7641,10665,-3024
1,10,12,14,5,8822,9958,-1136
1,10,13,14,5,9303,9442,-139
1,10,14,14,5,9540,9584,-44
1,0,0,15,5,8539,9156,-617
1,0,1,15,5,8663,8690,-27
1,0,2,15,5,8683,8325,358
1,0,3,15,5,9143,7839,1304
1,0,4,15,5,9616,7367,2249
1,0,5,15,5,9156,7331,1825
1,0,6,15,5,8690,7485,1205
1,0,7,15,5,8325,8092,233
1,0,8,15,5,7839,8508,-669
1,0,9,15,5,7367,8936,-1569
1,0,10,15,5,7331,9455,-2124
1,0,11,15,5,7485,9642,-2157
1,0,12,15,5,8092,9478,-1386
1,0,13,15,5,8508,9530,-1022
1,0,14,15,5,8936,9394,-458
1,1,0,15,5,8765,9600,-835
1,1,1,15,5,8992,9011,-19
1,1,2,15,5,9010,8578,432
1,1,3,15,5,9590,7964,1626
1,1,4,15,5,10176,7347,2829
1,1,5,15,5,9600,7313,2287
1,1,6,15,5,9011,7506,1505
1,1,7,15,5,8578,8278,300
1,1,8,15,5,7964,8760,-796
1,1,9,15,5,7347,9336,-1989
1,1,10,15,5,7313,9988,-2675
1,1,11,15,5,7506,10171,-2665
1,1,12,15,5,8278,9945,-1667
1,1,13,15,5,8760,10005,-1245
1,1,14,15,5,9336,9771,-435
1,2,0,15,5,8858,10042,-1184
1,2,1,15,5,9224,9325,-101
1,2,2,15,5,9267,8855,412
1,2,3,15,5,10020,8124,1896
1,2,4,15,5,10724,7384,3340
1,2,5,15,5,10042,7342,2700
1,2,6,15,5,9325,7589,1736
1,2,7,15,5,8855,8509,346
1,2,8,15,5,8124,9030,-906
1,2,9,15,5,7384,9683,-2299
1,2,10,15,5,7342,10457,-3115
1,2,11,15,5,7589,10628,-3039
1,2,12,15,5,8509,10320,-1811
1,2,13,15,5,9030,10320,-1290
1,2,14,15,5,9683,10039,-356
1,3,0,15,5,8907,10281,-1374
1,3,1,15,5,9354,9482,-128
1,3,2,15,5,9441,8968,473
1,3,3,15,5,10356,8101,2255
1,3,4,15,5,11102,7255,3847
1,3,5,15,5,10281,7206,3075
1,3,6,15,5,9482,7481,2001
1,3,7,15,5,8968,8566,402
1,3,8,15,5,8101,9162,-1061
1,3,9,15,5,7255,9806,-2551
1,3,10,15,5,7206,10682,-3476
1,3,11,15,5,7481,10895,-3414
1,3,12,15,5,8566,10518,-1952
1,3,13,15,5,9162,10444,-1282
1,3,14,15,5,9806,10246,-440
1,4,0,15,5,9063,10359,-1296
1,4,1,15,5,9564,9505,59
1,4,2,15,5,9633,9055,578
1,4,3,15,5,10595,8220,2375
1,4,4,15,5,11302,7346,3956
1,4,5,15,5,10359,7331,3028
1,4,6,15,5,9505,7612,1893
1,4,7,15,5,9055,8653,402
1,4,8,15,5,8220,9263,-1043
1,4,9,15,5,7346,9851,-2505
1,4,10,15,5,7331,10693,-3362
1,4,11,15,5,7612,10984,-3372
1,4,12,15,5,8653,10690,-2037
1,4,13,15,5,9263,10527,-1264
1,4,14,15,5,9851,10383,-532
1,5,0,15,5,9223,10525,-1302
1,5,1,15,5,9608,9821,-213
1,5,2,15,5,9684,9479,205
1,5,3,15,5,10679,8735,1944
1,5,4,15,5,11400,7840,3560
1,5,5,15,5,10525,7816,2709
1,5,6,15,5,9821,8004,1817
1,5,7,15,5,9479,9088,391
1,5,8,15,5,8735,9717,-982
1,5,9,15,5,7840,10156,-2316
1,5,10,15,5,7816,10875,-3059
1,5,11,15,5,8004,11211,-3207
1,5,12,15,5,9088,10757,-1669
1,5,13,15,5,9717,10422,-705
1,5,14,15,5,10156,10406,-250
1,6,0,15,5,9284,10842,-1558
1,6,1,15,5,9527,10290,-763
1,6,2,15,5,9653,9999,-346
1,6,3,15,5,10840,9202,1638
1,6,4,15,5,11625,8213,3412
1,6,5,15,5,10842,8144,2698
1,6,6,15,5,10290,8255,2035
1,6,7,15,5,9999,9367,632
1,6,8,15,5,9202,9971,-769
1,6,9,15,5,8213,10296,-2083
1,6,10,15,5,8144,10966,-2822
1,6,11,15,5,8255,11340,-3085
1,6,12,15,5,9367,10729,-1362
1,6,13,15,5,9971,10269,-298
1,6,14,15,5,10296,10389,-93
1,7,0,15,5,9416,10857,-1441
1,7,1,15,5,9526,10312,-786
1,7,2,15,5,9695,10005,-310
1,7,3,15,5,10928,9201,1727
1,7,4,15,5,11643,8103,3540
1,7,5,15,5,10857,8018,2839
1,7,6,15,5,10312,8159,2153
1,7,7,15,5,10005,9262,743
1,7,8,15,5,9201,9851,-650
1,7,9,15,5,8103,10193,-2090
1,7,10,15,5,8018,10904,-2886
1,7,11,15,5,8159,11295,-3136
1,7,12,15,5,9262,10700,-1438
1,7,13,15,5,9851,10216,-365
1,7,14,15,5,10193,10410,-217
1,8,0,15,5,9389,10799,-1410
1,8,1,15,5,9512,10247,-735
1,8,2,15,5,9695,9939,-244
1,8,3,15,5,10932,9162,1770
1,8,4,15,5,11632,7993,3639
1,8,5,15,5,10799,7891,2908
1,8,6,15,5,10247,8061,2186
1,8,7,15,5,9939,9215,724
1,8,8,15,5,9162,9773,-611
1,8,9,15,5,7993,10071,-2078
1,8,10,15,5,7891,10827,-2936
1,8,11,15,5,8061,11192,-3131
1,8,12,15,5,9215,10554,-1339
1,8,13,15,5,9773,10028,-255
1,8,14,15,5,10071,10212,-141
1,9,0,15,5,9232,10604,-1372
1,9,1,15,5,9341,10006,-665
1,9,2,15,5,9509,9708,-199
1,9,3,15,5,10772,8958,1814
1,9,4,15,5,11480,7734,3746
1,9,5,15,5,10604,7623,2981
1,9,6,15,5,10006,7824,2182
1,9,7,15,5,9708,9028,680
1,9,8,15,5,8958,9536,-578
1,9,9,15,5,7734,9803,-2069
1,9,10,15,5,7623,10582,-2959
1,9,11,15,5,7824,10946,-3122
1,9,12,15,5,9028,10240,-1212
1,9,13,15,5,9536,9734,-198
1,9,14,15,5,9803,9921,-118
1,0,0,16,5,9287,10128,-841
1,0,1,16,5,9515,9530,-15
1,0,2,16,5,9530,9095,435
1,0,3,16,5,10120,8477,1643
1,0,4,16,5,10712,7859,2853
1,0,5,16,5,10128,7826,2302
1,0,6,16,5,9530,8022,1508
1,0,7,16,5,9095,8790,305
1,0,8,16,5,8477,9272,-795
1,0,9,16,5,7859,9855,-1996
1,0,10,16,5,7826,10511,-2685
1,0,11,16,5,8022,10687,-2665
1,0,12,16,5,8790,10466,-1676
1,0,13,16,5,9272,10533,-1261
1,0,14,16,5,9855,10291,-436
1,1,0,16,5,9400,10573,-1173
1,1,1,16,5,9768,9852,-84
1,1,2,16,5,9802,9383,419
1,1,3,16,5,10555,8648,1907
1,1,4,16,5,11261,7904,3357
1,1,5,16,5,10573,7861,2712
1,1,6,16,5,9852,8111,1741
1,1,7,16,5,9383,9043,340
1,1,8,16,5,8648,9568,-920
1,1,9,16,5,7904,10221,-2317
1,1,10,16,5,7861,10992,-3131
1,1,11,16,5,8111,11157,-3046
1,1,12,16,5,9043,10845,-1802
1,1,13,16,5,9568,10852,-1284
1,1,14,16,5,10221,10569,-348
1,2,0,16,5,9457,10843,-1386
1,2,1,16,5,9906,10045,-139
1,2,2,16,5,9986,9530,456
1,2,3,16,5,10907,8651,2256
1,2,4,16,5,11661,7798,3863
1,2,5,16,5,10843,7746,3097
1,2,6,16,5,10045,8023,2022
1,2,7,16,5,9530,9118,412
1,2,8,16,5,8651,9717,-1066
1,2,9,16,5,7798,10362,-2564
1,2,10,16,5,7746,11235,-3489
1,2,11,16,5,8023,11440,-3417
1,2,12,16,5,9118,11056,-1938
1,2,13,16,5,9717,10988,-1271
1,2,14,16,5,10362,10787,-425
1,3,0,16,5,9619,10842,-1223
1,3,1,16,5,10123,9939,184
1,3,2,16,5,10187,9440,747
1,3,3,16,5,11154,8552,2602
1,3,4,16,5,11828,7669,4159
1,3,5,16,5,10842,7650,3192
1,3,6,16,5,9939,7932,2007
1,3,7,16,5,9440,9000,440
1,3,8,16,5,8552,9647,-1095
1,3,9,16,5,7669,10289,-2620
1,3,10,16,5,7650,11187,-3537
1,3,11,16,5,7932,11518,-3586
1,3,12,16,5,9000,11238,-2238
1,3,13,16,5,9647,11087,-1440
1,3,14,16,5,10289,10937,-648
1,4,0,16,5,9811,10920,-1109
1,4,1,16,5,10202,10144,58
1,4,2,16,5,10253,9753,500
1,4,3,16,5,11210,8977,2233
1,4,4,16,5,11870,8073,3797
1,4,5,16,5,10920,8045,2875
1,4,6,16,5,10144,8233,1911
1,4,7,16,5,9753,9331,422
1,4,8,16,5,8977,9991,-1014
1,4,9,16,5,8073,10491,-2418
1,4,10,16,5,8045,11286,-3241
1,4,11,16,5,8233,11689,-3456
1,4,12,16,5,9331,11286,-1955
1,4,13,16,5,9991,10989,-998
1,4,14,16,5,10491,10977,-486
1,5,0,16,5,9884,11196,-1312
1,5,1,16,5,10122,10602,-480
1,5,2,16,5,10195,10307,-112
1,5,3,16,5,11301,9536,1765
1,5,4,16,5,12036,8543,3493
1,5,5,16,5,11196,8471,2725
1,5,6,16,5,10602,8581,2021
1,5,7,16,5,10307,9683,624
1,5,8,16,5,9536,10280,-744
1,5,9,16,5,8543,10621,-2078
1,5,10,16,5,8471,11333,-2862
1,5,11,16,5,8581,11757,-3176
1,5,12,16,5,9683,11210,-1527
1,5,13,16,5,10280,10810,-530
1,5,14,16,5,10621,10957,-336
1,6,0,16,5,9945,11202,-1257
1,6,1,16,5,10017,10644,-627
1,6,2,16,5,10129,10339,-210
1,6,3,16,5,11311,9546,1765
1,6,4,16,5,12006,8448,3558
1,6,5,16,5,11202,8362,2840
1,6,6,16,5,10644,8502,2142
1,6,7,16,5,10339,9613,726
1,6,8,16,5,9546,10199,-653
1,6,9,16,5,8448,10543,-2095
1,6,10,16,5,8362,11273,-2911
1,6,11,16,5,8502,11693,-3191
1,6,12,16,5,9613,11128,-1515
1,6,13,16,5,10199,10694,-495
1,6,14,16,5,10543,10932,-389
1,7,0,16,5,9823,11234,-1411
1,7,1,16,5,9873,10722,-849
1,7,2,16,5,10013,10431,-418
1,7,3,16,5,11265,9648,1617
1,7,4,16,5,12011,8482,3529
1,7,5,16,5,11234,8381,2853
1,7,6,16,5,10722,8550,2172
1,7,7,16,5,10431,9704,727
1,7,8,16,5,9648,10247,-599
1,7,9,16,5,8482,10526,-2044
1,7,10,16,5,8381,11262,-2881
1,7,11,16,5,8550,11603,-3053
1,7,12,16,5,9704,10950,-1246
1,7,13,16,5,10247,10450,-203
1,7,14,16,5,10526,10680,-154
1,8,0,16,5,9761,11216,-1455
1,8,1,16,5,9838,10654,-816
1,8,2,16,5,10000,10358,-358
1,8,3,16,5,11263,9633,1630
1,8,4,16,5,12020,8428,3592
1,8,5,16,5,11216,8320,2896
1,8,6,16,5,10654,8529,2125
1,8,7,16,5,10358,9730,628
1,8,8,16,5,9633,10223,-590
1,8,9,16,5,8428,10473,-2045
1,8,10,16,5,8320,11207,-2887
1,8,11,16,5,8529,11532,-3003
1,8,12,16,5,9730,10820,-1090
1,8,13,16,5,10223,10301,-78
1,8,14,16,5,10473,10490,-17
1,0,0,17,5,9922,11101,-1179
1,0,1,17,5,10291,10371,-80
1,0,2,17,5,10322,9900,422
1,0,3,17,5,11085,9161,1924
1,0,4,17,5,11797,8416,3381
1,0,5,17,5,11101,8374,2727
1,0,6,17,5,10371,8627,1744
1,0,7,17,5,9900,9555,345
1,0,8,17,5,9161,10080,-919
1,0,9,17,5,8416,10740,-2324
1,0,10,17,5,8374,11515,-3141
1,0,11,17,5,8627,11673,-3046
1,0,12,17,5,9555,11366,-1811
1,0,13,17,5,10080,11380,-1300
1,0,14,17,5,10740,11089,-349
1,1,0,17,5,9999,11374,-1375
1,1,1,17,5,10450,10572,-122
1,1,2,17,5,10521,10058,463
1,1,3,17,5,11442,9175,2267
1,1,4,17,5,12198,8318,3880
1,1,5,17,5,11374,8265,3109
1,1,6,17,5,10572,8545,2027
1,1,7,17,5,10058,9652,406
1,1,8,17,5,9175,10255,-1080
1,1,9,17,5,8318,10900,-2582
1,1,10,17,5,8265,11770,-3505
1,1,11,17,5,8545,11969,-3424
1,1,12,17,5,9652,11581,-1929
1,1,13,17,5,10255,11520,-1265
1,1,14,17,5,10900,11317,-417
1,2,0,17,5,10169,11404,-1235
1,2,1,17,5,10675,10502,173
1,2,2,17,5,10732,10002,730
1,2,3,17,5,11705,9102,2603
1,2,4,17,5,12387,8212,4175
1,2,5,17,5,11404,8190,3214
1,2,6,17,5,10502,8474,2028
1,2,7,17,5,10002,9552,450
1,2,8,17,5,9102,10202,-1100
1,2,9,17,5,8212,10845,-2633
1,2,10,17,5,8190,11740,-3550
1,2,11,17,5,8474,12063,-3589
1,2,12,17,5,9552,11776,-2224
1,2,13,17,5,10202,11631,-1429
1,2,14,17,5,10845,11478,-633
1,3,0,17,5,10367,11403,-1036
1,3,1,17,5,10761,10578,183
1,3,2,17,5,10807,10138,669
1,3,3,17,5,11769,9309,2460
1,3,4,17,5,12396,8396,4000
1,3,5,17,5,11403,8364,3039
1,3,6,17,5,10578,8553,2025
1,3,7,17,5,10138,9678,460
1,3,8,17,5,9309,10375,-1066
1,3,9,17,5,8396,10929,-2533
1,3,10,17,5,8364,11780,-3416
1,3,11,17,5,8553,12223,-3670
1,3,12,17,5,9678,11834,-2156
1,3,13,17,5,10375,11549,-1174
1,3,14,17,5,10929,11531,-602
1,4,0,17,5,10472,11591,-1119
1,4,1,17,5,10716,10925,-209
1,4,2,17,5,10764,10581,183
1,4,3,17,5,11832,9778,2054
1,4,4,17,5,12506,8776,3730
1,4,5,17,5,11591,8700,2891
1,4,6,17,5,10925,8810,2115
1,4,7,17,5,10581,9926,655
1,4,8,17,5,9778,10554,-776
1,4,9,17,5,8776,10956,-2180
1,4,10,17,5,8700,11744,-3044
1,4,11,17,5,8810,12235,-3425
1,4,12,17,5,9926,11739,-1813
1,4,13,17,5,10554,11377,-823
1,4,14,17,5,10956,11528,-572
1,5,0,17,5,10545,11556,-1011
1,5,1,17,5,10612,10956,-344
1,5,2,17,5,10671,10647,24
1,5,3,17,5,11772,9880,1892
1,5,4,17,5,12417,8778,3639
1,5,5,17,5,11556,8689,2867
1,5,6,17,5,10956,8828,2128
1,5,7,17,5,10647,9929,718
1,5,8,17,5,9880,10508,-628
1,5,9,17,5,8778,10868,-2090
1,5,10,17,5,8689,11640,-2951
1,5,11,17,5,8828,12110,-3282
1,5,12,17,5,9929,11609,-1680
1,5,13,17,5,10508,11235,-727
1,5,14,17,5,10868,11500,-632
1,6,0,17,5,10352,11579,-1227
1,6,1,17,5,10364,11054,-690
1,6,2,17,5,10447,10765,-318
1,6,3,17,5,11648,9993,1655
1,6,4,17,5,12374,8827,3547
1,6,5,17,5,11579,8725,2854
1,6,6,17,5,11054,8893,2161
1,6,7,17,5,10765,10055,710
1,6,8,17,5,9993,10595,-602
1,6,9,17,5,8827,10876,-2049
1,6,10,17,5,8725,11631,-2906
1,6,11,17,5,8893,12001,-3108
1,6,12,17,5,10055,11378,-1323
1,6,13,17,5,10595,10928,-333
1,6,14,17,5,10876,11202,-326
1,7,0,17,5,10195,11651,-1456
1,7,1,17,5,10199,11129,-930
1,7,2,17,5,10318,10850,-532
1,7,3,17,5,11596,10119,1477
1,7,4,17,5,12399,8917,3482
1,7,5,17,5,11651,8810,2841
1,7,6,17,5,11129,9018,2111
1,7,7,17,5,10850,10219,631
1,7,8,17,5,10119,10697,-578
1,7,9,17,5,8917,10928,-2011
1,7,10,17,5,8810,11642,-2832
1,7,11,17,5,9018,11943,-2925
1,7,12,17,5,10219,11216,-997
1,7,13,17,5,10697,10723,-26
1,7,14,17,5,10928,10958,-30
1,0,0,18,5,10521,11902,-1381
1,0,1,18,5,10973,11091,-118
1,0,2,18,5,11041,10575,466
1,0,3,18,5,11972,9688,2284
1,0,4,18,5,12734,8830,3904
1,0,5,18,5,11902,8778,3124
1,0,6,18,5,11091,9061,2030
1,0,7,18,5,10575,10164,411
1,0,8,18,5,9688,10767,-1079
1,0,9,18,5,8830,11419,-2589
1,0,10,18,5,8778,12293,-3515
1,0,11,18,5,9061,12485,-3424
1,0,12,18,5,10164,12102,-1938
1,0,13,18,5,10767,12048,-1281
1,0,14,18,5,11419,11837,-418
1,1,0,18,5,10711,11935,-1224
1,1,1,18,5,11219,11029,190
1,1,2,18,5,11267,10530,737
1,1,3,18,5,12240,9626,2614
1,1,4,18,5,12924,8732,4192
1,1,5,18,5,11935,8709,3226
1,1,6,18,5,11029,8996,2033
1,1,7,18,5,10530,10086,444
1,1,8,18,5,9626,10740,-1114
1,1,9,18,5,8732,11383,-2651
1,1,10,18,5,8709,12275,-3566
1,1,11,18,5,8996,12592,-3596
1,1,12,18,5,10086,12301,-2215
1,1,13,18,5,10740,12163,-1423
1,1,14,18,5,11383,12008,-625
1,2,0,18,5,10917,11965,-1048
1,2,1,18,5,11313,11141,172
1,2,2,18,5,11352,10700,652
1,2,3,18,5,12320,9859,2461
1,2,4,18,5,12955,8939,4016
1,2,5,18,5,11965,8904,3061
1,2,6,18,5,11141,9095,2046
1,2,7,18,5,10700,10230,470
1,2,8,18,5,9859,10930,-1071
1,2,9,18,5,8939,11485,-2546
1,2,10,18,5,8904,12333,-3429
1,2,11,18,5,9095,12768,-3673
1,2,12,18,5,10230,12372,-2142
1,2,13,18,5,10930,12093,-1163
1,2,14,18,5,11485,12072,-587
1,3,0,18,5,11028,12074,-1046
1,3,1,18,5,11275,11359,-84
1,3,2,18,5,11318,10966,352
1,3,3,18,5,12391,10110,2281
1,3,4,18,5,13032,9099,3933
1,3,5,18,5,12074,9019,3055
1,3,6,18,5,11359,9130,2229
1,3,7,18,5,10966,10273,693
1,3,8,18,5,10110,10938,-828
1,3,9,18,5,9099,11394,-2295
1,3,10,18,5,9019,12238,-3219
1,3,11,18,5,9130,12769,-3639
1,3,12,18,5,10273,12287,-2014
1,3,13,18,5,10938,11937,-999
1,3,14,18,5,11394,12082,-688
1,4,0,18,5,11133,11951,-818
1,4,1,18,5,11206,11279,-73
1,4,2,18,5,11240,10921,319
1,4,3,18,5,12303,10122,2181
1,4,4,18,5,12887,9011,3876
1,4,5,18,5,11951,8918,3033
1,4,6,18,5,11279,9057,2222
1,4,7,18,5,10921,10172,749
1,4,8,18,5,10122,10782,-660
1,4,9,18,5,9011,11203,-2192
1,4,10,18,5,8918,12051,-3133
1,4,11,18,5,9057,12588,-3531
1,4,12,18,5,10172,12138,-1966
1,4,13,18,5,10782,11802,-1020
1,4,14,18,5,11203,12071,-868
1,5,0,18,5,10952,11933,-981
1,5,1,18,5,10959,11366,-407
1,5,2,18,5,10989,11073,-84
1,5,3,18,5,12109,10327,1782
1,5,4,18,5,12785,9157,3628
1,5,5,18,5,11933,9052,2881
1,5,6,18,5,11366,9219,2147
1,5,7,18,5,11073,10371,702
1,5,8,18,5,10327,10904,-577
1,5,9,18,5,9157,11201,-2044
1,5,10,18,5,9052,11998,-2946
1,5,11,18,5,9219,12418,-3199
1,5,12,18,5,10371,11859,-1488
1,5,13,18,5,10904,11469,-565
1,5,14,18,5,11201,11770,-569
1,6,0,18,5,10724,11996,-1272
1,6,1,18,5,10690,11461,-771
1,6,2,18,5,10752,11184,-432
1,6,3,18,5,11979,10464,1515
1,6,4,18,5,12762,9262,3500
1,6,5,18,5,11996,9154,2842
1,6,6,18,5,11461,9361,2100
1,6,7,18,5,11184,10570,614
1,6,8,18,5,10464,11045,-581
1,6,9,18,5,9262,11278,-2016
1,6,10,18,5,9154,12011,-2857
1,6,11,18,5,9361,12341,-2980
1,6,12,18,5,10570,11644,-1074
1,6,13,18,5,11045,11201,-156
1,6,14,18,5,11278,11480,-202
1,0,0,19,5,11233,12463,-1230
1,0,1,19,5,11742,11548,194
1,0,2,19,5,11787,11047,740
1,0,3,19,5,12770,10139,2631
1,0,4,19,5,13460,9244,4216
1,0,5,19,5,12463,9222,3241
1,0,6,19,5,11548,9512,2036
1,0,7,19,5,11047,10598,449
1,0,8,19,5,10139,11252,-1113
1,0,9,19,5,9244,11902,-2658
1,0,10,19,5,9222,12798,-3576
1,0,11,19,5,9512,13108,-3596
1,0,12,19,5,10598,12822,-2224
1,0,13,19,5,11252,12691,-1439
1,0,14,19,5,11902,12528,-626
1,1,0,19,5,11459,12496,-1037
1,1,1,19,5,11857,11668,189
1,1,2,19,5,11887,11228,659
1,1,3,19,5,12855,10383,2472
1,1,4,19,5,13492,9459,4033
1,1,5,19,5,12496,9423,3073
1,1,6,19,5,11668,9617,2051
1,1,7,19,5,11228,10764,464
1,1,8,19,5,10383,11468,-1085
1,1,9,19,5,9459,12023,-2564
1,1,10,19,5,9423,12868,-3445
1,1,11,19,5,9617,13297,-3680
1,1,12,19,5,10764,12897,-2133
1,1,13,19,5,11468,12625,-1157
1,1,14,19,5,12023,12602,-579
1,2,0,19,5,11578,12636,-1058
1,2,1,19,5,11827,11922,-95
1,2,2,19,5,11863,11528,335
1,2,3,19,5,12942,10660,2282
1,2,4,19,5,13591,9642,3949
1,2,5,19,5,12636,9559,3077
1,2,6,19,5,11922,9672,2250
1,2,7,19,5,11528,10825,703
1,2,8,19,5,10660,11493,-833
1,2,9,19,5,9642,11950,-2308
1,2,10,19,5,9559,12791,-3232
1,2,11,19,5,9672,13314,-3642
1,2,12,19,5,10825,12825,-2000
1,2,13,19,5,11493,12481,-988
1,2,14,19,5,11950,12623,-673
1,3,0,19,5,11689,12434,-745
1,3,1,19,5,11765,11713,52
1,3,2,19,5,11794,11306,488
1,3,3,19,5,12862,10454,2408
1,3,4,19,5,13413,9334,4079
1,3,5,19,5,12434,9237,3197
1,3,6,19,5,11713,9377,2336
1,3,7,19,5,11306,10519,787
1,3,8,19,5,10454,11166,-712
1,3,9,19,5,9334,11641,-2307
1,3,10,19,5,9237,12545,-3308
1,3,11,19,5,9377,13122,-3745
1,3,12,19,5,10519,12686,-2167
1,3,13,19,5,11166,12362,-1196
1,3,14,19,5,11641,12625,-984
1,4,0,19,5,11540,12328,-788
1,4,1,19,5,11553,11689,-136
1,4,2,19,5,11558,11347,211
1,4,3,19,5,12640,10569,2071
1,4,4,19,5,13255,9390,3865
1,4,5,19,5,12328,9281,3047
1,4,6,19,5,11689,9448,2241
1,4,7,19,5,11347,10614,733
1,4,8,19,5,10569,11178,-609
1,4,9,19,5,9390,11536,-2146
1,4,10,19,5,9281,12409,-3128
1,4,11,19,5,9448,12896,-3448
1,4,12,19,5,10614,12388,-1774
1,4,13,19,5,11178,12036,-858
1,4,14,19,5,11536,12341,-805
1,5,0,19,5,11324,12350,-1026
1,5,1,19,5,11285,11773,-488
1,5,2,19,5,11294,11492,-198
1,5,3,19,5,12440,10798,1642
1,5,4,19,5,13173,9592,3581
1,5,5,19,5,12350,9481,2869
1,5,6,19,5,11773,9687,2086
1,5,7,19,5,11492,10886,606
1,5,8,19,5,10798,11354,-556
1,5,9,19,5,9592,11603,-2011
1,5,10,19,5,9481,12378,-2897
1,5,11,19,5,9687,12758,-3071
1,5,12,19,5,10886,12125,-1239
1,5,13,19,5,11354,11742,-388
1,5,14,19,5,11603,12048,-445
1,0,0,20,5,11981,13024,-1043
1,0,1,20,5,12380,12187,193
1,0,2,20,5,12407,11745,662
1,0,3,20,5,13385,10896,2489
1,0,4,20,5,14028,9971,4057
1,0,5,20,5,13024,9936,3088
1,0,6,20,5,12187,10133,2054
1,0,7,20,5,11745,11276,469
1,0,8,20,5,10896,11980,-1084
1,0,9,20,5,9971,12542,-2571
1,0,10,20,5,9936,13391,-3455
1,0,11,20,5,10133,13813,-3680
1,0,12,20,5,11276,13418,-2142
1,0,13,20,5,11980,13153,-1173
1,0,14,20,5,12542,13122,-580
1,1,0,20,5,12120,13167,-1047
1,1,1,20,5,12371,12449,-78
1,1,2,20,5,12398,12056,342
1,1,3,20,5,13477,11184,2293
1,1,4,20,5,14128,10162,3966
1,1,5,20,5,13167,10078,3089
1,1,6,20,5,12449,10194,2255
1,1,7,20,5,12056,11359,697
1,1,8,20,5,11184,12031,-847
1,1,9,20,5,10162,12488,-2326
1,1,10,20,5,10078,13326,-3248
1,1,11,20,5,10194,13843,-3649
1,1,12,20,5,11359,13350,-1991
1,1,13,20,5,12031,13013,-982
1,1,14,20,5,12488,13153,-665
1,2,0,20,5,12239,12996,-757
1,2,1,20,5,12317,12276,41
1,2,2,20,5,12339,11868,471
1,2,3,20,5,13413,11004,2409
1,2,4,20,5,13972,9877,4095
1,2,5,20,5,12996,9777,3219
1,2,6,20,5,12276,9919,2357
1,2,7,20,5,11868,11071,797
1,2,8,20,5,11004,11721,-717
1,2,9,20,5,9877,12197,-2320
1,2,10,20,5,9777,13098,-3321
1,2,11,20,5,9919,13667,-3748
1,2,12,20,5,11071,13224,-2153
1,2,13,20,5,11721,12906,-1185
1,2,14,20,5,12197,13166,-969
1,3,0,20,5,12096,12811,-715
1,3,1,20,5,12112,12123,-11
1,3,2,20,5,12112,11732,380
1,3,3,20,5,13199,10901,2298
1,3,4,20,5,13781,9713,4068
1,3,5,20,5,12811,9600,3211
1,3,6,20,5,12123,9768,2355
1,3,7,20,5,11732,10961,771
1,3,8,20,5,10901,11562,-661
1,3,9,20,5,9713,11974,-2261
1,3,10,20,5,9600,12903,-3303
1,3,11,20,5,9768,13430,-3662
1,3,12,20,5,10961,12936,-1975
1,3,13,20,5,11562,12596,-1034
1,3,14,20,5,11974,12895,-921
1,4,0,20,5,11912,12745,-833
1,4,1,20,5,11879,12096,-217
1,4,2,20,5,11863,11766,97
1,4,3,20,5,12971,11040,1931
1,4,4,20,5,13643,9825,3818
1,4,5,20,5,12745,9710,3035
1,4,6,20,5,12096,9916,2180
1,4,7,20,5,11766,11129,637
1,4,8,20,5,11040,11628,-588
1,4,9,20,5,9825,11938,-2113
1,4,10,20,5,9710,12789,-3079
1,4,11,20,5,9916,13236,-3320
1,4,12,20,5,11129,12654,-1525
1,4,13,20,5,11628,12309,-681
1,4,14,20,5,11938,12619,-681
1,0,0,21,5,12642,13695,-1053
1,0,1,21,5,12894,12968,-74
1,0,2,21,5,12918,12573,345
1,0,3,21,5,14007,11697,2310
1,0,4,21,5,14664,10674,3990
1,0,5,21,5,13695,10591,3104
1,0,6,21,5,12968,10710,2258
1,0,7,21,5,12573,11871,702
1,0,8,21,5,11697,12543,-846
1,0,9,21,5,10674,13007,-2333
1,0,10,21,5,10591,13849,-3258
1,0,11,21,5,10710,14359,-3649
1,0,12,21,5,11871,13871,-2000
1,0,13,21,5,12543,13541,-998
1,0,14,21,5,13007,13673,-666
1,1,0,21,5,12781,13527,-746
1,1,1,21,5,12861,12803,58
1,1,2,21,5,12874,12396,478
1,1,3,21,5,13948,11528,2420
1,1,4,21,5,14509,10397,4112
1,1,5,21,5,13527,10296,3231
1,1,6,21,5,12803,10441,2362
1,1,7,21,5,12396,11605,791
1,1,8,21,5,11528,12259,-731
1,1,9,21,5,10397,12735,-2338
1,1,10,21,5,10296,13633,-3337
1,1,11,21,5,10441,14196,-3755
1,1,12,21,5,11605,13749,-2144
1,1,13,21,5,12259,13438,-1179
1,1,14,21,5,12735,13696,-961
1,2,0,21,5,12646,13373,-727
1,2,1,21,5,12664,12686,-22
1,2,2,21,5,12657,12294,363
1,2,3,21,5,13750,11451,2299
1,2,4,21,5,14340,10256,4084
1,2,5,21,5,13373,10140,3233
1,2,6,21,5,12686,10310,2376
1,2,7,21,5,12294,11513,781
1,2,8,21,5,11451,12117,-666
1,2,9,21,5,10256,12530,-2274
1,2,10,21,5,10140,13456,-3316
1,2,11,21,5,10310,13975,-3665
1,2,12,21,5,11513,13474,-1961
1,2,13,21,5,12117,13140,-1023
1,2,14,21,5,12530,13436,-906
1,3,0,21,5,12468,13228,-760
1,3,1,21,5,12438,12530,-92
1,3,2,21,5,12417,12151,266
1,3,3,21,5,13530,11372,2158
1,3,4,21,5,14169,10148,4021
1,3,5,21,5,13228,10029,3199
1,3,6,21,5,12530,10236,2294
1,3,7,21,5,12151,11476,675
1,3,8,21,5,11372,12012,-640
1,3,9,21,5,10148,12376,-2228
1,3,10,21,5,10029,13283,-3254
1,3,11,21,5,10236,13770,-3534
1,3,12,21,5,11476,13202,-1726
1,3,13,21,5,12012,12869,-857
1,3,14,21,5,12376,13173,-797
1,0,0,22,5,13303,14055,-752
1,0,1,22,5,13384,13322,62
1,0,2,22,5,13394,12913,481
1,0,3,22,5,14478,12041,2437
1,0,4,22,5,15045,10909,4136
1,0,5,22,5,14055,10809,3246
1,0,6,22,5,13322,10957,2365
1,0,7,22,5,12913,12117,796
1,0,8,22,5,12041,12771,-730
1,0,9,22,5,10909,13254,-2345
1,0,10,22,5,10809,14156,-3347
1,0,11,22,5,10957,14712,-3755
1,0,12,22,5,12117,14270,-2153
1,0,13,22,5,12771,13966,-1195
1,0,14,22,5,13254,14216,-962
1,1,0,22,5,13188,13904,-716
1,1,1,22,5,13208,13213,-5
1,1,2,22,5,13192,12822,370
1,1,3,22,5,14285,11975,2310
1,1,4,22,5,14877,10776,4101
1,1,5,22,5,13904,10659,3245
1,1,6,22,5,13213,10832,2381
1,1,7,22,5,12822,12047,775
1,1,8,22,5,11975,12655,-680
1,1,9,22,5,10776,13068,-2292
1,1,10,22,5,10659,13991,-3332
1,1,11,22,5,10832,14504,-3672
1,1,12,22,5,12047,13999,-1952
1,1,13,22,5,12655,13672,-1017
1,1,14,22,5,13068,13966,-898
1,2,0,22,5,13018,13790,-772
1,2,1,22,5,12990,13093,-103
1,2,2,22,5,12962,12713,249
1,2,3,22,5,14081,11922,2159
1,2,4,22,5,14728,10691,4037
1,2,5,22,5,13790,10569,3221
1,2,6,22,5,13093,10778,2315
1,2,7,22,5,12713,12028,685
1,2,8,22,5,11922,12567,-645
1,2,9,22,5,10691,12932,-2241
1,2,10,22,5,10569,13836,-3267
1,2,11,22,5,10778,14315,-3537
1,2,12,22,5,12028,13740,-1712
1,2,13,22,5,12567,13413,-846
1,2,14,22,5,12932,13714,-782
1,0,0,23,5,13710,14432,-722
1,0,1,23,5,13731,13732,-1
1,0,2,23,5,13712,13339,373
1,0,3,23,5,14815,12488,2327
1,0,4,23,5,15413,11288,4125
1,0,5,23,5,14432,11172,3260
1,0,6,23,5,13732,11348,2384
1,0,7,23,5,13339,12559,780
1,0,8,23,5,12488,13167,-679
1,0,9,23,5,11288,13587,-2299
1,0,10,23,5,11172,14514,-3342
1,0,11,23,5,11348,15020,-3672
1,0,12,23,5,12559,14520,-1961
1,0,13,23,5,13167,14200,-1033
1,0,14,23,5,13587,14486,-899
1,1,0,23,5,13560,14321,-761
1,1,1,23,5,13534,13620,-86
1,1,2,23,5,13497,13241,256
1,1,3,23,5,14616,12446,2170
1,1,4,23,5,15265,11211,4054
1,1,5,23,5,14321,11088,3233
1,1,6,23,5,13620,11300,2320
1,1,7,23,5,13241,12562,679
1,1,8,23,5,12446,13105,-659
1,1,9,23,5,11211,13470,-2259
1,1,10,23,5,11088,14371,-3283
1,1,11,23,5,11300,14844,-3544
1,1,12,23,5,12562,14265,-1703
1,1,13,23,5,13105,13945,-840
1,1,14,23,5,13470,14244,-774
1,0,0,24,5,14082,14849,-767
1,0,1,24,5,14057,14139,-82
1,0,2,24,5,14017,13758,259
1,0,3,24,5,15146,12959,2187
1,0,4,24,5,15801,11723,4078
1,0,5,24,5,14849,11601,3248
1,0,6,24,5,14139,11816,2323
1,0,7,24,5,13758,13074,684
1,0,8,24,5,12959,13617,-658
1,0,9,24,5,11723,13989,-2266
1,0,10,24,5,11601,14894,-3293
1,0,11,24,5,11816,15360,-3544
1,0,12,24,5,13074,14786,-1712
1,0,13,24,5,13617,14473,-856
1,0,14,24,5,13989,14764,-775
1,0,0,1,6,633,621,12
1,0,1,1,6,627,619,8
1,0,2,1,6,626,616,10
1,0,3,1,6,634,616,18
1,0,4,1,6,639,618,21
1,0,5,1,6,630,614,16
1,0,6,1,6,621,614,7
1,0,7,1,6,619,622,-3
1,0,8,1,6,616,627,-11
1,0,9,1,6,616,621,-5
1,0,10,1,6,618,619,-1
1,0,11,1,6,614,630,-16
1,0,12,1,6,614,630,-16
1,1,0,1,6,650,630,20
1,1,1,1,6,646,631,15
1,1,2,1,6,642,628,14
1,1,3,1,6,643,625,18
1,1,4,1,6,643,626,17
1,1,5,1,6,635,637,-2
1,1,6,1,6,630,641,-11
1,1,7,1,6,631,642,-11
1,1,8,1,6,628,640,-12
1,1,9,1,6,625,636,-11
1,1,10,1,6,626,640,-14
1,1,11,1,6,637,639,-2
1,1,12,1,6,641,634,7
1,2,0,1,6,658,670,-12
1,2,1,1,6,660,668,-8
1,2,2,1,6,663,658,5
1,2,3,1,6,666,653,13
1,2,4,1,6,672,651,21
1,2,5,1,6,671,659,12
1,2,6,1,6,670,661,9
1,2,7,1,6,668,664,4
1,2,8,1,6,658,663,-5
1,2,9,1,6,653,656,-3
1,2,10,1,6,651,655,-4
1,2,11,1,6,659,653,6
1,2,12,1,6,661,650,11
1,3,0,1,6,671,497,174
1,3,1,1,6,671,447,224
1,3,2,1,6,669,395,274
1,3,3,1,6,631,388,243
1,3,4,1,6,595,386,209
1,3,5,1,6,549,410,139
1,3,6,1,6,497,446,51
1,3,7,1,6,447,501,-54
1,3,8,1,6,395,559,-164
1,3,9,1,6,388,601,-213
1,3,10,1,6,386,638,-252
1,3,11,1,6,410,659,-249
1,3,12,1,6,446,671,-225
1,4,0,1,6,708,368,340
1,4,1,1,6,688,318,370
1,4,2,1,6,645,287,358
1,4,3,1,6,585,280,305
1,4,4,1,6,521,277,244
1,4,5,1,6,443,288,155
1,4,6,1,6,368,318,50
1,4,7,1,6,318,380,-62
1,4,8,1,6,287,458,-171
1,4,9,1,6,280,526,-246
1,4,10,1,6,277,588,-311
1,4,11,1,6,288,642,-354
1,4,12,1,6,318,677,-359
1,5,0,1,6,709,377,332
1,5,1,1,6,664,373,291
1,5,2,1,6,581,399,182
1,5,3,1,6,530,395,135
1,5,4,1,6,479,393,86
1,5,5,1,6,421,381,40
1,5,6,1,6,377,374,3
1,5,7,1,6,373,390,-17
1,5,8,1,6,399,432,-33
1,5,9,1,6,395,483,-88
1,5,10,1,6,393,536,-143
1,5,11,1,6,381,599,-218
1,5,12,1,6,374,649,-275
1,6,0,1,6,611,401,210
1,6,1,1,6,558,403,155
1,6,2,1,6,492,414,78
1,6,3,1,6,452,413,39
1,6,4,1,6,432,412,20
1,6,5,1,6,414,420,-6
1,6,6,1,6,401,417,-16
1,6,7,1,6,403,419,-16
1,6,8,1,6,414,437,-23
1,6,9,1,6,413,466,-53
1,6,10,1,6,412,505,-93
1,6,11,1,6,420,544,-124
1,6,12,1,6,417,593,-176
1,7,0,1,6,491,574,-83
1,7,1,1,6,443,591,-148
1,7,2,1,6,423,584,-161
1,7,3,1,6,428,586,-158
1,7,4,1,6,475,586,-111
1,7,5,1,6,532,588,-56
1,7,6,1,6,574,573,1
1,7,7,1,6,591,553,38
1,7,8,1,6,584,532,52
1,7,9,1,6,586,507,79
1,7,10,1,6,586,495,91
1,7,11,1,6,588,506,82
1,7,12,1,6,573,547,26
1,8,0,1,6,623,785,-162
1,8,1,1,6,632,796,-164
1,8,2,1,6,612,821,-209
1,8,3,1,6,618,832,-214
1,8,4,1,6,675,835,-160
1,8,5,1,6,742,839,-97
1,8,6,1,6,785,833,-48
1,8,7,1,6,796,816,-20
1,8,8,1,6,821,763,58
1,8,9,1,6,832,724,108
1,8,10,1,6,835,714,121
1,8,11,1,6,839,698,141
1,8,12,1,6,833,698,135
1,9,0,1,6,383,281,102
1,9,1,1,6,321,276,45
1,9,2,1,6,319,237,82
1,9,3,1,6,314,200,114
1,9,4,1,6,312,212,100
1,9,5,1,6,300,242,58
1,9,6,1,6,281,272,9
1,9,7,1,6,276,291,-15
1,9,8,1,6,237,310,-73
1,9,9,1,6,200,334,-134
1,9,10,1,6,212,341,-129
1,9,11,1,6,242,358,-116
1,9,12,1,6,272,395,-123
1,10,0,1,6,550,801,-251
1,10,1,1,6,569,803,-234
1,10,2,1,6,682,778,-96
1,10,3,1,6,764,760,4
1,10,4,1,6,816,761,55
1,10,5,1,6,800,774,26
1,10,6,1,6,801,804,-3
1,10,7,1,6,803,791,12
1,10,8,1,6,778,779,-1
1,10,9,1,6,760,770,-10
1,10,10,1,6,761,723,38
1,10,11,1,6,774,677,97
1,10,12,1,6,804,634,170
1,11,0,1,6,880,1219,-339
1,11,1,1,6,964,1187,-223
1,11,2,1,6,1094,1157,-63
1,11,3,1,6,1220,1125,95
1,11,4,1,6,1275,1136,139
1,11,5,1,6,1216,1184,32
1,11,6,1,6,1219,1242,-23
1,11,7,1,6,1187,1235,-48
1,11,8,1,6,1157,1246,-89
1,11,9,1,6,1125,1275,-150
1,11,10,1,6,1136,1255,-119
1,11,11,1,6,1184,1186,-2
1,11,12,1,6,1242,1084,158
1,12,0,1,6,966,1009,-43
1,12,1,1,6,1028,927,101
1,12,2,1,6,1105,814,291
1,12,3,1,6,1233,685,548
1,12,4,1,6,1218,733,485
1,12,5,1,6,1095,870,225
1,12,6,1,6,1009,993,16
1,12,7,1,6,927,1062,-135
1,12,8,1,6,814,1173,-359
1,12,9,1,6,685,1288,-603
1,12,10,1,6,733,1326,-593
1,12,11,1,6,870,1274,-404
1,12,12,1,6,993,1167,-174
1,13,0,1,6,978,951,27
1,13,1,1,6,1002,891,111
1,13,2,1,6,1076,754,322
1,13,3,1,6,1215,596,619
1,13,4,1,6,1192,653,539
1,13,5,1,6,1111,796,315
1,13,6,1,6,951,920,31
1,13,7,1,6,891,1028,-137
1,13,8,1,6,754,1145,-391
1,13,9,1,6,596,1231,-635
1,13,10,1,6,653,1262,-609
1,13,11,1,6,796,1210,-414
1,13,12,1,6,920,1127,-207
1,14,0,1,6,988,930,58
1,14,1,1,6,979,896,83
1,14,2,1,6,1041,777,264
1,14,3,1,6,1162,645,517
1,14,4,1,6,1140,700,440
1,14,5,1,6,1091,814,277
1,14,6,1,6,930,901,29
1,14,7,1,6,896,1022,-126
1,14,8,1,6,777,1123,-346
1,14,9,1,6,645,1172,-527
1,14,10,1,6,700,1212,-512
1,14,11,1,6,814,1172,-358
1,14,12,1,6,901,1146,-245
1,15,0,1,6,998,934,64
1,15,1,1,6,1016,875,141
1,15,2,1,6,1084,730,354
1,15,3,1,6,1215,578,637
1,15,4,1,6,1179,655,524
1,15,5,1,6,1090,792,298
1,15,6,1,6,934,869,65
1,15,7,1,6,875,1011,-136
1,15,8,1,6,730,1142,-412
1,15,9,1,6,578,1205,-627
1,15,10,1,6,655,1243,-588
1,15,11,1,6,792,1174,-382
1,15,12,1,6,869,1144,-275
1,16,0,1,6,884,935,-51
1,16,1,1,6,906,932,-26
1,16,2,1,6,1040,796,244
1,16,3,1,6,1204,655,549
1,16,4,1,6,1192,722,470
1,16,5,1,6,1090,859,231
1,16,6,1,6,935,935,0
1,16,7,1,6,932,997,-65
1,16,8,1,6,796,1102,-306
1,16,9,1,6,655,1160,-505
1,16,10,1,6,722,1154,-432
1,16,11,1,6,859,1017,-158
1,16,12,1,6,935,987,-52
1,17,0,1,6,790,787,3
1,17,1,1,6,794,758,36
1,17,2,1,6,950,610,340
1,17,3,1,6,1083,475,608
1,17,4,1,6,1008,544,464
1,17,5,1,6,911,676,235
1,17,6,1,6,787,770,17
1,17,7,1,6,758,762,-4
1,17,8,1,6,610,839,-229
1,17,9,1,6,475,952,-477
1,17,10,1,6,544,978,-434
1,17,11,1,6,676,829,-153
1,17,12,1,6,770,823,-53
1,18,0,1,6,891,541,350
1,18,1,1,6,838,579,259
1,18,2,1,6,874,526,348
1,18,3,1,6,910,517,393
1,18,4,1,6,799,526,273
1,18,5,1,6,636,518,118
1,18,6,1,6,541,592,-51
1,18,7,1,6,579,558,21
1,18,8,1,6,526,608,-82
1,18,9,1,6,517,705,-188
1,18,10,1,6,526,787,-261
1,18,11,1,6,518,801,-283
1,18,12,1,6,592,764,-172
1,19,0,1,6,828,770,58
1,19,1,1,6,710,856,-146
1,19,2,1,6,719,914,-195
1,19,3,1,6,802,837,-35
1,19,4,1,6,691,779,-88
1,19,5,1,6,719,809,-90
1,19,6,1,6,770,886,-116
1,19,7,1,6,856,797,59
1,19,8,1,6,914,703,211
1,19,9,1,6,837,770,67
1,19,10,1,6,779,784,-5
1,19,11,1,6,809,670,139
1,19,12,1,6,886,663,223
1,20,0,1,6,704,901,-197
1,20,1,1,6,587,980,-393
1,20,2,1,6,690,947,-257
1,20,3,1,6,866,787,79
1,20,4,1,6,768,730,38
1,20,5,1,6,824,715,109
1,20,6,1,6,901,715,186
1,20,7,1,6,980,611,369
1,20,8,1,6,947,542,405
1,20,9,1,6,787,621,166
1,20,10,1,6,730,591,139
1,20,11,1,6,715,508,207
1,20,12,1,6,715,599,116
1,21,0,1,6,693,398,295
1,21,1,1,6,548,428,120
1,21,2,1,6,560,380,180
1,21,3,1,6,616,259,357
1,21,4,1,6,422,273,149
1,21,5,1,6,386,290,96
1,21,6,1,6,398,316,82
1,21,7,1,6,428,283,145
1,21,8,1,6,380,331,49
1,21,9,1,6,259,408,-149
1,21,10,1,6,273,442,-169
1,21,11,1,6,290,495,-205
1,21,12,1,6,316,598,-282
1,22,0,1,6,444,471,-27
1,22,1,1,6,392,542,-150
1,22,2,1,6,413,530,-117
1,22,3,1,6,488,412,76
1,22,4,1,6,417,461,-44
1,22,5,1,6,447,503,-56
1,22,6,1,6,471,512,-41
1,22,7,1,6,542,416,126
1,22,8,1,6,530,391,139
1,22,9,1,6,412,406,6
1,22,10,1,6,461,362,99
1,22,11,1,6,503,304,199
1,22,12,1,6,512,290,222
1,23,0,1,6,437,467,-30
1,23,1,1,6,374,551,-177
1,23,2,1,6,385,561,-176
1,23,3,1,6,457,527,-70
1,23,4,1,6,486,523,-37
1,23,5,1,6,472,575,-103
1,23,6,1,6,467,582,-115
1,23,7,1,6,551,492,59
1,23,8,1,6,561,472,89
1,23,9,1,6,527,434,93
1,23,10,1,6,523,373,150
1,23,11,1,6,575,340,235
1,23,12,1,6,582,320,262
1,0,0,2,6,1283,1251,32
1,0,1,2,6,1273,1250,23
1,0,2,2,6,1268,1244,24
1,0,3,2,6,1277,1241,36
1,0,4,2,6,1282,1244,38
1,0,5,2,6,1265,1251,14
1,0,6,2,6,1251,1255,-4
1,0,7,2,6,1250,1264,-14
1,0,8,2,6,1244,1267,-23
1,0,9,2,6,1241,1257,-16
1,0,10,2,6,1244,1259,-15
1,0,11,2,6,1251,1269,-18
1,0,12,2,6,1255,1264,-9
1,1,0,2,6,1308,1300,8
1,1,1,2,6,1306,1299,7
1,1,2,2,6,1305,1286,19
1,1,3,2,6,1309,1278,31
1,1,4,2,6,1315,1277,38
1,1,5,2,6,1306,1296,10
1,1,6,2,6,1300,1302,-2
1,1,7,2,6,1299,1306,-7
1,1,8,2,6,1286,1303,-17
1,1,9,2,6,1278,1292,-14
1,1,10,2,6,1277,1295,-18
1,1,11,2,6,1296,1292,4
1,1,12,2,6,1302,1284,18
1,2,0,2,6,1329,1167,162
1,2,1,2,6,1331,1115,216
1,2,2,2,6,1332,1053,279
1,2,3,2,6,1297,1041,256
1,2,4,2,6,1267,1037,230
1,2,5,2,6,1220,1069,151
1,2,6,2,6,1167,1107,60
1,2,7,2,6,1115,1165,-50
1,2,8,2,6,1053,1222,-169
1,2,9,2,6,1041,1257,-216
1,2,10,2,6,1037,1293,-256
1,2,11,2,6,1069,1312,-243
1,2,12,2,6,1107,1321,-214
1,3,0,2,6,1379,865,514
1,3,1,2,6,1359,765,594
1,3,2,2,6,1314,682,632
1,3,3,2,6,1216,668,548
1,3,4,2,6,1116,663,453
1,3,5,2,6,992,698,294
1,3,6,2,6,865,764,101
1,3,7,2,6,765,881,-116
1,3,8,2,6,682,1017,-335
1,3,9,2,6,668,1127,-459
1,3,10,2,6,663,1226,-563
1,3,11,2,6,698,1301,-603
1,3,12,2,6,764,1348,-584
1,4,0,2,6,1417,745,672
1,4,1,2,6,1352,691,661
1,4,2,2,6,1226,686,540
1,4,3,2,6,1115,675,440
1,4,4,2,6,1000,670,330
1,4,5,2,6,864,669,195
1,4,6,2,6,745,692,53
1,4,7,2,6,691,770,-79
1,4,8,2,6,686,890,-204
1,4,9,2,6,675,1009,-334
1,4,10,2,6,670,1124,-454
1,4,11,2,6,669,1241,-572
1,4,12,2,6,692,1326,-634
1,5,0,2,6,1320,778,542
1,5,1,2,6,1222,776,446
1,5,2,2,6,1073,813,260
1,5,3,2,6,982,808,174
1,5,4,2,6,911,805,106
1,5,5,2,6,835,801,34
1,5,6,2,6,778,791,-13
1,5,7,2,6,776,809,-33
1,5,8,2,6,813,869,-56
1,5,9,2,6,808,949,-141
1,5,10,2,6,805,1041,-236
1,5,11,2,6,801,1143,-342
1,5,12,2,6,791,1242,-451
1,6,0,2,6,1102,975,127
1,6,1,2,6,1001,994,7
1,6,2,2,6,915,998,-83
1,6,3,2,6,880,999,-119
1,6,4,2,6,907,998,-91
1,6,5,2,6,946,1008,-62
1,6,6,2,6,975,990,-15
1,6,7,2,6,994,972,22
1,6,8,2,6,998,969,29
1,6,9,2,6,999,973,26
1,6,10,2,6,998,1000,-2
1,6,11,2,6,1008,1050,-42
1,6,12,2,6,990,1140,-150
1,7,0,2,6,1114,1359,-245
1,7,1,2,6,1075,1387,-312
1,7,2,2,6,1035,1405,-370
1,7,3,2,6,1046,1418,-372
1,7,4,2,6,1150,1421,-271
1,7,5,2,6,1274,1427,-153
1,7,6,2,6,1359,1406,-47
1,7,7,2,6,1387,1369,18
1,7,8,2,6,1405,1295,110
1,7,9,2,6,1418,1231,187
1,7,10,2,6,1421,1209,212
1,7,11,2,6,1427,1204,223
1,7,12,2,6,1406,1245,161
1,8,0,2,6,1006,1066,-60
1,8,1,2,6,953,1072,-119
1,8,2,2,6,931,1058,-127
1,8,3,2,6,932,1032,-100
1,8,4,2,6,987,1047,-60
1,8,5,2,6,1042,1081,-39
1,8,6,2,6,1066,1105,-39
1,8,7,2,6,1072,1107,-35
1,8,8,2,6,1058,1073,-15
1,8,9,2,6,1032,1058,-26
1,8,10,2,6,1047,1055,-8
1,8,11,2,6,1081,1056,25
1,8,12,2,6,1105,1093,12
1,9,0,2,6,933,1082,-149
1,9,1,2,6,890,1079,-189
1,9,2,2,6,1001,1015,-14
1,9,3,2,6,1078,960,118
1,9,4,2,6,1128,973,155
1,9,5,2,6,1100,1016,84
1,9,6,2,6,1082,1076,6
1,9,7,2,6,1079,1082,-3
1,9,8,2,6,1015,1089,-74
1,9,9,2,6,960,1104,-144
1,9,10,2,6,973,1064,-91
1,9,11,2,6,1016,1035,-19
1,9,12,2,6,1076,1029,47
1,10,0,2,6,1430,2020,-590
1,10,1,2,6,1533,1990,-457
1,10,2,2,6,1776,1935,-159
1,10,3,2,6,1984,1885,99
1,10,4,2,6,2091,1897,194
1,10,5,2,6,2016,1958,58
1,10,6,2,6,2020,2046,-26
1,10,7,2,6,1990,2026,-36
1,10,8,2,6,1935,2025,-90
1,10,9,2,6,1885,2045,-160
1,10,10,2,6,1897,1978,-81
1,10,11,2,6,1958,1863,95
1,10,12,2,6,2046,1718,328
1,11,0,2,6,1846,2228,-382
1,11,1,2,6,1992,2114,-122
1,11,2,2,6,2199,1971,228
1,11,3,2,6,2453,1810,643
1,11,4,2,6,2493,1869,624
1,11,5,2,6,2311,2054,257
1,11,6,2,6,2228,2235,-7
1,11,7,2,6,2114,2297,-183
1,11,8,2,6,1971,2419,-448
1,11,9,2,6,1810,2563,-753
1,11,10,2,6,1869,2581,-712
1,11,11,2,6,2054,2460,-406
1,11,12,2,6,2235,2251,-16
1,12,0,2,6,1944,1960,-16
1,12,1,2,6,2030,1818,212
1,12,2,2,6,2181,1568,613
1,12,3,2,6,2448,1281,1167
1,12,4,2,6,2410,1386,1024
1,12,5,2,6,2206,1666,540
1,12,6,2,6,1960,1913,47
1,12,7,2,6,1818,2090,-272
1,12,8,2,6,1568,2318,-750
1,12,9,2,6,1281,2519,-1238
1,12,10,2,6,1386,2588,-1202
1,12,11,2,6,1666,2484,-818
1,12,12,2,6,1913,2294,-381
1,13,0,2,6,1966,1881,85
1,13,1,2,6,1981,1787,194
1,13,2,2,6,2117,1531,586
1,13,3,2,6,2377,1241,1136
1,13,4,2,6,2332,1353,979
1,13,5,2,6,2202,1610,592
1,13,6,2,6,1881,1821,60
1,13,7,2,6,1787,2050,-263
1,13,8,2,6,1531,2268,-737
1,13,9,2,6,1241,2403,-1162
1,13,10,2,6,1353,2474,-1121
1,13,11,2,6,1610,2382,-772
1,13,12,2,6,1821,2273,-452
1,14,0,2,6,1986,1864,122
1,14,1,2,6,1995,1771,224
1,14,2,2,6,2125,1507,618
1,14,3,2,6,2377,1223,1154
1,14,4,2,6,2319,1355,964
1,14,5,2,6,2181,1606,575
1,14,6,2,6,1864,1770,94
1,14,7,2,6,1771,2033,-262
1,14,8,2,6,1507,2265,-758
1,14,9,2,6,1223,2377,-1154
1,14,10,2,6,1355,2455,-1100
1,14,11,2,6,1606,2346,-740
1,14,12,2,6,1770,2290,-520
1,15,0,2,6,1882,1869,13
1,15,1,2,6,1922,1807,115
1,15,2,2,6,2124,1526,598
1,15,3,2,6,2419,1233,1186
1,15,4,2,6,2371,1377,994
1,15,5,2,6,2180,1651,529
1,15,6,2,6,1869,1804,65
1,15,7,2,6,1807,2008,-201
1,15,8,2,6,1526,2244,-718
1,15,9,2,6,1233,2365,-1132
1,15,10,2,6,1377,2397,-1020
1,15,11,2,6,1651,2191,-540
1,15,12,2,6,1804,2131,-327
1,16,0,2,6,1674,1722,-48
1,16,1,2,6,1700,1690,10
1,16,2,2,6,1990,1406,584
1,16,3,2,6,2287,1130,1157
1,16,4,2,6,2200,1266,934
1,16,5,2,6,2001,1535,466
1,16,6,2,6,1722,1705,17
1,16,7,2,6,1690,1759,-69
1,16,8,2,6,1406,1941,-535
1,16,9,2,6,1130,2112,-982
1,16,10,2,6,1266,2132,-866
1,16,11,2,6,1535,1846,-311
1,16,12,2,6,1705,1810,-105
1,17,0,2,6,1681,1328,353
1,17,1,2,6,1632,1337,295
1,17,2,2,6,1824,1136,688
1,17,3,2,6,1993,992,1001
1,17,4,2,6,1807,1070,737
1,17,5,2,6,1547,1194,353
1,17,6,2,6,1328,1362,-34
1,17,7,2,6,1337,1320,17
1,17,8,2,6,1136,1447,-311
1,17,9,2,6,992,1657,-665
1,17,10,2,6,1070,1765,-695
1,17,11,2,6,1194,1630,-436
1,17,12,2,6,1362,1587,-225
1,18,0,2,6,1719,1311,408
1,18,1,2,6,1548,1435,113
1,18,2,2,6,1593,1440,153
1,18,3,2,6,1712,1354,358
1,18,4,2,6,1490,1305,185
1,18,5,2,6,1355,1327,28
1,18,6,2,6,1311,1478,-167
1,18,7,2,6,1435,1355,80
1,18,8,2,6,1440,1311,129
1,18,9,2,6,1354,1475,-121
1,18,10,2,6,1305,1571,-266
1,18,11,2,6,1327,1471,-144
1,18,12,2,6,1478,1427,51
1,19,0,2,6,1532,1671,-139
1,19,1,2,6,1297,1836,-539
1,19,2,2,6,1409,1861,-452
1,19,3,2,6,1668,1624,44
1,19,4,2,6,1459,1509,-50
1,19,5,2,6,1543,1524,19
1,19,6,2,6,1671,1601,70
1,19,7,2,6,1836,1408,428
1,19,8,2,6,1861,1245,616
1,19,9,2,6,1624,1391,233
1,19,10,2,6,1509,1375,134
1,19,11,2,6,1524,1178,346
1,19,12,2,6,1601,1262,339
1,20,0,2,6,1397,1299,98
1,20,1,2,6,1135,1408,-273
1,20,2,2,6,1250,1327,-77
1,20,3,2,6,1482,1046,436
1,20,4,2,6,1190,1003,187
1,20,5,2,6,1210,1005,205
1,20,6,2,6,1299,1031,268
1,20,7,2,6,1408,894,514
1,20,8,2,6,1327,873,454
1,20,9,2,6,1046,1029,17
1,20,10,2,6,1003,1033,-30
1,20,11,2,6,1005,1003,2
1,20,12,2,6,1031,1197,-166
1,21,0,2,6,1137,869,268
1,21,1,2,6,940,970,-30
1,21,2,2,6,973,910,63
1,21,3,2,6,1104,671,433
1,21,4,2,6,839,734,105
1,21,5,2,6,833,793,40
1,21,6,2,6,869,828,41
1,21,7,2,6,970,699,271
1,21,8,2,6,910,722,188
1,21,9,2,6,671,814,-143
1,21,10,2,6,734,804,-70
1,21,11,2,6,793,799,-6
1,21,12,2,6,828,888,-60
1,22,0,2,6,881,938,-57
1,22,1,2,6,766,1093,-327
1,22,2,2,6,798,1091,-293
1,22,3,2,6,945,939,6
1,22,4,2,6,903,984,-81
1,22,5,2,6,919,1078,-159
1,22,6,2,6,938,1094,-156
1,22,7,2,6,1093,908,185
1,22,8,2,6,1091,863,228
1,22,9,2,6,939,840,99
1,22,10,2,6,984,735,249
1,22,11,2,6,1078,644,434
1,22,12,2,6,1094,610,484
1,0,0,3,6,1941,1921,20
1,0,1,3,6,1933,1918,15
1,0,2,3,6,1931,1902,29
1,0,3,3,6,1943,1894,49
1,0,4,3,6,1954,1895,59
1,0,5,3,6,1936,1910,26
1,0,6,3,6,1921,1916,5
1,0,7,3,6,1918,1928,-10
1,0,8,3,6,1902,1930,-28
1,0,9,3,6,1894,1913,-19
1,0,10,3,6,1895,1914,-19
1,0,11,3,6,1910,1922,-12
1,0,12,3,6,1916,1914,2
1,1,0,3,6,1979,1797,182
1,1,1,3,6,1977,1746,231
1,1,2,3,6,1974,1681,293
1,1,3,3,6,1940,1666,274
1,1,4,3,6,1910,1663,247
1,1,5,3,6,1855,1706,149
1,1,6,3,6,1797,1748,49
1,1,7,3,6,1746,1807,-61
1,1,8,3,6,1681,1862,-181
1,1,9,3,6,1666,1893,-227
1,1,10,3,6,1663,1933,-270
1,1,11,3,6,1706,1951,-245
1,1,12,3,6,1748,1955,-207
1,2,0,3,6,2037,1535,502
1,2,1,3,6,2019,1433,586
1,2,2,3,6,1977,1340,637
1,2,3,3,6,1882,1321,561
1,2,4,3,6,1788,1314,474
1,2,5,3,6,1663,1357,306
1,2,6,3,6,1535,1425,110
1,2,7,3,6,1433,1545,-112
1,2,8,3,6,1340,1680,-340
1,2,9,3,6,1321,1783,-462
1,2,10,3,6,1314,1881,-567
1,2,11,3,6,1357,1954,-597
1,2,12,3,6,1425,1998,-573
1,3,0,3,6,2088,1242,846
1,3,1,3,6,2023,1138,885
1,3,2,3,6,1895,1081,814
1,3,3,3,6,1746,1063,683
1,3,4,3,6,1595,1056,539
1,3,5,3,6,1413,1079,334
1,3,6,3,6,1242,1138,104
1,3,7,3,6,1138,1271,-133
1,3,8,3,6,1081,1449,-368
1,3,9,3,6,1063,1610,-547
1,3,10,3,6,1056,1762,-706
1,3,11,3,6,1079,1900,-821
1,3,12,3,6,1138,1997,-859
1,4,0,3,6,2028,1146,882
1,4,1,3,6,1910,1094,816
1,4,2,3,6,1718,1100,618
1,4,3,3,6,1567,1088,479
1,4,4,3,6,1432,1082,350
1,4,5,3,6,1278,1089,189
1,4,6,3,6,1146,1109,37
1,4,7,3,6,1094,1189,-95
1,4,8,3,6,1100,1327,-227
1,4,9,3,6,1088,1475,-387
1,4,10,3,6,1082,1629,-547
1,4,11,3,6,1089,1785,-696
1,4,12,3,6,1109,1919,-810
1,5,0,3,6,1811,1352,459
1,5,1,3,6,1665,1367,298
1,5,2,3,6,1496,1397,99
1,5,3,3,6,1410,1394,16
1,5,4,3,6,1386,1391,-5
1,5,5,3,6,1367,1389,-22
1,5,6,3,6,1352,1364,-12
1,5,7,3,6,1367,1362,5
1,5,8,3,6,1397,1401,-4
1,5,9,3,6,1394,1456,-62
1,5,10,3,6,1391,1536,-145
1,5,11,3,6,1389,1649,-260
1,5,12,3,6,1364,1789,-425
1,6,0,3,6,1725,1760,-35
1,6,1,3,6,1633,1790,-157
1,6,2,3,6,1527,1819,-292
1,6,3,3,6,1498,1831,-333
1,6,4,3,6,1582,1833,-251
1,6,5,3,6,1688,1847,-159
1,6,6,3,6,1760,1823,-63
1,6,7,3,6,1790,1788,2
1,6,8,3,6,1819,1732,87
1,6,9,3,6,1831,1697,134
1,6,10,3,6,1833,1714,119
1,6,11,3,6,1847,1748,99
1,6,12,3,6,1823,1838,-15
1,7,0,3,6,1497,1640,-143
1,7,1,3,6,1396,1663,-267
1,7,2,3,6,1354,1642,-288
1,7,3,3,6,1360,1618,-258
1,7,4,3,6,1462,1633,-171
1,7,5,3,6,1574,1669,-95
1,7,6,3,6,1640,1678,-38
1,7,7,3,6,1663,1660,3
1,7,8,3,6,1642,1605,37
1,7,9,3,6,1618,1565,53
1,7,10,3,6,1633,1550,83
1,7,11,3,6,1669,1562,107
1,7,12,3,6,1678,1640,38
1,8,0,3,6,1556,1867,-311
1,8,1,3,6,1522,1875,-353
1,8,2,3,6,1613,1836,-223
1,8,3,3,6,1696,1792,-96
1,8,4,3,6,1803,1808,-5
1,8,5,3,6,1842,1855,-13
1,8,6,3,6,1867,1909,-42
1,8,7,3,6,1875,1898,-23
1,8,8,3,6,1836,1852,-16
1,8,9,3,6,1792,1828,-36
1,8,10,3,6,1808,1778,30
1,8,11,3,6,1855,1733,122
1,8,12,3,6,1909,1727,182
1,9,0,3,6,1813,2301,-488
1,9,1,3,6,1854,2266,-412
1,9,2,3,6,2095,2172,-77
1,9,3,3,6,2298,2085,213
1,9,4,3,6,2403,2109,294
1,9,5,3,6,2316,2200,116
1,9,6,3,6,2301,2318,-17
1,9,7,3,6,2266,2317,-51
1,9,8,3,6,2172,2335,-163
1,9,9,3,6,2085,2379,-294
1,9,10,3,6,2109,2319,-210
1,9,11,3,6,2200,2221,-21
1,9,12,3,6,2318,2113,205
1,10,0,3,6,2396,3029,-633
1,10,1,3,6,2561,2917,-356
1,10,2,3,6,2881,2749,132
1,10,3,3,6,3217,2570,647
1,10,4,3,6,3309,2630,679
1,10,5,3,6,3111,2828,283
1,10,6,3,6,3029,3039,-10
1,10,7,3,6,2917,3088,-171
1,10,8,3,6,2749,3198,-449
1,10,9,3,6,2570,3333,-763
1,10,10,3,6,2630,3304,-674
1,10,11,3,6,2828,3137,-309
1,10,12,3,6,3039,2885,154
1,11,0,3,6,2824,3179,-355
1,11,1,3,6,2994,3005,-11
1,11,2,3,6,3275,2725,550
1,11,3,3,6,3668,2406,1262
1,11,4,3,6,3685,2522,1163
1,11,5,3,6,3422,2850,572
1,11,6,3,6,3179,3155,24
1,11,7,3,6,3005,3325,-320
1,11,8,3,6,2725,3564,-839
1,11,9,3,6,2406,3794,-1388
1,11,10,3,6,2522,3843,-1321
1,11,11,3,6,2850,3670,-820
1,11,12,3,6,3155,3378,-223
1,12,0,3,6,2932,2890,42
1,12,1,3,6,3009,2714,295
1,12,2,3,6,3222,2345,877
1,12,3,3,6,3610,1926,1684
1,12,4,3,6,3550,2086,1464
1,12,5,3,6,3297,2480,817
1,12,6,3,6,2890,2814,76
1,12,7,3,6,2714,3112,-398
1,12,8,3,6,2345,3441,-1096
1,12,9,3,6,1926,3691,-1765
1,12,10,3,6,2086,3800,-1714
1,12,11,3,6,2480,3656,-1176
1,12,12,3,6,2814,3440,-626
1,13,0,3,6,2964,2815,149
1,13,1,3,6,2997,2662,335
1,13,2,3,6,3201,2261,940
1,13,3,3,6,3592,1819,1773
1,13,4,3,6,3511,2008,1503
1,13,5,3,6,3292,2402,890
1,13,6,3,6,2815,2690,125
1,13,7,3,6,2662,3061,-399
1,13,8,3,6,2261,3410,-1149
1,13,9,3,6,1819,3608,-1789
1,13,10,3,6,2008,3717,-1709
1,13,11,3,6,2402,3556,-1154
1,13,12,3,6,2690,3417,-727
1,14,0,3,6,2870,2799,71
1,14,1,3,6,2901,2703,198
1,14,2,3,6,3165,2303,862
1,14,3,3,6,3581,1878,1703
1,14,4,3,6,3511,2077,1434
1,14,5,3,6,3271,2465,806
1,14,6,3,6,2799,2705,94
1,14,7,3,6,2703,3030,-327
1,14,8,3,6,2303,3367,-1064
1,14,9,3,6,1878,3537,-1659
1,14,10,3,6,2077,3609,-1532
1,14,11,3,6,2465,3363,-898
1,14,12,3,6,2705,3277,-572
1,15,0,3,6,2672,2656,16
1,15,1,3,6,2716,2565,151
1,15,2,3,6,3074,2136,938
1,15,3,3,6,3502,1708,1794
1,15,4,3,6,3379,1921,1458
1,15,5,3,6,3091,2327,764
1,15,6,3,6,2656,2574,82
1,15,7,3,6,2565,2770,-205
1,15,8,3,6,2136,3083,-947
1,15,9,3,6,1708,3317,-1609
1,15,10,3,6,1921,3375,-1454
1,15,11,3,6,2327,3020,-693
1,15,12,3,6,2574,2954,-380
1,16,0,3,6,2565,2263,302
1,16,1,3,6,2538,2269,269
1,16,2,3,6,2864,1932,932
1,16,3,3,6,3197,1647,1550
1,16,4,3,6,2999,1792,1207
1,16,5,3,6,2637,2053,584
1,16,6,3,6,2263,2297,-34
1,16,7,3,6,2269,2317,-48
1,16,8,3,6,1932,2549,-617
1,16,9,3,6,1647,2817,-1170
1,16,10,3,6,1792,2919,-1127
1,16,11,3,6,2053,2647,-594
1,16,12,3,6,2297,2574,-277
1,17,0,3,6,2509,2098,411
1,17,1,3,6,2342,2193,149
1,17,2,3,6,2543,2050,493
1,17,3,3,6,2795,1829,966
1,17,4,3,6,2498,1849,649
1,17,5,3,6,2266,2003,263
1,17,6,3,6,2098,2248,-150
1,17,7,3,6,2193,2117,76
1,17,8,3,6,2050,2150,-100
1,17,9,3,6,1829,2427,-598
1,17,10,3,6,1849,2549,-700
1,17,11,3,6,2003,2300,-297
1,17,12,3,6,2248,2250,-2
1,18,0,3,6,2423,2212,211
1,18,1,3,6,2135,2415,-280
1,18,2,3,6,2283,2387,-104
1,18,3,3,6,2578,2141,437
1,18,4,3,6,2258,2035,223
1,18,5,3,6,2179,2042,137
1,18,6,3,6,2212,2193,19
1,18,7,3,6,2415,1966,449
1,18,8,3,6,2387,1853,534
1,18,9,3,6,2141,2096,45
1,18,10,3,6,2035,2162,-127
1,18,11,3,6,2042,1979,63
1,18,12,3,6,2193,2026,167
1,19,0,3,6,2225,2069,156
1,19,1,3,6,1845,2264,-419
1,19,2,3,6,1969,2241,-272
1,19,3,3,6,2284,1883,401
1,19,4,3,6,1881,1782,99
1,19,5,3,6,1929,1814,115
1,19,6,3,6,2069,1917,152
1,19,7,3,6,2264,1691,573
1,19,8,3,6,2241,1576,665
1,19,9,3,6,1883,1799,84
1,19,10,3,6,1782,1817,-35
1,19,11,3,6,1814,1673,141
1,19,12,3,6,1917,1860,57
1,20,0,3,6,1841,1770,71
1,20,1,3,6,1527,1950,-423
1,20,2,3,6,1663,1857,-194
1,20,3,3,6,1970,1458,512
1,20,4,3,6,1607,1464,143
1,20,5,3,6,1657,1508,149
1,20,6,3,6,1770,1543,227
1,20,7,3,6,1950,1310,640
1,20,8,3,6,1857,1264,593
1,20,9,3,6,1458,1435,23
1,20,10,3,6,1464,1395,69
1,20,11,3,6,1508,1307,201
1,20,12,3,6,1543,1487,56
1,21,0,3,6,1574,1336,238
1,21,1,3,6,1314,1521,-207
1,21,2,3,6,1358,1471,-113
1,21,3,3,6,1561,1198,363
1,21,4,3,6,1325,1257,68
1,21,5,3,6,1305,1368,-63
1,21,6,3,6,1336,1410,-74
1,21,7,3,6,1521,1191,330
1,21,8,3,6,1471,1194,277
1,21,9,3,6,1198,1248,-50
1,21,10,3,6,1257,1177,80
1,21,11,3,6,1368,1139,229
1,21,12,3,6,1410,1208,202
1,0,0,4,6,2612,2418,194
1,0,1,4,6,2604,2365,239
1,0,2,4,6,2600,2297,303
1,0,3,4,6,2574,2282,292
1,0,4,4,6,2549,2281,268
1,0,5,4,6,2485,2320,165
1,0,6,4,6,2418,2362,56
1,0,7,4,6,2365,2429,-64
1,0,8,4,6,2297,2489,-192
1,0,9,4,6,2282,2514,-232
1,0,10,4,6,2281,2552,-271
1,0,11,4,6,2320,2581,-261
1,0,12,4,6,2362,2585,-223
1,1,0,4,6,2687,2165,522
1,1,1,4,6,2665,2064,601
1,1,2,4,6,2619,1968,651
1,1,3,4,6,2525,1946,579
1,1,4,4,6,2431,1940,491
1,1,5,4,6,2298,1994,304
1,1,6,4,6,2165,2066,99
1,1,7,4,6,2064,2187,-123
1,1,8,4,6,1968,2320,-352
1,1,9,4,6,1946,2419,-473
1,1,10,4,6,1940,2521,-581
1,1,11,4,6,1994,2593,-599
1,1,12,4,6,2066,2632,-566
1,2,0,4,6,2746,1912,834
1,2,1,4,6,2683,1806,877
1,2,2,4,6,2558,1739,819
1,2,3,4,6,2412,1716,696
1,2,4,4,6,2267,1707,560
1,2,5,4,6,2084,1738,346
1,2,6,4,6,1912,1799,113
1,2,7,4,6,1806,1935,-129
1,2,8,4,6,1739,2112,-373
1,2,9,4,6,1716,2266,-550
1,2,10,4,6,1707,2417,-710
1,2,11,4,6,1738,2553,-815
1,2,12,4,6,1799,2647,-848
1,3,0,4,6,2699,1643,1056
1,3,1,4,6,2581,1541,1040
1,3,2,4,6,2387,1495,892
1,3,3,4,6,2198,1476,722
1,3,4,4,6,2027,1468,559
1,3,5,4,6,1827,1499,328
1,3,6,4,6,1643,1555,88
1,3,7,4,6,1541,1690,-149
1,3,8,4,6,1495,1886,-391
1,3,9,4,6,1476,2076,-600
1,3,10,4,6,1468,2267,-799
1,3,11,4,6,1499,2444,-945
1,3,12,4,6,1555,2590,-1035
1,4,0,4,6,2519,1720,799
1,4,1,4,6,2353,1685,668
1,4,2,4,6,2141,1684,457
1,4,3,4,6,1995,1674,321
1,4,4,4,6,1907,1668,239
1,4,5,4,6,1810,1677,133
1,4,6,4,6,1720,1682,38
1,4,7,4,6,1685,1742,-57
1,4,8,4,6,1684,1859,-175
1,4,9,4,6,1674,1982,-308
1,4,10,4,6,1668,2124,-456
1,4,11,4,6,1677,2291,-614
1,4,12,4,6,1682,2466,-784
1,5,0,4,6,2434,2137,297
1,5,1,4,6,2297,2163,134
1,5,2,4,6,2108,2218,-110
1,5,3,4,6,2028,2226,-198
1,5,4,4,6,2061,2226,-165
1,5,5,4,6,2109,2228,-119
1,5,6,4,6,2137,2197,-60
1,5,7,4,6,2163,2178,-15
1,5,8,4,6,2218,2164,54
1,5,9,4,6,2226,2180,46
1,5,10,4,6,2226,2250,-24
1,5,11,4,6,2228,2347,-119
1,5,12,4,6,2197,2487,-290
1,6,0,4,6,2108,2041,67
1,6,1,4,6,1954,2066,-112
1,6,2,4,6,1846,2056,-210
1,6,3,4,6,1812,2031,-219
1,6,4,4,6,1894,2045,-151
1,6,5,4,6,1988,2089,-101
1,6,6,4,6,2041,2095,-54
1,6,7,4,6,2066,2079,-13
1,6,8,4,6,2056,2042,14
1,6,9,4,6,2031,2031,0
1,6,10,4,6,2045,2055,-10
1,6,11,4,6,2089,2106,-17
1,6,12,4,6,2095,2233,-138
1,7,0,4,6,2047,2441,-394
1,7,1,4,6,1965,2466,-501
1,7,2,4,6,2036,2420,-384
1,7,3,4,6,2124,2378,-254
1,7,4,4,6,2278,2394,-116
1,7,5,4,6,2374,2443,-69
1,7,6,4,6,2441,2482,-41
1,7,7,4,6,2466,2451,15
1,7,8,4,6,2420,2384,36
1,7,9,4,6,2378,2335,43
1,7,10,4,6,2394,2273,121
1,7,11,4,6,2443,2239,204
1,7,12,4,6,2482,2274,208
1,8,0,4,6,2436,3086,-650
1,8,1,4,6,2486,3062,-576
1,8,2,4,6,2707,2993,-286
1,8,3,4,6,2916,2917,-1
1,8,4,4,6,3078,2944,134
1,8,5,4,6,3058,3039,19
1,8,6,4,6,3086,3151,-65
1,8,7,4,6,3062,3133,-71
1,8,8,4,6,2993,3098,-105
1,8,9,4,6,2917,3103,-186
1,8,10,4,6,2944,3033,-89
1,8,11,4,6,3039,2919,120
1,8,12,4,6,3151,2811,340
1,9,0,4,6,2779,3310,-531
1,9,1,4,6,2882,3193,-311
1,9,2,4,6,3200,2986,214
1,9,3,4,6,3531,2770,761
1,9,4,4,6,3621,2842,779
1,9,5,4,6,3411,3070,341
1,9,6,4,6,3310,3311,-1
1,9,7,4,6,3193,3379,-186
1,9,8,4,6,2986,3508,-522
1,9,9,4,6,2770,3667,-897
1,9,10,4,6,2842,3645,-803
1,9,11,4,6,3070,3495,-425
1,9,12,4,6,3311,3280,31
1,10,0,4,6,3374,3980,-606
1,10,1,4,6,3563,3808,-245
1,10,2,4,6,3957,3503,454
1,10,3,4,6,4432,3166,1266
1,10,4,4,6,4501,3283,1218
1,10,5,4,6,4222,3624,598
1,10,6,4,6,3980,3959,21
1,10,7,4,6,3808,4116,-308
1,10,8,4,6,3503,4343,-840
1,10,9,4,6,3166,4564,-1398
1,10,10,4,6,3283,4566,-1283
1,10,11,4,6,3624,4347,-723
1,10,12,4,6,3959,4012,-53
1,11,0,4,6,3812,4109,-297
1,11,1,4,6,3973,3901,72
1,11,2,4,6,4316,3502,814
1,11,3,4,6,4830,3051,1779
1,11,4,4,6,4825,3222,1603
1,11,5,4,6,4513,3664,849
1,11,6,4,6,4109,4056,53
1,11,7,4,6,3901,4347,-446
1,11,8,4,6,3502,4687,-1185
1,11,9,4,6,3051,4966,-1915
1,11,10,4,6,3222,5055,-1833
1,11,11,4,6,3664,4842,-1178
1,11,12,4,6,4056,4524,-468
1,12,0,4,6,3930,3824,106
1,12,1,4,6,4025,3589,436
1,12,2,4,6,4306,3075,1231
1,12,3,4,6,4825,2504,2321
1,12,4,4,6,4729,2741,1988
1,12,5,4,6,4387,3272,1115
1,12,6,4,6,3824,3683,141
1,12,7,4,6,3589,4123,-534
1,12,8,4,6,3075,4583,-1508
1,12,9,4,6,2504,4896,-2392
1,12,10,4,6,2741,5043,-2302
1,12,11,4,6,3272,4830,-1558
1,12,12,4,6,3683,4584,-901
1,13,0,4,6,3848,3750,98
1,13,1,4,6,3903,3594,309
1,13,2,4,6,4241,3057,1184
1,13,3,4,6,4796,2474,2322
1,13,4,4,6,4703,2730,1973
1,13,5,4,6,4382,3261,1121
1,13,6,4,6,3750,3625,125
1,13,7,4,6,3594,4058,-464
1,13,8,4,6,3057,4512,-1455
1,13,9,4,6,2474,4768,-2294
1,13,10,4,6,2730,4871,-2141
1,13,11,4,6,3261,4573,-1312
1,13,12,4,6,3625,4404,-779
1,14,0,4,6,3660,3586,74
1,14,1,4,6,3695,3461,234
1,14,2,4,6,4115,2913,1202
1,14,3,4,6,4664,2353,2311
1,14,4,4,6,4519,2621,1898
1,14,5,4,6,4182,3141,1041
1,14,6,4,6,3586,3475,111
1,14,7,4,6,3461,3792,-331
1,14,8,4,6,2913,4206,-1293
1,14,9,4,6,2353,4489,-2136
1,14,10,4,6,2621,4587,-1966
1,14,11,4,6,3141,4192,-1051
1,14,12,4,6,3475,4100,-625
1,15,0,4,6,3563,3197,366
1,15,1,4,6,3554,3144,410
1,15,2,4,6,3948,2662,1286
1,15,3,4,6,4412,2225,2187
1,15,4,4,6,4178,2447,1731
1,15,5,4,6,3727,2845,882
1,15,6,4,6,3197,3166,31
1,15,7,4,6,3144,3328,-184
1,15,8,4,6,2662,3691,-1029
1,15,9,4,6,2225,4022,-1797
1,15,10,4,6,2447,4162,-1715
1,15,11,4,6,2845,3821,-976
1,15,12,4,6,3166,3718,-552
1,16,0,4,6,3393,3033,360
1,16,1,4,6,3248,3125,123
1,16,2,4,6,3583,2846,737
1,16,3,4,6,3999,2484,1515
1,16,4,4,6,3690,2571,1119
1,16,5,4,6,3356,2862,494
1,16,6,4,6,3033,3183,-150
1,16,7,4,6,3125,3114,11
1,16,8,4,6,2846,3252,-406
1,16,9,4,6,2484,3587,-1103
1,16,10,4,6,2571,3703,-1132
1,16,11,4,6,2862,3317,-455
1,16,12,4,6,3183,3237,-54
1,17,0,4,6,3213,2999,214
1,17,1,4,6,2929,3173,-244
1,17,2,4,6,3233,2997,236
1,17,3,4,6,3661,2616,1045
1,17,4,4,6,3266,2579,687
1,17,5,4,6,3090,2718,372
1,17,6,4,6,2999,2963,36
1,17,7,4,6,3173,2728,445
1,17,8,4,6,2997,2692,305
1,17,9,4,6,2616,3048,-432
1,17,10,4,6,2579,3140,-561
1,17,11,4,6,2718,2808,-90
1,17,12,4,6,2963,2849,114
1,18,0,4,6,3116,2610,506
1,18,1,4,6,2683,2843,-160
1,18,2,4,6,2843,2767,76
1,18,3,4,6,3194,2400,794
1,18,4,4,6,2680,2308,372
1,18,5,4,6,2565,2332,233
1,18,6,4,6,2610,2509,101
1,18,7,4,6,2843,2249,594
1,18,8,4,6,2767,2184,583
1,18,9,4,6,2400,2504,-104
1,18,10,4,6,2308,2604,-296
1,18,11,4,6,2332,2474,-142
1,18,12,4,6,2509,2624,-115
1,19,0,4,6,2669,2540,129
1,19,1,4,6,2237,2806,-569
1,19,2,4,6,2382,2771,-389
1,19,3,4,6,2772,2295,477
1,19,4,4,6,2298,2243,55
1,19,5,4,6,2376,2317,59
1,19,6,4,6,2540,2429,111
1,19,7,4,6,2806,2107,699
1,19,8,4,6,2771,1967,804
1,19,9,4,6,2295,2205,90
1,19,10,4,6,2243,2179,64
1,19,11,4,6,2317,1977,340
1,19,12,4,6,2429,2150,279
1,20,0,4,6,2278,2237,41
1,20,1,4,6,1901,2501,-600
1,20,2,4,6,2048,2418,-370
1,20,3,4,6,2427,1985,442
1,20,4,4,6,2093,1987,106
1,20,5,4,6,2129,2083,46
1,20,6,4,6,2237,2125,112
1,20,7,4,6,2501,1802,699
1,20,8,4,6,2418,1736,682
1,20,9,4,6,1985,1869,116
1,20,10,4,6,1987,1768,219
1,20,11,4,6,2083,1647,436
1,20,12,4,6,2125,1807,318
1,0,0,5,6,3320,2786,534
1,0,1,5,6,3292,2683,609
1,0,2,5,6,3245,2584,661
1,0,3,5,6,3159,2562,597
1,0,4,5,6,3070,2558,512
1,0,5,5,6,2928,2608,320
1,0,6,5,6,2786,2680,106
1,0,7,5,6,2683,2809,-126
1,0,8,5,6,2584,2947,-363
1,0,9,5,6,2562,3040,-478
1,0,10,5,6,2558,3140,-582
1,0,11,5,6,2608,3223,-615
1,0,12,5,6,2680,3262,-582
1,1,0,5,6,3396,2542,854
1,1,1,5,6,3329,2437,892
1,1,2,5,6,3200,2367,833
1,1,3,5,6,3055,2341,714
1,1,4,5,6,2910,2333,577
1,1,5,5,6,2719,2375,344
1,1,6,5,6,2542,2440,102
1,1,7,5,6,2437,2577,-140
1,1,8,5,6,2367,2752,-385
1,1,9,5,6,2341,2902,-561
1,1,10,5,6,2333,3057,-724
1,1,11,5,6,2375,3192,-817
1,1,12,5,6,2440,3281,-841
1,2,0,5,6,3357,2313,1044
1,2,1,5,6,3241,2209,1032
1,2,2,5,6,3050,2153,897
1,2,3,5,6,2864,2129,735
1,2,4,5,6,2699,2119,580
1,2,5,5,6,2498,2158,340
1,2,6,5,6,2313,2216,97
1,2,7,5,6,2209,2354,-145
1,2,8,5,6,2153,2549,-396
1,2,9,5,6,2129,2732,-603
1,2,10,5,6,2119,2922,-803
1,2,11,5,6,2158,3097,-939
1,2,12,5,6,2216,3240,-1024
1,3,0,5,6,3190,2217,973
1,3,1,5,6,3024,2132,892
1,3,2,5,6,2810,2079,731
1,3,3,5,6,2626,2062,564
1,3,4,5,6,2502,2054,448
1,3,5,5,6,2359,2087,272
1,3,6,5,6,2217,2128,89
1,3,7,5,6,2132,2243,-111
1,3,8,5,6,2079,2418,-339
1,3,9,5,6,2062,2583,-521
1,3,10,5,6,2054,2762,-708
1,3,11,5,6,2087,2950,-863
1,3,12,5,6,2128,3137,-1009
1,4,0,5,6,3142,2505,637
1,4,1,5,6,2985,2481,504
1,4,2,5,6,2753,2505,248
1,4,3,5,6,2613,2506,107
1,4,4,5,6,2582,2503,79
1,4,5,5,6,2552,2516,36
1,4,6,5,6,2505,2515,-10
1,4,7,5,6,2481,2558,-77
1,4,8,5,6,2505,2622,-117
1,4,9,5,6,2506,2706,-200
1,4,10,5,6,2503,2838,-335
1,4,11,5,6,2516,2989,-473
1,4,12,5,6,2515,3164,-649
1,5,0,5,6,2817,2418,399
1,5,1,5,6,2618,2439,179
1,5,2,5,6,2427,2455,-28
1,5,3,5,6,2342,2426,-84
1,5,4,5,6,2373,2438,-65
1,5,5,5,6,2409,2470,-61
1,5,6,5,6,2418,2469,-51
1,5,7,5,6,2439,2469,-30
1,5,8,5,6,2455,2474,-19
1,5,9,5,6,2426,2514,-88
1,5,10,5,6,2438,2591,-153
1,5,11,5,6,2470,2705,-235
1,5,12,5,6,2469,2882,-413
1,6,0,5,6,2658,2842,-184
1,6,1,5,6,2523,2869,-346
1,6,2,5,6,2528,2834,-306
1,6,3,5,6,2576,2791,-215
1,6,4,5,6,2710,2806,-96
1,6,5,5,6,2788,2863,-75
1,6,6,5,6,2842,2899,-57
1,6,7,5,6,2869,2870,-1
1,6,8,5,6,2834,2821,13
1,6,9,5,6,2791,2801,-10
1,6,10,5,6,2806,2778,28
1,6,11,5,6,2863,2783,80
1,6,12,5,6,2899,2867,32
1,7,0,5,6,2927,3660,-733
1,7,1,5,6,2929,3653,-724
1,7,2,5,6,3130,3577,-447
1,7,3,5,6,3344,3503,-159
1,7,4,5,6,3553,3530,23
1,7,5,5,6,3590,3627,-37
1,7,6,5,6,3660,3724,-64
1,7,7,5,6,3653,3686,-33
1,7,8,5,6,3577,3630,-53
1,7,9,5,6,3503,3610,-107
1,7,10,5,6,3530,3528,2
1,7,11,5,6,3627,3425,202
1,7,12,5,6,3724,3358,366
1,8,0,5,6,3402,4095,-693
1,8,1,5,6,3514,3989,-475
1,8,2,5,6,3812,3807,5
1,8,3,5,6,4149,3602,547
1,8,4,5,6,4296,3677,619
1,8,5,5,6,4153,3909,244
1,8,6,5,6,4095,4144,-49
1,8,7,5,6,3989,4195,-206
1,8,8,5,6,3807,4271,-464
1,8,9,5,6,3602,4391,-789
1,8,10,5,6,3677,4359,-682
1,8,11,5,6,3909,4193,-284
1,8,12,5,6,4144,3978,166
1,9,0,5,6,3757,4261,-504
1,9,1,5,6,3884,4084,-200
1,9,2,5,6,4276,3740,536
1,9,3,5,6,4746,3366,1380
1,9,4,5,6,4813,3495,1318
1,9,5,5,6,4522,3866,656
1,9,6,5,6,4261,4231,30
1,9,7,5,6,4084,4407,-323
1,9,8,5,6,3740,4653,-913
1,9,9,5,6,3366,4898,-1532
1,9,10,5,6,3495,4907,-1412
1,9,11,5,6,3866,4705,-839
1,9,12,5,6,4231,4407,-176
1,10,0,5,6,4362,4910,-548
1,10,1,5,6,4542,4704,-162
1,10,2,5,6,4998,4280,718
1,10,3,5,6,5594,3811,1783
1,10,4,5,6,5641,3983,1658
1,10,5,5,6,5313,4438,875
1,10,6,5,6,4910,4860,50
1,10,7,5,6,4704,5138,-434
1,10,8,5,6,4280,5466,-1186
1,10,9,5,6,3811,5736,-1925
1,10,10,5,6,3983,5778,-1795
1,10,11,5,6,4438,5519,-1081
1,10,12,5,6,4860,5158,-298
1,11,0,5,6,4810,5043,-233
1,11,1,5,6,4989,4776,213
1,11,2,5,6,5400,4232,1168
1,11,3,5,6,6045,3629,2416
1,11,4,5,6,6004,3877,2127
1,11,5,5,6,5603,4456,1147
1,11,6,5,6,5043,4925,118
1,11,7,5,6,4776,5358,-582
1,11,8,5,6,4232,5829,-1597
1,11,9,5,6,3629,6171,-2542
1,11,10,5,6,3877,6298,-2421
1,11,11,5,6,4456,6016,-1560
1,11,12,5,6,4925,5668,-743
1,12,0,5,6,4814,4759,55
1,12,1,5,6,4931,4521,410
1,12,2,5,6,5346,3871,1475
1,12,3,5,6,6029,3159,2870
1,12,4,5,6,5921,3463,2458
1,12,5,5,6,5477,4131,1346
1,12,6,5,6,4759,4618,141
1,12,7,5,6,4521,5120,-599
1,12,8,5,6,3871,5685,-1814
1,12,9,5,6,3159,6056,-2897
1,12,10,5,6,3463,6197,-2734
1,12,11,5,6,4131,5847,-1716
1,12,12,5,6,4618,5571,-953
1,13,0,5,6,4638,4537,101
1,13,1,5,6,4697,4352,345
1,13,2,5,6,5191,3667,1524
1,13,3,5,6,5879,2949,2930
1,13,4,5,6,5711,3274,2437
1,13,5,5,6,5293,3937,1356
1,13,6,5,6,4537,4395,142
1,13,7,5,6,4352,4820,-468
1,13,8,5,6,3667,5351,-1684
1,13,9,5,6,2949,5720,-2771
1,13,10,5,6,3274,5849,-2575
1,13,11,5,6,3937,5402,-1465
1,13,12,5,6,4395,5227,-832
1,14,0,5,6,4551,4127,424
1,14,1,5,6,4533,4040,493
1,14,2,5,6,4989,3439,1550
1,14,3,5,6,5574,2870,2704
1,14,4,5,6,5318,3147,2171
1,14,5,5,6,4818,3659,1159
1,14,6,5,6,4127,4067,60
1,14,7,5,6,4040,4350,-310
1,14,8,5,6,3439,4814,-1375
1,14,9,5,6,2870,5194,-2324
1,14,10,5,6,3147,5374,-2227
1,14,11,5,6,3659,4993,-1334
1,14,12,5,6,4067,4864,-797
1,15,0,5,6,4391,3967,424
1,15,1,5,6,4264,4000,264
1,15,2,5,6,4667,3576,1091
1,15,3,5,6,5214,3062,2152
1,15,4,5,6,4869,3226,1643
1,15,5,5,6,4446,3654,792
1,15,6,5,6,3967,4052,-85
1,15,7,5,6,4000,4125,-125
1,15,8,5,6,3576,4394,-818
1,15,9,5,6,3062,4792,-1730
1,15,10,5,6,3226,4946,-1720
1,15,11,5,6,3654,4491,-837
1,15,12,5,6,4052,4381,-329
1,16,0,5,6,4097,3934,163
1,16,1,5,6,3835,4105,-270
1,16,2,5,6,4273,3793,480
1,16,3,5,6,4865,3271,1594
1,16,4,5,6,4458,3301,1157
1,16,5,5,6,4180,3577,603
1,16,6,5,6,3934,3898,36
1,16,7,5,6,4105,3725,380
1,16,8,5,6,3793,3794,-1
1,16,9,5,6,3271,4208,-937
1,16,10,5,6,3301,4294,-993
1,16,11,5,6,3577,3825,-248
1,16,12,5,6,3898,3836,62
1,17,0,5,6,3906,3397,509
1,17,1,5,6,3477,3601,-124
1,17,2,5,6,3793,3377,416
1,17,3,5,6,4277,2875,1402
1,17,4,5,6,3688,2852,836
1,17,5,5,6,3476,3008,468
1,17,6,5,6,3397,3279,118
1,17,7,5,6,3601,3011,590
1,17,8,5,6,3377,3023,354
1,17,9,5,6,2875,3456,-581
1,17,10,5,6,2852,3582,-730
1,17,11,5,6,3008,3303,-295
1,17,12,5,6,3279,3447,-168
1,18,0,5,6,3560,3081,479
1,18,1,5,6,3075,3385,-310
1,18,2,5,6,3256,3297,-41
1,18,3,5,6,3682,2812,870
1,18,4,5,6,3097,2769,328
1,18,5,5,6,3012,2835,177
1,18,6,5,6,3081,3021,60
1,18,7,5,6,3385,2665,720
1,18,8,5,6,3297,2575,722
1,18,9,5,6,2812,2910,-98
1,18,10,5,6,2769,2966,-197
1,18,11,5,6,2835,2778,57
1,18,12,5,6,3021,2914,107
1,19,0,5,6,3106,3007,99
1,19,1,5,6,2611,3357,-746
1,19,2,5,6,2767,3332,-565
1,19,3,5,6,3229,2822,407
1,19,4,5,6,2784,2766,18
1,19,5,5,6,2848,2892,-44
1,19,6,5,6,3007,3011,-4
1,19,7,5,6,3357,2599,758
1,19,8,5,6,3332,2439,893
1,19,9,5,6,2822,2639,183
1,19,10,5,6,2766,2552,214
1,19,11,5,6,2892,2317,575
1,19,12,5,6,3011,2470,541
1,0,0,6,6,4029,3163,866
1,0,1,6,6,3956,3056,900
1,0,2,6,6,3826,2983,843
1,0,3,6,6,3689,2957,732
1,0,4,6,6,3549,2951,598
1,0,5,6,6,3349,2989,360
1,0,6,6,6,3163,3054,109
1,0,7,6,6,3056,3199,-143
1,0,8,6,6,2983,3379,-396
1,0,9,6,6,2957,3523,-566
1,0,10,6,6,2951,3676,-725
1,0,11,6,6,2989,3822,-833
1,0,12,6,6,3054,3911,-857
1,1,0,6,6,4007,2943,1064
1,1,1,6,6,3887,2840,1047
1,1,2,6,6,3692,2781,911
1,1,3,6,6,3507,2754,753
1,1,4,6,6,3342,2745,597
1,1,5,6,6,3133,2795,338
1,1,6,6,6,2943,2857,86
1,1,7,6,6,2840,2996,-156
1,1,8,6,6,2781,3189,-408
1,1,9,6,6,2754,3368,-614
1,1,10,6,6,2745,3562,-817
1,1,11,6,6,2795,3736,-941
1,1,12,6,6,2857,3874,-1017
1,2,0,6,6,3848,2887,961
1,2,1,6,6,3684,2800,884
1,2,2,6,6,3473,2737,736
1,2,3,6,6,3292,2715,577
1,2,4,6,6,3174,2705,469
1,2,5,6,6,3030,2746,284
1,2,6,6,6,2887,2789,98
1,2,7,6,6,2800,2907,-107
1,2,8,6,6,2737,3081,-344
1,2,9,6,6,2715,3239,-524
1,2,10,6,6,2705,3417,-712
1,2,11,6,6,2746,3603,-857
1,2,12,6,6,2789,3787,-998
1,3,0,6,6,3813,3002,811
1,3,1,6,6,3656,2928,728
1,3,2,6,6,3422,2900,522
1,3,3,6,6,3244,2894,350
1,3,4,6,6,3177,2889,288
1,3,5,6,6,3101,2926,175
1,3,6,6,6,3002,2961,41
1,3,7,6,6,2928,3059,-131
1,3,8,6,6,2900,3181,-281
1,3,9,6,6,2894,3307,-413
1,3,10,6,6,2889,3476,-587
1,3,11,6,6,2926,3648,-722
1,3,12,6,6,2961,3835,-874
1,4,0,6,6,3525,2786,739
1,4,1,6,6,3306,2757,549
1,4,2,6,6,3072,2742,330
1,4,3,6,6,2927,2706,221
1,4,4,6,6,2894,2715,179
1,4,5,6,6,2852,2758,94
1,4,6,6,6,2786,2787,-1
1,4,7,6,6,2757,2849,-92
1,4,8,6,6,2742,2932,-190
1,4,9,6,6,2706,3040,-334
1,4,10,6,6,2715,3179,-464
1,4,11,6,6,2758,3347,-589
1,4,12,6,6,2787,3559,-772
1,5,0,6,6,3367,3219,148
1,5,1,6,6,3187,3242,-55
1,5,2,6,6,3109,3233,-124
1,5,3,6,6,3106,3186,-80
1,5,4,6,6,3189,3199,-10
1,5,5,6,6,3209,3244,-35
1,5,6,6,6,3219,3273,-54
1,5,7,6,6,3242,3260,-18
1,5,8,6,6,3233,3253,-20
1,5,9,6,6,3186,3284,-98
1,5,10,6,6,3199,3314,-115
1,5,11,6,6,3244,3382,-138
1,5,12,6,6,3273,3516,-243
1,6,0,6,6,3538,4061,-523
1,6,1,6,6,3487,4056,-569
1,6,2,6,6,3622,3991,-369
1,6,3,6,6,3796,3916,-120
1,6,4,6,6,3985,3942,43
1,6,5,6,6,4004,4047,-43
1,6,6,6,6,4061,4141,-80
1,6,7,6,6,4056,4105,-49
1,6,8,6,6,3991,4067,-76
1,6,9,6,6,3916,4076,-160
1,6,10,6,6,3942,4033,-91
1,6,11,6,6,4047,3969,78
1,6,12,6,6,4141,3951,190
1,7,0,6,6,3893,4669,-776
1,7,1,6,6,3957,4580,-623
1,7,2,6,6,4235,4391,-156
1,7,3,6,6,4577,4188,389
1,7,4,6,6,4771,4263,508
1,7,5,6,6,4685,4497,188
1,7,6,6,6,4669,4717,-48
1,7,7,6,6,4580,4748,-168
1,7,8,6,6,4391,4803,-412
1,7,9,6,6,4188,4898,-710
1,7,10,6,6,4263,4854,-591
1,7,11,6,6,4497,4699,-202
1,7,12,6,6,4717,4525,192
1,8,0,6,6,4380,5046,-666
1,8,1,6,6,4516,4880,-364
1,8,2,6,6,4888,4561,327
1,8,3,6,6,5364,4198,1166
1,8,4,6,6,5488,4330,1158
1,8,5,6,6,5264,4705,559
1,8,6,6,6,5046,5064,-18
1,8,7,6,6,4880,5223,-343
1,8,8,6,6,4561,5416,-855
1,8,9,6,6,4198,5622,-1424
1,8,10,6,6,4330,5621,-1291
1,8,11,6,6,4705,5403,-698
1,8,12,6,6,5064,5105,-41
1,9,0,6,6,4745,5191,-446
1,9,1,6,6,4863,4980,-117
1,9,2,6,6,5317,4517,800
1,9,3,6,6,5908,4011,1897
1,9,4,6,6,5953,4195,1758
1,9,5,6,6,5613,4680,933
1,9,6,6,6,5191,5132,59
1,9,7,6,6,4980,5429,-449
1,9,8,6,6,4517,5776,-1259
1,9,9,6,6,4011,6070,-2059
1,9,10,6,6,4195,6119,-1924
1,9,11,6,6,4680,5877,-1197
1,9,12,6,6,5132,5553,-421
1,10,0,6,6,5360,5844,-484
1,10,1,6,6,5558,5579,-21
1,10,2,6,6,6082,5010,1072
1,10,3,6,6,6809,4389,2420
1,10,4,6,6,6820,4638,2182
1,10,5,6,6,6403,5230,1173
1,10,6,6,6,5844,5729,115
1,10,7,6,6,5579,6149,-570
1,10,8,6,6,5010,6608,-1598
1,10,9,6,6,4389,6941,-2552
1,10,10,6,6,4638,7021,-2383
1,10,11,6,6,5230,6693,-1463
1,10,12,6,6,5729,6302,-573
1,11,0,6,6,5694,5978,-284
1,11,1,6,6,5895,5708,187
1,11,2,6,6,6440,5028,1412
1,11,3,6,6,7249,4284,2965
1,11,4,6,6,7196,4599,2597
1,11,5,6,6,6693,5315,1378
1,11,6,6,6,5978,5860,118
1,11,7,6,6,5708,6355,-647
1,11,8,6,6,5028,6931,-1903
1,11,9,6,6,4284,7331,-3047
1,11,10,6,6,4599,7452,-2853
1,11,11,6,6,5315,7033,-1718
1,11,12,6,6,5860,6655,-795
1,12,0,6,6,5604,5546,58
1,12,1,6,6,5725,5279,446
1,12,2,6,6,6296,4481,1815
1,12,3,6,6,7112,3634,3478
1,12,4,6,6,6929,4007,2922
1,12,5,6,6,6388,4807,1581
1,12,6,6,6,5546,5388,158
1,12,7,6,6,5279,5882,-603
1,12,8,6,6,4481,6524,-2043
1,12,9,6,6,3634,7008,-3374
1,12,10,6,6,4007,7175,-3168
1,12,11,6,6,4807,6676,-1869
1,12,12,6,6,5388,6394,-1006
1,13,0,6,6,5529,5078,451
1,13,1,6,6,5535,4931,604
1,13,2,6,6,6065,4193,1872
1,13,3,6,6,6789,3466,3323
1,13,4,6,6,6510,3800,2710
1,13,5,6,6,5929,4455,1474
1,13,6,6,6,5078,4987,91
1,13,7,6,6,4931,5378,-447
1,13,8,6,6,4193,5959,-1766
1,13,9,6,6,3466,6425,-2959
1,13,10,6,6,3800,6636,-2836
1,13,11,6,6,4455,6203,-1748
1,13,12,6,6,4987,5991,-1004
1,14,0,6,6,5379,4897,482
1,14,1,6,6,5243,4896,347
1,14,2,6,6,5708,4353,1355
1,14,3,6,6,6376,3707,2669
1,14,4,6,6,6009,3926,2083
1,14,5,6,6,5537,4468,1069
1,14,6,6,6,4897,4953,-56
1,14,7,6,6,4896,5147,-251
1,14,8,6,6,4353,5517,-1164
1,14,9,6,6,3707,5964,-2257
1,14,10,6,6,3926,6158,-2232
1,14,11,6,6,4468,5663,-1195
1,14,12,6,6,4953,5527,-574
1,15,0,6,6,5095,4868,227
1,15,1,6,6,4851,4980,-129
1,15,2,6,6,5357,4523,834
1,15,3,6,6,6080,3849,2231
1,15,4,6,6,5637,3956,1681
1,15,5,6,6,5270,4369,901
1,15,6,6,6,4868,4767,101
1,15,7,6,6,4980,4736,244
1,15,8,6,6,4523,4936,-413
1,15,9,6,6,3849,5413,-1564
1,15,10,6,6,3956,5537,-1581
1,15,11,6,6,4369,4999,-630
1,15,12,6,6,4767,4980,-213
1,16,0,6,6,4790,4332,458
1,16,1,6,6,4383,4533,-150
1,16,2,6,6,4833,4173,660
1,16,3,6,6,5481,3530,1951
1,16,4,6,6,4880,3574,1306
1,16,5,6,6,4566,3867,699
1,16,6,6,6,4332,4214,118
1,16,7,6,6,4533,4008,525
1,16,8,6,6,4173,4125,48
1,16,9,6,6,3530,4616,-1086
1,16,10,6,6,3574,4736,-1162
1,16,11,6,6,3867,4320,-453
1,16,12,6,6,4214,4434,-220
1,17,0,6,6,4350,3868,482
1,17,1,6,6,3869,4143,-274
1,17,2,6,6,4206,3907,299
1,17,3,6,6,4765,3287,1478
1,17,4,6,6,4105,3313,792
1,17,5,6,6,3923,3511,412
1,17,6,6,6,3868,3791,77
1,17,7,6,6,4143,3427,716
1,17,8,6,6,3907,3414,493
1,17,9,6,6,3287,3862,-575
1,17,10,6,6,3313,3944,-631
1,17,11,6,6,3511,3607,-96
1,17,12,6,6,3791,3737,54
1,18,0,6,6,3997,3548,449
1,18,1,6,6,3449,3936,-487
1,18,2,6,6,3641,3858,-217
1,18,3,6,6,4139,3339,800
1,18,4,6,6,3583,3292,291
1,18,5,6,6,3484,3410,74
1,18,6,6,6,3548,3603,-55
1,18,7,6,6,3936,3157,779
1,18,8,6,6,3858,3047,811
1,18,9,6,6,3339,3344,-5
1,18,10,6,6,3292,3339,-47
1,18,11,6,6,3410,3118,292
1,18,12,6,6,3603,3234,369
1,0,0,7,6,4640,3564,1076
1,0,1,7,6,4514,3459,1055
1,0,2,7,6,4318,3397,921
1,0,3,7,6,4141,3370,771
1,0,4,7,6,3981,3363,618
1,0,5,7,6,3763,3409,354
1,0,6,7,6,3564,3471,93
1,0,7,7,6,3459,3618,-159
1,0,8,7,6,3397,3816,-419
1,0,9,7,6,3370,3989,-619
1,0,10,7,6,3363,4181,-818
1,0,11,7,6,3409,4366,-957
1,0,12,7,6,3471,4504,-1033
1,1,0,7,6,4498,3517,981
1,1,1,7,6,4330,3431,899
1,1,2,7,6,4115,3365,750
1,1,3,7,6,3935,3340,595
1,1,4,7,6,3817,3331,486
1,1,5,7,6,3665,3383,282
1,1,6,7,6,3517,3430,87
1,1,7,7,6,3431,3549,-118
1,1,8,7,6,3365,3721,-356
1,1,9,7,6,3340,3875,-535
1,1,10,7,6,3331,4057,-726
1,1,11,7,6,3383,4242,-859
1,1,12,7,6,3430,4421,-991
1,2,0,7,6,4471,3672,799
1,2,1,7,6,4316,3596,720
1,2,2,7,6,4085,3558,527
1,2,3,7,6,3910,3547,363
1,2,4,7,6,3849,3540,309
1,2,5,7,6,3772,3585,187
1,2,6,7,6,3672,3622,50
1,2,7,7,6,3596,3723,-127
1,2,8,7,6,3558,3844,-286
1,2,9,7,6,3547,3963,-416
1,2,10,7,6,3540,4131,-591
1,2,11,7,6,3585,4301,-716
1,2,12,7,6,3622,4485,-863
1,3,0,7,6,4196,3283,913
1,3,1,7,6,3977,3204,773
1,3,2,7,6,3741,3137,604
1,3,3,7,6,3558,3094,464
1,3,4,7,6,3489,3101,388
1,3,5,7,6,3401,3168,233
1,3,6,7,6,3283,3233,50
1,3,7,7,6,3204,3350,-146
1,3,8,7,6,3137,3491,-354
1,3,9,7,6,3094,3641,-547
1,3,10,7,6,3101,3817,-716
1,3,11,7,6,3168,4006,-838
1,3,12,7,6,3233,4230,-997
1,4,0,7,6,4075,3587,488
1,4,1,7,6,3875,3560,315
1,4,2,7,6,3754,3520,234
1,4,3,7,6,3691,3466,225
1,4,4,7,6,3710,3476,234
1,4,5,7,6,3652,3532,120
1,4,6,7,6,3587,3591,-4
1,4,7,7,6,3560,3640,-80
1,4,8,7,6,3520,3711,-191
1,4,9,7,6,3466,3810,-344
1,4,10,7,6,3476,3902,-426
1,4,11,7,6,3532,4024,-492
1,4,12,7,6,3591,4193,-602
1,5,0,7,6,4247,4438,-191
1,5,1,7,6,4151,4429,-278
1,5,2,7,6,4203,4390,-187
1,5,3,7,6,4326,4311,15
1,5,4,7,6,4464,4335,129
1,5,5,7,6,4425,4428,-3
1,5,6,7,6,4438,4515,-77
1,5,7,7,6,4429,4495,-66
1,5,8,7,6,4390,4499,-109
1,5,9,7,6,4311,4559,-248
1,5,10,7,6,4335,4569,-234
1,5,11,7,6,4428,4568,-140
1,5,12,7,6,4515,4600,-85
1,6,0,7,6,4504,5070,-566
1,6,1,7,6,4515,4983,-468
1,6,2,7,6,4727,4805,-78
1,6,3,7,6,5029,4601,428
1,6,4,7,6,5203,4675,528
1,6,5,7,6,5099,4917,182
1,6,6,7,6,5070,5134,-64
1,6,7,7,6,4983,5167,-184
1,6,8,7,6,4805,5240,-435
1,6,9,7,6,4601,5364,-763
1,6,10,7,6,4675,5359,-684
1,6,11,7,6,4917,5243,-326
1,6,12,7,6,5134,5118,16
1,7,0,7,6,4871,5620,-749
1,7,1,7,6,4959,5471,-512
1,7,2,7,6,5311,5145,166
1,7,3,7,6,5792,4784,1008
1,7,4,7,6,5963,4916,1047
1,7,5,7,6,5796,5293,503
1,7,6,7,6,5620,5637,-17
1,7,7,7,6,5471,5776,-305
1,7,8,7,6,5145,5948,-803
1,7,9,7,6,4784,6129,-1345
1,7,10,7,6,4916,6116,-1200
1,7,11,7,6,5293,5909,-616
1,7,12,7,6,5637,5652,-15
1,8,0,7,6,5368,5976,-608
1,8,1,7,6,5495,5776,-281
1,8,2,7,6,5929,5338,591
1,8,3,7,6,6526,4843,1683
1,8,4,7,6,6628,5030,1598
1,8,5,7,6,6355,5519,836
1,8,6,7,6,5976,5965,11
1,8,7,7,6,5776,6245,-469
1,8,8,7,6,5338,6539,-1201
1,8,9,7,6,4843,6794,-1951
1,8,10,7,6,5030,6833,-1803
1,8,11,7,6,5519,6575,-1056
1,8,12,7,6,5965,6251,-286
1,9,0,7,6,5743,6125,-382
1,9,1,7,6,5879,5855,24
1,9,2,7,6,6401,5247,1154
1,9,3,7,6,7123,4589,2534
1,9,4,7,6,7132,4850,2282
1,9,5,7,6,6703,5472,1231
1,9,6,7,6,6125,6001,124
1,9,7,7,6,5855,6440,-585
1,9,8,7,6,5247,6918,-1671
1,9,9,7,6,4589,7275,-2686
1,9,10,7,6,4850,7362,-2512
1,9,11,7,6,5472,7051,-1579
1,9,12,7,6,6001,6697,-696
1,10,0,7,6,6244,6779,-535
1,10,1,7,6,6464,6511,-47
1,10,2,7,6,7122,5806,1316
1,10,3,7,6,8013,5044,2969
1,10,4,7,6,8012,5360,2652
1,10,5,7,6,7493,6089,1404
1,10,6,7,6,6779,6664,115
1,10,7,7,6,6511,7146,-635
1,10,8,7,6,5806,7710,-1904
1,10,9,7,6,5044,8101,-3057
1,10,10,7,6,5360,8175,-2815
1,10,11,7,6,6089,7710,-1621
1,10,12,7,6,6664,7289,-625
1,11,0,7,6,6484,6765,-281
1,11,1,7,6,6689,6466,223
1,11,2,7,6,7390,5638,1752
1,11,3,7,6,8332,4759,3573
1,11,4,7,6,8204,5143,3061
1,11,5,7,6,7604,5991,1613
1,11,6,7,6,6765,6630,135
1,11,7,7,6,6466,7117,-651
1,11,8,7,6,5638,7770,-2132
1,11,9,7,6,4759,8283,-3524
1,11,10,7,6,5143,8430,-3287
1,11,11,7,6,5991,7862,-1871
1,11,12,7,6,6630,7478,-848
1,12,0,7,6,6495,6087,408
1,12,1,7,6,6563,5858,705
1,12,2,7,6,7170,5007,2163
1,12,3,7,6,8022,4151,3871
1,12,4,7,6,7728,4533,3195
1,12,5,7,6,7024,5325,1699
1,12,6,7,6,6087,5980,107
1,12,7,7,6,5858,6440,-582
1,12,8,7,6,5007,7132,-2125
1,12,9,7,6,4151,7713,-3562
1,12,10,7,6,4533,7962,-3429
1,12,11,7,6,5325,7477,-2152
1,12,12,7,6,5980,7158,-1178
1,13,0,7,6,6357,5848,509
1,13,1,7,6,6245,5787,458
1,13,2,7,6,6784,5107,1677
1,13,3,7,6,7591,4303,3288
1,13,4,7,6,7201,4579,2622
1,13,5,7,6,6648,5264,1384
1,13,6,7,6,5848,5873,-25
1,13,7,7,6,5787,6175,-388
1,13,8,7,6,5107,6662,-1555
1,13,9,7,6,4303,7195,-2892
1,13,10,7,6,4579,7420,-2841
1,13,11,7,6,5264,6873,-1609
1,13,12,7,6,5873,6654,-781
1,14,0,7,6,6083,5798,285
1,14,1,7,6,5830,5876,-46
1,14,2,7,6,6398,5300,1098
1,14,3,7,6,7242,4494,2748
1,14,4,7,6,6777,4656,2121
1,14,5,7,6,6361,5183,1178
1,14,6,7,6,5798,5668,130
1,14,7,7,6,5876,5758,118
1,14,8,7,6,5300,6059,-759
1,14,9,7,6,4494,6585,-2091
1,14,10,7,6,4656,6749,-2093
1,14,11,7,6,5183,6171,-988
1,14,12,7,6,5668,6126,-458
1,15,0,7,6,5788,5266,522
1,15,1,7,6,5399,5408,-9
1,15,2,7,6,5917,4903,1014
1,15,3,7,6,6696,4108,2588
1,15,4,7,6,6059,4229,1830
1,15,5,7,6,5656,4659,997
1,15,6,7,6,5266,5083,183
1,15,7,7,6,5408,5019,389
1,15,8,7,6,4903,5267,-364
1,15,9,7,6,4108,5821,-1713
1,15,10,7,6,4229,5979,-1750
1,15,11,7,6,4659,5494,-835
1,15,12,7,6,5083,5578,-495
1,16,0,7,6,5234,4803,431
1,16,1,7,6,4775,5075,-300
1,16,2,7,6,5246,4703,543
1,16,3,7,6,5969,3942,2027
1,16,4,7,6,5297,4035,1262
1,16,5,7,6,5013,4370,643
1,16,6,7,6,4803,4726,77
1,16,7,7,6,5075,4424,651
1,16,8,7,6,4703,4516,187
1,16,9,7,6,3942,5022,-1080
1,16,10,7,6,4035,5098,-1063
1,16,11,7,6,4370,4624,-254
1,16,12,7,6,4726,4724,2
1,17,0,7,6,4787,4335,452
1,17,1,7,6,4243,4694,-451
1,17,2,7,6,4591,4468,123
1,17,3,7,6,5222,3814,1408
1,17,4,7,6,4591,3836,755
1,17,5,7,6,4395,4086,309
1,17,6,7,6,4335,4373,-38
1,17,7,7,6,4694,3919,775
1,17,8,7,6,4468,3886,582
1,17,9,7,6,3814,4296,-482
1,17,10,7,6,3836,4317,-481
1,17,11,7,6,4086,3947,139
1,17,12,7,6,4373,4057,316
1,0,0,8,6,5131,4138,993
1,0,1,8,6,4957,4050,907
1,0,2,8,6,4741,3981,760
1,0,3,8,6,4569,3956,613
1,0,4,8,6,4456,3949,507
1,0,5,8,6,4295,3997,298
1,0,6,8,6,4138,4044,94
1,0,7,8,6,4050,4171,-121
1,0,8,8,6,3981,4348,-367
1,0,9,8,6,3956,4496,-540
1,0,10,8,6,3949,4676,-727
1,0,11,8,6,3997,4872,-875
1,0,12,8,6,4044,5051,-1007
1,1,0,8,6,5121,4302,819
1,1,1,8,6,4962,4227,735
1,1,2,8,6,4727,4186,541
1,1,3,8,6,4553,4172,381
1,1,4,8,6,4492,4166,326
1,1,5,8,6,4407,4222,185
1,1,6,8,6,4302,4263,39
1,1,7,8,6,4227,4365,-138
1,1,8,8,6,4186,4484,-298
1,1,9,8,6,4172,4599,-427
1,1,10,8,6,4166,4771,-605
1,1,11,8,6,4222,4940,-718
1,1,12,8,6,4263,5119,-856
1,2,0,8,6,4854,3953,901
1,2,1,8,6,4637,3872,765
1,2,2,8,6,4404,3795,609
1,2,3,8,6,4224,3747,477
1,2,4,8,6,4161,3752,409
1,2,5,8,6,4072,3827,245
1,2,6,8,6,3953,3894,59
1,2,7,8,6,3872,4014,-142
1,2,8,8,6,3795,4154,-359
1,2,9,8,6,3747,4297,-550
1,2,10,8,6,3752,4472,-720
1,2,11,8,6,3827,4659,-832
1,2,12,8,6,3894,4880,-986
1,3,0,8,6,4746,4084,662
1,3,1,8,6,4546,4007,539
1,3,2,8,6,4423,3915,508
1,3,3,8,6,4322,3854,468
1,3,4,8,6,4305,3862,443
1,3,5,8,6,4201,3942,259
1,3,6,8,6,4084,4037,47
1,3,7,8,6,4007,4141,-134
1,3,8,8,6,3915,4270,-355
1,3,9,8,6,3854,4411,-557
1,3,10,8,6,3862,4540,-678
1,3,11,8,6,3942,4683,-741
1,3,12,8,6,4037,4864,-827
1,4,0,8,6,4955,4806,149
1,4,1,8,6,4839,4747,92
1,4,2,8,6,4848,4677,171
1,4,3,8,6,4911,4591,320
1,4,4,8,6,4985,4612,373
1,4,5,8,6,4868,4716,152
1,4,6,8,6,4806,4833,-27
1,4,7,8,6,4747,4875,-128
1,4,8,8,6,4677,4957,-280
1,4,9,8,6,4591,5085,-494
1,4,10,8,6,4612,5157,-545
1,4,11,8,6,4716,5210,-494
1,4,12,8,6,4833,5277,-444
1,5,0,8,6,5213,5447,-234
1,5,1,8,6,5179,5356,-177
1,5,2,8,6,5308,5204,104
1,5,3,8,6,5559,4996,563
1,5,4,8,6,5682,5068,614
1,5,5,8,6,5520,5298,222
1,5,6,8,6,5447,5508,-61
1,5,7,8,6,5356,5557,-201
1,5,8,8,6,5204,5672,-468
1,5,9,8,6,4996,5847,-851
1,5,10,8,6,5068,5895,-827
1,5,11,8,6,5298,5842,-544
1,5,12,8,6,5508,5767,-259
1,6,0,8,6,5482,6021,-539
1,6,1,8,6,5517,5874,-357
1,6,2,8,6,5803,5559,244
1,6,3,8,6,6244,5197,1047
1,6,4,8,6,6395,5328,1067
1,6,5,8,6,6210,5713,497
1,6,6,8,6,6021,6054,-33
1,6,7,8,6,5874,6195,-321
1,6,8,8,6,5559,6385,-826
1,6,9,8,6,5197,6595,-1398
1,6,10,8,6,5328,6621,-1293
1,6,11,8,6,5713,6453,-740
1,6,12,8,6,6054,6245,-191
1,7,0,8,6,5859,6550,-691
1,7,1,8,6,5938,6367,-429
1,7,2,8,6,6352,5922,430
1,7,3,8,6,6954,5429,1525
1,7,4,8,6,7103,5616,1487
1,7,5,8,6,6887,6107,780
1,7,6,8,6,6550,6538,12
1,7,7,8,6,6367,6798,-431
1,7,8,8,6,5922,7071,-1149
1,7,9,8,6,5429,7301,-1872
1,7,10,8,6,5616,7328,-1712
1,7,11,8,6,6107,7081,-974
1,7,12,8,6,6538,6798,-260
1,8,0,8,6,6366,6910,-544
1,8,1,8,6,6511,6651,-140
1,8,2,8,6,7013,6068,945
1,8,3,8,6,7741,5421,2320
1,8,4,8,6,7807,5685,2122
1,8,5,8,6,7445,6311,1134
1,8,6,8,6,6910,6834,76
1,8,7,8,6,6651,7256,-605
1,8,8,8,6,6068,7681,-1613
1,8,9,8,6,5421,7999,-2578
1,8,10,8,6,5685,8076,-2391
1,8,11,8,6,6311,7749,-1438
1,8,12,8,6,6834,7395,-561
1,9,0,8,6,6627,7060,-433
1,9,1,8,6,6785,6787,-2
1,9,2,8,6,7441,6043,1398
1,9,3,8,6,8327,5244,3083
1,9,4,8,6,8324,5572,2752
1,9,5,8,6,7793,6331,1462
1,9,6,8,6,7060,6936,124
1,9,7,8,6,6787,7437,-650
1,9,8,8,6,6043,8020,-1977
1,9,9,8,6,5244,8435,-3191
1,9,10,8,6,5572,8516,-2944
1,9,11,8,6,6331,8068,-1737
1,9,12,8,6,6936,7684,-748
1,10,0,8,6,7034,7566,-532
1,10,1,8,6,7258,7269,-11
1,10,2,8,6,8072,6416,1656
1,10,3,8,6,9096,5519,3577
1,10,4,8,6,9020,5904,3116
1,10,5,8,6,8404,6765,1639
1,10,6,8,6,7566,7434,132
1,10,7,8,6,7269,7908,-639
1,10,8,8,6,6416,8549,-2133
1,10,9,8,6,5519,9053,-3534
1,10,10,8,6,5904,9153,-3249
1,10,11,8,6,6765,8539,-1774
1,10,12,8,6,7434,8112,-678
1,11,0,8,6,7375,7306,69
1,11,1,8,6,7527,7045,482
1,11,2,8,6,8264,6164,2100
1,11,3,8,6,9242,5276,3966
1,11,4,8,6,9003,5669,3334
1,11,5,8,6,8240,6509,1731
1,11,6,8,6,7306,7222,84
1,11,7,8,6,7045,7675,-630
1,11,8,8,6,6164,8378,-2214
1,11,9,8,6,5276,8988,-3712
1,11,10,8,6,5669,9217,-3548
1,11,11,8,6,6509,8663,-2154
1,11,12,8,6,7222,8242,-1020
1,12,0,8,6,7323,6857,466
1,12,1,8,6,7273,6714,559
1,12,2,8,6,7889,5921,1968
1,12,3,8,6,8824,4988,3836
1,12,4,8,6,8419,5312,3107
1,12,5,8,6,7743,6134,1609
1,12,6,8,6,6857,6866,-9
1,12,7,8,6,6714,7237,-523
1,12,8,8,6,5921,7835,-1914
1,12,9,8,6,4988,8483,-3495
1,12,10,8,6,5312,8746,-3434
1,12,11,8,6,6134,8147,-2013
1,12,12,8,6,6866,7821,-955
1,13,0,8,6,7061,6749,312
1,13,1,8,6,6832,6767,65
1,13,2,8,6,7474,6054,1420
1,13,3,8,6,8457,5090,3367
1,13,4,8,6,7969,5309,2660
1,13,5,8,6,7472,5979,1493
1,13,6,8,6,6749,6588,161
1,13,7,8,6,6767,6786,-19
1,13,8,8,6,6054,7204,-1150
1,13,9,8,6,5090,7816,-2726
1,13,10,8,6,5309,8011,-2702
1,13,11,8,6,5979,7381,-1402
1,13,12,8,6,6588,7253,-665
1,14,0,8,6,6776,6196,580
1,14,1,8,6,6378,6304,74
1,14,2,8,6,6958,5680,1278
1,14,3,8,6,7858,4753,3105
1,14,4,8,6,7199,4929,2270
1,14,5,8,6,6747,5473,1274
1,14,6,8,6,6196,5984,212
1,14,7,8,6,6304,6041,263
1,14,8,8,6,5680,6390,-710
1,14,9,8,6,4753,6993,-2240
1,14,10,8,6,4929,7191,-2262
1,14,11,8,6,5473,6666,-1193
1,14,12,8,6,5984,6724,-740
1,15,0,8,6,6232,5737,495
1,15,1,8,6,5791,5950,-159
1,15,2,8,6,6330,5433,897
1,15,3,8,6,7184,4520,2664
1,15,4,8,6,6476,4690,1786
1,15,5,8,6,6103,5162,941
1,15,6,8,6,5737,5595,142
1,15,7,8,6,5950,5435,515
1,15,8,8,6,5433,5658,-225
1,15,9,8,6,4520,6227,-1707
1,15,10,8,6,4690,6341,-1651
1,15,11,8,6,5162,5798,-636
1,15,12,8,6,5595,5868,-273
1,16,0,8,6,5671,5270,401
1,16,1,8,6,5149,5626,-477
1,16,2,8,6,5631,5264,367
1,16,3,8,6,6426,4469,1957
1,16,4,8,6,5783,4558,1225
1,16,5,8,6,5485,4945,540
1,16,6,8,6,5270,5308,-38
1,16,7,8,6,5626,4916,710
1,16,8,8,6,5264,4988,276
1,16,9,8,6,4469,5456,-987
1,16,10,8,6,4558,5471,-913
1,16,11,8,6,4945,4964,-19
1,16,12,8,6,5308,5044,264
1,0,0,9,6,5754,4923,831
1,0,1,9,6,5589,4846,743
1,0,2,9,6,5353,4802,551
1,0,3,9,6,5187,4788,399
1,0,4,9,6,5131,4784,347
1,0,5,9,6,5037,4836,201
1,0,6,9,6,4923,4877,46
1,0,7,9,6,4846,4987,-141
1,0,8,9,6,4802,5111,-309
1,0,9,9,6,4788,5220,-432
1,0,10,9,6,4784,5390,-606
1,0,11,9,6,4836,5570,-734
1,0,12,9,6,4877,5749,-872
1,1,0,9,6,5504,4583,921
1,1,1,9,6,5283,4503,780
1,1,2,9,6,5046,4423,623
1,1,3,9,6,4867,4372,495
1,1,4,9,6,4804,4378,426
1,1,5,9,6,4707,4464,243
1,1,6,9,6,4583,4535,48
1,1,7,9,6,4503,4656,-153
1,1,8,9,6,4423,4794,-371
1,1,9,9,6,4372,4933,-561
1,1,10,9,6,4378,5112,-734
1,1,11,9,6,4464,5298,-834
1,1,12,9,6,4535,5514,-979
1,2,0,9,6,5404,4754,650
1,2,1,9,6,5206,4675,531
1,2,2,9,6,5086,4573,513
1,2,3,9,6,4988,4507,481
1,2,4,9,6,4977,4513,464
1,2,5,9,6,4872,4601,271
1,2,6,9,6,4754,4698,56
1,2,7,9,6,4675,4805,-130
1,2,8,9,6,4573,4933,-360
1,2,9,9,6,4507,5067,-560
1,2,10,9,6,4513,5195,-682
1,2,11,9,6,4601,5336,-735
1,2,12,9,6,4698,5514,-816
1,3,0,9,6,5626,5303,323
1,3,1,9,6,5510,5194,316
1,3,2,9,6,5517,5072,445
1,3,3,9,6,5542,4979,563
1,3,4,9,6,5580,4998,582
1,3,5,9,6,5417,5126,291
1,3,6,9,6,5303,5279,24
1,3,7,9,6,5194,5376,-182
1,3,8,9,6,5072,5516,-444
1,3,9,9,6,4979,5686,-707
1,3,10,9,6,4998,5795,-797
1,3,11,9,6,5126,5869,-743
1,3,12,9,6,5279,5948,-669
1,4,0,9,6,5921,5815,106
1,4,1,9,6,5867,5674,193
1,4,2,9,6,5953,5491,462
1,4,3,9,6,6144,5276,868
1,4,4,9,6,6203,5345,858
1,4,5,9,6,5963,5586,377
1,4,6,9,6,5815,5826,-11
1,4,7,9,6,5674,5937,-263
1,4,8,9,6,5491,6130,-639
1,4,9,9,6,5276,6373,-1097
1,4,10,9,6,5345,6483,-1138
1,4,11,9,6,5586,6484,-898
1,4,12,9,6,5826,6444,-618
1,5,0,9,6,6191,6398,-207
1,5,1,9,6,6181,6247,-66
1,5,2,9,6,6384,5958,426
1,5,3,9,6,6774,5592,1182
1,5,4,9,6,6874,5721,1153
1,5,5,9,6,6631,6094,537
1,5,6,9,6,6398,6428,-30
1,5,7,9,6,6247,6585,-338
1,5,8,9,6,5958,6817,-859
1,5,9,9,6,5592,7078,-1486
1,5,10,9,6,5721,7157,-1436
1,5,11,9,6,6094,7052,-958
1,5,12,9,6,6428,6894,-466
1,6,0,9,6,6470,6951,-481
1,6,1,9,6,6496,6770,-274
1,6,2,9,6,6844,6336,508
1,6,3,9,6,7406,5842,1564
1,6,4,9,6,7535,6028,1507
1,6,5,9,6,7301,6527,774
1,6,6,9,6,6951,6955,-4
1,6,7,9,6,6770,7217,-447
1,6,8,9,6,6336,7508,-1172
1,6,9,9,6,5842,7767,-1925
1,6,10,9,6,6028,7833,-1805
1,6,11,9,6,6527,7625,-1098
1,6,12,9,6,6955,7391,-436
1,7,0,9,6,6857,7484,-627
1,7,1,9,6,6954,7242,-288
1,7,2,9,6,7436,6652,784
1,7,3,9,6,8169,6007,2162
1,7,4,9,6,8282,6271,2011
1,7,5,9,6,7977,6899,1078
1,7,6,9,6,7484,7407,77
1,7,7,9,6,7242,7809,-567
1,7,8,9,6,6652,8213,-1561
1,7,9,9,6,6007,8506,-2499
1,7,10,9,6,6271,8571,-2300
1,7,11,9,6,6899,8255,-1356
1,7,12,9,6,7407,7942,-535
1,8,0,9,6,7250,7845,-595
1,8,1,9,6,7417,7583,-166
1,8,2,9,6,8053,6864,1189
1,8,3,9,6,8945,6076,2869
1,8,4,9,6,8999,6407,2592
1,8,5,9,6,8535,7170,1365
1,8,6,9,6,7845,7769,76
1,8,7,9,6,7583,8253,-670
1,8,8,9,6,6864,8783,-1919
1,8,9,9,6,6076,9159,-3083
1,8,10,9,6,6407,9230,-2823
1,8,11,9,6,7170,8766,-1596
1,8,12,9,6,7769,8382,-613
1,9,0,9,6,7417,7847,-430
1,9,1,9,6,7579,7545,34
1,9,2,9,6,8391,6653,1738
1,9,3,9,6,9410,5719,3691
1,9,4,9,6,9332,6116,3216
1,9,5,9,6,8704,7007,1697
1,9,6,9,6,7847,7706,141
1,9,7,9,6,7545,8199,-654
1,9,8,9,6,6653,8859,-2206
1,9,9,9,6,5719,9387,-3668
1,9,10,9,6,6116,9494,-3378
1,9,11,9,6,7007,8897,-1890
1,9,12,9,6,7706,8507,-801
1,10,0,9,6,7925,8107,-182
1,10,1,9,6,8096,7848,248
1,10,2,9,6,8946,6942,2004
1,10,3,9,6,10006,6036,3970
1,10,4,9,6,9819,6430,3389
1,10,5,9,6,9040,7283,1757
1,10,6,9,6,8107,8026,81
1,10,7,9,6,7848,8466,-618
1,10,8,9,6,6942,9157,-2215
1,10,9,9,6,6036,9758,-3722
1,10,10,9,6,6430,9940,-3510
1,10,11,9,6,7283,9340,-2057
1,10,12,9,6,8026,8876,-850
1,11,0,9,6,8203,8076,127
1,11,1,9,6,8237,7901,336
1,11,2,9,6,8983,7078,1905
1,11,3,9,6,10044,6113,3931
1,11,4,9,6,9694,6448,3246
1,11,5,9,6,8959,7318,1641
1,11,6,9,6,8076,8108,-32
1,11,7,9,6,7901,8472,-571
1,11,8,9,6,7078,9081,-2003
1,11,9,9,6,6113,9758,-3645
1,11,10,9,6,6448,10001,-3553
1,11,11,9,6,7318,9333,-2015
1,11,12,9,6,8108,8905,-797
1,12,0,9,6,8027,7758,269
1,12,1,9,6,7860,7694,166
1,12,2,9,6,8579,6868,1711
1,12,3,9,6,9690,5775,3915
1,12,4,9,6,9187,6042,3145
1,12,5,9,6,8567,6849,1718
1,12,6,9,6,7758,7581,177
1,12,7,9,6,7694,7848,-154
1,12,8,9,6,6868,8377,-1509
1,12,9,9,6,5775,9104,-3329
1,12,10,9,6,6042,9337,-3295
1,12,11,9,6,6849,8655,-1806
1,12,12,9,6,7581,8420,-839
1,13,0,9,6,7754,7147,607
1,13,1,9,6,7380,7195,185
1,13,2,9,6,8034,6434,1600
1,13,3,9,6,9073,5349,3724
1,13,4,9,6,8391,5582,2809
1,13,5,9,6,7858,6269,1589
1,13,6,9,6,7147,6904,243
1,13,7,9,6,7195,7069,126
1,13,8,9,6,6434,7535,-1101
1,13,9,9,6,5349,8224,-2875
1,13,10,9,6,5582,8453,-2871
1,13,11,9,6,6269,7876,-1607
1,13,12,9,6,6904,7851,-947
1,14,0,9,6,7220,6667,553
1,14,1,9,6,6770,6846,-76
1,14,2,9,6,7371,6210,1161
1,14,3,9,6,8346,5165,3181
1,14,4,9,6,7616,5390,2226
1,14,5,9,6,7194,5976,1218
1,14,6,9,6,6667,6496,171
1,14,7,9,6,6846,6457,389
1,14,8,9,6,6210,6781,-571
1,14,9,9,6,5165,7399,-2234
1,14,10,9,6,5390,7553,-2163
1,14,11,9,6,5976,6970,-994
1,14,12,9,6,6496,7014,-518
1,15,0,9,6,6669,6204,465
1,15,1,9,6,6165,6501,-336
1,15,2,9,6,6715,5994,721
1,15,3,9,6,7641,5047,2594
1,15,4,9,6,6962,5213,1749
1,15,5,9,6,6575,5737,838
1,15,6,9,6,6204,6177,27
1,15,7,9,6,6501,5927,574
1,15,8,9,6,5994,6130,-136
1,15,9,9,6,5047,6661,-1614
1,15,10,9,6,5213,6714,-1501
1,15,11,9,6,5737,6138,-401
1,15,12,9,6,6177,6188,-11
1,0,0,10,6,6137,5204,933
1,0,1,10,6,5910,5122,788
1,0,2,10,6,5672,5039,633
1,0,3,10,6,5501,4988,513
1,0,4,10,6,5443,4996,447
1,0,5,10,6,5337,5078,259
1,0,6,10,6,5204,5149,55
1,0,7,10,6,5122,5278,-156
1,0,8,10,6,5039,5421,-382
1,0,9,10,6,4988,5554,-566
1,0,10,10,6,4996,5731,-735
1,0,11,10,6,5078,5928,-850
1,0,12,10,6,5149,6144,-995
1,1,0,10,6,6054,5384,670
1,1,1,10,6,5852,5306,546
1,1,2,10,6,5728,5201,527
1,1,3,10,6,5631,5132,499
1,1,4,10,6,5620,5139,481
1,1,5,10,6,5507,5238,269
1,1,6,10,6,5384,5339,45
1,1,7,10,6,5306,5447,-141
1,1,8,10,6,5201,5573,-372
1,1,9,10,6,5132,5703,-571
1,1,10,10,6,5139,5835,-696
1,1,11,10,6,5238,5975,-737
1,1,12,10,6,5339,6148,-809
1,2,0,10,6,6284,5973,311
1,2,1,10,6,6170,5862,308
1,2,2,10,6,6180,5730,450
1,2,3,10,6,6208,5632,576
1,2,4,10,6,6252,5649,603
1,2,5,10,6,6088,5785,303
1,2,6,10,6,5973,5940,33
1,2,7,10,6,5862,6040,-178
1,2,8,10,6,5730,6179,-449
1,2,9,10,6,5632,6342,-710
1,2,10,10,6,5649,6450,-801
1,2,11,10,6,5785,6522,-737
1,2,12,10,6,5940,6598,-658
1,3,0,10,6,6592,6312,280
1,3,1,10,6,6538,6121,417
1,3,2,10,6,6622,5886,736
1,3,3,10,6,6775,5664,1111
1,3,4,10,6,6798,5731,1067
1,3,5,10,6,6512,5996,516
1,3,6,10,6,6312,6272,40
1,3,7,10,6,6121,6438,-317
1,3,8,10,6,5886,6689,-803
1,3,9,10,6,5664,6974,-1310
1,3,10,10,6,5731,7121,-1390
1,3,11,10,6,5996,7143,-1147
1,3,12,10,6,6272,7115,-843
1,4,0,10,6,6899,6766,133
1,4,1,10,6,6869,6565,304
1,4,2,10,6,7029,6245,784
1,4,3,10,6,7359,5872,1487
1,4,4,10,6,7395,5998,1397
1,4,5,10,6,7074,6382,692
1,4,6,10,6,6766,6746,20
1,4,7,10,6,6565,6965,-400
1,4,8,10,6,6245,7275,-1030
1,4,9,10,6,5872,7604,-1732
1,4,10,10,6,5998,7745,-1747
1,4,11,10,6,6382,7694,-1312
1,4,12,10,6,6746,7571,-825
1,5,0,10,6,7179,7328,-149
1,5,1,10,6,7160,7143,17
1,5,2,10,6,7425,6735,690
1,5,3,10,6,7936,6237,1699
1,5,4,10,6,8014,6421,1593
1,5,5,10,6,7722,6908,814
1,5,6,10,6,7328,7329,-1
1,5,7,10,6,7143,7607,-464
1,5,8,10,6,6735,7940,-1205
1,5,9,10,6,6237,8250,-2013
1,5,10,10,6,6421,8369,-1948
1,5,11,10,6,6908,8224,-1316
1,5,12,10,6,7329,8040,-711
1,6,0,10,6,7468,7885,-417
1,6,1,10,6,7512,7645,-133
1,6,2,10,6,7928,7066,862
1,6,3,10,6,8621,6420,2201
1,6,4,10,6,8714,6683,2031
1,6,5,10,6,8391,7319,1072
1,6,6,10,6,7885,7824,61
1,6,7,10,6,7645,8228,-583
1,6,8,10,6,7066,8650,-1584
1,6,9,10,6,6420,8972,-2552
1,6,10,10,6,6683,9076,-2393
1,6,11,10,6,7319,8799,-1480
1,6,12,10,6,7824,8535,-711
1,7,0,10,6,7741,8419,-678
1,7,1,10,6,7860,8174,-314
1,7,2,10,6,8476,7448,1028
1,7,3,10,6,9373,6662,2711
1,7,4,10,6,9474,6993,2481
1,7,5,10,6,9067,7758,1309
1,7,6,10,6,8419,8342,77
1,7,7,10,6,8174,8806,-632
1,7,8,10,6,7448,9315,-1867
1,7,9,10,6,6662,9666,-3004
1,7,10,10,6,6993,9725,-2732
1,7,11,10,6,7758,9272,-1514
1,7,12,10,6,8342,8929,-587
1,8,0,10,6,8040,8632,-592
1,8,1,10,6,8211,8341,-130
1,8,2,10,6,9003,7474,1529
1,8,3,10,6,10028,6551,3477
1,8,4,10,6,10007,6951,3056
1,8,5,10,6,9446,7846,1600
1,8,6,10,6,8632,8539,93
1,8,7,10,6,8341,9015,-674
1,8,8,10,6,7474,9622,-2148
1,8,9,10,6,6551,10111,-3560
1,8,10,10,6,6951,10208,-3257
1,8,11,10,6,7846,9595,-1749
1,8,12,10,6,8539,9205,-666
1,9,0,10,6,8308,8388,-80
1,9,1,10,6,8417,8124,293
1,9,2,10,6,9265,7179,2086
1,9,3,10,6,10320,6236,4084
1,9,4,10,6,10131,6642,3489
1,9,5,10,6,9340,7525,1815
1,9,6,10,6,8388,8298,90
1,9,7,10,6,8124,8757,-633
1,9,8,10,6,7179,9467,-2288
1,9,9,10,6,6236,10092,-3856
1,9,10,10,6,6642,10281,-3639
1,9,11,10,6,7525,9698,-2173
1,9,12,10,6,8298,9271,-973
1,10,0,10,6,8753,8877,-124
1,10,1,10,6,8806,8704,102
1,10,2,10,6,9665,7856,1809
1,10,3,10,6,10808,6873,3935
1,10,4,10,6,10510,7209,3301
1,10,5,10,6,9759,8092,1667
1,10,6,10,6,8877,8912,-35
1,10,7,10,6,8704,9263,-559
1,10,8,10,6,7856,9860,-2004
1,10,9,10,6,6873,10528,-3655
1,10,10,10,6,7209,10724,-3515
1,10,11,10,6,8092,10010,-1918
1,10,12,10,6,8912,9539,-627
1,11,0,10,6,8907,8977,-70
1,11,1,10,6,8824,8881,-57
1,11,2,10,6,9673,8025,1648
1,11,3,10,6,10910,6900,4010
1,11,4,10,6,10462,7178,3284
1,11,5,10,6,9783,8033,1750
1,11,6,10,6,8977,8823,154
1,11,7,10,6,8881,9083,-202
1,11,8,10,6,8025,9623,-1598
1,11,9,10,6,6900,10379,-3479
1,11,10,10,6,7178,10592,-3414
1,11,11,10,6,8033,9841,-1808
1,11,12,10,6,8823,9504,-681
1,12,0,10,6,8720,8156,564
1,12,1,10,6,8408,8122,286
1,12,2,10,6,9139,7248,1891
1,12,3,10,6,10306,6034,4272
1,12,4,10,6,9609,6315,3294
1,12,5,10,6,8953,7139,1814
1,12,6,10,6,8156,7897,259
1,12,7,10,6,8122,8131,-9
1,12,8,10,6,7248,8708,-1460
1,12,9,10,6,6034,9512,-3478
1,12,10,10,6,6315,9779,-3464
1,12,11,10,6,7139,9150,-2011
1,12,12,10,6,7897,9018,-1121
1,13,0,10,6,8198,7618,580
1,13,1,10,6,7772,7737,35
1,13,2,10,6,8447,6964,1483
1,13,3,10,6,9561,5761,3800
1,13,4,10,6,8808,6043,2765
1,13,5,10,6,8305,6772,1533
1,13,6,10,6,7618,7416,202
1,13,7,10,6,7737,7485,252
1,13,8,10,6,6964,7926,-962
1,13,9,10,6,5761,8630,-2869
1,13,10,10,6,6043,8815,-2772
1,13,11,10,6,6772,8180,-1408
1,13,12,10,6,7416,8141,-725
1,14,0,10,6,7657,7134,523
1,14,1,10,6,7144,7397,-253
1,14,2,10,6,7756,6771,985
1,14,3,10,6,8803,5692,3111
1,14,4,10,6,8102,5913,2189
1,14,5,10,6,7666,6551,1115
1,14,6,10,6,7134,7078,56
1,14,7,10,6,7397,6949,448
1,14,8,10,6,6771,7253,-482
1,14,9,10,6,5692,7833,-2141
1,14,10,10,6,5913,7926,-2013
1,14,11,10,6,6551,7310,-759
1,14,12,10,6,7078,7334,-256
1,0,0,11,6,6687,6005,682
1,0,1,11,6,6479,5925,554
1,0,2,11,6,6354,5817,537
1,0,3,11,6,6265,5748,517
1,0,4,11,6,6259,5757,502
1,0,5,11,6,6137,5852,285
1,0,6,11,6,6005,5953,52
1,0,7,11,6,5925,6069,-144
1,0,8,11,6,5817,6200,-383
1,0,9,11,6,5748,6324,-576
1,0,10,11,6,5757,6454,-697
1,0,11,11,6,5852,6605,-753
1,0,12,11,6,5953,6778,-825
1,1,0,11,6,6934,6603,331
1,1,1,11,6,6816,6493,323
1,1,2,11,6,6822,6358,464
1,1,3,11,6,6851,6257,594
1,1,4,11,6,6895,6275,620
1,1,5,11,6,6723,6422,301
1,1,6,11,6,6603,6581,22
1,1,7,11,6,6493,6682,-189
1,1,8,11,6,6358,6819,-461
1,1,9,11,6,6257,6978,-721
1,1,10,11,6,6275,7090,-815
1,1,11,11,6,6422,7161,-739
1,1,12,11,6,6581,7232,-651
1,2,0,11,6,7250,6982,268
1,2,1,11,6,7198,6789,409
1,2,2,11,6,7285,6544,741
1,2,3,11,6,7441,6317,1124
1,2,4,11,6,7470,6382,1088
1,2,5,11,6,7183,6655,528
1,2,6,11,6,6982,6933,49
1,2,7,11,6,6789,7102,-313
1,2,8,11,6,6544,7352,-808
1,2,9,11,6,6317,7630,-1313
1,2,10,11,6,6382,7776,-1394
1,2,11,11,6,6655,7796,-1141
1,2,12,11,6,6933,7765,-832
1,3,0,11,6,7570,7263,307
1,3,1,11,6,7540,7012,528
1,3,2,11,6,7698,6640,1058
1,3,3,11,6,7990,6260,1730
1,3,4,11,6,7990,6384,1606
1,3,5,11,6,7623,6792,831
1,3,6,11,6,7263,7192,71
1,3,7,11,6,7012,7466,-454
1,3,8,11,6,6640,7834,-1194
1,3,9,11,6,6260,8205,-1945
1,3,10,11,6,6384,8383,-1999
1,3,11,11,6,6792,8353,-1561
1,3,12,11,6,7192,8242,-1050
1,4,0,11,6,7887,7696,191
1,4,1,11,6,7848,7461,387
1,4,2,11,6,8070,7022,1048
1,4,3,11,6,8521,6517,2004
1,4,4,11,6,8535,6698,1837
1,4,5,11,6,8165,7196,969
1,4,6,11,6,7696,7647,49
1,4,7,11,6,7461,7987,-526
1,4,8,11,6,7022,8398,-1376
1,4,9,11,6,6517,8776,-2259
1,4,10,11,6,6698,8957,-2259
1,4,11,11,6,7196,8866,-1670
1,4,12,11,6,7647,8717,-1070
1,5,0,11,6,8177,8262,-85
1,5,1,11,6,8176,8018,158
1,5,2,11,6,8509,7465,1044
1,5,3,11,6,9151,6815,2336
1,5,4,11,6,9193,7076,2117
1,5,5,11,6,8812,7700,1112
1,5,6,11,6,8262,8198,64
1,5,7,11,6,8018,8618,-600
1,5,8,11,6,7465,9082,-1617
1,5,9,11,6,6815,9455,-2640
1,5,10,11,6,7076,9612,-2536
1,5,11,11,6,7700,9398,-1698
1,5,12,11,6,8198,9184,-986
1,6,0,11,6,8352,8820,-468
1,6,1,11,6,8418,8577,-159
1,6,2,11,6,8968,7862,1106
1,6,3,11,6,9825,7075,2750
1,6,4,11,6,9906,7405,2501
1,6,5,11,6,9481,8178,1303
1,6,6,11,6,8820,8759,61
1,6,7,11,6,8577,9225,-648
1,6,8,11,6,7862,9752,-1890
1,6,9,11,6,7075,10132,-3057
1,6,10,11,6,7405,10230,-2825
1,6,11,11,6,8178,9816,-1638
1,6,12,11,6,8759,9522,-763
1,7,0,11,6,8531,9206,-675
1,7,1,11,6,8654,8932,-278
1,7,2,11,6,9426,8058,1368
1,7,3,11,6,10456,7137,3319
1,7,4,11,6,10482,7537,2945
1,7,5,11,6,9978,8434,1544
1,7,6,11,6,9206,9112,94
1,7,7,11,6,8932,9568,-636
1,7,8,11,6,8058,10154,-2096
1,7,9,11,6,7137,10618,-3481
1,7,10,11,6,7537,10703,-3166
1,7,11,11,6,8434,10101,-1667
1,7,12,11,6,9112,9752,-640
1,8,0,11,6,8931,9173,-242
1,8,1,11,6,9049,8920,129
1,8,2,11,6,9877,8000,1877
1,8,3,11,6,10938,7068,3870
1,8,4,11,6,10806,7477,3329
1,8,5,11,6,10082,8364,1718
1,8,6,11,6,9173,9131,42
1,8,7,11,6,8920,9573,-653
1,8,8,11,6,8000,10230,-2230
1,8,9,11,6,7068,10816,-3748
1,8,10,11,6,7477,10995,-3518
1,8,11,11,6,8364,10396,-2032
1,8,12,11,6,9131,9969,-838
1,9,0,11,6,9136,9158,-22
1,9,1,11,6,9127,8980,147
1,9,2,11,6,9984,8093,1891
1,9,3,11,6,11122,7073,4049
1,9,4,11,6,10822,7421,3401
1,9,5,11,6,10059,8334,1725
1,9,6,11,6,9158,9184,-26
1,9,7,11,6,8980,9554,-574
1,9,8,11,6,8093,10170,-2077
1,9,9,11,6,7073,10862,-3789
1,9,10,11,6,7421,11065,-3644
1,9,11,11,6,8334,10368,-2034
1,9,12,11,6,9184,9934,-750
1,10,0,11,6,9457,9778,-321
1,10,1,11,6,9393,9684,-291
1,10,2,11,6,10355,8803,1552
1,10,3,11,6,11674,7660,4014
1,10,4,11,6,11278,7939,3339
1,10,5,11,6,10583,8807,1776
1,10,6,11,6,9778,9627,151
1,10,7,11,6,9684,9874,-190
1,10,8,11,6,8803,10402,-1599
1,10,9,11,6,7660,11149,-3489
1,10,10,11,6,7939,11315,-3376
1,10,11,11,6,8807,10518,-1711
1,10,12,11,6,9627,10138,-511
1,11,0,11,6,9600,9375,225
1,11,1,11,6,9372,9309,63
1,11,2,11,6,10233,8405,1828
1,11,3,11,6,11526,7159,4367
1,11,4,11,6,10884,7451,3433
1,11,5,11,6,10169,8323,1846
1,11,6,11,6,9375,9139,236
1,11,7,11,6,9309,9366,-57
1,11,8,11,6,8405,9954,-1549
1,11,9,11,6,7159,10787,-3628
1,11,10,11,6,7451,11034,-3583
1,11,11,11,6,8323,10336,-2013
1,11,12,11,6,9139,10102,-963
1,12,0,11,6,9164,8627,537
1,12,1,11,6,8800,8664,136
1,12,2,11,6,9552,7778,1774
1,12,3,11,6,10794,6446,4348
1,12,4,11,6,10026,6776,3250
1,12,5,11,6,9400,7642,1758
1,12,6,11,6,8627,8409,218
1,12,7,11,6,8664,8547,117
1,12,8,11,6,7778,9099,-1321
1,12,9,11,6,6446,9918,-3472
1,12,10,11,6,6776,10141,-3365
1,12,11,11,6,7642,9454,-1812
1,12,12,11,6,8409,9308,-899
1,13,0,11,6,8635,8085,550
1,13,1,11,6,8146,8288,-142
1,13,2,11,6,8832,7525,1307
1,13,3,11,6,10018,6288,3730
1,13,4,11,6,9294,6566,2728
1,13,5,11,6,8777,7347,1430
1,13,6,11,6,8085,7998,87
1,13,7,11,6,8288,7977,311
1,13,8,11,6,7525,8398,-873
1,13,9,11,6,6288,9064,-2776
1,13,10,11,6,6566,9188,-2622
1,13,11,11,6,7347,8520,-1173
1,13,12,11,6,7998,8461,-463
1,0,0,12,6,7567,7224,343
1,0,1,12,6,7443,7112,331
1,0,2,12,6,7448,6974,474
1,0,3,12,6,7485,6873,612
1,0,4,12,6,7534,6893,641
1,0,5,12,6,7353,7036,317
1,0,6,12,6,7224,7195,29
1,0,7,12,6,7112,7304,-192
1,0,8,12,6,6974,7446,-472
1,0,9,12,6,6873,7599,-726
1,0,10,12,6,6893,7709,-816
1,0,11,12,6,7036,7791,-755
1,0,12,12,6,7195,7862,-667
1,1,0,12,6,7900,7612,288
1,1,1,12,6,7844,7420,424
1,1,2,12,6,7927,7172,755
1,1,3,12,6,8084,6942,1142
1,1,4,12,6,8113,7008,1105
1,1,5,12,6,7818,7292,526
1,1,6,12,6,7612,7574,38
1,1,7,12,6,7420,7744,-324
1,1,8,12,6,7172,7992,-820
1,1,9,12,6,6942,8266,-1324
1,1,10,12,6,7008,8416,-1408
1,1,11,12,6,7292,8435,-1143
1,1,12,12,6,7574,8399,-825
1,2,0,12,6,8228,7933,295
1,2,1,12,6,8200,7680,520
1,2,2,12,6,8361,7298,1063
1,2,3,12,6,8656,6913,1743
1,2,4,12,6,8662,7035,1627
1,2,5,12,6,8294,7451,843
1,2,6,12,6,7933,7853,80
1,2,7,12,6,7680,8130,-450
1,2,8,12,6,7298,8497,-1199
1,2,9,12,6,6913,8861,-1948
1,2,10,12,6,7035,9038,-2003
1,2,11,12,6,7451,9006,-1555
1,2,12,12,6,7853,8892,-1039
1,3,0,12,6,8558,8193,365
1,3,1,12,6,8519,7908,611
1,3,2,12,6,8739,7417,1322
1,3,3,12,6,9152,6905,2247
1,3,4,12,6,9130,7084,2046
1,3,5,12,6,8714,7606,1108
1,3,6,12,6,8193,8093,100
1,3,7,12,6,7908,8488,-580
1,3,8,12,6,7417,8957,-1540
1,3,9,12,6,6905,9377,-2472
1,3,10,12,6,7084,9595,-2511
1,3,11,12,6,7606,9525,-1919
1,3,12,12,6,8093,9388,-1295
1,4,0,12,6,8885,8630,255
1,4,1,12,6,8864,8336,528
1,4,2,12,6,9154,7752,1402
1,4,3,12,6,9736,7095,2641
1,4,4,12,6,9714,7353,2361
1,4,5,12,6,9255,7988,1267
1,4,6,12,6,8630,8516,114
1,4,7,12,6,8336,8998,-662
1,4,8,12,6,7752,9540,-1788
1,4,9,12,6,7095,9981,-2886
1,4,10,12,6,7353,10200,-2847
1,4,11,12,6,7988,10040,-2052
1,4,12,12,6,8516,9861,-1345
1,5,0,12,6,9061,9197,-136
1,5,1,12,6,9082,8950,132
1,5,2,12,6,9549,8261,1288
1,5,3,12,6,10355,7470,2885
1,5,4,12,6,10385,7798,2587
1,5,5,12,6,9902,8559,1343
1,5,6,12,6,9197,9133,64
1,5,7,12,6,8950,9615,-665
1,5,8,12,6,8261,10184,-1923
1,5,9,12,6,7470,10615,-3145
1,5,10,12,6,7798,10766,-2968
1,5,11,12,6,8559,10415,-1856
1,5,12,12,6,9133,10171,-1038
1,6,0,12,6,9142,9607,-465
1,6,1,12,6,9212,9335,-123
1,6,2,12,6,9918,8472,1446
1,6,3,12,6,10908,7550,3358
1,6,4,12,6,10914,7949,2965
1,6,5,12,6,10392,8854,1538
1,6,6,12,6,9607,9529,78
1,6,7,12,6,9335,9987,-652
1,6,8,12,6,8472,10591,-2119
1,6,9,12,6,7550,11084,-3534
1,6,10,12,6,7949,11208,-3259
1,6,11,12,6,8854,10645,-1791
1,6,12,12,6,9529,10345,-816
1,7,0,12,6,9422,9747,-325
1,7,1,12,6,9492,9511,-19
1,7,2,12,6,10300,8584,1716
1,7,3,12,6,11366,7654,3712
1,7,4,12,6,11281,8063,3218
1,7,5,12,6,10614,8952,1662
1,7,6,12,6,9747,9704,43
1,7,7,12,6,9511,10126,-615
1,7,8,12,6,8584,10762,-2178
1,7,9,12,6,7654,11323,-3669
1,7,10,12,6,8063,11490,-3427
1,7,11,12,6,8952,10902,-1950
1,7,12,12,6,9704,10516,-812
1,8,0,12,6,9759,9943,-184
1,8,1,12,6,9759,9776,-17
1,8,2,12,6,10596,8914,1682
1,8,3,12,6,11740,7905,3835
1,8,4,12,6,11497,8256,3241
1,8,5,12,6,10801,9173,1628
1,8,6,12,6,9943,10017,-74
1,8,7,12,6,9776,10370,-594
1,8,8,12,6,8914,10933,-2019
1,8,9,12,6,7905,11586,-3681
1,8,10,12,6,8256,11779,-3523
1,8,11,12,6,9173,11066,-1893
1,8,12,12,6,10017,10632,-615
1,9,0,12,6,9840,10059,-219
1,9,1,12,6,9714,9960,-246
1,9,2,12,6,10674,9040,1634
1,9,3,12,6,11988,7860,4128
1,9,4,12,6,11590,8151,3439
1,9,5,12,6,10883,9049,1834
1,9,6,12,6,10059,9899,160
1,9,7,12,6,9960,10165,-205
1,9,8,12,6,9040,10712,-1672
1,9,9,12,6,7860,11483,-3623
1,9,10,12,6,8151,11656,-3505
1,9,11,12,6,9049,10876,-1827
1,9,12,12,6,9899,10533,-634
1,10,0,12,6,10150,10176,-26
1,10,1,12,6,9941,10112,-171
1,10,2,12,6,10915,9183,1732
1,10,3,12,6,12290,7919,4371
1,10,4,12,6,11700,8212,3488
1,10,5,12,6,10969,9097,1872
1,10,6,12,6,10176,9943,233
1,10,7,12,6,10112,10157,-45
1,10,8,12,6,9183,10733,-1550
1,10,9,12,6,7919,11557,-3638
1,10,10,12,6,8212,11757,-3545
1,10,11,12,6,9097,11013,-1916
1,10,12,12,6,9943,10736,-793
1,11,0,12,6,10044,9846,198
1,11,1,12,6,9764,9851,-87
1,11,2,12,6,10646,8935,1711
1,11,3,12,6,12014,7571,4443
1,11,4,12,6,11301,7912,3389
1,11,5,12,6,10616,8826,1790
1,11,6,12,6,9846,9651,195
1,11,7,12,6,9851,9782,69
1,11,8,12,6,8935,10345,-1410
1,11,9,12,6,7571,11193,-3622
1,11,10,12,6,7912,11396,-3484
1,11,11,12,6,8826,10640,-1814
1,11,12,12,6,9651,10392,-741
1,12,0,12,6,9601,9094,507
1,12,1,12,6,9174,9215,-41
1,12,2,12,6,9937,8339,1598
1,12,3,12,6,11251,6973,4278
1,12,4,12,6,10512,7299,3213
1,12,5,12,6,9872,8217,1655
1,12,6,12,6,9094,8991,103
1,12,7,12,6,9215,9039,176
1,12,8,12,6,8339,9571,-1232
1,12,9,12,6,6973,10352,-3379
1,12,10,12,6,7299,10514,-3215
1,12,11,12,6,8217,9794,-1577
1,12,12,12,6,8991,9628,-637
1,0,0,13,6,8533,8233,300
1,0,1,13,6,8471,8039,432
1,0,2,13,6,8553,7788,765
1,0,3,13,6,8718,7558,1160
1,0,4,13,6,8752,7626,1126
1,0,5,13,6,8448,7906,542
1,0,6,13,6,8233,8188,45
1,0,7,13,6,8039,8366,-327
1,0,8,13,6,7788,8619,-831
1,0,9,13,6,7558,8887,-1329
1,0,10,13,6,7626,9035,-1409
1,0,11,13,6,7906,9065,-1159
1,0,12,13,6,8188,9029,-841
1,1,0,13,6,8878,8563,315
1,1,1,13,6,8846,8311,535
1,1,2,13,6,9003,7926,1077
1,1,3,13,6,9299,7538,1761
1,1,4,13,6,9305,7661,1644
1,1,5,13,6,8929,8088,841
1,1,6,13,6,8563,8494,69
1,1,7,13,6,8311,8772,-461
1,1,8,13,6,7926,9137,-1211
1,1,9,13,6,7538,9497,-1959
1,1,10,13,6,7661,9678,-2017
1,1,11,13,6,8088,9645,-1557
1,1,12,13,6,8494,9526,-1032
1,2,0,13,6,9216,8863,353
1,2,1,13,6,9179,8576,603
1,2,2,13,6,9402,8075,1327
1,2,3,13,6,9818,7558,2260
1,2,4,13,6,9802,7735,2067
1,2,5,13,6,9385,8265,1120
1,2,6,13,6,8863,8754,109
1,2,7,13,6,8576,9152,-576
1,2,8,13,6,8075,9620,-1545
1,2,9,13,6,7558,10033,-2475
1,2,10,13,6,7735,10250,-2515
1,2,11,13,6,8265,10178,-1913
1,2,12,13,6,8754,10038,-1284
1,3,0,13,6,9556,9127,429
1,3,1,13,6,9535,8783,752
1,3,2,13,6,9823,8147,1676
1,3,3,13,6,10367,7483,2884
1,3,4,13,6,10309,7739,2570
1,3,5,13,6,9804,8398,1406
1,3,6,13,6,9127,8962,165
1,3,7,13,6,8783,9499,-716
1,3,8,13,6,8147,10099,-1952
1,3,9,13,6,7483,10582,-3099
1,3,10,13,6,7739,10838,-3099
1,3,11,13,6,8398,10699,-2301
1,3,12,13,6,8962,10532,-1570
1,4,0,13,6,9769,9565,204
1,4,1,13,6,9770,9268,502
1,4,2,13,6,10194,8548,1646
1,4,3,13,6,10940,7750,3190
1,4,4,13,6,10906,8075,2831
1,4,5,13,6,10345,8847,1498
1,4,6,13,6,9565,9451,114
1,4,7,13,6,9268,9995,-727
1,4,8,13,6,8548,10642,-2094
1,4,9,13,6,7750,11141,-3391
1,4,10,13,6,8075,11354,-3279
1,4,11,13,6,8847,11057,-2210
1,4,12,13,6,9451,10848,-1397
1,5,0,13,6,9851,9984,-133
1,5,1,13,6,9876,9708,168
1,5,2,13,6,10499,8871,1628
1,5,3,13,6,11438,7945,3493
1,5,4,13,6,11393,8342,3051
1,5,5,13,6,10813,9235,1578
1,5,6,13,6,9984,9903,81
1,5,7,13,6,9708,10377,-669
1,5,8,13,6,8871,11023,-2152
1,5,9,13,6,7945,11567,-3622
1,5,10,13,6,8342,11744,-3402
1,5,11,13,6,9235,11244,-2009
1,5,12,13,6,9903,10994,-1091
1,6,0,13,6,10033,10148,-115
1,6,1,13,6,10050,9914,136
1,6,2,13,6,10792,8998,1794
1,6,3,13,6,11818,8067,3751
1,6,4,13,6,11713,8475,3238
1,6,5,13,6,11028,9372,1656
1,6,6,13,6,10148,10121,27
1,6,7,13,6,9914,10545,-631
1,6,8,13,6,8998,11199,-2201
1,6,9,13,6,8067,11789,-3722
1,6,10,13,6,8475,11995,-3520
1,6,11,13,6,9372,11446,-2074
1,6,12,13,6,10121,11109,-988
1,7,0,13,6,10250,10517,-267
1,7,1,13,6,10202,10367,-165
1,7,2,13,6,11019,9498,1521
1,7,3,13,6,12168,8491,3677
1,7,4,13,6,11972,8842,3130
1,7,5,13,6,11333,9761,1572
1,7,6,13,6,10517,10590,-73
1,7,7,13,6,10367,10923,-556
1,7,8,13,6,9498,11465,-1967
1,7,9,13,6,8491,12093,-3602
1,7,10,13,6,8842,12274,-3432
1,7,11,13,6,9761,11572,-1811
1,7,12,13,6,10590,11179,-589
1,8,0,13,6,10463,10844,-381
1,8,1,13,6,10346,10756,-410
1,8,2,13,6,11286,9861,1425
1,8,3,13,6,12606,8692,3914
1,8,4,13,6,12265,8986,3279
1,8,5,13,6,11625,9888,1737
1,8,6,13,6,10844,10732,112
1,8,7,13,6,10756,10981,-225
1,8,8,13,6,9861,11475,-1614
1,8,9,13,6,8692,12207,-3515
1,8,10,13,6,8986,12370,-3384
1,8,11,13,6,9888,11574,-1686
1,8,12,13,6,10732,11231,-499
1,9,0,13,6,10533,10457,76
1,9,1,13,6,10262,10388,-126
1,9,2,13,6,11234,9420,1814
1,9,3,13,6,12604,8119,4485
1,9,4,13,6,12012,8424,3588
1,9,5,13,6,11269,9339,1930
1,9,6,13,6,10457,10215,242
1,9,7,13,6,10388,10448,-60
1,9,8,13,6,9420,11043,-1623
1,9,9,13,6,8119,11891,-3772
1,9,10,13,6,8424,12098,-3674
1,9,11,13,6,9339,11371,-2032
1,9,12,13,6,10215,11131,-916
1,10,0,13,6,10594,10647,-53
1,10,1,13,6,10333,10654,-321
1,10,2,13,6,11328,9713,1615
1,10,3,13,6,12778,8331,4447
1,10,4,13,6,12117,8673,3444
1,10,5,13,6,11416,9600,1816
1,10,6,13,6,10647,10455,192
1,10,7,13,6,10654,10573,81
1,10,8,13,6,9713,11124,-1411
1,10,9,13,6,8331,11963,-3632
1,10,10,13,6,8673,12119,-3446
1,10,11,13,6,9600,11317,-1717
1,10,12,13,6,10455,11026,-571
1,11,0,13,6,10481,10313,168
1,11,1,13,6,10138,10402,-264
1,11,2,13,6,11031,9496,1535
1,11,3,13,6,12471,8098,4373
1,11,4,13,6,11787,8435,3352
1,11,5,13,6,11088,9401,1687
1,11,6,13,6,10313,10233,80
1,11,7,13,6,10402,10274,128
1,11,8,13,6,9496,10817,-1321
1,11,9,13,6,8098,11627,-3529
1,11,10,13,6,8435,11769,-3334
1,11,11,13,6,9401,10980,-1579
1,11,12,13,6,10233,10712,-479
1,0,0,14,6,9511,9184,327
1,0,1,14,6,9473,8930,543
1,0,2,14,6,9629,8542,1087
1,0,3,14,6,9933,8154,1779
1,0,4,14,6,9944,8279,1665
1,0,5,14,6,9559,8702,857
1,0,6,14,6,9184,9108,76
1,0,7,14,6,8930,9394,-464
1,0,8,14,6,8542,9764,-1222
1,0,9,14,6,8154,10118,-1964
1,0,10,14,6,8279,10297,-2018
1,0,11,14,6,8702,10275,-1573
1,0,12,14,6,9108,10156,-1048
1,1,0,14,6,9866,9493,373
1,1,1,14,6,9825,9207,618
1,1,2,14,6,10044,8703,1341
1,1,3,14,6,10461,8183,2278
1,1,4,14,6,10445,8361,2084
1,1,5,14,6,10020,8902,1118
1,1,6,14,6,9493,9395,98
1,1,7,14,6,9207,9794,-587
1,1,8,14,6,8703,10260,-1557
1,1,9,14,6,8183,10669,-2486
1,1,10,14,6,8361,10890,-2529
1,1,11,14,6,8902,10817,-1915
1,1,12,14,6,9395,10672,-1277
1,2,0,14,6,10214,9797,417
1,2,1,14,6,10195,9451,744
1,2,2,14,6,10486,8805,1681
1,2,3,14,6,11033,8136,2897
1,2,4,14,6,10981,8390,2591
1,2,5,14,6,10475,9057,1418
1,2,6,14,6,9797,9623,174
1,2,7,14,6,9451,10163,-712
1,2,8,14,6,8805,10762,-1957
1,2,9,14,6,8136,11238,-3102
1,2,10,14,6,8390,11493,-3103
1,2,11,14,6,9057,11352,-2295
1,2,12,14,6,9623,11182,-1559
1,3,0,14,6,10440,10062,378
1,3,1,14,6,10441,9715,726
1,3,2,14,6,10863,8943,1920
1,3,3,14,6,11571,8138,3433
1,3,4,14,6,11501,8461,3040
1,3,5,14,6,10894,9257,1637
1,3,6,14,6,10062,9897,165
1,3,7,14,6,9715,10496,-781
1,3,8,14,6,8943,11201,-2258
1,3,9,14,6,8138,11742,-3604
1,3,10,14,6,8461,11992,-3531
1,3,11,14,6,9257,11716,-2459
1,3,12,14,6,9897,11519,-1622
1,4,0,14,6,10559,10352,207
1,4,1,14,6,10564,10026,538
1,4,2,14,6,11144,9158,1986
1,4,3,14,6,12023,8225,3798
1,4,4,14,6,11914,8619,3295
1,4,5,14,6,11256,9523,1733
1,4,6,14,6,10352,10221,131
1,4,7,14,6,10026,10757,-731
1,4,8,14,6,9158,11481,-2323
1,4,9,14,6,8225,12093,-3868
1,4,10,14,6,8619,12332,-3713
1,4,11,14,6,9523,11886,-2363
1,4,12,14,6,10221,11671,-1450
1,5,0,14,6,10742,10525,217
1,5,1,14,6,10714,10287,427
1,5,2,14,6,11373,9397,1976
1,5,3,14,6,12348,8462,3886
1,5,4,14,6,12192,8868,3324
1,5,5,14,6,11449,9753,1696
1,5,6,14,6,10525,10495,30
1,5,7,14,6,10287,10935,-648
1,5,8,14,6,9397,11631,-2234
1,5,9,14,6,8462,12272,-3810
1,5,10,14,6,8868,12531,-3663
1,5,11,14,6,9753,12045,-2292
1,5,12,14,6,10495,11758,-1263
1,6,0,14,6,10861,10918,-57
1,6,1,14,6,10760,10770,-10
1,6,2,14,6,11511,9912,1599
1,6,3,14,6,12620,8904,3716
1,6,4,14,6,12404,9254,3150
1,6,5,14,6,11747,10181,1566
1,6,6,14,6,10918,11007,-89
1,6,7,14,6,10770,11342,-572
1,6,8,14,6,9912,11902,-1990
1,6,9,14,6,8904,12559,-3655
1,6,10,14,6,9254,12779,-3525
1,6,11,14,6,10181,12116,-1935
1,6,12,14,6,11007,11772,-765
1,7,0,14,6,10954,11418,-464
1,7,1,14,6,10789,11347,-558
1,7,2,14,6,11709,10445,1264
1,7,3,14,6,13034,9278,3756
1,7,4,14,6,12740,9572,3168
1,7,5,14,6,12157,10476,1681
1,7,6,14,6,11418,11305,113
1,7,7,14,6,11347,11534,-187
1,7,8,14,6,10445,12007,-1562
1,7,9,14,6,9278,12714,-3436
1,7,10,14,6,9572,12865,-3293
1,7,11,14,6,10476,12080,-1604
1,7,12,14,6,11305,11778,-473
1,8,0,14,6,11156,11242,-86
1,8,1,14,6,10894,11184,-290
1,8,2,14,6,11846,10241,1605
1,8,3,14,6,13222,8951,4271
1,8,4,14,6,12687,9259,3428
1,8,5,14,6,12011,10178,1833
1,8,6,14,6,11242,11048,194
1,8,7,14,6,11184,11264,-80
1,8,8,14,6,10241,11806,-1565
1,8,9,14,6,8951,12615,-3664
1,8,10,14,6,9259,12812,-3553
1,8,11,14,6,10178,12069,-1891
1,8,12,14,6,11048,11829,-781
1,9,0,14,6,10977,10928,49
1,9,1,14,6,10654,10930,-276
1,9,2,14,6,11647,9950,1697
1,9,3,14,6,13092,8531,4561
1,9,4,14,6,12429,8885,3544
1,9,5,14,6,11716,9842,1874
1,9,6,14,6,10928,10727,201
1,9,7,14,6,10930,10864,66
1,9,8,14,6,9950,11434,-1484
1,9,9,14,6,8531,12297,-3766
1,9,10,14,6,8885,12460,-3575
1,9,11,14,6,9842,11675,-1833
1,9,12,14,6,10727,11421,-694
1,10,0,14,6,11031,11114,-83
1,10,1,14,6,10707,11205,-498
1,10,2,14,6,11713,10274,1439
1,10,3,14,6,13235,8858,4377
1,10,4,14,6,12603,9196,3407
1,10,5,14,6,11888,10175,1713
1,10,6,14,6,11114,11037,77
1,10,7,14,6,11205,11065,140
1,10,8,14,6,10274,11596,-1322
1,10,9,14,6,8858,12397,-3539
1,10,10,14,6,9196,12492,-3296
1,10,11,14,6,10175,11657,-1482
1,10,12,14,6,11037,11346,-309
1,0,0,15,6,10499,10114,385
1,0,1,15,6,10452,9826,626
1,0,2,15,6,10670,9319,1351
1,0,3,15,6,11095,8799,2296
1,0,4,15,6,11084,8979,2105
1,0,5,15,6,10650,9516,1134
1,0,6,15,6,10114,10009,105
1,0,7,15,6,9826,10416,-590
1,0,8,15,6,9319,10887,-1568
1,0,9,15,6,8799,11290,-2491
1,0,10,15,6,8979,11509,-2530
1,0,11,15,6,9516,11447,-1931
1,0,12,15,6,10009,11302,-1293
1,1,0,15,6,10864,10427,437
1,1,1,15,6,10841,10082,759
1,1,2,15,6,11128,9433,1695
1,1,3,15,6,11676,8761,2915
1,1,4,15,6,11624,9016,2608
1,1,5,15,6,11110,9694,1416
1,1,6,15,6,10427,10264,163
1,1,7,15,6,10082,10805,-723
1,1,8,15,6,9433,11402,-1969
1,1,9,15,6,8761,11874,-3113
1,1,10,15,6,9016,12133,-3117
1,1,11,15,6,9694,11991,-2297
1,1,12,15,6,10264,11816,-1552
1,2,0,15,6,11098,10732,366
1,2,1,15,6,11101,10383,718
1,2,2,15,6,11526,9601,1925
1,2,3,15,6,12237,8791,3446
1,2,4,15,6,12173,9112,3061
1,2,5,15,6,11565,9916,1649
1,2,6,15,6,10732,10558,174
1,2,7,15,6,10383,11160,-777
1,2,8,15,6,9601,11864,-2263
1,2,9,15,6,8791,12398,-3607
1,2,10,15,6,9112,12647,-3535
1,2,11,15,6,9916,12369,-2453
1,2,12,15,6,10558,12169,-1611
1,3,0,15,6,11230,10849,381
1,3,1,15,6,11235,10473,762
1,3,2,15,6,11813,9553,2260
1,3,3,15,6,12654,8613,4041
1,3,4,15,6,12509,9005,3504
1,3,5,15,6,11805,9933,1872
1,3,6,15,6,10849,10667,182
1,3,7,15,6,10473,11258,-785
1,3,8,15,6,9553,12040,-2487
1,3,9,15,6,8613,12694,-4081
1,3,10,15,6,9005,12970,-3965
1,3,11,15,6,9933,12545,-2612
1,3,12,15,6,10667,12342,-1675
1,4,0,15,6,11450,10893,557
1,4,1,15,6,11402,10605,797
1,4,2,15,6,12018,9684,2334
1,4,3,15,6,12933,8742,4191
1,4,4,15,6,12713,9145,3568
1,4,5,15,6,11892,10041,1851
1,4,6,15,6,10893,10813,80
1,4,7,15,6,10605,11315,-710
1,4,8,15,6,9684,12089,-2405
1,4,9,15,6,8742,12798,-4056
1,4,10,15,6,9145,13119,-3974
1,4,11,15,6,10041,12687,-2646
1,4,12,15,6,10813,12435,-1622
1,5,0,15,6,11570,11295,275
1,5,1,15,6,11424,11143,281
1,5,2,15,6,12092,10311,1781
1,5,3,15,6,13150,9299,3851
1,5,4,15,6,12883,9647,3236
1,5,5,15,6,12168,10562,1606
1,5,6,15,6,11295,11381,-86
1,5,7,15,6,11143,11732,-589
1,5,8,15,6,10311,12334,-2023
1,5,9,15,6,9299,13042,-3743
1,5,10,15,6,9647,13315,-3668
1,5,11,15,6,10562,12715,-2153
1,5,12,15,6,11381,12421,-1040
1,6,0,15,6,11565,11819,-254
1,6,1,15,6,11347,11750,-403
1,6,2,15,6,12201,10859,1342
1,6,3,15,6,13486,9691,3795
1,6,4,15,6,13172,9984,3188
1,6,5,15,6,12571,10896,1675
1,6,6,15,6,11819,11722,97
1,6,7,15,6,11750,11953,-203
1,6,8,15,6,10859,12444,-1585
1,6,9,15,6,9691,13180,-3489
1,6,10,15,6,9984,13370,-3386
1,6,11,15,6,10896,12624,-1728
1,6,12,15,6,11722,12371,-649
1,7,0,15,6,11647,11816,-169
1,7,1,15,6,11337,11775,-438
1,7,2,15,6,12269,10825,1444
1,7,3,15,6,13650,9537,4113
1,7,4,15,6,13162,9845,3317
1,7,5,15,6,12543,10766,1777
1,7,6,15,6,11816,11621,195
1,7,7,15,6,11775,11817,-42
1,7,8,15,6,10825,12338,-1513
1,7,9,15,6,9537,13122,-3585
1,7,10,15,6,9845,13307,-3462
1,7,11,15,6,10766,12575,-1809
1,7,12,15,6,11621,12376,-755
1,8,0,15,6,11600,11713,-113
1,8,1,15,6,11286,11726,-440
1,8,2,15,6,12259,10771,1488
1,8,3,15,6,13710,9363,4347
1,8,4,15,6,13104,9720,3384
1,8,5,15,6,12458,10681,1777
1,8,6,15,6,11713,11560,153
1,8,7,15,6,11726,11680,46
1,8,8,15,6,10771,12197,-1426
1,8,9,15,6,9363,13021,-3658
1,8,10,15,6,9720,13174,-3454
1,8,11,15,6,10681,12373,-1692
1,8,12,15,6,11560,12119,-559
1,9,0,15,6,11414,11395,19
1,9,1,15,6,11028,11481,-453
1,9,2,15,6,12032,10511,1521
1,9,3,15,6,13549,9058,4491
1,9,4,15,6,12915,9408,3507
1,9,5,15,6,12188,10417,1771
1,9,6,15,6,11395,11309,86
1,9,7,15,6,11481,11356,125
1,9,8,15,6,10511,11906,-1395
1,9,9,15,6,9058,12731,-3673
1,9,10,15,6,9408,12833,-3425
1,9,11,15,6,10417,12015,-1598
1,9,12,15,6,11309,11741,-432
1,0,0,16,6,11497,11048,449
1,0,1,16,6,11468,10701,767
1,0,2,16,6,11754,10049,1705
1,0,3,16,6,12310,9377,2933
1,0,4,16,6,12263,9634,2629
1,0,5,16,6,11740,10308,1432
1,0,6,16,6,11048,10878,170
1,0,7,16,6,10701,11427,-726
1,0,8,16,6,10049,12029,-1980
1,0,9,16,6,9377,12495,-3118
1,0,10,16,6,9634,12752,-3118
1,0,11,16,6,10308,12621,-2313
1,0,12,16,6,10878,12446,-1568
1,1,0,16,6,11748,11362,386
1,1,1,16,6,11747,11014,733
1,1,2,16,6,12168,10229,1939
1,1,3,16,6,12880,9416,3464
1,1,4,16,6,12816,9738,3078
1,1,5,16,6,12200,10553,1647
1,1,6,16,6,11362,11199,163
1,1,7,16,6,11014,11802,-788
1,1,8,16,6,10229,12504,-2275
1,1,9,16,6,9416,13034,-3618
1,1,10,16,6,9738,13287,-3549
1,1,11,16,6,10553,13008,-2455
1,1,12,16,6,11199,12803,-1604
1,2,0,16,6,11888,11519,369
1,2,1,16,6,11895,11141,754
1,2,2,16,6,12476,10211,2265
1,2,3,16,6,13320,9266,4054
1,2,4,16,6,13181,9656,3525
1,2,5,16,6,12476,10592,1884
1,2,6,16,6,11519,11328,191
1,2,7,16,6,11141,11922,-781
1,2,8,16,6,10211,12703,-2492
1,2,9,16,6,9266,13350,-4084
1,2,10,16,6,9656,13625,-3969
1,2,11,16,6,10592,13198,-2606
1,2,12,16,6,11328,12992,-1664
1,3,0,16,6,12121,11390,731
1,3,1,16,6,12073,11052,1021
1,3,2,16,6,12687,10079,2608
1,3,3,16,6,13564,9130,4434
1,3,4,16,6,13308,9531,3777
1,3,5,16,6,12441,10451,1990
1,3,6,16,6,11390,11259,131
1,3,7,16,6,11052,11816,-764
1,3,8,16,6,10079,12648,-2569
1,3,9,16,6,9130,13399,-4269
1,3,10,16,6,9531,13757,-4226
1,3,11,16,6,10451,13346,-2895
1,3,12,16,6,11259,13106,-1847
1,4,0,16,6,12278,11663,615
1,4,1,16,6,12112,11461,651
1,4,2,16,6,12737,10598,2139
1,4,3,16,6,13735,9579,4156
1,4,4,16,6,13404,9924,3480
1,4,5,16,6,12611,10850,1761
1,4,6,16,6,11663,11699,-36
1,4,7,16,6,11461,12112,-651
1,4,8,16,6,10598,12792,-2194
1,4,9,16,6,9579,13568,-3989
1,4,10,16,6,9924,13903,-3979
1,4,11,16,6,10850,13357,-2507
1,4,12,16,6,11699,13098,-1399
1,5,0,16,6,12274,12196,78
1,5,1,16,6,12011,12123,-112
1,5,2,16,6,12782,11258,1524
1,5,3,16,6,14016,10086,3930
1,5,4,16,6,13651,10377,3274
1,5,5,16,6,12992,11277,1715
1,5,6,16,6,12196,12096,100
1,5,7,16,6,12123,12343,-220
1,5,8,16,6,11258,12876,-1618
1,5,9,16,6,10086,13663,-3577
1,5,10,16,6,10377,13906,-3529
1,5,11,16,6,11277,13223,-1946
1,5,12,16,6,12096,13020,-924
1,6,0,16,6,12258,12217,41
1,6,1,16,6,11895,12178,-283
1,6,2,16,6,12761,11239,1522
1,6,3,16,6,14102,9950,4152
1,6,4,16,6,13594,10257,3337
1,6,5,16,6,12957,11186,1771
1,6,6,16,6,12217,12038,179
1,6,7,16,6,12178,12236,-58
1,6,8,16,6,11239,12775,-1536
1,6,9,16,6,9950,13588,-3638
1,6,10,16,6,10257,13812,-3555
1,6,11,16,6,11186,13119,-1933
1,6,12,16,6,12038,12969,-931
1,7,0,16,6,12091,12287,-196
1,7,1,16,6,11729,12317,-588
1,7,2,16,6,12682,11355,1327
1,7,3,16,6,14138,9949,4189
1,7,4,16,6,13579,10306,3273
1,7,5,16,6,12990,11269,1721
1,7,6,16,6,12287,12133,154
1,7,7,16,6,12317,12233,84
1,7,8,16,6,11355,12729,-1374
1,7,9,16,6,9949,13528,-3579
1,7,10,16,6,10306,13669,-3363
1,7,11,16,6,11269,12879,-1610
1,7,12,16,6,12133,12666,-533
1,8,0,16,6,12037,12180,-143
1,8,1,16,6,11660,12277,-617
1,8,2,16,6,12644,11332,1312
1,8,3,16,6,14167,9890,4277
1,8,4,16,6,13590,10243,3347
1,8,5,16,6,12930,11256,1674
1,8,6,16,6,12180,12142,38
1,8,7,16,6,12277,12172,105
1,8,8,16,6,11332,12669,-1337
1,8,9,16,6,9890,13455,-3565
1,8,10,16,6,10243,13547,-3304
1,8,11,16,6,11256,12713,-1457
1,8,12,16,6,12142,12439,-297
1,0,0,17,6,12381,11983,398
1,0,1,17,6,12374,11633,741
1,0,2,17,6,12794,10845,1949
1,0,3,17,6,13514,10032,3482
1,0,4,17,6,13455,10356,3099
1,0,5,17,6,12830,11167,1663
1,0,6,17,6,11983,11813,170
1,0,7,17,6,11633,12424,-791
1,0,8,17,6,10845,13131,-2286
1,0,9,17,6,10032,13655,-3623
1,0,10,17,6,10356,13906,-3550
1,0,11,17,6,11167,13638,-2471
1,0,12,17,6,11813,13433,-1620
1,1,0,17,6,12538,12149,389
1,1,1,17,6,12541,11772,769
1,1,2,17,6,13118,10839,2279
1,1,3,17,6,13963,9891,4072
1,1,4,17,6,13824,10282,3542
1,1,5,17,6,13111,11229,1882
1,1,6,17,6,12149,11969,180
1,1,7,17,6,11772,12564,-792
1,1,8,17,6,10839,13343,-2504
1,1,9,17,6,9891,13986,-4095
1,1,10,17,6,10282,14265,-3983
1,1,11,17,6,11229,13837,-2608
1,1,12,17,6,11969,13626,-1657
1,2,0,17,6,12779,12060,719
1,2,1,17,6,12733,11720,1013
1,2,2,17,6,13350,10737,2613
1,2,3,17,6,14230,9783,4447
1,2,4,17,6,13980,10182,3798
1,2,5,17,6,13112,11110,2002
1,2,6,17,6,12060,11920,140
1,2,7,17,6,11720,12480,-760
1,2,8,17,6,10737,13311,-2574
1,2,9,17,6,9783,14055,-4272
1,2,10,17,6,10182,14412,-4230
1,2,11,17,6,11110,13999,-2889
1,2,12,17,6,11920,13756,-1836
1,3,0,17,6,12949,12160,789
1,3,1,17,6,12783,11908,875
1,3,2,17,6,13406,10993,2413
1,3,3,17,6,14366,9967,4399
1,3,4,17,6,13999,10310,3689
1,3,5,17,6,13160,11260,1900
1,3,6,17,6,12160,12145,15
1,3,7,17,6,11908,12613,-705
1,3,8,17,6,10993,13351,-2358
1,3,9,17,6,9967,14169,-4202
1,3,10,17,6,10310,14541,-4231
1,3,11,17,6,11260,14016,-2756
1,3,12,17,6,12145,13769,-1624
1,4,0,17,6,12982,12564,418
1,4,1,17,6,12699,12441,258
1,4,2,17,6,13427,11545,1882
1,4,3,17,6,14601,10366,4235
1,4,4,17,6,14172,10654,3518
1,4,5,17,6,13435,11565,1870
1,4,6,17,6,12564,12414,150
1,4,7,17,6,12441,12723,-282
1,4,8,17,6,11545,13334,-1789
1,4,9,17,6,10366,14189,-3823
1,4,10,17,6,10654,14494,-3840
1,4,11,17,6,11565,13865,-2300
1,4,12,17,6,12414,13697,-1283
1,5,0,17,6,12967,12594,373
1,5,1,17,6,12559,12551,8
1,5,2,17,6,13342,11638,1704
1,5,3,17,6,14632,10345,4287
1,5,4,17,6,14073,10650,3423
1,5,5,17,6,13378,11567,1811
1,5,6,17,6,12594,12412,182
1,5,7,17,6,12551,12626,-75
1,5,8,17,6,11638,13207,-1569
1,5,9,17,6,10345,14071,-3726
1,5,10,17,6,10650,14348,-3698
1,5,11,17,6,11567,13718,-2151
1,5,12,17,6,12412,13618,-1206
1,6,0,17,6,12702,12688,14
1,6,1,17,6,12287,12720,-433
1,6,2,17,6,13174,11769,1405
1,6,3,17,6,14590,10362,4228
1,6,4,17,6,14011,10718,3293
1,6,5,17,6,13404,11689,1715
1,6,6,17,6,12688,12550,138
1,6,7,17,6,12720,12652,68
1,6,8,17,6,11769,13166,-1397
1,6,9,17,6,10362,13994,-3632
1,6,10,17,6,10718,14174,-3456
1,6,11,17,6,11689,13423,-1734
1,6,12,17,6,12550,13259,-709
1,7,0,17,6,12528,12754,-226
1,7,1,17,6,12103,12868,-765
1,7,2,17,6,13067,11916,1151
1,7,3,17,6,14595,10476,4119
1,7,4,17,6,14065,10829,3236
1,7,5,17,6,13462,11844,1618
1,7,6,17,6,12754,12715,39
1,7,7,17,6,12868,12725,143
1,7,8,17,6,11916,13201,-1285
1,7,9,17,6,10476,13962,-3486
1,7,10,17,6,10829,14042,-3213
1,7,11,17,6,11844,13219,-1375
1,7,12,17,6,12715,12986,-271
1,0,0,18,6,13171,12770,401
1,0,1,18,6,13168,12391,777
1,0,2,18,6,13744,11455,2289
1,0,3,18,6,14597,10507,4090
1,0,4,18,6,14463,10900,3563
1,0,5,18,6,13741,11843,1898
1,0,6,18,6,12770,12583,187
1,0,7,18,6,12391,13186,-795
1,0,8,18,6,11455,13970,-2515
1,0,9,18,6,10507,14607,-4100
1,0,10,18,6,10900,14884,-3984
1,0,11,18,6,11843,14467,-2624
1,0,12,18,6,12583,14256,-1673
1,1,0,18,6,13429,12690,739
1,1,1,18,6,13379,12351,1028
1,1,2,18,6,13992,11365,2627
1,1,3,18,6,14873,10408,4465
1,1,4,18,6,14623,10808,3815
1,1,5,18,6,13747,11747,2000
1,1,6,18,6,12690,12561,129
1,1,7,18,6,12351,13122,-771
1,1,8,18,6,11365,13951,-2586
1,1,9,18,6,10408,14691,-4283
1,1,10,18,6,10808,15052,-4244
1,1,11,18,6,11747,14638,-2891
1,1,12,18,6,12561,14390,-1829
1,2,0,18,6,13607,12830,777
1,2,1,18,6,13443,12576,867
1,2,2,18,6,14069,11651,2418
1,2,3,18,6,15032,10620,4412
1,2,4,18,6,14671,10961,3710
1,2,5,18,6,13831,11919,1912
1,2,6,18,6,12830,12806,24
1,2,7,18,6,12576,13277,-701
1,2,8,18,6,11651,14014,-2363
1,2,9,18,6,10620,14825,-4205
1,2,10,18,6,10961,15196,-4235
1,2,11,18,6,11919,14669,-2750
1,2,12,18,6,12806,14419,-1613
1,3,0,18,6,13653,13061,592
1,3,1,18,6,13370,12888,482
1,3,2,18,6,14096,11940,2156
1,3,3,18,6,15232,10754,4478
1,3,4,18,6,14767,11040,3727
1,3,5,18,6,13984,11975,2009
1,3,6,18,6,13061,12860,201
1,3,7,18,6,12888,13224,-336
1,3,8,18,6,11940,13893,-1953
1,3,9,18,6,10754,14790,-4036
1,3,10,18,6,11040,15132,-4092
1,3,11,18,6,11975,14524,-2549
1,3,12,18,6,12860,14368,-1508
1,4,0,18,6,13675,12962,713
1,4,1,18,6,13247,12869,378
1,4,2,18,6,13987,11925,2062
1,4,3,18,6,15217,10625,4592
1,4,4,18,6,14594,10927,3667
1,4,5,18,6,13821,11855,1966
1,4,6,18,6,12962,12730,232
1,4,7,18,6,12869,13006,-137
1,4,8,18,6,11925,13665,-1740
1,4,9,18,6,10625,14597,-3972
1,4,10,18,6,10927,14936,-4009
1,4,11,18,6,11855,14360,-2505
1,4,12,18,6,12730,14295,-1565
1,5,0,18,6,13411,13065,346
1,5,1,18,6,12951,13093,-142
1,5,2,18,6,13755,12168,1587
1,5,3,18,6,15120,10757,4363
1,5,4,18,6,14490,11111,3379
1,5,5,18,6,13825,12070,1755
1,5,6,18,6,13065,12924,141
1,5,7,18,6,13093,13042,51
1,5,8,18,6,12168,13598,-1430
1,5,9,18,6,10757,14477,-3720
1,5,10,18,6,11111,14710,-3599
1,5,11,18,6,12070,14022,-1952
1,5,12,18,6,12924,13908,-984
1,6,0,18,6,13139,13155,-16
1,6,1,18,6,12661,13271,-610
1,6,2,18,6,13559,12330,1229
1,6,3,18,6,15047,10889,4158
1,6,4,18,6,14497,11241,3256
1,6,5,18,6,13876,12264,1612
1,6,6,18,6,13155,13132,23
1,6,7,18,6,13271,13144,127
1,6,8,18,6,12330,13638,-1308
1,6,9,18,6,10889,14428,-3539
1,6,10,18,6,11241,14547,-3306
1,6,11,18,6,12264,13763,-1499
1,6,12,18,6,13132,13579,-447
1,0,0,19,6,14062,13311,751
1,0,1,19,6,14006,12970,1036
1,0,2,19,6,14618,11981,2637
1,0,3,19,6,15507,11024,4483
1,0,4,19,6,15262,11426,3836
1,0,5,19,6,14377,12361,2016
1,0,6,19,6,13311,13175,136
1,0,7,19,6,12970,13744,-774
1,0,8,19,6,11981,14578,-2597
1,0,9,19,6,11024,15312,-4288
1,0,10,19,6,11426,15671,-4245
1,0,11,19,6,12361,15268,-2907
1,0,12,19,6,13175,15020,-1845
1,1,0,19,6,14257,13460,797
1,1,1,19,6,14089,13207,882
1,1,2,19,6,14711,12279,2432
1,1,3,19,6,15675,11245,4430
1,1,4,19,6,15314,11587,3727
1,1,5,19,6,14466,12556,1910
1,1,6,19,6,13460,13447,13
1,1,7,19,6,13207,13919,-712
1,1,8,19,6,12279,14654,-2375
1,1,9,19,6,11245,15461,-4216
1,1,10,19,6,11587,15836,-4249
1,1,11,19,6,12556,15308,-2752
1,1,12,19,6,13447,15053,-1606
1,2,0,19,6,14311,13731,580
1,2,1,19,6,14030,13556,474
1,2,2,19,6,14759,12598,2161
1,2,3,19,6,15898,11407,4491
1,2,4,19,6,15439,11691,3748
1,2,5,19,6,14655,12634,2021
1,2,6,19,6,13731,13521,210
1,2,7,19,6,13556,13888,-332
1,2,8,19,6,12598,14556,-1958
1,2,9,19,6,11407,15446,-4039
1,2,10,19,6,11691,15787,-4096
1,2,11,19,6,12634,15177,-2543
1,2,12,19,6,13521,15018,-1497
1,3,0,19,6,14346,13459,887
1,3,1,19,6,13918,13316,602
1,3,2,19,6,14656,12320,2336
1,3,3,19,6,15848,11013,4835
1,3,4,19,6,15189,11313,3876
1,3,5,19,6,14370,12265,2105
1,3,6,19,6,13459,13176,283
1,3,7,19,6,13316,13507,-191
1,3,8,19,6,12320,14224,-1904
1,3,9,19,6,11013,15198,-4185
1,3,10,19,6,11313,15574,-4261
1,3,11,19,6,12265,15019,-2754
1,3,12,19,6,13176,14966,-1790
1,4,0,19,6,14119,13433,686
1,4,1,19,6,13639,13411,228
1,4,2,19,6,14400,12455,1945
1,4,3,19,6,15705,11037,4668
1,4,4,19,6,15011,11388,3623
1,4,5,19,6,14268,12358,1910
1,4,6,19,6,13433,13242,191
1,4,7,19,6,13411,13422,-11
1,4,8,19,6,12455,14056,-1601
1,4,9,19,6,11037,15003,-3966
1,4,10,19,6,11388,15298,-3910
1,4,11,19,6,12358,14664,-2306
1,4,12,19,6,13242,14585,-1343
1,5,0,19,6,13848,13532,316
1,5,1,19,6,13325,13644,-319
1,5,2,19,6,14140,12729,1411
1,5,3,19,6,15577,11284,4293
1,5,4,19,6,14976,11634,3342
1,5,5,19,6,14297,12645,1652
1,5,6,19,6,13532,13506,26
1,5,7,19,6,13644,13534,110
1,5,8,19,6,12729,14070,-1341
1,5,9,19,6,11284,14911,-3627
1,5,10,19,6,11634,15083,-3449
1,5,11,19,6,12645,14362,-1717
1,5,12,19,6,13506,14228,-722
1,0,0,20,6,14890,14081,809
1,0,1,20,6,14716,13826,890
1,0,2,20,6,15337,12895,2442
1,0,3,20,6,16309,11861,4448
1,0,4,20,6,15953,12205,3748
1,0,5,20,6,15096,13170,1926
1,0,6,20,6,14081,14061,20
1,0,7,20,6,13826,14541,-715
1,0,8,20,6,12895,15281,-2386
1,0,9,20,6,11861,16082,-4221
1,0,10,20,6,12205,16455,-4250
1,0,11,20,6,13170,15938,-2768
1,0,12,20,6,14061,15683,-1622
1,1,0,20,6,14961,14361,600
1,1,1,20,6,14676,14187,489
1,1,2,20,6,15401,13226,2175
1,1,3,20,6,16541,12032,4509
1,1,4,20,6,16082,12317,3765
1,1,5,20,6,15290,13271,2019
1,1,6,20,6,14361,14162,199
1,1,7,20,6,14187,14530,-343
1,1,8,20,6,13226,15196,-1970
1,1,9,20,6,12032,16082,-4050
1,1,10,20,6,12317,16427,-4110
1,1,11,20,6,13271,15816,-2545
1,1,12,20,6,14162,15652,-1490
1,2,0,20,6,15004,14129,875
1,2,1,20,6,14578,13984,594
1,2,2,20,6,15319,12978,2341
1,2,3,20,6,16514,11666,4848
1,2,4,20,6,15861,11964,3897
1,2,5,20,6,15041,12924,2117
1,2,6,20,6,14129,13837,292
1,2,7,20,6,13984,14171,-187
1,2,8,20,6,12978,14887,-1909
1,2,9,20,6,11666,15854,-4188
1,2,10,20,6,11964,16229,-4265
1,2,11,20,6,12924,15672,-2748
1,2,12,20,6,13837,15616,-1779
1,3,0,20,6,14790,13930,860
1,3,1,20,6,14310,13858,452
1,3,2,20,6,15069,12850,2219
1,3,3,20,6,16336,11425,4911
1,3,4,20,6,15606,11774,3832
1,3,5,20,6,14817,12768,2049
1,3,6,20,6,13930,13688,242
1,3,7,20,6,13858,13923,-65
1,3,8,20,6,12850,14615,-1765
1,3,9,20,6,11425,15604,-4179
1,3,10,20,6,11774,15936,-4162
1,3,11,20,6,12768,15323,-2555
1,3,12,20,6,13688,15256,-1568
1,4,0,20,6,14556,13900,656
1,4,1,20,6,14013,13962,51
1,4,2,20,6,14785,13016,1769
1,4,3,20,6,16162,11564,4598
1,4,4,20,6,15497,11911,3586
1,4,5,20,6,14740,12933,1807
1,4,6,20,6,13900,13824,76
1,4,7,20,6,13962,13914,48
1,4,8,20,6,13016,14528,-1512
1,4,9,20,6,11564,15437,-3873
1,4,10,20,6,11911,15671,-3760
1,4,11,20,6,12933,15004,-2071
1,4,12,20,6,13824,14905,-1081
1,0,0,21,6,15594,14982,612
1,0,1,21,6,15303,14806,497
1,0,2,21,6,16027,13842,2185
1,0,3,21,6,17175,12648,4527
1,0,4,21,6,16721,12935,3786
1,0,5,21,6,15920,13885,2035
1,0,6,21,6,14982,14776,206
1,0,7,21,6,14806,15152,-346
1,0,8,21,6,13842,15823,-1981
1,0,9,21,6,12648,16703,-4055
1,0,10,21,6,12935,17046,-4111
1,0,11,21,6,13885,16446,-2561
1,0,12,21,6,14776,16282,-1506
1,1,0,21,6,15654,14759,895
1,1,1,21,6,15224,14615,609
1,1,2,21,6,15961,13606,2355
1,1,3,21,6,17157,12291,4866
1,1,4,21,6,16504,12590,3914
1,1,5,21,6,15676,13561,2115
1,1,6,21,6,14759,14478,281
1,1,7,21,6,14615,14813,-198
1,1,8,21,6,13606,15527,-1921
1,1,9,21,6,12291,16490,-4199
1,1,10,21,6,12590,16869,-4279
1,1,11,21,6,13561,16311,-2750
1,1,12,21,6,14478,16250,-1772
1,2,0,21,6,15448,14600,848
1,2,1,21,6,14970,14526,444
1,2,2,21,6,15732,13508,2224
1,2,3,21,6,17002,12078,4924
1,2,4,21,6,16278,12425,3853
1,2,5,21,6,15488,13427,2061
1,2,6,21,6,14600,14349,251
1,2,7,21,6,14526,14587,-61
1,2,8,21,6,13508,15278,-1770
1,2,9,21,6,12078,16260,-4182
1,2,10,21,6,12425,16591,-4166
1,2,11,21,6,13427,15976,-2549
1,2,12,21,6,14349,15906,-1557
1,3,0,21,6,15227,14397,830
1,3,1,21,6,14684,14409,275
1,3,2,21,6,15454,13411,2043
1,3,3,21,6,16793,11952,4841
1,3,4,21,6,16092,12297,3795
1,3,5,21,6,15289,13343,1946
1,3,6,21,6,14397,14270,127
1,3,7,21,6,14409,14415,-6
1,3,8,21,6,13411,15087,-1676
1,3,9,21,6,11952,16038,-4086
1,3,10,21,6,12297,16309,-4012
1,3,11,21,6,13343,15663,-2320
1,3,12,21,6,14270,15576,-1306
1,0,0,22,6,16287,15380,907
1,0,1,22,6,15851,15234,617
1,0,2,22,6,16587,14222,2365
1,0,3,22,6,17791,12907,4884
1,0,4,22,6,17143,13208,3935
1,0,5,22,6,16306,14175,2131
1,0,6,22,6,15380,15092,288
1,0,7,22,6,15234,15435,-201
1,0,8,22,6,14222,16154,-1932
1,0,9,22,6,12907,17111,-4204
1,0,10,22,6,13208,17488,-4280
1,0,11,22,6,14175,16941,-2766
1,0,12,22,6,15092,16880,-1788
1,1,0,22,6,16098,15230,868
1,1,1,22,6,15616,15157,459
1,1,2,22,6,16374,14136,2238
1,1,3,22,6,17645,12703,4942
1,1,4,22,6,16921,13051,3870
1,1,5,22,6,16123,14064,2059
1,1,6,22,6,15230,14990,240
1,1,7,22,6,15157,15229,-72
1,1,8,22,6,14136,15918,-1782
1,1,9,22,6,12703,16896,-4193
1,1,10,22,6,13051,17231,-4180
1,1,11,22,6,14064,16615,-2551
1,1,12,22,6,14990,16540,-1550
1,2,0,22,6,15885,15067,818
1,2,1,22,6,15344,15077,267
1,2,2,22,6,16117,14069,2048
1,2,3,22,6,17459,12605,4854
1,2,4,22,6,16764,12948,3816
1,2,5,22,6,15960,14002,1958
1,2,6,22,6,15067,14931,136
1,2,7,22,6,15077,15079,-2
1,2,8,22,6,14069,15750,-1681
1,2,9,22,6,12605,16694,-4089
1,2,10,22,6,12948,16964,-4016
1,2,11,22,6,14002,16316,-2314
1,2,12,22,6,14931,16226,-1295
1,0,0,23,6,16731,15851,880
1,0,1,23,6,16243,15776,467
1,0,2,23,6,17000,14752,2248
1,0,3,23,6,18279,13319,4960
1,0,4,23,6,17560,13669,3891
1,0,5,23,6,16753,14678,2075
1,0,6,23,6,15851,15604,247
1,0,7,23,6,15776,15851,-75
1,0,8,23,6,14752,16545,-1793
1,0,9,23,6,13319,17517,-4198
1,0,10,23,6,13669,17850,-4181
1,0,11,23,6,14678,17245,-2567
1,0,12,23,6,15604,17170,-1566
1,1,0,23,6,16535,15697,838
1,1,1,23,6,15990,15708,282
1,1,2,23,6,16759,14697,2062
1,1,3,23,6,18102,13230,4872
1,1,4,23,6,17407,13574,3833
1,1,5,23,6,16595,14639,1956
1,1,6,23,6,15697,15572,125
1,1,7,23,6,15708,15721,-13
1,1,8,23,6,14697,16390,-1693
1,1,9,23,6,13230,17330,-4100
1,1,10,23,6,13574,17604,-4030
1,1,11,23,6,14639,16955,-2316
1,1,12,23,6,15572,16860,-1288
1,0,0,24,6,17168,16318,850
1,0,1,24,6,16617,16327,290
1,0,2,24,6,17385,15313,2072
1,0,3,24,6,18736,13846,4890
1,0,4,24,6,18046,14192,3854
1,0,5,24,6,17225,15253,1972
1,0,6,24,6,16318,16186,132
1,0,7,24,6,16327,16343,-16
1,0,8,24,6,15313,17017,-1704
1,0,9,24,6,13846,17951,-4105
1,0,10,24,6,14192,18223,-4031
1,0,11,24,6,15253,17585,-2332
1,0,12,24,6,16186,17490,-1304
1,0,0,1,7,737,722,15
1,0,1,1,7,733,720,13
1,0,2,1,7,730,721,9
1,0,3,1,7,737,716,21
1,0,4,1,7,741,716,25
1,0,5,1,7,732,724,8
1,0,6,1,7,723,730,-7
1,0,7,1,7,722,725,-3
1,0,8,1,7,720,724,-4
1,0,9,1,7,721,728,-7
1,0,10,1,7,716,732,-16
1,1,0,1,7,752,735,17
1,1,1,1,7,753,733,20
1,1,2,1,7,750,732,18
1,1,3,1,7,749,741,8
1,1,4,1,7,747,744,3
1,1,5,1,7,738,745,-7
1,1,6,1,7,733,744,-11
1,1,7,1,7,735,741,-6
1,1,8,1,7,733,747,-14
1,1,9,1,7,732,754,-22
1,1,10,1,7,741,741,0
1,2,0,1,7,766,776,-10
1,2,1,1,7,778,768,10
1,2,2,1,7,778,764,14
1,2,3,1,7,779,768,11
1,2,4,1,7,781,768,13
1,2,5,1,7,778,770,8
1,2,6,1,7,776,771,5
1,2,7,1,7,776,766,10
1,2,8,1,7,768,766,2
1,2,9,1,7,764,770,-6
1,2,10,1,7,768,759,9
1,3,0,1,7,783,510,273
1,3,1,1,7,786,460,326
1,3,2,1,7,741,455,286
1,3,3,1,7,700,476,224
1,3,4,1,7,661,509,152
1,3,5,1,7,612,563,49
1,3,6,1,7,559,622,-63
1,3,7,1,7,510,666,-156
1,3,8,1,7,460,705,-245
1,3,9,1,7,455,749,-294
1,3,10,1,7,476,770,-294
1,4,0,1,7,802,363,439
1,4,1,1,7,764,334,430
1,4,2,1,7,699,328,371
1,4,3,1,7,636,336,300
1,4,4,1,7,569,363,206
1,4,5,1,7,488,424,64
1,4,6,1,7,412,503,-91
1,4,7,1,7,363,573,-210
1,4,8,1,7,334,636,-302
1,4,9,1,7,328,701,-373
1,4,10,1,7,336,752,-416
1,5,0,1,7,778,438,340
1,5,1,1,7,703,464,239
1,5,2,1,7,650,461,189
1,5,3,1,7,598,448,150
1,5,4,1,7,546,439,107
1,5,5,1,7,486,455,31
1,5,6,1,7,442,497,-55
1,5,7,1,7,438,548,-110
1,5,8,1,7,464,602,-138
1,5,9,1,7,461,654,-193
1,5,10,1,7,448,707,-259
1,6,0,1,7,678,472,206
1,6,1,1,7,616,482,134
1,6,2,1,7,561,481,80
1,6,3,1,7,521,489,32
1,6,4,1,7,501,486,15
1,6,5,1,7,483,488,-5
1,6,6,1,7,470,506,-36
1,6,7,1,7,472,534,-62
1,6,8,1,7,482,573,-91
1,6,9,1,7,481,621,-140
1,6,10,1,7,489,659,-170
1,7,0,1,7,573,689,-116
1,7,1,1,7,548,681,-133
1,7,2,1,7,518,682,-164
1,7,3,1,7,524,685,-161
1,7,4,1,7,572,672,-100
1,7,5,1,7,631,652,-21
1,7,6,1,7,673,630,43
1,7,7,1,7,689,604,85
1,7,8,1,7,681,591,90
1,7,9,1,7,682,605,77
1,7,10,1,7,685,631,54
1,8,0,1,7,758,942,-184
1,8,1,1,7,753,959,-206
1,8,2,1,7,739,970,-231
1,8,3,1,7,753,969,-216
1,8,4,1,7,805,970,-165
1,8,5,1,7,879,962,-83
1,8,6,1,7,931,909,22
1,8,7,1,7,942,862,80
1,8,8,1,7,959,852,107
1,8,9,1,7,970,832,138
1,8,10,1,7,969,829,140
1,9,0,1,7,427,304,123
1,9,1,1,7,388,264,124
1,9,2,1,7,383,253,130
1,9,3,1,7,355,271,84
1,9,4,1,7,341,308,33
1,9,5,1,7,336,330,6
1,9,6,1,7,320,338,-18
1,9,7,1,7,304,361,-57
1,9,8,1,7,264,394,-130
1,9,9,1,7,253,417,-164
1,9,10,1,7,271,461,-190
1,10,0,1,7,673,935,-262
1,10,1,1,7,726,902,-176
1,10,2,1,7,824,889,-65
1,10,3,1,7,892,906,-14
1,10,4,1,7,948,923,25
1,10,5,1,7,919,916,3
1,10,6,1,7,926,911,15
1,10,7,1,7,935,894,41
1,10,8,1,7,902,852,50
1,10,9,1,7,889,822,67
1,10,10,1,7,906,783,123
1,11,0,1,7,1103,1387,-284
1,11,1,1,7,1194,1341,-147
1,11,2,1,7,1310,1314,-4
1,11,3,1,7,1398,1378,20
1,11,4,1,7,1469,1420,49
1,11,5,1,7,1394,1426,-32
1,11,6,1,7,1410,1446,-36
1,11,7,1,7,1387,1459,-72
1,11,8,1,7,1341,1444,-103
1,11,9,1,7,1314,1428,-114
1,11,10,1,7,1378,1320,58
1,12,0,1,7,1179,1038,141
1,12,1,1,7,1252,917,335
1,12,2,1,7,1337,844,493
1,12,3,1,7,1344,984,360
1,12,4,1,7,1332,1108,224
1,12,5,1,7,1210,1193,17
1,12,6,1,7,1140,1284,-144
1,12,7,1,7,1038,1391,-353
1,12,8,1,7,917,1485,-568
1,12,9,1,7,844,1525,-681
1,12,10,1,7,984,1405,-421
1,13,0,1,7,1148,987,161
1,13,1,1,7,1235,845,390
1,13,2,1,7,1325,753,572
1,13,3,1,7,1315,902,413
1,13,4,1,7,1298,1013,285
1,13,5,1,7,1204,1138,66
1,13,6,1,7,1061,1241,-180
1,13,7,1,7,987,1322,-335
1,13,8,1,7,845,1419,-574
1,13,9,1,7,753,1459,-706
1,13,10,1,7,902,1344,-442
1,14,0,1,7,1131,1008,123
1,14,1,1,7,1210,881,329
1,14,2,1,7,1277,800,477
1,14,3,1,7,1262,941,321
1,14,4,1,7,1267,994,273
1,14,5,1,7,1184,1131,53
1,14,6,1,7,1039,1235,-196
1,14,7,1,7,1008,1276,-268
1,14,8,1,7,881,1367,-486
1,14,9,1,7,800,1413,-613
1,14,10,1,7,941,1326,-385
1,15,0,1,7,1162,967,195
1,15,1,1,7,1253,816,437
1,15,2,1,7,1322,738,584
1,15,3,1,7,1298,910,388
1,15,4,1,7,1297,963,334
1,15,5,1,7,1184,1116,68
1,15,6,1,7,1039,1234,-195
1,15,7,1,7,967,1291,-324
1,15,8,1,7,816,1403,-587
1,15,9,1,7,738,1429,-691
1,15,10,1,7,910,1315,-405
1,16,0,1,7,1014,1044,-30
1,16,1,1,7,1154,894,260
1,16,2,1,7,1279,829,450
1,16,3,1,7,1311,976,335
1,16,4,1,7,1309,1029,280
1,16,5,1,7,1184,1124,60
1,16,6,1,7,1062,1214,-152
1,16,7,1,7,1044,1258,-214
1,16,8,1,7,894,1328,-434
1,16,9,1,7,829,1271,-442
1,16,10,1,7,976,1157,-181
1,17,0,1,7,902,841,61
1,17,1,1,7,1025,671,354
1,17,2,1,7,1146,615,531
1,17,3,1,7,1154,786,368
1,17,4,1,7,1118,837,281
1,17,5,1,7,978,845,133
1,17,6,1,7,870,922,-52
1,17,7,1,7,841,1013,-172
1,17,8,1,7,671,1118,-447
1,17,9,1,7,615,1071,-456
1,17,10,1,7,786,984,-198
1,18,0,1,7,960,654,306
1,18,1,1,7,966,629,337
1,18,2,1,7,986,599,387
1,18,3,1,7,983,593,390
1,18,4,1,7,874,676,198
1,18,5,1,7,720,665,55
1,18,6,1,7,648,683,-35
1,18,7,1,7,654,808,-154
1,18,8,1,7,629,869,-240
1,18,9,1,7,599,868,-269
1,18,10,1,7,593,922,-329
1,19,0,1,7,900,1013,-113
1,19,1,1,7,809,1024,-215
1,19,2,1,7,906,902,4
1,19,3,1,7,925,967,-42
1,19,4,1,7,849,1017,-168
1,19,5,1,7,850,955,-105
1,19,6,1,7,928,860,68
1,19,7,1,7,1013,880,133
1,19,8,1,7,1024,849,175
1,19,9,1,7,902,858,44
1,19,10,1,7,967,871,96
1,20,0,1,7,777,1126,-349
1,20,1,1,7,766,1031,-265
1,20,2,1,7,934,862,72
1,20,3,1,7,998,868,130
1,20,4,1,7,921,835,86
1,20,5,1,7,944,763,181
1,20,6,1,7,1053,688,365
1,20,7,1,7,1126,705,421
1,20,8,1,7,1031,666,365
1,20,9,1,7,862,646,216
1,20,10,1,7,868,719,149
1,21,0,1,7,751,464,287
1,21,1,1,7,632,404,228
1,21,2,1,7,705,314,391
1,21,3,1,7,657,316,341
1,21,4,1,7,448,360,88
1,21,5,1,7,430,371,59
1,21,6,1,7,486,367,119
1,21,7,1,7,464,432,32
1,21,8,1,7,404,497,-93
1,21,9,1,7,314,538,-224
1,21,10,1,7,316,668,-352
1,22,0,1,7,489,625,-136
1,22,1,1,7,487,563,-76
1,22,2,1,7,564,510,54
1,22,3,1,7,537,573,-36
1,22,4,1,7,487,573,-86
1,22,5,1,7,508,532,-24
1,22,6,1,7,587,474,113
1,22,7,1,7,625,439,186
1,22,8,1,7,563,460,103
1,22,9,1,7,510,416,94
1,22,10,1,7,573,360,213
1,23,0,1,7,485,641,-156
1,23,1,1,7,454,653,-199
1,23,2,1,7,511,621,-110
1,23,3,1,7,555,630,-75
1,23,4,1,7,541,642,-101
1,23,5,1,7,532,624,-92
1,23,6,1,7,599,562,37
1,23,7,1,7,641,526,115
1,23,8,1,7,653,467,186
1,23,9,1,7,621,447,174
1,23,10,1,7,630,387,243
1,0,0,2,7,1489,1457,32
1,0,1,2,7,1486,1453,33
1,0,2,2,7,1480,1453,27
1,0,3,2,7,1486,1457,29
1,0,4,2,7,1488,1460,28
1,0,5,2,7,1470,1469,1
1,0,6,2,7,1456,1474,-18
1,0,7,2,7,1457,1466,-9
1,0,8,2,7,1453,1471,-18
1,0,9,2,7,1453,1482,-29
1,0,10,2,7,1457,1473,-16
1,1,0,2,7,1518,1511,7
1,1,1,2,7,1531,1501,30
1,1,2,2,7,1528,1496,32
1,1,3,2,7,1528,1509,19
1,1,4,2,7,1528,1512,16
1,1,5,2,7,1516,1515,1
1,1,6,2,7,1509,1515,-6
1,1,7,2,7,1511,1507,4
1,1,8,2,7,1501,1513,-12
1,1,9,2,7,1496,1524,-28
1,1,10,2,7,1509,1500,9
1,2,0,2,7,1549,1286,263
1,2,1,2,7,1564,1228,336
1,2,2,2,7,1519,1219,300
1,2,3,2,7,1479,1244,235
1,2,4,2,7,1442,1277,165
1,2,5,2,7,1390,1333,57
1,2,6,2,7,1335,1393,-58
1,2,7,2,7,1286,1432,-146
1,2,8,2,7,1228,1471,-243
1,2,9,2,7,1219,1519,-300
1,2,10,2,7,1244,1529,-285
1,3,0,2,7,1585,873,712
1,3,1,2,7,1550,794,756
1,3,2,2,7,1440,783,657
1,3,3,2,7,1336,812,524
1,3,4,2,7,1230,872,358
1,3,5,2,7,1100,987,113
1,3,6,2,7,971,1125,-154
1,3,7,2,7,873,1239,-366
1,3,8,2,7,794,1341,-547
1,3,9,2,7,783,1450,-667
1,3,10,2,7,812,1522,-710
1,4,0,2,7,1580,801,779
1,4,1,2,7,1467,798,669
1,4,2,2,7,1349,789,560
1,4,3,2,7,1234,784,450
1,4,4,2,7,1115,802,313
1,4,5,2,7,974,879,95
1,4,6,2,7,854,1000,-146
1,4,7,2,7,801,1121,-320
1,4,8,2,7,798,1238,-440
1,4,9,2,7,789,1355,-566
1,4,10,2,7,784,1459,-675
1,5,0,2,7,1456,910,546
1,5,1,2,7,1319,946,373
1,5,2,2,7,1211,942,269
1,5,3,2,7,1119,937,182
1,5,4,2,7,1047,925,122
1,5,5,2,7,969,943,26
1,5,6,2,7,912,1003,-91
1,5,7,2,7,910,1082,-172
1,5,8,2,7,946,1175,-229
1,5,9,2,7,942,1275,-333
1,5,10,2,7,937,1366,-429
1,6,0,2,7,1251,1161,90
1,6,1,2,7,1164,1163,1
1,6,2,2,7,1079,1163,-84
1,6,3,2,7,1045,1174,-129
1,6,4,2,7,1073,1158,-85
1,6,5,2,7,1114,1140,-26
1,6,6,2,7,1143,1136,7
1,6,7,2,7,1161,1138,23
1,6,8,2,7,1163,1164,-1
1,6,9,2,7,1163,1226,-63
1,6,10,2,7,1174,1290,-116
1,7,0,2,7,1331,1631,-300
1,7,1,2,7,1301,1640,-339
1,7,2,2,7,1257,1652,-395
1,7,3,2,7,1277,1654,-377
1,7,4,2,7,1377,1642,-265
1,7,5,2,7,1510,1614,-104
1,7,6,2,7,1604,1539,65
1,7,7,2,7,1631,1466,165
1,7,8,2,7,1640,1443,197
1,7,9,2,7,1652,1437,215
1,7,10,2,7,1654,1460,194
1,8,0,2,7,1185,1246,-61
1,8,1,2,7,1141,1223,-82
1,8,2,2,7,1122,1223,-101
1,8,3,2,7,1108,1240,-132
1,8,4,2,7,1146,1278,-132
1,8,5,2,7,1215,1292,-77
1,8,6,2,7,1251,1247,4
1,8,7,2,7,1246,1223,23
1,8,8,2,7,1223,1246,-23
1,8,9,2,7,1223,1249,-26
1,8,10,2,7,1240,1290,-50
1,9,0,2,7,1100,1239,-139
1,9,1,2,7,1114,1166,-52
1,9,2,2,7,1207,1142,65
1,9,3,2,7,1247,1177,70
1,9,4,2,7,1289,1231,58
1,9,5,2,7,1255,1246,9
1,9,6,2,7,1246,1249,-3
1,9,7,2,7,1239,1255,-16
1,9,8,2,7,1166,1246,-80
1,9,9,2,7,1142,1239,-97
1,9,10,2,7,1177,1244,-67
1,10,0,2,7,1776,2322,-546
1,10,1,2,7,1920,2243,-323
1,10,2,2,7,2134,2203,-69
1,10,3,2,7,2290,2284,6
1,10,4,2,7,2417,2343,74
1,10,5,2,7,2313,2342,-29
1,10,6,2,7,2336,2357,-21
1,10,7,2,7,2322,2353,-31
1,10,8,2,7,2243,2296,-53
1,10,9,2,7,2203,2250,-47
1,10,10,2,7,2284,2103,181
1,11,0,2,7,2282,2425,-143
1,11,1,2,7,2446,2258,188
1,11,2,2,7,2647,2158,489
1,11,3,2,7,2742,2362,380
1,11,4,2,7,2801,2528,273
1,11,5,2,7,2604,2619,-15
1,11,6,2,7,2550,2730,-180
1,11,7,2,7,2425,2850,-425
1,11,8,2,7,2258,2929,-671
1,11,9,2,7,2158,2953,-795
1,11,10,2,7,2362,2725,-363
1,12,0,2,7,2327,2025,302
1,12,1,2,7,2487,1762,725
1,12,2,2,7,2662,1597,1065
1,12,3,2,7,2659,1886,773
1,12,4,2,7,2630,2121,509
1,12,5,2,7,2414,2331,83
1,12,6,2,7,2201,2525,-324
1,12,7,2,7,2025,2713,-688
1,12,8,2,7,1762,2904,-1142
1,12,9,2,7,1597,2984,-1387
1,12,10,2,7,1886,2749,-863
1,13,0,2,7,2279,1995,284
1,13,1,2,7,2445,1726,719
1,13,2,2,7,2602,1553,1049
1,13,3,2,7,2577,1843,734
1,13,4,2,7,2565,2007,558
1,13,5,2,7,2388,2269,119
1,13,6,2,7,2100,2476,-376
1,13,7,2,7,1995,2598,-603
1,13,8,2,7,1726,2786,-1060
1,13,9,2,7,1553,2872,-1319
1,13,10,2,7,1843,2670,-827
1,14,0,2,7,2293,1975,318
1,14,1,2,7,2463,1697,766
1,14,2,2,7,2599,1538,1061
1,14,3,2,7,2560,1851,709
1,14,4,2,7,2564,1957,607
1,14,5,2,7,2368,2247,121
1,14,6,2,7,2078,2469,-391
1,14,7,2,7,1975,2567,-592
1,14,8,2,7,1697,2770,-1073
1,14,9,2,7,1538,2842,-1304
1,14,10,2,7,1851,2641,-790
1,15,0,2,7,2176,2011,165
1,15,1,2,7,2407,1710,697
1,15,2,2,7,2601,1567,1034
1,15,3,2,7,2609,1886,723
1,15,4,2,7,2606,1992,614
1,15,5,2,7,2368,2240,128
1,15,6,2,7,2101,2448,-347
1,15,7,2,7,2011,2549,-538
1,15,8,2,7,1710,2731,-1021
1,15,9,2,7,1567,2700,-1133
1,15,10,2,7,1886,2472,-586
1,16,0,2,7,1916,1885,31
1,16,1,2,7,2179,1565,614
1,16,2,2,7,2425,1444,981
1,16,3,2,7,2465,1762,703
1,16,4,2,7,2427,1866,561
1,16,5,2,7,2162,1969,193
1,16,6,2,7,1932,2136,-204
1,16,7,2,7,1885,2271,-386
1,16,8,2,7,1565,2446,-881
1,16,9,2,7,1444,2342,-898
1,16,10,2,7,1762,2141,-379
1,17,0,2,7,1862,1495,367
1,17,1,2,7,1991,1300,691
1,17,2,2,7,2132,1214,918
1,17,3,2,7,2137,1379,758
1,17,4,2,7,1992,1513,479
1,17,5,2,7,1698,1510,188
1,17,6,2,7,1518,1605,-87
1,17,7,2,7,1495,1821,-326
1,17,8,2,7,1300,1987,-687
1,17,9,2,7,1214,1939,-725
1,17,10,2,7,1379,1906,-527
1,18,0,2,7,1860,1667,193
1,18,1,2,7,1775,1653,122
1,18,2,2,7,1892,1501,391
1,18,3,2,7,1908,1560,348
1,18,4,2,7,1723,1693,30
1,18,5,2,7,1570,1620,-50
1,18,6,2,7,1576,1543,33
1,18,7,2,7,1667,1688,-21
1,18,8,2,7,1653,1718,-65
1,18,9,2,7,1501,1726,-225
1,18,10,2,7,1560,1793,-233
1,19,0,2,7,1677,2139,-462
1,19,1,2,7,1575,2055,-480
1,19,2,2,7,1840,1764,76
1,19,3,2,7,1923,1835,88
1,19,4,2,7,1770,1852,-82
1,19,5,2,7,1794,1718,76
1,19,6,2,7,1981,1548,433
1,19,7,2,7,2139,1585,554
1,19,8,2,7,2055,1515,540
1,19,9,2,7,1764,1504,260
1,19,10,2,7,1835,1590,245
1,20,0,2,7,1528,1590,-62
1,20,1,2,7,1398,1435,-37
1,20,2,2,7,1639,1176,463
1,20,3,2,7,1655,1184,471
1,20,4,2,7,1369,1195,174
1,20,5,2,7,1374,1134,240
1,20,6,2,7,1539,1055,484
1,20,7,2,7,1590,1137,453
1,20,8,2,7,1435,1163,272
1,20,9,2,7,1176,1184,-8
1,20,10,2,7,1184,1387,-203
1,21,0,2,7,1240,1089,151
1,21,1,2,7,1119,967,152
1,21,2,2,7,1269,824,445
1,21,3,2,7,1194,889,305
1,21,4,2,7,935,933,2
1,21,5,2,7,938,903,35
1,21,6,2,7,1073,841,232
1,21,7,2,7,1089,871,218
1,21,8,2,7,967,957,10
1,21,9,2,7,824,954,-130
1,21,10,2,7,889,1028,-139
1,22,0,2,7,974,1266,-292
1,22,1,2,7,941,1216,-275
1,22,2,2,7,1075,1131,-56
1,22,3,2,7,1092,1203,-111
1,22,4,2,7,1028,1215,-187
1,22,5,2,7,1040,1156,-116
1,22,6,2,7,1186,1036,150
1,22,7,2,7,1266,965,301
1,22,8,2,7,1216,927,289
1,22,9,2,7,1131,863,268
1,22,10,2,7,1203,747,456
1,0,0,3,7,2255,2233,22
1,0,1,3,7,2264,2221,43
1,0,2,3,7,2258,2217,41
1,0,3,3,7,2265,2225,40
1,0,4,3,7,2269,2228,41
1,0,5,3,7,2248,2239,9
1,0,6,3,7,2232,2245,-13
1,0,7,3,7,2233,2232,1
1,0,8,3,7,2221,2237,-16
1,0,9,3,7,2217,2252,-35
1,0,10,3,7,2225,2232,-7
1,1,0,3,7,2301,2021,280
1,1,1,3,7,2317,1961,356
1,1,2,3,7,2269,1951,318
1,1,3,3,7,2228,1985,243
1,1,4,3,7,2189,2021,168
1,1,5,3,7,2128,2078,50
1,1,6,3,7,2068,2137,-69
1,1,7,3,7,2021,2173,-152
1,1,8,3,7,1961,2218,-257
1,1,9,3,7,1951,2273,-322
1,1,10,3,7,1985,2270,-285
1,2,0,3,7,2351,1649,702
1,2,1,3,7,2328,1562,766
1,2,2,3,7,2218,1547,671
1,2,3,3,7,2115,1580,535
1,2,4,3,7,2011,1640,371
1,2,5,3,7,1878,1757,121
1,2,6,3,7,1747,1896,-149
1,2,7,3,7,1649,2005,-356
1,2,8,3,7,1562,2107,-545
1,2,9,3,7,1547,2220,-673
1,2,10,3,7,1580,2281,-701
1,3,0,3,7,2363,1311,1052
1,3,1,3,7,2253,1258,995
1,3,2,3,7,2090,1244,846
1,3,3,3,7,1934,1260,674
1,3,4,3,7,1776,1311,465
1,3,5,3,7,1586,1442,144
1,3,6,3,7,1413,1622,-209
1,3,7,3,7,1311,1787,-476
1,3,8,3,7,1258,1943,-685
1,3,9,3,7,1244,2104,-860
1,3,10,3,7,1260,2229,-969
1,4,0,3,7,2258,1273,985
1,4,1,3,7,2083,1280,803
1,4,2,3,7,1910,1270,640
1,4,3,3,7,1755,1273,482
1,4,4,3,7,1616,1288,328
1,4,5,3,7,1457,1367,90
1,4,6,3,7,1324,1506,-182
1,4,7,3,7,1273,1655,-382
1,4,8,3,7,1280,1811,-531
1,4,9,3,7,1270,1976,-706
1,4,10,3,7,1273,2118,-845
1,5,0,3,7,2029,1599,430
1,5,1,3,7,1867,1627,240
1,5,2,3,7,1729,1624,105
1,5,3,3,7,1643,1622,21
1,5,4,3,7,1619,1597,22
1,5,5,3,7,1600,1595,5
1,5,6,3,7,1585,1633,-48
1,5,7,3,7,1599,1686,-87
1,5,8,3,7,1627,1766,-139
1,5,9,3,7,1624,1880,-256
1,5,10,3,7,1622,1997,-375
1,6,0,3,7,2009,2103,-94
1,6,1,3,7,1917,2122,-205
1,6,2,3,7,1818,2133,-315
1,6,3,3,7,1798,2143,-345
1,6,4,3,7,1878,2128,-250
1,6,5,3,7,1993,2102,-109
1,6,6,3,7,2074,2045,29
1,6,7,3,7,2103,2000,103
1,6,8,3,7,2122,2016,106
1,6,9,3,7,2133,2058,75
1,6,10,3,7,2143,2119,24
1,7,0,3,7,1758,1935,-177
1,7,1,3,7,1689,1904,-215
1,7,2,3,7,1640,1905,-265
1,7,3,3,7,1632,1925,-293
1,7,4,3,7,1718,1950,-232
1,7,5,3,7,1846,1944,-98
1,7,6,3,7,1924,1877,47
1,7,7,3,7,1935,1827,108
1,7,8,3,7,1904,1837,67
1,7,9,3,7,1905,1854,51
1,7,10,3,7,1925,1921,4
1,8,0,3,7,1858,2181,-323
1,8,1,3,7,1867,2125,-258
1,8,2,3,7,1946,2112,-166
1,8,3,3,7,2000,2146,-146
1,8,4,3,7,2094,2201,-107
1,8,5,3,7,2134,2208,-74
1,8,6,3,7,2177,2158,19
1,8,7,3,7,2181,2117,64
1,8,8,3,7,2125,2098,27
1,8,9,3,7,2112,2071,41
1,8,10,3,7,2146,2073,73
1,9,0,3,7,2203,2626,-423
1,9,1,3,7,2308,2507,-199
1,9,2,3,7,2517,2456,61
1,9,3,3,7,2645,2555,90
1,9,4,3,7,2758,2651,107
1,9,5,3,7,2649,2672,-23
1,9,6,3,7,2656,2695,-39
1,9,7,3,7,2626,2714,-88
1,9,8,3,7,2507,2690,-183
1,9,9,3,7,2456,2667,-211
1,9,10,3,7,2555,2564,-9
1,10,0,3,7,2955,3360,-405
1,10,1,3,7,3172,3160,12
1,10,2,3,7,3471,3047,424
1,10,3,3,7,3634,3268,366
1,10,4,3,7,3749,3451,298
1,10,5,3,7,3523,3535,-12
1,10,6,3,7,3476,3641,-165
1,10,7,3,7,3360,3744,-384
1,10,8,3,7,3160,3781,-621
1,10,9,3,7,3047,3775,-728
1,10,10,3,7,3268,3508,-240
1,11,0,3,7,3430,3412,18
1,11,1,3,7,3681,3103,578
1,11,2,3,7,3972,2911,1061
1,11,3,3,7,4057,3264,793
1,11,4,3,7,4099,3541,558
1,11,5,3,7,3808,3757,51
1,11,6,3,7,3611,3971,-360
1,11,7,3,7,3412,4172,-760
1,11,8,3,7,3103,4348,-1245
1,11,9,3,7,2911,4412,-1501
1,11,10,3,7,3264,4069,-805
1,12,0,3,7,3458,3033,425
1,12,1,3,7,3697,2643,1054
1,12,2,3,7,3939,2397,1542
1,12,3,3,7,3921,2827,1094
1,12,4,3,7,3897,3115,782
1,12,5,3,7,3598,3462,136
1,12,6,3,7,3240,3760,-520
1,12,7,3,7,3033,3989,-956
1,12,8,3,7,2643,4271,-1628
1,12,9,3,7,2397,4397,-2000
1,12,10,3,7,2827,4075,-1248
1,13,0,3,7,3441,2962,479
1,13,1,3,7,3698,2542,1156
1,13,2,3,7,3924,2291,1633
1,13,3,3,7,3875,2753,1122
1,13,4,3,7,3862,2970,892
1,13,5,3,7,3572,3385,187
1,13,6,3,7,3139,3710,-571
1,13,7,3,7,2962,3889,-927
1,13,8,3,7,2542,4189,-1647
1,13,9,3,7,2291,4301,-2010
1,13,10,3,7,2753,3985,-1232
1,14,0,3,7,3307,3019,288
1,14,1,3,7,3617,2591,1026
1,14,2,3,7,3878,2367,1511
1,14,3,3,7,3871,2827,1044
1,14,4,3,7,3873,2986,887
1,14,5,3,7,3552,3371,181
1,14,6,3,7,3140,3683,-543
1,14,7,3,7,3019,3825,-806
1,14,8,3,7,2591,4098,-1507
1,14,9,3,7,2367,4113,-1746
1,14,10,3,7,2827,3798,-971
1,15,0,3,7,3078,2852,226
1,15,1,3,7,3432,2381,1051
1,15,2,3,7,3747,2182,1565
1,15,3,3,7,3763,2672,1091
1,15,4,3,7,3724,2829,895
1,15,5,3,7,3346,3085,261
1,15,6,3,7,2971,3370,-399
1,15,7,3,7,2852,3562,-710
1,15,8,3,7,2381,3849,-1468
1,15,9,3,7,2182,3771,-1589
1,15,10,3,7,2672,3456,-784
1,16,0,3,7,2876,2539,337
1,16,1,3,7,3145,2194,951
1,16,2,3,7,3411,2043,1368
1,16,3,3,7,3448,2355,1093
1,16,4,3,7,3301,2542,759
1,16,5,3,7,2882,2634,248
1,16,6,3,7,2580,2819,-239
1,16,7,3,7,2539,3079,-540
1,16,8,3,7,2194,3315,-1121
1,16,9,3,7,2043,3210,-1167
1,16,10,3,7,2355,3063,-708
1,17,0,3,7,2762,2508,254
1,17,1,3,7,2800,2324,476
1,17,2,3,7,3038,2116,922
1,17,3,3,7,3062,2346,716
1,17,4,3,7,2841,2530,311
1,17,5,3,7,2548,2465,83
1,17,6,3,7,2446,2465,-19
1,17,7,3,7,2508,2701,-193
1,17,8,3,7,2324,2836,-512
1,17,9,3,7,2116,2797,-681
1,17,10,3,7,2346,2777,-431
1,18,0,3,7,2637,2793,-156
1,18,1,3,7,2541,2684,-143
1,18,2,3,7,2826,2363,463
1,18,3,3,7,2906,2428,478
1,18,4,3,7,2644,2528,116
1,18,5,3,7,2514,2383,131
1,18,6,3,7,2629,2231,398
1,18,7,3,7,2793,2393,400
1,18,8,3,7,2684,2384,300
1,18,9,3,7,2363,2372,-9
1,18,10,3,7,2428,2512,-84
1,19,0,3,7,2428,2603,-175
1,19,1,3,7,2207,2459,-252
1,19,2,3,7,2545,2078,467
1,19,3,3,7,2580,2151,429
1,19,4,3,7,2218,2212,6
1,19,5,3,7,2224,2089,135
1,19,6,3,7,2467,1915,552
1,19,7,3,7,2603,2017,586
1,19,8,3,7,2459,2012,447
1,19,9,3,7,2078,2042,36
1,19,10,3,7,2151,2258,-107
1,20,0,3,7,2017,2215,-198
1,20,1,3,7,1885,1998,-113
1,20,2,3,7,2203,1686,517
1,20,3,3,7,2192,1757,435
1,20,4,3,7,1856,1768,88
1,20,5,3,7,1882,1666,216
1,20,6,3,7,2126,1529,597
1,20,7,3,7,2215,1576,639
1,20,8,3,7,1998,1623,375
1,20,9,3,7,1686,1600,86
1,20,10,3,7,1757,1747,10
1,21,0,3,7,1725,1730,-5
1,21,1,3,7,1573,1620,-47
1,21,2,3,7,1780,1445,335
1,21,3,3,7,1749,1519,230
1,21,4,3,7,1476,1575,-99
1,21,5,3,7,1470,1527,-57
1,21,6,3,7,1672,1403,269
1,21,7,3,7,1730,1397,333
1,21,8,3,7,1620,1424,196
1,21,9,3,7,1445,1401,44
1,21,10,3,7,1519,1415,104
1,0,0,4,7,3038,2743,295
1,0,1,4,7,3050,2681,369
1,0,2,4,7,2999,2672,327
1,0,3,4,7,2965,2701,264
1,0,4,4,7,2930,2737,193
1,0,5,4,7,2860,2802,58
1,0,6,4,7,2791,2867,-76
1,0,7,4,7,2743,2898,-155
1,0,8,4,7,2681,2942,-261
1,0,9,4,7,2672,3001,-329
1,0,10,4,7,2701,3002,-301
1,1,0,4,7,3103,2384,719
1,1,1,4,7,3081,2295,786
1,1,2,4,7,2968,2279,689
1,1,3,4,7,2864,2321,543
1,1,4,4,7,2758,2384,374
1,1,5,4,7,2616,2502,114
1,1,6,4,7,2480,2640,-160
1,1,7,4,7,2384,2746,-362
1,1,8,4,7,2295,2854,-559
1,1,9,4,7,2279,2974,-695
1,1,10,4,7,2321,3022,-701
1,2,0,4,7,3129,2087,1042
1,2,1,4,7,3031,2026,1005
1,2,2,4,7,2868,2008,860
1,2,3,4,7,2713,2028,685
1,2,4,4,7,2557,2079,478
1,2,5,4,7,2364,2212,152
1,2,6,4,7,2189,2393,-204
1,2,7,4,7,2087,2553,-466
1,2,8,4,7,2026,2709,-683
1,2,9,4,7,2008,2874,-866
1,2,10,4,7,2028,2988,-960
1,3,0,4,7,3041,1783,1258
1,3,1,4,7,2869,1740,1129
1,3,2,4,7,2651,1725,926
1,3,3,4,7,2455,1749,706
1,3,4,4,7,2277,1797,480
1,3,5,4,7,2069,1930,139
1,3,6,4,7,1883,2128,-245
1,3,7,4,7,1783,2321,-538
1,3,8,4,7,1740,2516,-776
1,3,9,4,7,1725,2725,-1000
1,3,10,4,7,1749,2888,-1139
1,4,0,4,7,2831,1962,869
1,4,1,4,7,2631,1961,670
1,4,2,4,7,2428,1952,476
1,4,3,4,7,2279,1958,321
1,4,4,4,7,2188,1960,228
1,4,5,4,7,2088,2019,69
1,4,6,4,7,1997,2136,-139
1,4,7,4,7,1962,2259,-297
1,4,8,4,7,1961,2402,-441
1,4,9,4,7,1952,2581,-629
1,4,10,4,7,1958,2749,-791
1,5,0,4,7,2787,2541,246
1,5,1,4,7,2620,2586,34
1,5,2,4,7,2468,2594,-126
1,5,3,4,7,2396,2591,-195
1,5,4,4,7,2424,2567,-143
1,5,5,4,7,2479,2557,-78
1,5,6,4,7,2516,2542,-26
1,5,7,4,7,2541,2548,-7
1,5,8,4,7,2586,2618,-32
1,5,9,4,7,2594,2712,-118
1,5,10,4,7,2591,2826,-235
1,6,0,4,7,2436,2407,29
1,6,1,4,7,2305,2386,-81
1,6,2,4,7,2201,2386,-185
1,6,3,4,7,2153,2414,-261
1,6,4,4,7,2219,2436,-217
1,6,5,4,7,2329,2432,-103
1,6,6,4,7,2394,2383,11
1,6,7,4,7,2407,2361,46
1,6,8,4,7,2386,2410,-24
1,6,9,4,7,2386,2475,-89
1,6,10,4,7,2414,2580,-166
1,7,0,4,7,2431,2870,-439
1,7,1,4,7,2415,2806,-391
1,7,2,4,7,2464,2794,-330
1,7,3,4,7,2524,2831,-307
1,7,4,4,7,2666,2873,-207
1,7,5,4,7,2765,2860,-95
1,7,6,4,7,2850,2788,62
1,7,7,4,7,2870,2721,149
1,7,8,4,7,2806,2689,117
1,7,9,4,7,2794,2676,118
1,7,10,4,7,2831,2704,127
1,8,0,4,7,2961,3568,-607
1,8,1,4,7,3061,3466,-405
1,8,2,4,7,3256,3426,-170
1,8,3,4,7,3398,3524,-126
1,8,4,4,7,3563,3621,-58
1,8,5,4,7,3528,3634,-106
1,8,6,4,7,3587,3604,-17
1,8,7,4,7,3568,3576,-8
1,8,8,4,7,3466,3542,-76
1,8,9,4,7,3426,3499,-73
1,8,10,4,7,3524,3393,131
1,9,0,4,7,3382,3664,-282
1,9,1,4,7,3560,3424,136
1,9,2,4,7,3854,3300,554
1,9,3,4,7,3989,3539,450
1,9,4,4,7,4090,3759,331
1,9,5,4,7,3859,3865,-6
1,9,6,4,7,3796,3979,-183
1,9,7,4,7,3664,4105,-441
1,9,8,4,7,3424,4175,-751
1,9,9,4,7,3300,4192,-892
1,9,10,4,7,3539,3969,-430
1,10,0,4,7,4103,4347,-244
1,10,1,4,7,4407,4005,402
1,10,2,4,7,4796,3800,996
1,10,3,4,7,4949,4170,779
1,10,4,4,7,5047,4464,583
1,10,5,4,7,4727,4673,54
1,10,6,4,7,4537,4882,-345
1,10,7,4,7,4347,5066,-719
1,10,8,4,7,4005,5200,-1195
1,10,9,4,7,3800,5234,-1434
1,10,10,4,7,4170,4852,-682
1,11,0,4,7,4561,4420,141
1,11,1,4,7,4891,3984,907
1,11,2,4,7,5249,3711,1538
1,11,3,4,7,5319,4205,1114
1,11,4,4,7,5366,4535,831
1,11,5,4,7,4992,4888,104
1,11,6,4,7,4650,5206,-556
1,11,7,4,7,4420,5448,-1028
1,11,8,4,7,3984,5715,-1731
1,11,9,4,7,3711,5825,-2114
1,11,10,4,7,4205,5395,-1190
1,12,0,4,7,4620,4000,620
1,12,1,4,7,4950,3459,1491
1,12,2,4,7,5261,3135,2126
1,12,3,4,7,5219,3737,1482
1,12,4,4,7,5194,4078,1116
1,12,5,4,7,4782,4578,204
1,12,6,4,7,4279,4994,-715
1,12,7,4,7,4000,5280,-1280
1,12,8,4,7,3459,5674,-2215
1,12,9,4,7,3135,5826,-2691
1,12,10,4,7,3737,5390,-1653
1,13,0,4,7,4455,4006,449
1,13,1,4,7,4852,3436,1416
1,13,2,4,7,5203,3120,2083
1,13,3,4,7,5186,3729,1457
1,13,4,4,7,5171,3999,1172
1,13,5,4,7,4756,4509,247
1,13,6,4,7,4201,4924,-723
1,13,7,4,7,4006,5147,-1141
1,13,8,4,7,3436,5517,-2081
1,13,9,4,7,3120,5572,-2452
1,13,10,4,7,3729,5142,-1413
1,14,0,4,7,4209,3860,349
1,14,1,4,7,4642,3262,1380
1,14,2,4,7,5024,2982,2042
1,14,3,4,7,5025,3613,1412
1,14,4,4,7,4991,3823,1168
1,14,5,4,7,4530,4216,314
1,14,6,4,7,4010,4605,-595
1,14,7,4,7,3860,4838,-978
1,14,8,4,7,3262,5216,-1954
1,14,9,4,7,2982,5184,-2202
1,14,10,4,7,3613,4782,-1169
1,15,0,4,7,4038,3506,532
1,15,1,4,7,4398,3010,1388
1,15,2,4,7,4733,2781,1952
1,15,3,4,7,4746,3265,1481
1,15,4,4,7,4598,3505,1093
1,15,5,4,7,4066,3750,316
1,15,6,4,7,3619,4053,-434
1,15,7,4,7,3506,4370,-864
1,15,8,4,7,3010,4718,-1708
1,15,9,4,7,2781,4639,-1858
1,15,10,4,7,3265,4378,-1113
1,16,0,4,7,3776,3552,224
1,16,1,4,7,3954,3218,736
1,16,2,4,7,4317,2945,1372
1,16,3,4,7,4373,3322,1051
1,16,4,4,7,4150,3559,591
1,16,5,4,7,3732,3589,143
1,16,6,4,7,3508,3679,-171
1,16,7,4,7,3552,3959,-407
1,16,8,4,7,3218,4164,-946
1,16,9,4,7,2945,4068,-1123
1,16,10,4,7,3322,3934,-612
1,17,0,4,7,3539,3634,-95
1,17,1,4,7,3566,3355,211
1,17,2,4,7,3972,2978,994
1,17,3,4,7,4060,3214,846
1,17,4,4,7,3762,3365,397
1,17,5,4,7,3492,3228,264
1,17,6,4,7,3499,3153,346
1,17,7,4,7,3634,3406,228
1,17,8,4,7,3355,3502,-147
1,17,9,4,7,2978,3443,-465
1,17,10,4,7,3214,3496,-282
1,18,0,4,7,3388,3257,131
1,18,1,4,7,3173,3088,85
1,18,2,4,7,3531,2677,854
1,18,3,4,7,3563,2744,819
1,18,4,4,7,3092,2888,204
1,18,5,4,7,2944,2754,190
1,18,6,4,7,3115,2598,517
1,18,7,4,7,3257,2825,432
1,18,8,4,7,3088,2881,207
1,18,9,4,7,2677,2910,-233
1,18,10,4,7,2744,3180,-436
1,19,0,4,7,2917,3228,-311
1,19,1,4,7,2694,3022,-328
1,19,2,4,7,3109,2588,521
1,19,3,4,7,3117,2724,393
1,19,4,4,7,2705,2785,-80
1,19,5,4,7,2732,2621,111
1,19,6,4,7,3054,2389,665
1,19,7,4,7,3228,2456,772
1,19,8,4,7,3022,2472,550
1,19,9,4,7,2588,2458,130
1,19,10,4,7,2724,2618,106
1,20,0,4,7,2502,2856,-354
1,20,1,4,7,2339,2651,-312
1,20,2,4,7,2714,2307,407
1,20,3,4,7,2747,2387,360
1,20,4,4,7,2397,2410,-13
1,20,5,4,7,2414,2290,124
1,20,6,4,7,2725,2091,634
1,20,7,4,7,2856,2102,754
1,20,8,4,7,2651,2090,561
1,20,9,4,7,2307,2047,260
1,20,10,4,7,2387,2134,253
1,0,0,5,7,3840,3106,734
1,0,1,5,7,3814,3015,799
1,0,2,5,7,3698,3000,698
1,0,3,5,7,3601,3037,564
1,0,4,5,7,3499,3100,399
1,0,5,5,7,3348,3226,122
1,0,6,5,7,3203,3370,-167
1,0,7,5,7,3106,3471,-365
1,0,8,5,7,3015,3578,-563
1,0,9,5,7,3000,3702,-702
1,0,10,5,7,3037,3754,-717
1,1,0,5,7,3881,2822,1059
1,1,1,5,7,3784,2759,1025
1,1,2,5,7,3618,2740,878
1,1,3,5,7,3462,2769,693
1,1,4,5,7,3304,2823,481
1,1,5,5,7,3102,2957,145
1,1,6,5,7,2922,3137,-215
1,1,7,5,7,2822,3294,-472
1,1,8,5,7,2759,3456,-697
1,1,9,5,7,2740,3628,-888
1,1,10,5,7,2769,3729,-960
1,2,0,5,7,3807,2559,1248
1,2,1,5,7,3647,2508,1139
1,2,2,5,7,3429,2489,940
1,2,3,5,7,3234,2517,717
1,2,4,5,7,3058,2565,493
1,2,5,5,7,2847,2700,147
1,2,6,5,7,2659,2899,-240
1,2,7,5,7,2559,3087,-528
1,2,8,5,7,2508,3282,-774
1,2,9,5,7,2489,3495,-1006
1,2,10,5,7,2517,3647,-1130
1,3,0,5,7,3614,2472,1142
1,3,1,5,7,3417,2421,996
1,3,2,5,7,3169,2407,762
1,3,3,5,7,2979,2434,545
1,3,4,5,7,2849,2469,380
1,3,5,5,7,2700,2582,118
1,3,6,5,7,2556,2758,-202
1,3,7,5,7,2472,2925,-453
1,3,8,5,7,2421,3107,-686
1,3,9,5,7,2407,3330,-923
1,3,10,5,7,2434,3519,-1085
1,4,0,5,7,3589,2904,685
1,4,1,5,7,3384,2920,464
1,4,2,5,7,3167,2922,245
1,4,3,5,7,3032,2927,105
1,4,4,5,7,2993,2930,63
1,4,5,5,7,2967,2981,-14
1,4,6,5,7,2928,3045,-117
1,4,7,5,7,2904,3121,-217
1,4,8,5,7,2920,3254,-334
1,4,9,5,7,2922,3413,-491
1,4,10,5,7,2927,3578,-651
1,5,0,5,7,3214,2845,369
1,5,1,5,7,3008,2850,158
1,5,2,5,7,2851,2847,4
1,5,3,5,7,2751,2862,-111
1,5,4,5,7,2765,2875,-110
1,5,5,5,7,2815,2887,-72
1,5,6,5,7,2836,2880,-44
1,5,7,5,7,2845,2909,-64
1,5,8,5,7,2850,3012,-162
1,5,9,5,7,2847,3129,-282
1,5,10,5,7,2862,3287,-425
1,6,0,5,7,3109,3342,-233
1,6,1,5,7,3031,3288,-257
1,6,2,5,7,3025,3275,-250
1,6,3,5,7,3045,3320,-275
1,6,4,5,7,3167,3359,-192
1,6,5,5,7,3248,3348,-100
1,6,6,5,7,3320,3294,26
1,6,7,5,7,3342,3255,87
1,6,8,5,7,3288,3262,26
1,6,9,5,7,3275,3297,-22
1,6,10,5,7,3320,3363,-43
1,7,0,5,7,3534,4257,-723
1,7,1,5,7,3609,4147,-538
1,7,2,5,7,3774,4108,-334
1,7,3,5,7,3922,4209,-287
1,7,4,5,7,4135,4293,-158
1,7,5,5,7,4159,4286,-127
1,7,6,5,7,4260,4234,26
1,7,7,5,7,4257,4180,77
1,7,8,5,7,4147,4133,14
1,7,9,5,7,4108,4104,4
1,7,10,5,7,4209,4024,185
1,8,0,5,7,4140,4606,-466
1,8,1,5,7,4313,4383,-70
1,8,2,5,7,4593,4270,323
1,8,3,5,7,4742,4508,234
1,8,4,5,7,4895,4729,166
1,8,5,5,7,4738,4827,-89
1,8,6,5,7,4727,4888,-161
1,8,7,5,7,4606,4967,-361
1,8,8,5,7,4383,5027,-644
1,8,9,5,7,4270,5024,-754
1,8,10,5,7,4508,4798,-290
1,9,0,5,7,4530,4651,-121
1,9,1,5,7,4795,4269,526
1,9,2,5,7,5179,4053,1126
1,9,3,5,7,5304,4441,863
1,9,4,5,7,5388,4772,616
1,9,5,5,7,5063,5003,60
1,9,6,5,7,4857,5220,-363
1,9,7,5,7,4651,5427,-776
1,9,8,5,7,4269,5594,-1325
1,9,9,5,7,4053,5651,-1598
1,9,10,5,7,4441,5313,-872
1,10,0,5,7,5234,5355,-121
1,10,1,5,7,5617,4886,731
1,10,2,5,7,6073,4600,1473
1,10,3,5,7,6211,5111,1100
1,10,4,5,7,6314,5458,856
1,10,5,5,7,5911,5804,107
1,10,6,5,7,5576,6117,-541
1,10,7,5,7,5355,6342,-987
1,10,8,5,7,4886,6567,-1681
1,10,9,5,7,4600,6647,-2047
1,10,10,5,7,5111,6178,-1067
1,11,0,5,7,5723,5387,336
1,11,1,5,7,6144,4800,1344
1,11,2,5,7,6571,4449,2122
1,11,3,5,7,6617,5115,1502
1,11,4,5,7,6663,5498,1165
1,11,5,5,7,6176,6004,172
1,11,6,5,7,5689,6440,-751
1,11,7,5,7,5387,6739,-1352
1,11,8,5,7,4800,7118,-2318
1,11,9,5,7,4449,7254,-2805
1,11,10,5,7,5115,6710,-1595
1,12,0,5,7,5634,5044,590
1,12,1,5,7,6104,4353,1751
1,12,2,5,7,6540,3964,2576
1,12,3,5,7,6530,4713,1817
1,12,4,5,7,6503,5107,1396
1,12,5,5,7,5966,5702,264
1,12,6,5,7,5341,6208,-867
1,12,7,5,7,5044,6538,-1494
1,12,8,5,7,4353,7002,-2649
1,12,9,5,7,3964,7097,-3133
1,12,10,5,7,4713,6547,-1834
1,13,0,5,7,5357,4847,510
1,13,1,5,7,5877,4107,1770
1,13,2,5,7,6349,3735,2614
1,13,3,5,7,6340,4515,1825
1,13,4,5,7,6289,4836,1453
1,13,5,5,7,5734,5354,380
1,13,6,5,7,5071,5846,-775
1,13,7,5,7,4847,6160,-1313
1,13,8,5,7,4107,6635,-2528
1,13,9,5,7,3735,6643,-2908
1,13,10,5,7,4515,6126,-1611
1,14,0,5,7,5169,4514,655
1,14,1,5,7,5608,3891,1717
1,14,2,5,7,6010,3581,2429
1,14,3,5,7,6008,4206,1802
1,14,4,5,7,5865,4499,1366
1,14,5,5,7,5250,4881,369
1,14,6,5,7,4658,5288,-630
1,14,7,5,7,4514,5646,-1132
1,14,8,5,7,3891,6085,-2194
1,14,9,5,7,3581,6052,-2471
1,14,10,5,7,4206,5704,-1498
1,15,0,5,7,4938,4519,419
1,15,1,5,7,5207,4034,1173
1,15,2,5,7,5639,3683,1956
1,15,3,5,7,5671,4232,1439
1,15,4,5,7,5447,4522,925
1,15,5,5,7,4916,4705,211
1,15,6,5,7,4547,4913,-366
1,15,7,5,7,4519,5250,-731
1,15,8,5,7,4034,5567,-1533
1,15,9,5,7,3683,5497,-1814
1,15,10,5,7,4232,5249,-1017
1,16,0,5,7,4553,4678,-125
1,16,1,5,7,4720,4249,471
1,16,2,5,7,5251,3807,1444
1,16,3,5,7,5371,4190,1181
1,16,4,5,7,5071,4394,677
1,16,5,5,7,4676,4352,324
1,16,6,5,7,4561,4367,194
1,16,7,5,7,4678,4664,14
1,16,8,5,7,4249,4830,-581
1,16,9,5,7,3807,4714,-907
1,16,10,5,7,4190,4653,-463
1,17,0,5,7,4290,4098,192
1,17,1,5,7,4198,3759,439
1,17,2,5,7,4677,3292,1385
1,17,3,5,7,4717,3530,1187
1,17,4,5,7,4210,3725,485
1,17,5,5,7,3922,3599,323
1,17,6,5,7,3985,3520,465
1,17,7,5,7,4098,3838,260
1,17,8,5,7,3759,3999,-240
1,17,9,5,7,3292,3981,-689
1,17,10,5,7,3530,4164,-634
1,18,0,5,7,3877,3882,-5
1,18,1,5,7,3660,3651,9
1,18,2,5,7,4095,3187,908
1,18,3,5,7,4100,3317,783
1,18,4,5,7,3579,3461,118
1,18,5,5,7,3452,3286,166
1,18,6,5,7,3702,3072,630
1,18,7,5,7,3882,3264,618
1,18,8,5,7,3651,3341,310
1,18,9,5,7,3187,3326,-139
1,18,10,5,7,3317,3540,-223
1,19,0,5,7,3402,3869,-467
1,19,1,5,7,3148,3675,-527
1,19,2,5,7,3620,3209,411
1,19,3,5,7,3672,3354,318
1,19,4,5,7,3246,3427,-181
1,19,5,5,7,3264,3245,19
1,19,6,5,7,3653,2951,702
1,19,7,5,7,3869,2982,887
1,19,8,5,7,3675,2939,736
1,19,9,5,7,3209,2905,304
1,19,10,5,7,3354,3005,349
1,0,0,6,7,4618,3544,1074
1,0,1,6,7,4517,3479,1038
1,0,2,6,7,4348,3461,887
1,0,3,6,7,4199,3485,714
1,0,4,6,7,4045,3539,506
1,0,5,6,7,3834,3681,153
1,0,6,6,7,3645,3867,-222
1,0,7,6,7,3544,4019,-475
1,0,8,6,7,3479,4180,-701
1,0,9,6,7,3461,4356,-895
1,0,10,6,7,3485,4461,-976
1,1,0,6,7,4559,3294,1265
1,1,1,6,7,4400,3241,1159
1,1,2,6,7,4179,3221,958
1,1,3,6,7,3983,3258,725
1,1,4,6,7,3805,3309,496
1,1,5,6,7,3585,3445,140
1,1,6,6,7,3392,3643,-251
1,1,7,6,7,3294,3828,-534
1,1,8,6,7,3241,4029,-788
1,1,9,6,7,3221,4249,-1028
1,1,10,6,7,3258,4388,-1130
1,2,0,6,7,4380,3248,1132
1,2,1,6,7,4195,3189,1006
1,2,2,6,7,3947,3171,776
1,2,3,6,7,3758,3202,556
1,2,4,6,7,3630,3237,393
1,2,5,6,7,3478,3352,126
1,2,6,6,7,3332,3529,-197
1,2,7,6,7,3248,3691,-443
1,2,8,6,7,3189,3873,-684
1,2,9,6,7,3171,4100,-929
1,2,10,6,7,3202,4278,-1076
1,3,0,6,7,4372,3414,958
1,3,1,6,7,4170,3380,790
1,3,2,6,7,3908,3377,531
1,3,3,6,7,3732,3403,329
1,3,4,6,7,3654,3439,215
1,3,5,6,7,3579,3544,35
1,3,6,6,7,3487,3667,-180
1,3,7,6,7,3414,3787,-373
1,3,8,6,7,3380,3959,-579
1,3,9,6,7,3377,4162,-785
1,3,10,6,7,3403,4348,-945
1,4,0,6,7,4016,3208,808
1,4,1,6,7,3772,3184,588
1,4,2,6,7,3550,3175,375
1,4,3,6,7,3387,3198,189
1,4,4,6,7,3334,3238,96
1,4,5,6,7,3303,3311,-8
1,4,6,6,7,3248,3383,-135
1,4,7,6,7,3208,3482,-274
1,4,8,6,7,3184,3648,-464
1,4,9,6,7,3175,3830,-655
1,4,10,6,7,3198,4039,-841
1,5,0,6,7,3887,3780,107
1,5,1,6,7,3734,3752,-18
1,5,2,6,7,3675,3736,-61
1,5,3,6,7,3643,3768,-125
1,5,4,6,7,3713,3798,-85
1,5,5,6,7,3734,3803,-69
1,5,6,6,7,3762,3791,-29
1,5,7,6,7,3780,3803,-23
1,5,8,6,7,3752,3864,-112
1,5,9,6,7,3736,3951,-215
1,5,10,6,7,3768,4070,-302
1,6,0,6,7,4212,4729,-517
1,6,1,6,7,4225,4629,-404
1,6,2,6,7,4335,4589,-254
1,6,3,6,7,4443,4698,-255
1,6,4,6,7,4636,4779,-143
1,6,5,6,7,4642,4774,-132
1,6,6,6,7,4730,4740,-10
1,6,7,6,7,4729,4714,15
1,6,8,6,7,4629,4706,-77
1,6,9,6,7,4589,4725,-136
1,6,10,6,7,4698,4683,15
1,7,0,6,7,4713,5295,-582
1,7,1,6,7,4861,5064,-203
1,7,2,6,7,5111,4952,159
1,7,3,6,7,5266,5193,73
1,7,4,6,7,5467,5401,66
1,7,5,6,7,5369,5479,-110
1,7,6,6,7,5400,5518,-118
1,7,7,6,7,5295,5571,-276
1,7,8,6,7,5064,5618,-554
1,7,9,6,7,4952,5629,-677
1,7,10,6,7,5193,5429,-236
1,8,0,6,7,5288,5593,-305
1,8,1,6,7,5548,5228,320
1,8,2,6,7,5918,5023,895
1,8,3,6,7,6057,5410,647
1,8,4,6,7,6193,5742,451
1,8,5,6,7,5942,5965,-23
1,8,6,6,7,5788,6129,-341
1,8,7,6,7,5593,6289,-696
1,8,8,6,7,5228,6446,-1218
1,8,9,6,7,5023,6483,-1460
1,8,10,6,7,5410,6142,-732
1,9,0,6,7,5661,5659,2
1,9,1,6,7,6005,5150,855
1,9,2,6,7,6456,4853,1603
1,9,3,6,7,6566,5382,1184
1,9,4,6,7,6655,5766,889
1,9,5,6,7,6247,6134,113
1,9,6,6,7,5896,6455,-559
1,9,7,6,7,5659,6703,-1044
1,9,8,6,7,5150,6961,-1811
1,9,9,6,7,4853,7064,-2211
1,9,10,6,7,5382,6639,-1257
1,10,0,6,7,6396,6322,74
1,10,1,6,7,6870,5702,1168
1,10,2,6,7,7395,5338,2057
1,10,3,6,7,7509,6021,1488
1,10,4,6,7,7611,6421,1190
1,10,5,6,7,7095,6920,175
1,10,6,6,7,6615,7351,-736
1,10,7,6,7,6322,7633,-1311
1,10,8,6,7,5702,7970,-2268
1,10,9,6,7,5338,8076,-2738
1,10,10,6,7,6021,7493,-1472
1,11,0,6,7,6737,6431,306
1,11,1,6,7,7298,5694,1604
1,11,2,6,7,7850,5278,2572
1,11,3,6,7,7928,6091,1837
1,11,4,6,7,7972,6527,1445
1,11,5,6,7,7360,7128,232
1,11,6,6,7,6751,7654,-903
1,11,7,6,7,6431,7997,-1566
1,11,8,6,7,5694,8446,-2752
1,11,9,6,7,5278,8525,-3247
1,11,10,6,7,6091,7867,-1776
1,12,0,6,7,6536,5885,651
1,12,1,6,7,7129,5024,2105
1,12,2,6,7,7686,4579,3107
1,12,3,6,7,7684,5499,2185
1,12,4,6,7,7621,5944,1677
1,12,5,6,7,6944,6547,397
1,12,6,6,7,6211,7130,-919
1,12,7,6,7,5885,7551,-1666
1,12,8,6,7,5024,8120,-3096
1,12,9,6,7,4579,8168,-3589
1,12,10,6,7,5499,7531,-2032
1,13,0,6,7,6317,5501,816
1,13,1,6,7,6843,4736,2107
1,13,2,6,7,7335,4334,3001
1,13,3,6,7,7323,5108,2215
1,13,4,6,7,7163,5512,1651
1,13,5,6,7,6454,6019,435
1,13,6,6,7,5719,6529,-810
1,13,7,6,7,5501,6968,-1467
1,13,8,6,7,4736,7504,-2768
1,13,9,6,7,4334,7511,-3177
1,13,10,6,7,5108,7048,-1940
1,14,0,6,7,6069,5527,542
1,14,1,6,7,6417,4915,1502
1,14,2,6,7,6916,4483,2433
1,14,3,6,7,6933,5173,1760
1,14,4,6,7,6714,5516,1198
1,14,5,6,7,6100,5836,264
1,14,6,6,7,5586,6148,-562
1,14,7,6,7,5527,6526,-999
1,14,8,6,7,4915,6934,-2019
1,14,9,6,7,4483,6910,-2427
1,14,10,6,7,5173,6575,-1402
1,15,0,6,7,5715,5645,70
1,15,1,6,7,5973,5065,908
1,15,2,6,7,6573,4545,2028
1,15,3,6,7,6669,5100,1569
1,15,4,6,7,6368,5357,1011
1,15,5,6,7,5860,5468,392
1,15,6,6,7,5600,5601,-1
1,15,7,6,7,5645,5955,-310
1,15,8,6,7,5065,6233,-1168
1,15,9,6,7,4545,6143,-1598
1,15,10,6,7,5100,5968,-868
1,16,0,6,7,5304,5142,162
1,16,1,6,7,5352,4653,699
1,16,2,6,7,5956,4121,1835
1,16,3,6,7,6028,4506,1522
1,16,4,6,7,5519,4754,765
1,16,5,6,7,5106,4723,383
1,16,6,6,7,5047,4734,313
1,16,7,6,7,5142,5096,46
1,16,8,6,7,4653,5327,-674
1,16,9,6,7,4121,5252,-1131
1,16,10,6,7,4506,5321,-815
1,17,0,6,7,4779,4723,56
1,17,1,6,7,4685,4322,363
1,17,2,6,7,5241,3802,1439
1,17,3,6,7,5254,4103,1151
1,17,4,6,7,4697,4298,399
1,17,5,6,7,4430,4131,299
1,17,6,6,7,4572,3994,578
1,17,7,6,7,4723,4277,446
1,17,8,6,7,4322,4459,-137
1,17,9,6,7,3802,4397,-595
1,17,10,6,7,4103,4524,-421
1,18,0,6,7,4362,4523,-161
1,18,1,6,7,4114,4304,-190
1,18,2,6,7,4606,3808,798
1,18,3,6,7,4655,3947,708
1,18,4,6,7,4120,4103,17
1,18,5,6,7,3984,3910,74
1,18,6,6,7,4301,3634,667
1,18,7,6,7,4523,3790,733
1,18,8,6,7,4304,3808,496
1,18,9,6,7,3808,3773,35
1,18,10,6,7,3947,3927,20
1,0,0,7,7,5296,4016,1280
1,0,1,7,7,5133,3961,1172
1,0,2,7,7,4909,3942,967
1,0,3,7,7,4720,3974,746
1,0,4,7,7,4546,4025,521
1,0,5,7,7,4317,4169,148
1,0,6,7,7,4115,4373,-258
1,0,7,7,7,4016,4553,-537
1,0,8,7,7,3961,4753,-792
1,0,9,7,7,3942,4977,-1035
1,0,10,7,7,3974,5120,-1146
1,1,0,7,7,5132,3983,1149
1,1,1,7,7,4948,3922,1026
1,1,2,7,7,4697,3903,794
1,1,3,7,7,4507,3943,564
1,1,4,7,7,4377,3981,396
1,1,5,7,7,4216,4097,119
1,1,6,7,7,4065,4273,-208
1,1,7,7,7,3983,4432,-449
1,1,8,7,7,3922,4620,-698
1,1,9,7,7,3903,4854,-951
1,1,10,7,7,3943,5019,-1076
1,2,0,7,7,5138,4190,948
1,2,1,7,7,4948,4148,800
1,2,2,7,7,4686,4141,545
1,2,3,7,7,4511,4171,340
1,2,4,7,7,4435,4207,228
1,2,5,7,7,4357,4314,43
1,2,6,7,7,4263,4438,-175
1,2,7,7,7,4190,4553,-363
1,2,8,7,7,4148,4725,-577
1,2,9,7,7,4141,4932,-791
1,2,10,7,7,4171,5107,-936
1,3,0,7,7,4799,3718,1081
1,3,1,7,7,4558,3644,914
1,3,2,7,7,4291,3630,661
1,3,3,7,7,4087,3674,413
1,3,4,7,7,3995,3747,248
1,3,5,7,7,3915,3874,41
1,3,6,7,7,3807,4005,-198
1,3,7,7,7,3718,4148,-430
1,3,8,7,7,3644,4353,-709
1,3,9,7,7,3630,4579,-949
1,3,10,7,7,3674,4809,-1135
1,4,0,7,7,4689,4143,546
1,4,1,7,7,4498,4086,412
1,4,2,7,7,4374,4064,310
1,4,3,7,7,4279,4104,175
1,4,4,7,7,4282,4161,121
1,4,5,7,7,4222,4227,-5
1,4,6,7,7,4174,4294,-120
1,4,7,7,7,4143,4376,-233
1,4,8,7,7,4086,4500,-414
1,4,9,7,7,4064,4652,-588
1,4,10,7,7,4104,4822,-718
1,5,0,7,7,4990,5167,-177
1,5,1,7,7,4928,5093,-165
1,5,2,7,7,4985,5050,-65
1,5,3,7,7,5041,5146,-105
1,5,4,7,7,5182,5218,-36
1,5,5,7,7,5128,5229,-101
1,5,6,7,7,5172,5237,-65
1,5,7,7,7,5167,5262,-95
1,5,8,7,7,5093,5308,-215
1,5,9,7,7,5050,5379,-329
1,5,10,7,7,5146,5390,-244
1,6,0,7,7,5391,5767,-376
1,6,1,7,7,5477,5546,-69
1,6,2,7,7,5672,5433,239
1,6,3,7,7,5787,5682,105
1,6,4,7,7,5968,5887,81
1,6,5,7,7,5852,5967,-115
1,6,6,7,7,5870,6024,-154
1,6,7,7,7,5767,6105,-338
1,6,8,7,7,5546,6191,-645
1,6,9,7,7,5433,6250,-817
1,6,10,7,7,5682,6088,-406
1,7,0,7,7,5861,6282,-421
1,7,1,7,7,6096,5909,187
1,7,2,7,7,6436,5705,731
1,7,3,7,7,6581,6095,486
1,7,4,7,7,6765,6414,351
1,7,5,7,7,6573,6617,-44
1,7,6,7,7,6461,6759,-298
1,7,7,7,7,6282,6893,-611
1,7,8,7,7,5909,7037,-1128
1,7,9,7,7,5705,7088,-1383
1,7,10,7,7,6095,6773,-678
1,8,0,7,7,6419,6601,-182
1,8,1,7,7,6758,6109,649
1,8,2,7,7,7195,5823,1372
1,8,3,7,7,7319,6351,968
1,8,4,7,7,7460,6736,724
1,8,5,7,7,7126,7096,30
1,8,6,7,7,6827,7364,-537
1,8,7,7,7,6601,7565,-964
1,8,8,7,7,6109,7813,-1704
1,8,9,7,7,5823,7896,-2073
1,8,10,7,7,6351,7468,-1117
1,9,0,7,7,6823,6626,197
1,9,1,7,7,7258,5966,1292
1,9,2,7,7,7778,5591,2187
1,9,3,7,7,7864,6292,1572
1,9,4,7,7,7952,6729,1223
1,9,5,7,7,7431,7250,181
1,9,6,7,7,6935,7689,-754
1,9,7,7,7,6626,7994,-1368
1,9,8,7,7,5966,8364,-2398
1,9,9,7,7,5591,8493,-2902
1,9,10,7,7,6292,7954,-1662
1,10,0,7,7,7410,7366,44
1,10,1,7,7,8024,6596,1428
1,10,2,7,7,8674,6167,2507
1,10,3,7,7,8820,6997,1823
1,10,4,7,7,8920,7450,1470
1,10,5,7,7,8279,8044,235
1,10,6,7,7,7677,8565,-888
1,10,7,7,7,7366,8891,-1525
1,10,8,7,7,6596,9298,-2702
1,10,9,7,7,6167,9347,-3180
1,10,10,7,7,6997,8650,-1653
1,11,0,7,7,7639,7272,367
1,11,1,7,7,8323,6365,1958
1,11,2,7,7,8996,5893,3103
1,11,3,7,7,9082,6877,2205
1,11,4,7,7,9090,7364,1726
1,11,5,7,7,8338,7973,365
1,11,6,7,7,7621,8576,-955
1,11,7,7,7,7272,9010,-1738
1,11,8,7,7,6365,9564,-3199
1,11,9,7,7,5893,9596,-3703
1,11,10,7,7,6877,8851,-1974
1,12,0,7,7,7496,6539,957
1,12,1,7,7,8095,5653,2442
1,12,2,7,7,8672,5178,3494
1,12,3,7,7,8667,6092,2575
1,12,4,7,7,8495,6620,1875
1,12,5,7,7,7664,7212,452
1,12,6,7,7,6859,7813,-954
1,12,7,7,7,6539,8359,-1820
1,12,8,7,7,5653,8989,-3336
1,12,9,7,7,5178,9036,-3858
1,12,10,7,7,6092,8453,-2361
1,13,0,7,7,7217,6514,703
1,13,1,7,7,7652,5760,1892
1,13,2,7,7,8241,5236,3005
1,13,3,7,7,8248,6075,2173
1,13,4,7,7,8012,6529,1483
1,13,5,7,7,7304,6974,330
1,13,6,7,7,6647,7389,-742
1,13,7,7,7,6514,7848,-1334
1,13,8,7,7,5760,8353,-2593
1,13,9,7,7,5236,8369,-3133
1,13,10,7,7,6075,7919,-1844
1,14,0,7,7,6846,6653,193
1,14,1,7,7,7183,5946,1237
1,14,2,7,7,7850,5345,2505
1,14,3,7,7,7931,6041,1890
1,14,4,7,7,7635,6351,1284
1,14,5,7,7,7044,6599,445
1,14,6,7,7,6639,6836,-197
1,14,7,7,7,6653,7231,-578
1,14,8,7,7,5946,7600,-1654
1,14,9,7,7,5345,7556,-2211
1,14,10,7,7,6041,7294,-1253
1,15,0,7,7,6466,6109,357
1,15,1,7,7,6605,5469,1136
1,15,2,7,7,7278,4859,2419
1,15,3,7,7,7326,5416,1910
1,15,4,7,7,6816,5717,1099
1,15,5,7,7,6290,5839,451
1,15,6,7,7,6086,5968,118
1,15,7,7,7,6109,6387,-278
1,15,8,7,7,5469,6730,-1261
1,15,9,7,7,4859,6681,-1822
1,15,10,7,7,5416,6636,-1220
1,16,0,7,7,5793,5767,26
1,16,1,7,7,5839,5216,623
1,16,2,7,7,6520,4631,1889
1,16,3,7,7,6565,5079,1486
1,16,4,7,7,6006,5327,679
1,16,5,7,7,5614,5255,359
1,16,6,7,7,5634,5208,426
1,16,7,7,7,5767,5535,232
1,16,8,7,7,5216,5787,-571
1,16,9,7,7,4631,5668,-1037
1,16,10,7,7,5079,5681,-602
1,17,0,7,7,5264,5364,-100
1,17,1,7,7,5139,4975,164
1,17,2,7,7,5752,4423,1329
1,17,3,7,7,5809,4733,1076
1,17,4,7,7,5238,4940,298
1,17,5,7,7,4962,4755,207
1,17,6,7,7,5171,4556,615
1,17,7,7,7,5364,4803,561
1,17,8,7,7,4975,4926,49
1,17,9,7,7,4423,4844,-421
1,17,10,7,7,4733,4911,-178
1,0,0,8,7,5869,4705,1164
1,0,1,8,7,5681,4642,1039
1,0,2,8,7,5427,4624,803
1,0,3,8,7,5244,4659,585
1,0,4,8,7,5118,4697,421
1,0,5,8,7,4948,4821,127
1,0,6,8,7,4788,5003,-215
1,0,7,8,7,4705,5157,-452
1,0,8,8,7,4642,5344,-702
1,0,9,8,7,4624,5582,-958
1,0,10,8,7,4659,5751,-1092
1,1,0,8,7,5890,4925,965
1,1,1,8,7,5701,4881,820
1,1,2,8,7,5436,4873,563
1,1,3,8,7,5260,4912,348
1,1,4,8,7,5182,4951,231
1,1,5,8,7,5095,5059,36
1,1,6,8,7,4996,5182,-186
1,1,7,8,7,4925,5294,-369
1,1,8,8,7,4881,5472,-591
1,1,9,8,7,4873,5686,-813
1,1,10,8,7,4912,5848,-936
1,2,0,8,7,5565,4494,1071
1,2,1,8,7,5336,4412,924
1,2,2,8,7,5069,4394,675
1,2,3,8,7,4866,4442,424
1,2,4,8,7,4776,4515,261
1,2,5,8,7,4693,4644,49
1,2,6,8,7,4583,4776,-193
1,2,7,8,7,4494,4914,-420
1,2,8,8,7,4412,5119,-707
1,2,9,8,7,4394,5349,-955
1,2,10,8,7,4442,5568,-1126
1,3,0,8,7,5472,4653,819
1,3,1,8,7,5284,4546,738
1,3,2,8,7,5115,4519,596
1,3,3,8,7,4979,4580,399
1,3,4,8,7,4943,4670,273
1,3,5,8,7,4834,4790,44
1,3,6,8,7,4733,4916,-183
1,3,7,8,7,4653,5042,-389
1,3,8,8,7,4546,5205,-659
1,3,9,8,7,4519,5401,-882
1,3,10,8,7,4580,5592,-1012
1,4,0,8,7,5792,5530,262
1,4,1,8,7,5692,5427,265
1,4,2,8,7,5684,5378,306
1,4,3,8,7,5677,5482,195
1,4,4,8,7,5751,5581,170
1,4,5,8,7,5616,5653,-37
1,4,6,8,7,5584,5740,-156
1,4,7,8,7,5530,5835,-305
1,4,8,8,7,5427,5944,-517
1,4,9,8,7,5378,6080,-702
1,4,10,8,7,5482,6142,-660
1,5,0,8,7,6169,6205,-36
1,5,1,8,7,6180,6010,170
1,5,2,8,7,6322,5894,428
1,5,3,8,7,6385,6130,255
1,5,4,8,7,6514,6326,188
1,5,5,8,7,6338,6422,-84
1,5,6,8,7,6312,6521,-209
1,5,7,8,7,6205,6653,-448
1,5,8,8,7,6010,6793,-783
1,5,9,8,7,5894,6904,-1010
1,5,10,8,7,6130,6795,-665
1,6,0,8,7,6539,6754,-215
1,6,1,8,7,6712,6391,321
1,6,2,8,7,6997,6186,811
1,6,3,8,7,7102,6584,518
1,6,4,8,7,7266,6900,366
1,6,5,8,7,7056,7105,-49
1,6,6,8,7,6931,7265,-334
1,6,7,8,7,6754,7427,-673
1,6,8,8,7,6391,7610,-1219
1,6,9,8,7,6186,7709,-1523
1,6,10,8,7,6584,7432,-848
1,7,0,8,7,6992,7290,-298
1,7,1,8,7,7306,6790,516
1,7,2,8,7,7713,6505,1208
1,7,3,8,7,7843,7036,807
1,7,4,8,7,8032,7408,624
1,7,5,8,7,7757,7748,9
1,7,6,8,7,7500,7994,-494
1,7,7,8,7,7290,8169,-879
1,7,8,8,7,6790,8404,-1614
1,7,9,8,7,6505,8501,-1996
1,7,10,8,7,7036,8099,-1063
1,8,0,8,7,7581,7568,13
1,8,1,8,7,8011,6925,1086
1,8,2,8,7,8517,6561,1956
1,8,3,8,7,8617,7261,1356
1,8,4,8,7,8757,7699,1058
1,8,5,8,7,8310,8212,98
1,8,6,8,7,7866,8598,-732
1,8,7,8,7,7568,8856,-1288
1,8,8,8,7,6925,9216,-2291
1,8,9,8,7,6561,9325,-2764
1,8,10,8,7,7261,8783,-1522
1,9,0,8,7,7837,7670,167
1,9,1,8,7,8412,6860,1552
1,9,2,8,7,9057,6420,2637
1,9,3,8,7,9175,7268,1907
1,9,4,8,7,9261,7758,1503
1,9,5,8,7,8615,8374,241
1,9,6,8,7,7997,8903,-906
1,9,7,8,7,7670,9252,-1582
1,9,8,8,7,6860,9692,-2832
1,9,9,8,7,6420,9764,-3344
1,9,10,8,7,7268,9111,-1843
1,10,0,8,7,8312,8207,105
1,10,1,8,7,9049,7267,1782
1,10,2,8,7,9820,6782,3038
1,10,3,8,7,9974,7783,2191
1,10,4,8,7,10038,8287,1751
1,10,5,8,7,9257,8889,368
1,10,6,8,7,8547,9487,-940
1,10,7,8,7,8207,9904,-1697
1,10,8,8,7,7267,10416,-3149
1,10,9,8,7,6782,10418,-3636
1,10,10,8,7,7783,9634,-1851
1,11,0,8,7,8599,7926,673
1,11,1,8,7,9289,6994,2295
1,11,2,8,7,9982,6492,3490
1,11,3,8,7,10065,7470,2595
1,11,4,8,7,9964,8040,1924
1,11,5,8,7,9058,8638,420
1,11,6,8,7,8269,9259,-990
1,11,7,8,7,7926,9818,-1892
1,11,8,8,7,6994,10433,-3439
1,11,9,8,7,6492,10464,-3972
1,11,10,8,7,7470,9773,-2303
1,12,0,8,7,8396,7552,844
1,12,1,8,7,8904,6677,2227
1,12,2,8,7,9578,6080,3498
1,12,3,8,7,9592,7059,2533
1,12,4,8,7,9344,7637,1707
1,12,5,8,7,8514,8167,347
1,12,6,8,7,7787,8673,-886
1,12,7,8,7,7552,9239,-1687
1,12,8,8,7,6677,9838,-3161
1,12,9,8,7,6080,9894,-3814
1,12,10,8,7,7059,9324,-2265
1,13,0,8,7,7994,7640,354
1,13,1,8,7,8418,6791,1627
1,13,2,8,7,9175,6098,3077
1,13,3,8,7,9246,6943,2303
1,13,4,8,7,8933,7364,1569
1,13,5,8,7,8248,7737,511
1,13,6,8,7,7700,8077,-377
1,13,7,8,7,7640,8553,-913
1,13,8,8,7,6791,9019,-2228
1,13,9,8,7,6098,9015,-2917
1,13,10,8,7,6943,8638,-1695
1,14,0,8,7,7597,7117,480
1,14,1,8,7,7815,6350,1465
1,14,2,8,7,8555,5659,2896
1,14,3,8,7,8588,6357,2231
1,14,4,8,7,8083,6711,1372
1,14,5,8,7,7474,6970,504
1,14,6,8,7,7125,7203,-78
1,14,7,8,7,7117,7663,-546
1,14,8,8,7,6350,8097,-1747
1,14,9,8,7,5659,8094,-2435
1,14,10,8,7,6357,7962,-1605
1,15,0,8,7,6955,6734,221
1,15,1,8,7,7092,6032,1060
1,15,2,8,7,7842,5369,2473
1,15,3,8,7,7863,5989,1874
1,15,4,8,7,7303,6290,1013
1,15,5,8,7,6798,6371,427
1,15,6,8,7,6673,6442,231
1,15,7,8,7,6734,6826,-92
1,15,8,8,7,6032,7190,-1158
1,15,9,8,7,5369,7097,-1728
1,15,10,8,7,5989,6996,-1007
1,16,0,8,7,6278,6408,-130
1,16,1,8,7,6293,5869,424
1,16,2,8,7,7031,5252,1779
1,16,3,8,7,7120,5709,1411
1,16,4,8,7,6547,5969,578
1,16,5,8,7,6146,5879,267
1,16,6,8,7,6233,5770,463
1,16,7,8,7,6408,6061,347
1,16,8,8,7,5869,6254,-385
1,16,9,8,7,5252,6115,-863
1,16,10,8,7,5709,6068,-359
1,0,0,9,7,6627,5647,980
1,0,1,9,7,6434,5601,833
1,0,2,9,7,6166,5594,572
1,0,3,9,7,5997,5628,369
1,0,4,9,7,5923,5667,256
1,0,5,9,7,5827,5783,44
1,0,6,9,7,5719,5912,-193
1,0,7,9,7,5647,6019,-372
1,0,8,9,7,5601,6196,-595
1,0,9,9,7,5594,6414,-820
1,0,10,9,7,5628,6580,-952
1,1,0,9,7,6317,5229,1088
1,1,1,9,7,6089,5145,944
1,1,2,9,7,5819,5126,693
1,1,3,9,7,5615,5183,432
1,1,4,9,7,5523,5259,264
1,1,5,9,7,5431,5389,42
1,1,6,9,7,5316,5520,-204
1,1,7,9,7,5229,5655,-426
1,1,8,9,7,5145,5866,-721
1,1,9,9,7,5126,6103,-977
1,1,10,9,7,5183,6309,-1126
1,2,0,9,7,6238,5429,809
1,2,1,9,7,6062,5314,748
1,2,2,9,7,5893,5283,610
1,2,3,9,7,5758,5348,410
1,2,4,9,7,5724,5438,286
1,2,5,9,7,5612,5560,52
1,2,6,9,7,5509,5687,-178
1,2,7,9,7,5429,5808,-379
1,2,8,9,7,5314,5971,-657
1,2,9,9,7,5283,6171,-888
1,2,10,9,7,5348,6351,-1003
1,3,0,9,7,6575,6040,535
1,3,1,9,7,6478,5887,591
1,3,2,9,7,6425,5833,592
1,3,3,9,7,6377,5958,419
1,3,4,9,7,6412,6090,322
1,3,5,9,7,6228,6216,12
1,3,6,9,7,6143,6362,-219
1,3,7,9,7,6040,6501,-461
1,3,8,9,7,5887,6649,-762
1,3,9,9,7,5833,6829,-996
1,3,10,9,7,5958,6912,-954
1,4,0,9,7,6971,6568,403
1,4,1,9,7,6944,6344,600
1,4,2,9,7,7021,6222,799
1,4,3,9,7,7021,6466,555
1,4,4,9,7,7083,6689,394
1,4,5,9,7,6826,6846,-20
1,4,6,9,7,6724,7024,-300
1,4,7,9,7,6568,7226,-658
1,4,8,9,7,6344,7429,-1085
1,4,9,9,7,6222,7605,-1383
1,4,10,9,7,6466,7547,-1081
1,5,0,9,7,7317,7192,125
1,5,1,9,7,7415,6855,560
1,5,2,9,7,7647,6647,1000
1,5,3,9,7,7700,7032,668
1,5,4,9,7,7812,7339,473
1,5,5,9,7,7542,7560,-18
1,5,6,9,7,7373,7762,-389
1,5,7,9,7,7192,7975,-783
1,5,8,9,7,6855,8212,-1357
1,5,9,9,7,6647,8363,-1716
1,5,10,9,7,7032,8139,-1107
1,6,0,9,7,7670,7762,-92
1,6,1,9,7,7922,7272,650
1,6,2,9,7,8274,6986,1288
1,6,3,9,7,8364,7525,839
1,6,4,9,7,8533,7894,639
1,6,5,9,7,8240,8236,4
1,6,6,9,7,7970,8500,-530
1,6,7,9,7,7762,8703,-941
1,6,8,9,7,7272,8977,-1705
1,6,9,9,7,6986,9122,-2136
1,6,10,9,7,7525,8758,-1233
1,7,0,9,7,8154,8257,-103
1,7,1,9,7,8559,7606,953
1,7,2,9,7,9035,7243,1792
1,7,3,9,7,9141,7946,1195
1,7,4,9,7,9329,8371,958
1,7,5,9,7,8941,8864,77
1,7,6,9,7,8539,9228,-689
1,7,7,9,7,8257,9460,-1203
1,7,8,9,7,7606,9807,-2201
1,7,9,9,7,7243,9930,-2687
1,7,10,9,7,7946,9414,-1468
1,8,0,9,7,8595,8612,-17
1,8,1,9,7,9165,7819,1346
1,8,2,9,7,9796,7390,2406
1,8,3,9,7,9928,8237,1691
1,8,4,9,7,10066,8728,1338
1,8,5,9,7,9494,9336,158
1,8,6,9,7,8928,9812,-884
1,8,7,9,7,8612,10114,-1502
1,8,8,9,7,7819,10544,-2725
1,8,9,9,7,7390,10596,-3206
1,8,10,9,7,8237,9940,-1703
1,9,0,9,7,8739,8511,228
1,9,1,9,7,9437,7531,1906
1,9,2,9,7,10203,7035,3168
1,9,3,9,7,10329,8054,2275
1,9,4,9,7,10379,8595,1784
1,9,5,9,7,9593,9219,374
1,9,6,9,7,8867,9825,-958
1,9,7,9,7,8511,10265,-1754
1,9,8,9,7,7531,10810,-3279
1,9,9,9,7,7035,10835,-3800
1,9,10,9,7,8054,10095,-2041
1,10,0,9,7,9272,8861,411
1,10,1,9,7,10015,7896,2119
1,10,2,9,7,10806,7381,3425
1,10,3,9,7,10957,8376,2581
1,10,4,9,7,10912,8963,1949
1,10,5,9,7,9977,9554,423
1,10,6,9,7,9195,10170,-975
1,10,7,9,7,8861,10712,-1851
1,10,8,9,7,7896,11285,-3389
1,10,9,9,7,7381,11286,-3905
1,10,10,9,7,8376,10556,-2180
1,11,0,9,7,9499,8939,560
1,11,1,9,7,10098,8018,2080
1,11,2,9,7,10888,7394,3494
1,11,3,9,7,10990,8437,2553
1,11,4,9,7,10813,9057,1756
1,11,5,9,7,9908,9593,315
1,11,6,9,7,9197,10119,-922
1,11,7,9,7,8939,10698,-1759
1,11,8,9,7,8018,11282,-3264
1,11,9,9,7,7394,11322,-3928
1,11,10,9,7,8437,10644,-2207
1,12,0,9,7,9173,8678,495
1,12,1,9,7,9670,7708,1962
1,12,2,9,7,10512,6942,3570
1,12,3,9,7,10590,7927,2663
1,12,4,9,7,10265,8472,1793
1,12,5,9,7,9458,8930,528
1,12,6,9,7,8840,9361,-521
1,12,7,9,7,8678,9944,-1266
1,12,8,9,7,7708,10504,-2796
1,12,9,9,7,6942,10540,-3598
1,12,10,9,7,7927,10043,-2116
1,13,0,9,7,8745,8104,641
1,13,1,9,7,9050,7195,1855
1,13,2,9,7,9880,6412,3468
1,13,3,9,7,9903,7259,2644
1,13,4,9,7,9381,7724,1657
1,13,5,9,7,8678,8108,570
1,13,6,9,7,8186,8444,-258
1,13,7,9,7,8104,8985,-881
1,13,8,9,7,7195,9516,-2321
1,13,9,9,7,6412,9553,-3141
1,13,10,9,7,7259,9306,-2047
1,14,0,9,7,8086,7742,344
1,14,1,9,7,8302,6913,1389
1,14,2,9,7,9119,6169,2950
1,14,3,9,7,9125,6930,2195
1,14,4,9,7,8570,7284,1286
1,14,5,9,7,7982,7502,480
1,14,6,9,7,7712,7677,35
1,14,7,9,7,7742,8102,-360
1,14,8,9,7,6913,8557,-1644
1,14,9,9,7,6169,8510,-2341
1,14,10,9,7,6930,8322,-1392
1,15,0,9,7,7440,7375,65
1,15,1,9,7,7546,6685,861
1,15,2,9,7,8353,5990,2363
1,15,3,9,7,8418,6619,1799
1,15,4,9,7,7844,6932,912
1,15,5,9,7,7330,6995,335
1,15,6,9,7,7272,7004,268
1,15,7,9,7,7375,7352,23
1,15,8,9,7,6685,7657,-972
1,15,9,9,7,5990,7544,-1554
1,15,10,9,7,6619,7383,-764
1,0,0,10,7,7054,5951,1103
1,0,1,10,7,6822,5865,957
1,0,2,10,7,6549,5847,702
1,0,3,10,7,6352,5899,453
1,0,4,10,7,6264,5975,289
1,0,5,10,7,6163,6113,50
1,0,6,10,7,6039,6250,-211
1,0,7,10,7,5951,6380,-429
1,0,8,10,7,5865,6590,-725
1,0,9,10,7,5847,6831,-984
1,0,10,10,7,5899,7041,-1142
1,1,0,10,7,6990,6164,826
1,1,1,10,7,6815,6047,768
1,1,2,10,7,6643,6015,628
1,1,3,10,7,6507,6089,418
1,1,4,10,7,6471,6182,289
1,1,5,10,7,6350,6305,45
1,1,6,10,7,6242,6431,-189
1,1,7,10,7,6164,6549,-385
1,1,8,10,7,6047,6718,-671
1,1,9,10,7,6015,6925,-910
1,1,10,10,7,6089,7092,-1003
1,2,0,10,7,7341,6816,525
1,2,1,10,7,7256,6655,601
1,2,2,10,7,7203,6597,606
1,2,3,10,7,7156,6726,430
1,2,4,10,7,7193,6858,335
1,2,5,10,7,7006,6986,20
1,2,6,10,7,6919,7133,-214
1,2,7,10,7,6816,7267,-451
1,2,8,10,7,6655,7415,-760
1,2,9,10,7,6597,7599,-1002
1,2,10,10,7,6726,7671,-945
1,3,0,10,7,7754,7078,676
1,3,1,10,7,7730,6804,926
1,3,2,10,7,7762,6677,1085
1,3,3,10,7,7721,6942,779
1,3,4,10,7,7744,7198,546
1,3,5,10,7,7438,7409,29
1,3,6,10,7,7283,7646,-363
1,3,7,10,7,7078,7892,-814
1,3,8,10,7,6804,8134,-1330
1,3,9,10,7,6677,8354,-1677
1,3,10,10,7,6942,8317,-1375
1,4,0,10,7,8119,7555,564
1,4,1,10,7,8179,7189,990
1,4,2,10,7,8346,6975,1371
1,4,3,10,7,8336,7368,968
1,4,4,10,7,8381,7702,679
1,4,5,10,7,8030,7984,46
1,4,6,10,7,7785,8265,-480
1,4,7,10,7,7555,8548,-993
1,4,8,10,7,7189,8848,-1659
1,4,9,10,7,6975,9064,-2089
1,4,10,10,7,7368,8891,-1523
1,5,0,10,7,8448,8200,248
1,5,1,10,7,8625,7736,889
1,5,2,10,7,8924,7447,1477
1,5,3,10,7,8962,7973,989
1,5,4,10,7,9079,8333,746
1,5,5,10,7,8726,8691,35
1,5,6,10,7,8412,8997,-585
1,5,7,10,7,8200,9251,-1051
1,5,8,10,7,7736,9579,-1843
1,5,9,10,7,7447,9776,-2329
1,5,10,10,7,7973,9465,-1492
1,6,0,10,7,8832,8729,103
1,6,1,10,7,9175,8088,1087
1,6,2,10,7,9596,7724,1872
1,6,3,10,7,9662,8435,1227
1,6,4,10,7,9830,8857,973
1,6,5,10,7,9424,9352,72
1,6,6,10,7,9009,9734,-725
1,6,7,10,7,8729,9994,-1265
1,6,8,10,7,8088,10380,-2292
1,6,9,10,7,7724,10551,-2827
1,6,10,10,7,8435,10073,-1638
1,7,0,10,7,9168,9301,-133
1,7,1,10,7,9713,8500,1213
1,7,2,10,7,10314,8072,2242
1,7,3,10,7,10452,8922,1530
1,7,4,10,7,10638,9400,1238
1,7,5,10,7,10125,9988,137
1,7,6,10,7,9601,10442,-841
1,7,7,10,7,9301,10718,-1417
1,7,8,10,7,8500,11135,-2635
1,7,9,10,7,8072,11201,-3129
1,7,10,10,7,8922,10571,-1649
1,8,0,10,7,9497,9453,44
1,8,1,10,7,10190,8490,1700
1,8,2,10,7,10942,8005,2937
1,8,3,10,7,11082,9023,2059
1,8,4,10,7,11184,9565,1619
1,8,5,10,7,10472,10181,291
1,8,6,10,7,9798,10734,-936
1,8,7,10,7,9453,11127,-1674
1,8,8,10,7,8490,11662,-3172
1,8,9,10,7,8005,11667,-3662
1,8,10,10,7,9023,10924,-1901
1,9,0,10,7,9699,9165,534
1,9,1,10,7,10403,8160,2243
1,9,2,10,7,11189,7634,3555
1,9,3,10,7,11312,8647,2665
1,9,4,10,7,11253,9271,1982
1,9,5,10,7,10313,9884,429
1,9,6,10,7,9515,10508,-993
1,9,7,10,7,9165,11073,-1908
1,9,8,10,7,8160,11679,-3519
1,9,9,10,7,7634,11703,-4069
1,9,10,10,7,8647,11017,-2370
1,10,0,10,7,10172,9874,298
1,10,1,10,7,10824,8920,1904
1,10,2,10,7,11712,8283,3429
1,10,3,10,7,11882,9343,2539
1,10,4,10,7,11761,9980,1781
1,10,5,10,7,10827,10509,318
1,10,6,10,7,10123,11030,-907
1,10,7,10,7,9874,11592,-1718
1,10,8,10,7,8920,12134,-3214
1,10,9,10,7,8283,12144,-3861
1,10,10,10,7,9343,11427,-2084
1,11,0,10,7,10276,10065,211
1,11,1,10,7,10864,9049,1815
1,11,2,10,7,11822,8256,3566
1,11,3,10,7,11988,9305,2683
1,11,4,10,7,11734,9892,1842
1,11,5,10,7,10852,10356,496
1,11,6,10,7,10250,10807,-557
1,11,7,10,7,10065,11403,-1338
1,11,8,10,7,9049,11948,-2899
1,11,9,10,7,8256,11968,-3712
1,11,10,10,7,9305,11363,-2058
1,12,0,10,7,9924,9142,782
1,12,1,10,7,10302,8112,2190
1,12,2,10,7,11217,7256,3961
1,12,3,10,7,11247,8243,3004
1,12,4,10,7,10713,8832,1881
1,12,5,10,7,9888,9301,587
1,12,6,10,7,9326,9728,-402
1,12,7,10,7,9142,10376,-1234
1,12,8,10,7,8112,11001,-2889
1,12,9,10,7,7256,11078,-3822
1,12,10,10,7,8243,10711,-2468
1,13,0,10,7,9234,8729,505
1,13,1,10,7,9537,7758,1779
1,13,2,10,7,10444,6922,3522
1,13,3,10,7,10440,7832,2608
1,13,4,10,7,9868,8297,1571
1,13,5,10,7,9186,8640,546
1,13,6,10,7,8773,8918,-145
1,13,7,10,7,8729,9424,-695
1,13,8,10,7,7758,9976,-2218
1,13,9,10,7,6922,9969,-3047
1,13,10,10,7,7832,9666,-1834
1,14,0,10,7,8571,8383,188
1,14,1,10,7,8756,7566,1190
1,14,2,10,7,9630,6790,2840
1,14,3,10,7,9680,7560,2120
1,14,4,10,7,9111,7926,1185
1,14,5,10,7,8514,8126,388
1,14,6,10,7,8311,8239,72
1,14,7,10,7,8383,8628,-245
1,14,8,10,7,7566,9024,-1458
1,14,9,10,7,6790,8957,-2167
1,14,10,10,7,7560,8709,-1149
1,0,0,11,7,7727,6886,841
1,0,1,11,7,7548,6767,781
1,0,2,11,7,7373,6736,637
1,0,3,11,7,7244,6805,439
1,0,4,11,7,7212,6898,314
1,0,5,11,7,7082,7029,53
1,0,6,11,7,6965,7161,-196
1,0,7,11,7,6886,7274,-388
1,0,8,11,7,6767,7442,-675
1,0,9,11,7,6736,7653,-917
1,0,10,11,7,6805,7824,-1019
1,1,0,11,7,8093,7551,542
1,1,1,11,7,8009,7388,621
1,1,2,11,7,7953,7329,624
1,1,3,11,7,7905,7467,438
1,1,4,11,7,7940,7602,338
1,1,5,11,7,7744,7731,13
1,1,6,11,7,7652,7877,-225
1,1,7,11,7,7551,8008,-457
1,1,8,11,7,7388,8162,-774
1,1,9,11,7,7329,8353,-1024
1,1,10,11,7,7467,8412,-945
1,2,0,11,7,8520,7854,666
1,2,1,11,7,8508,7572,936
1,2,2,11,7,8540,7441,1099
1,2,3,11,7,8500,7710,790
1,2,4,11,7,8525,7966,559
1,2,5,11,7,8216,8179,37
1,2,6,11,7,8059,8417,-358
1,2,7,11,7,7854,8658,-804
1,2,8,11,7,7572,8900,-1328
1,2,9,11,7,7441,9124,-1683
1,2,10,11,7,7710,9076,-1366
1,3,0,11,7,8902,8065,837
1,3,1,11,7,8965,7649,1316
1,3,2,11,7,9087,7430,1657
1,3,3,11,7,9036,7844,1192
1,3,4,11,7,9042,8211,831
1,3,5,11,7,8642,8547,95
1,3,6,11,7,8344,8887,-543
1,3,7,11,7,8065,9214,-1149
1,3,8,11,7,7649,9553,-1904
1,3,9,11,7,7430,9813,-2383
1,3,10,11,7,7844,9661,-1817
1,4,0,11,7,9250,8563,687
1,4,1,11,7,9389,8070,1319
1,4,2,11,7,9623,7775,1848
1,4,3,11,7,9598,8309,1289
1,4,4,11,7,9648,8696,952
1,4,5,11,7,9214,9115,99
1,4,6,11,7,8824,9500,-676
1,4,7,11,7,8563,9824,-1261
1,4,8,11,7,8070,10215,-2145
1,4,9,11,7,7775,10477,-2702
1,4,10,11,7,8309,10217,-1908
1,5,0,11,7,9610,9167,443
1,5,1,11,7,9878,8552,1326
1,5,2,11,7,10246,8185,2061
1,5,3,11,7,10260,8883,1377
1,5,4,11,7,10376,9296,1080
1,5,5,11,7,9910,9807,103
1,5,6,11,7,9451,10231,-780
1,5,7,11,7,9167,10542,-1375
1,5,8,11,7,8552,10982,-2430
1,5,9,11,7,8185,11205,-3020
1,5,10,11,7,8883,10780,-1897
1,6,0,11,7,9846,9773,73
1,6,1,11,7,10329,8982,1347
1,6,2,11,7,10875,8553,2322
1,6,3,11,7,10973,9411,1562
1,6,4,11,7,11139,9886,1253
1,6,5,11,7,10608,10476,132
1,6,6,11,7,10071,10948,-877
1,6,7,11,7,9773,11252,-1479
1,6,8,11,7,8982,11708,-2726
1,6,9,11,7,8553,11822,-3269
1,6,10,11,7,9411,11230,-1819
1,7,0,11,7,10070,10142,-72
1,7,1,11,7,10738,9171,1567
1,7,2,11,7,11460,8687,2773
1,7,3,11,7,11606,9708,1898
1,7,4,11,7,11756,10237,1519
1,7,5,11,7,11103,10833,270
1,7,6,11,7,10471,11364,-893
1,7,7,11,7,10142,11731,-1589
1,7,8,11,7,9171,12253,-3082
1,7,9,11,7,8687,12272,-3585
1,7,10,11,7,9708,11555,-1847
1,8,0,11,7,10457,10107,350
1,8,1,11,7,11156,9119,2037
1,8,2,11,7,11928,8604,3324
1,8,3,11,7,12065,9616,2449
1,8,4,11,7,12058,10241,1817
1,8,5,11,7,11192,10846,346
1,8,6,11,7,10446,11417,-971
1,8,7,11,7,10107,11935,-1828
1,8,8,11,7,9119,12531,-3412
1,8,9,11,7,8604,12535,-3931
1,8,10,11,7,9616,11846,-2230
1,9,0,11,7,10599,10178,421
1,9,1,11,7,11212,9184,2028
1,9,2,11,7,12095,8536,3559
1,9,3,11,7,12237,9614,2623
1,9,4,11,7,12102,10288,1814
1,9,5,11,7,11163,10839,324
1,9,6,11,7,10443,11368,-925
1,9,7,11,7,10178,11953,-1775
1,9,8,11,7,9184,12528,-3344
1,9,9,11,7,8536,12561,-4025
1,9,10,11,7,9614,11888,-2274
1,10,0,11,7,10949,11000,-51
1,10,1,11,7,11590,9951,1639
1,10,2,11,7,12646,9145,3501
1,10,3,11,7,12880,10211,2669
1,10,4,11,7,12682,10815,1867
1,10,5,11,7,11771,11272,499
1,10,6,11,7,11176,11718,-542
1,10,7,11,7,11000,12297,-1297
1,10,8,11,7,9951,12800,-2849
1,10,9,11,7,9145,12790,-3645
1,10,10,11,7,10211,12146,-1935
1,11,0,11,7,11027,10529,498
1,11,1,11,7,11496,9453,2043
1,11,2,11,7,12527,8570,3957
1,11,3,11,7,12645,9621,3024
1,11,4,11,7,12182,10252,1930
1,11,5,11,7,11282,10727,555
1,11,6,11,7,10736,11174,-438
1,11,7,11,7,10529,11835,-1306
1,11,8,11,7,9453,12445,-2992
1,11,9,11,7,8570,12506,-3936
1,11,10,11,7,9621,12031,-2410
1,12,0,11,7,10413,9767,646
1,12,1,11,7,10789,8675,2114
1,12,2,11,7,11781,7766,4015
1,12,3,11,7,11784,8816,2968
1,12,4,11,7,11200,9405,1795
1,12,5,11,7,10396,9833,563
1,12,6,11,7,9913,10202,-289
1,12,7,11,7,9767,10815,-1048
1,12,8,11,7,8675,11461,-2786
1,12,9,11,7,7766,11494,-3728
1,12,10,11,7,8816,11071,-2255
1,13,0,11,7,9719,9370,349
1,13,1,11,7,9991,8411,1580
1,13,2,11,7,10955,7543,3412
1,13,3,11,7,10995,8462,2533
1,13,4,11,7,10409,8939,1470
1,13,5,11,7,9718,9264,454
1,13,6,11,7,9372,9480,-108
1,13,7,11,7,9370,9950,-580
1,13,8,11,7,8411,10443,-2032
1,13,9,11,7,7543,10416,-2873
1,13,10,11,7,8462,10053,-1591
1,0,0,12,7,8830,8273,557
1,0,1,12,7,8742,8108,634
1,0,2,12,7,8683,8050,633
1,0,3,12,7,8642,8183,459
1,0,4,12,7,8681,8318,363
1,0,5,12,7,8476,8455,21
1,0,6,12,7,8375,8607,-232
1,0,7,12,7,8273,8733,-460
1,0,8,12,7,8108,8886,-778
1,0,9,12,7,8050,9081,-1031
1,0,10,12,7,8183,9144,-961
1,1,0,12,7,9272,8589,683
1,1,1,12,7,9261,8305,956
1,1,2,12,7,9290,8173,1117
1,1,3,12,7,9249,8451,798
1,1,4,12,7,9272,8710,562
1,1,5,12,7,8954,8924,30
1,1,6,12,7,8792,9161,-369
1,1,7,12,7,8589,9399,-810
1,1,8,12,7,8305,9647,-1342
1,1,9,12,7,8173,9878,-1705
1,1,10,12,7,8451,9817,-1366
1,2,0,12,7,9668,8841,827
1,2,1,12,7,9743,8417,1326
1,2,2,12,7,9865,8194,1671
1,2,3,12,7,9815,8612,1203
1,2,4,12,7,9823,8979,844
1,2,5,12,7,9420,9317,103
1,2,6,12,7,9120,9658,-538
1,2,7,12,7,8841,9980,-1139
1,2,8,12,7,8417,10319,-1902
1,2,9,12,7,8194,10583,-2389
1,2,10,12,7,8612,10420,-1808
1,3,0,12,7,10033,9073,960
1,3,1,12,7,10175,8530,1645
1,3,2,12,7,10364,8230,2134
1,3,3,12,7,10298,8785,1513
1,3,4,12,7,10309,9205,1104
1,3,5,12,7,9826,9678,148
1,3,6,12,7,9383,10122,-739
1,3,7,12,7,9073,10490,-1417
1,3,8,12,7,8530,10920,-2390
1,3,9,12,7,8230,11226,-2996
1,3,10,12,7,8785,10987,-2202
1,4,0,12,7,10412,9530,882
1,4,1,12,7,10642,8886,1756
1,4,2,12,7,10945,8513,2432
1,4,3,12,7,10896,9219,1677
1,4,4,12,7,10945,9659,1286
1,4,5,12,7,10398,10231,167
1,4,6,12,7,9863,10734,-871
1,4,7,12,7,9530,11115,-1585
1,4,8,12,7,8886,11618,-2732
1,4,9,12,7,8513,11906,-3393
1,4,10,12,7,9219,11532,-2313
1,5,0,12,7,10624,10211,413
1,5,1,12,7,11032,9446,1586
1,5,2,12,7,11525,9014,2511
1,5,3,12,7,11571,9859,1712
1,5,4,12,7,11685,10325,1360
1,5,5,12,7,11094,10931,163
1,5,6,12,7,10513,11445,-932
1,5,7,12,7,10211,11800,-1589
1,5,8,12,7,9446,12310,-2864
1,5,9,12,7,9014,12476,-3462
1,5,10,12,7,9859,11937,-2078
1,6,0,12,7,10748,10614,134
1,6,1,12,7,11354,9653,1701
1,6,2,12,7,12021,9168,2853
1,6,3,12,7,12127,10197,1930
1,6,4,12,7,12257,10723,1534
1,6,5,12,7,11586,11321,265
1,6,6,12,7,10941,11870,-929
1,6,7,12,7,10614,12265,-1651
1,6,8,12,7,9653,12826,-3173
1,6,9,12,7,9168,12893,-3725
1,6,10,12,7,10197,12214,-2017
1,7,0,12,7,11030,10796,234
1,7,1,12,7,11704,9800,1904
1,7,2,12,7,12446,9286,3160
1,7,3,12,7,12589,10301,2288
1,7,4,12,7,12630,10913,1717
1,7,5,12,7,11823,11498,325
1,7,6,12,7,11119,12047,-928
1,7,7,12,7,10796,12539,-1743
1,7,8,12,7,9800,13122,-3322
1,7,9,12,7,9286,13140,-3854
1,7,10,12,7,10301,12477,-2176
1,8,0,12,7,11357,11120,237
1,8,1,12,7,11965,10143,1822
1,8,2,12,7,12834,9506,3328
1,8,3,12,7,12990,10583,2407
1,8,4,12,7,12907,11258,1649
1,8,5,12,7,12042,11801,241
1,8,6,12,7,11374,12277,-903
1,8,7,12,7,11120,12815,-1695
1,8,8,12,7,10143,13380,-3237
1,8,9,12,7,9506,13393,-3887
1,8,10,12,7,10583,12717,-2134
1,9,0,12,7,11376,11304,72
1,9,1,12,7,11978,10215,1763
1,9,2,12,7,13029,9398,3631
1,9,3,12,7,13235,10482,2753
1,9,4,12,7,13023,11123,1900
1,9,5,12,7,12107,11602,505
1,9,6,12,7,11496,12056,-560
1,9,7,12,7,11304,12658,-1354
1,9,8,12,7,10215,13194,-2979
1,9,9,12,7,9398,13207,-3809
1,9,10,12,7,10482,12607,-2125
1,10,0,12,7,11700,11464,236
1,10,1,12,7,12222,10355,1867
1,10,2,12,7,13351,9459,3892
1,10,3,12,7,13537,10527,3010
1,10,4,12,7,13130,11175,1955
1,10,5,12,7,12201,11643,558
1,10,6,12,7,11662,12085,-423
1,10,7,12,7,11464,12729,-1265
1,10,8,12,7,10355,13297,-2942
1,10,9,12,7,9459,13328,-3869
1,10,10,12,7,10527,12814,-2287
1,11,0,12,7,11516,11154,362
1,11,1,12,7,11983,10016,1967
1,11,2,12,7,13091,9080,4011
1,11,3,12,7,13182,10194,2988
1,11,4,12,7,12669,10825,1844
1,11,5,12,7,11790,11259,531
1,11,6,12,7,11323,11648,-325
1,11,7,12,7,11154,12274,-1120
1,11,8,12,7,10016,12905,-2889
1,11,9,12,7,9080,12922,-3842
1,11,10,12,7,10194,12391,-2197
1,12,0,12,7,10898,10408,490
1,12,1,12,7,11243,9328,1915
1,12,2,12,7,12292,8387,3905
1,12,3,12,7,12339,9446,2893
1,12,4,12,7,11741,10047,1694
1,12,5,12,7,10928,10457,471
1,12,6,12,7,10512,10764,-252
1,12,7,12,7,10408,11341,-933
1,12,8,12,7,9328,11928,-2600
1,12,9,12,7,8387,11941,-3554
1,12,10,12,7,9446,11458,-2012
1,0,0,13,7,10009,9311,698
1,0,1,13,7,9994,9025,969
1,0,2,13,7,10020,8894,1126
1,0,3,13,7,9986,9167,819
1,0,4,13,7,10013,9426,587
1,0,5,13,7,9686,9648,38
1,0,6,13,7,9515,9891,-376
1,0,7,13,7,9311,10124,-813
1,0,8,13,7,9025,10371,-1346
1,0,9,13,7,8894,10606,-1712
1,0,10,13,7,9167,10549,-1382
1,1,0,13,7,10420,9576,844
1,1,1,13,7,10496,9150,1346
1,1,2,13,7,10615,8926,1689
1,1,3,13,7,10564,9353,1211
1,1,4,13,7,10570,9723,847
1,1,5,13,7,10158,10062,96
1,1,6,13,7,9853,10402,-549
1,1,7,13,7,9576,10721,-1145
1,1,8,13,7,9150,11066,-1916
1,1,9,13,7,8926,11337,-2411
1,1,10,13,7,9353,11161,-1808
1,2,0,13,7,10799,9849,950
1,2,1,13,7,10953,9298,1655
1,2,2,13,7,11142,8994,2148
1,2,3,13,7,11077,9553,1524
1,2,4,13,7,11090,9973,1117
1,2,5,13,7,10604,10448,156
1,2,6,13,7,10159,10893,-734
1,2,7,13,7,9849,11256,-1407
1,2,8,13,7,9298,11686,-2388
1,2,9,13,7,8994,11996,-3002
1,2,10,13,7,9553,11746,-2193
1,3,0,13,7,11195,10040,1155
1,3,1,13,7,11428,9346,2082
1,3,2,13,7,11686,8968,2718
1,3,3,13,7,11596,9695,1901
1,3,4,13,7,11606,10168,1438
1,3,5,13,7,11010,10794,216
1,3,6,13,7,10422,11356,-934
1,3,7,13,7,10040,11781,-1741
1,3,8,13,7,9346,12323,-2977
1,3,9,13,7,8968,12655,-3687
1,3,10,13,7,9695,12302,-2607
1,4,0,13,7,11426,10574,852
1,4,1,13,7,11796,9780,2016
1,4,2,13,7,12224,9342,2882
1,4,3,13,7,12207,10195,2012
1,4,4,13,7,12254,10688,1566
1,4,5,13,7,11582,11355,227
1,4,6,13,7,10925,11948,-1023
1,4,7,13,7,10574,12373,-1799
1,4,8,13,7,9780,12946,-3166
1,4,9,13,7,9342,13177,-3835
1,4,10,13,7,10195,12689,-2494
1,5,0,13,7,11526,11052,474
1,5,1,13,7,12057,10117,1940
1,5,2,13,7,12671,9629,3042
1,5,3,13,7,12725,10645,2080
1,5,4,13,7,12803,11162,1641
1,5,5,13,7,12072,11776,296
1,5,6,13,7,11383,12367,-984
1,5,7,13,7,11052,12813,-1761
1,5,8,13,7,10117,13428,-3311
1,5,9,13,7,9629,13547,-3918
1,5,10,13,7,10645,12921,-2276
1,6,0,13,7,11708,11268,440
1,6,1,13,7,12320,10282,2038
1,6,2,13,7,13007,9767,3240
1,6,3,13,7,13110,10790,2320
1,6,4,13,7,13131,11399,1732
1,6,5,13,7,12306,11986,320
1,6,6,13,7,11589,12553,-964
1,6,7,13,7,11268,13073,-1805
1,6,8,13,7,10282,13695,-3413
1,6,9,13,7,9767,13761,-3994
1,6,10,13,7,10790,13136,-2346
1,7,0,13,7,11930,11809,121
1,7,1,13,7,12513,10824,1689
1,7,2,13,7,13352,10188,3164
1,7,3,13,7,13514,11268,2246
1,7,4,13,7,13479,11930,1549
1,7,5,13,7,12673,12453,220
1,7,6,13,7,12047,12907,-860
1,7,7,13,7,11809,13419,-1610
1,7,8,13,7,10824,13971,-3147
1,7,9,13,7,10188,13998,-3810
1,7,10,13,7,11268,13348,-2080
1,8,0,13,7,12134,12246,-112
1,8,1,13,7,12731,11174,1557
1,8,2,13,7,13768,10368,3400
1,8,3,13,7,13988,11451,2537
1,8,4,13,7,13828,12093,1735
1,8,5,13,7,12986,12564,422
1,8,6,13,7,12427,12965,-538
1,8,7,13,7,12246,13520,-1274
1,8,8,13,7,11174,14046,-2872
1,8,9,13,7,10368,14039,-3671
1,8,10,13,7,11451,13436,-1985
1,9,0,13,7,12127,11768,359
1,9,1,13,7,12610,10619,1991
1,9,2,13,7,13734,9712,4022
1,9,3,13,7,13892,10798,3094
1,9,4,13,7,13471,11483,1988
1,9,5,13,7,12537,11973,564
1,9,6,13,7,11982,12423,-441
1,9,7,13,7,11768,13090,-1322
1,9,8,13,7,10619,13691,-3072
1,9,9,13,7,9712,13745,-4033
1,9,10,13,7,10798,13275,-2477
1,10,0,13,7,12189,12089,100
1,10,1,13,7,12709,10918,1791
1,10,2,13,7,13915,9969,3946
1,10,3,13,7,14074,11100,2974
1,10,4,13,7,13617,11748,1869
1,10,5,13,7,12709,12175,534
1,10,6,13,7,12249,12559,-310
1,10,7,13,7,12089,13168,-1079
1,10,8,13,7,10918,13757,-2839
1,10,9,13,7,9969,13744,-3775
1,10,10,13,7,11100,13174,-2074
1,11,0,13,7,12001,11795,206
1,11,1,13,7,12437,10669,1768
1,11,2,13,7,13602,9701,3901
1,11,3,13,7,13737,10824,2913
1,11,4,13,7,13210,11467,1743
1,11,5,13,7,12322,11883,439
1,11,6,13,7,11922,12210,-288
1,11,7,13,7,11795,12800,-1005
1,11,8,13,7,10669,13372,-2703
1,11,9,13,7,9701,13369,-3668
1,11,10,13,7,10824,12778,-1954
1,0,0,14,7,11157,10298,859
1,0,1,14,7,11229,9870,1359
1,0,2,14,7,11345,9647,1698
1,0,3,14,7,11301,10069,1232
1,0,4,14,7,11311,10439,872
1,0,5,14,7,10890,10786,104
1,0,6,14,7,10576,11132,-556
1,0,7,14,7,10298,11446,-1148
1,0,8,14,7,9870,11790,-1920
1,0,9,14,7,9647,12065,-2418
1,0,10,14,7,10069,11893,-1824
1,1,0,14,7,11551,10584,967
1,1,1,14,7,11706,10031,1675
1,1,2,14,7,11892,9726,2166
1,1,3,14,7,11826,10294,1532
1,1,4,14,7,11837,10717,1120
1,1,5,14,7,11342,11193,149
1,1,6,14,7,10892,11637,-745
1,1,7,14,7,10584,11997,-1413
1,1,8,14,7,10031,12433,-2402
1,1,9,14,7,9726,12750,-3024
1,1,10,14,7,10294,12487,-2193
1,2,0,14,7,11961,10816,1145
1,2,1,14,7,12206,10114,2092
1,2,2,14,7,12464,9732,2732
1,2,3,14,7,12375,10463,1912
1,2,4,14,7,12387,10936,1451
1,2,5,14,7,11788,11564,224
1,2,6,14,7,11198,12127,-929
1,2,7,14,7,10816,12547,-1731
1,2,8,14,7,10114,13089,-2975
1,2,9,14,7,9732,13425,-3693
1,2,10,14,7,10463,13061,-2598
1,3,0,14,7,12209,11084,1125
1,3,1,14,7,12582,10240,2342
1,3,2,14,7,12965,9797,3168
1,3,3,14,7,12907,10671,2236
1,3,4,14,7,12915,11197,1718
1,3,5,14,7,12194,11918,276
1,3,6,14,7,11484,12570,-1086
1,3,7,14,7,11084,13039,-1955
1,3,8,14,7,10240,13651,-3411
1,3,9,14,7,9797,13926,-4129
1,3,10,14,7,10671,13459,-2788
1,4,0,14,7,12328,11415,913
1,4,1,14,7,12821,10451,2370
1,4,2,14,7,13370,9957,3413
1,4,3,14,7,13361,10981,2380
1,4,4,14,7,13372,11525,1847
1,4,5,14,7,12560,12200,360
1,4,6,14,7,11795,12870,-1075
1,4,7,14,7,11415,13386,-1971
1,4,8,14,7,10451,14064,-3613
1,4,9,14,7,9957,14248,-4291
1,4,10,14,7,10981,13673,-2692
1,5,0,14,7,12486,11706,780
1,5,1,14,7,13023,10746,2277
1,5,2,14,7,13657,10228,3429
1,5,3,14,7,13708,11238,2470
1,5,4,14,7,13677,11838,1839
1,5,5,14,7,12792,12441,351
1,5,6,14,7,12031,13050,-1019
1,5,7,14,7,11706,13621,-1915
1,5,8,14,7,10746,14297,-3551
1,5,9,14,7,10228,14415,-4187
1,5,10,14,7,11238,13843,-2605
1,6,0,14,7,12608,12281,327
1,6,1,14,7,13129,11306,1823
1,6,2,14,7,13913,10669,3244
1,6,3,14,7,14035,11757,2278
1,6,4,14,7,13980,12416,1564
1,6,5,14,7,13156,12941,215
1,6,6,14,7,12517,13413,-896
1,6,7,14,7,12281,13953,-1672
1,6,8,14,7,11306,14544,-3238
1,6,9,14,7,10669,14619,-3950
1,6,10,14,7,11757,14007,-2250
1,7,0,14,7,12707,12935,-228
1,7,1,14,7,13279,11855,1424
1,7,2,14,7,14286,11050,3236
1,7,3,14,7,14512,12136,2376
1,7,4,14,7,14400,12765,1635
1,7,5,14,7,13617,13216,401
1,7,6,14,7,13100,13595,-495
1,7,7,14,7,12935,14124,-1189
1,7,8,14,7,11855,14637,-2782
1,7,9,14,7,11050,14644,-3594
1,7,10,14,7,12136,14067,-1931
1,8,0,14,7,12885,12710,175
1,8,1,14,7,13363,11578,1785
1,8,2,14,7,14473,10682,3791
1,8,3,14,7,14645,11767,2878
1,8,4,14,7,14276,12453,1823
1,8,5,14,7,13416,12935,481
1,8,6,14,7,12913,13332,-419
1,8,7,14,7,12710,13952,-1242
1,8,8,14,7,11578,14543,-2965
1,8,9,14,7,10682,14577,-3895
1,8,10,14,7,11767,14104,-2337
1,9,0,14,7,12616,12393,223
1,9,1,14,7,13097,11182,1915
1,9,2,14,7,14298,10222,4076
1,9,3,14,7,14429,11371,3058
1,9,4,14,7,13958,12056,1902
1,9,5,14,7,13045,12505,540
1,9,6,14,7,12569,12897,-328
1,9,7,14,7,12393,13529,-1136
1,9,8,14,7,11182,14151,-2969
1,9,9,14,7,10222,14161,-3939
1,9,10,14,7,11371,13635,-2264
1,10,0,14,7,12674,12730,-56
1,10,1,14,7,13163,11571,1592
1,10,2,14,7,14426,10590,3836
1,10,3,14,7,14629,11730,2899
1,10,4,14,7,14158,12390,1768
1,10,5,14,7,13241,12799,442
1,10,6,14,7,12848,13121,-273
1,10,7,14,7,12730,13694,-964
1,10,8,14,7,11571,14224,-2653
1,10,9,14,7,10590,14191,-3601
1,10,10,14,7,11730,13561,-1831
1,0,0,15,7,12288,11306,982
1,0,1,15,7,12439,10751,1688
1,0,2,15,7,12622,10447,2175
1,0,3,15,7,12563,11010,1553
1,0,4,15,7,12578,11433,1145
1,0,5,15,7,12074,11917,157
1,0,6,15,7,11615,12367,-752
1,0,7,15,7,11306,12722,-1416
1,0,8,15,7,10751,13157,-2406
1,0,9,15,7,10447,13478,-3031
1,0,10,15,7,11010,13219,-2209
1,1,0,15,7,12713,11551,1162
1,1,1,15,7,12959,10847,2112
1,1,2,15,7,13214,10464,2750
1,1,3,15,7,13124,11204,1920
1,1,4,15,7,13134,11680,1454
1,1,5,15,7,12526,12309,217
1,1,6,15,7,11931,12871,-940
1,1,7,15,7,11551,13288,-1737
1,1,8,15,7,10847,13836,-2989
1,1,9,15,7,10464,14179,-3715
1,1,10,15,7,11204,13802,-2598
1,2,0,15,7,12975,11860,1115
1,2,1,15,7,13360,11008,2352
1,2,2,15,7,13743,10561,3182
1,2,3,15,7,13686,11439,2247
1,2,4,15,7,13696,11965,1731
1,2,5,15,7,12972,12688,284
1,2,6,15,7,12260,13341,-1081
1,2,7,15,7,11860,13805,-1945
1,2,8,15,7,11008,14417,-3409
1,2,9,15,7,10561,14696,-4135
1,2,10,15,7,11439,14218,-2779
1,3,0,15,7,13111,11925,1186
1,3,1,15,7,13607,10911,2696
1,3,2,15,7,14111,10412,3699
1,3,3,15,7,14061,11457,2604
1,3,4,15,7,14033,12034,1999
1,3,5,15,7,13172,12763,409
1,3,6,15,7,12354,13492,-1138
1,3,7,15,7,11925,14052,-2127
1,3,8,15,7,10911,14769,-3858
1,3,9,15,7,10412,14997,-4585
1,3,10,15,7,11457,14443,-2986
1,4,0,15,7,13288,12069,1219
1,4,1,15,7,13787,11080,2707
1,4,2,15,7,14356,10556,3800
1,4,3,15,7,14344,11574,2770
1,4,4,15,7,14246,12201,2045
1,4,5,15,7,13280,12865,415
1,4,6,15,7,12443,13553,-1110
1,4,7,15,7,12069,14194,-2125
1,4,8,15,7,11080,14933,-3853
1,4,9,15,7,10556,15116,-4560
1,4,10,15,7,11574,14595,-3021
1,5,0,15,7,13386,12719,667
1,5,1,15,7,13832,11770,2062
1,5,2,15,7,14563,11130,3433
1,5,3,15,7,14633,12205,2428
1,5,4,15,7,14526,12855,1671
1,5,5,15,7,13642,13396,246
1,5,6,15,7,12959,13910,-951
1,5,7,15,7,12719,14501,-1782
1,5,8,15,7,11770,15146,-3376
1,5,9,15,7,11130,15273,-4143
1,5,10,15,7,12205,14714,-2509
1,6,0,15,7,13385,13407,-22
1,6,1,15,7,13895,12337,1558
1,6,2,15,7,14847,11531,3316
1,6,3,15,7,15033,12625,2408
1,6,4,15,7,14901,13251,1650
1,6,5,15,7,14100,13704,396
1,6,6,15,7,13570,14101,-531
1,6,7,15,7,13407,14658,-1251
1,6,8,15,7,12337,15210,-2873
1,6,9,15,7,11531,15265,-3734
1,6,10,15,7,12625,14726,-2101
1,7,0,15,7,13458,13399,59
1,7,1,15,7,13911,12259,1652
1,7,2,15,7,14991,11364,3627
1,7,3,15,7,15169,12452,2717
1,7,4,15,7,14848,13125,1723
1,7,5,15,7,14047,13587,460
1,7,6,15,7,13586,13962,-376
1,7,7,15,7,13399,14556,-1157
1,7,8,15,7,12259,15134,-2875
1,7,9,15,7,11364,15182,-3818
1,7,10,15,7,12452,14735,-2283
1,8,0,15,7,13374,13335,39
1,8,1,15,7,13850,12141,1709
1,8,2,15,7,15037,11192,3845
1,8,3,15,7,15182,12340,2842
1,8,4,15,7,14763,13026,1737
1,8,5,15,7,13924,13467,457
1,8,6,15,7,13500,13806,-306
1,8,7,15,7,13335,14391,-1056
1,8,8,15,7,12141,15003,-2862
1,8,9,15,7,11192,14993,-3801
1,8,10,15,7,12340,14464,-2124
1,9,0,15,7,13101,13034,67
1,9,1,15,7,13551,11835,1716
1,9,2,15,7,14809,10843,3966
1,9,3,15,7,14984,12001,2983
1,9,4,15,7,14499,12698,1801
1,9,5,15,7,13577,13129,448
1,9,6,15,7,13168,13459,-291
1,9,7,15,7,13034,14055,-1021
1,9,8,15,7,11835,14618,-2783
1,9,9,15,7,10843,14608,-3765
1,9,10,15,7,12001,14022,-2021
1,0,0,16,7,13450,12273,1177
1,0,1,16,7,13692,11567,2125
1,0,2,16,7,13944,11185,2759
1,0,3,16,7,13861,11920,1941
1,0,4,16,7,13875,12396,1479
1,0,5,16,7,13258,13033,225
1,0,6,16,7,12654,13601,-947
1,0,7,16,7,12273,14013,-1740
1,0,8,16,7,11567,14560,-2993
1,0,9,16,7,11185,14907,-3722
1,0,10,16,7,11920,14534,-2614
1,1,0,16,7,13727,12595,1132
1,1,1,16,7,14113,11741,2372
1,1,2,16,7,14493,11293,3200
1,1,3,16,7,14435,12180,2255
1,1,4,16,7,14443,12709,1734
1,1,5,16,7,13710,13433,277
1,1,6,16,7,12993,14085,-1092
1,1,7,16,7,12595,14546,-1951
1,1,8,16,7,11741,15164,-3423
1,1,9,16,7,11293,15450,-4157
1,1,10,16,7,12180,14959,-2779
1,2,0,16,7,13877,12701,1176
1,2,1,16,7,14385,11679,2706
1,2,2,16,7,14889,11176,3713
1,2,3,16,7,14840,12225,2615
1,2,4,16,7,14814,12802,2012
1,2,5,16,7,13950,13533,417
1,2,6,16,7,13130,14263,-1133
1,2,7,16,7,12701,14818,-2117
1,2,8,16,7,11679,15535,-3856
1,2,9,16,7,11176,15767,-4591
1,2,10,16,7,12225,15202,-2977
1,3,0,16,7,14071,12579,1492
1,3,1,16,7,14573,11540,3033
1,3,2,16,7,15097,11011,4086
1,3,3,16,7,15044,12050,2994
1,3,4,16,7,14907,12710,2197
1,3,5,16,7,13892,13428,464
1,3,6,16,7,13002,14175,-1173
1,3,7,16,7,12579,14860,-2281
1,3,8,16,7,11540,15638,-4098
1,3,9,16,7,11011,15865,-4854
1,3,10,16,7,12050,15365,-3315
1,4,0,16,7,14188,13082,1106
1,4,1,16,7,14596,12104,2492
1,4,2,16,7,15262,11458,3804
1,4,3,16,7,15269,12541,2728
1,4,4,16,7,15095,13218,1877
1,4,5,16,7,14130,13820,310
1,4,6,16,7,13371,14413,-1042
1,4,7,16,7,13082,15074,-1992
1,4,8,16,7,12104,15782,-3678
1,4,9,16,7,11458,15974,-4516
1,4,10,16,7,12541,15466,-2925
1,5,0,16,7,14163,13845,318
1,5,1,16,7,14598,12801,1797
1,5,2,16,7,15497,11992,3505
1,5,3,16,7,15631,13073,2558
1,5,4,16,7,15447,13690,1757
1,5,5,16,7,14586,14159,427
1,5,6,16,7,14012,14598,-586
1,5,7,16,7,13845,15206,-1361
1,5,8,16,7,12801,15812,-3011
1,5,9,16,7,11992,15919,-3927
1,5,10,16,7,13073,15433,-2360
1,6,0,16,7,14136,13871,265
1,6,1,16,7,14527,12741,1786
1,6,2,16,7,15552,11845,3707
1,6,3,16,7,15690,12941,2749
1,6,4,16,7,15349,13611,1738
1,6,5,16,7,14530,14075,455
1,6,6,16,7,14056,14468,-412
1,6,7,16,7,13871,15090,-1219
1,6,8,16,7,12741,15707,-2966
1,6,9,16,7,11845,15803,-3958
1,6,10,16,7,12941,15394,-2453
1,7,0,16,7,13947,14024,-77
1,7,1,16,7,14398,12822,1576
1,7,2,16,7,15555,11874,3681
1,7,3,16,7,15706,13025,2681
1,7,4,16,7,15335,13698,1637
1,7,5,16,7,14555,14119,436
1,7,6,16,7,14173,14436,-263
1,7,7,16,7,14024,14995,-971
1,7,8,16,7,12822,15594,-2772
1,7,9,16,7,11874,15598,-3724
1,7,10,16,7,13025,15095,-2070
1,8,0,16,7,13859,13976,-117
1,8,1,16,7,14304,12794,1510
1,8,2,16,7,15548,11813,3735
1,8,3,16,7,15737,12970,2767
1,8,4,16,7,15304,13668,1636
1,8,5,16,7,14456,14091,365
1,8,6,16,7,14099,14368,-269
1,8,7,16,7,13976,14917,-941
1,8,8,16,7,12794,15470,-2676
1,8,9,16,7,11813,15440,-3627
1,8,10,16,7,12970,14851,-1881
1,0,0,17,7,14464,13317,1147
1,0,1,17,7,14846,12461,2385
1,0,2,17,7,15223,12014,3209
1,0,3,17,7,15172,12896,2276
1,0,4,17,7,15184,13425,1759
1,0,5,17,7,14442,14157,285
1,0,6,17,7,13716,14815,-1099
1,0,7,17,7,13317,15271,-1954
1,0,8,17,7,12461,15888,-3427
1,0,9,17,7,12014,16178,-4164
1,0,10,17,7,12896,15691,-2795
1,1,0,17,7,14629,13436,1193
1,1,1,17,7,15138,12412,2726
1,1,2,17,7,15639,11908,3731
1,1,3,17,7,15589,12966,2623
1,1,4,17,7,15561,13546,2015
1,1,5,17,7,14688,14278,410
1,1,6,17,7,13863,15007,-1144
1,1,7,17,7,13436,15559,-2123
1,1,8,17,7,12412,16282,-3870
1,1,9,17,7,11908,16521,-4613
1,1,10,17,7,12966,15943,-2977
1,2,0,17,7,14837,13355,1482
1,2,1,17,7,15351,12308,3043
1,2,2,17,7,15875,11775,4100
1,2,3,17,7,15823,12818,3005
1,2,4,17,7,15688,13478,2210
1,2,5,17,7,14670,14198,472
1,2,6,17,7,13778,14946,-1168
1,2,7,17,7,13355,15626,-2271
1,2,8,17,7,12308,16404,-4096
1,2,9,17,7,11775,16635,-4860
1,2,10,17,7,12818,16124,-3306
1,3,0,17,7,14971,13592,1379
1,3,1,17,7,15382,12564,2818
1,3,2,17,7,16003,11913,4090
1,3,3,17,7,15969,13017,2952
1,3,4,17,7,15756,13727,2029
1,3,5,17,7,14742,14383,359
1,3,6,17,7,13930,15035,-1105
1,3,7,17,7,13592,15740,-2148
1,3,8,17,7,12564,16487,-3923
1,3,9,17,7,11913,16723,-4810
1,3,10,17,7,13017,16236,-3219
1,4,0,17,7,14965,14208,757
1,4,1,17,7,15362,13135,2227
1,4,2,17,7,16196,12320,3876
1,4,3,17,7,16267,13409,2858
1,4,4,17,7,16016,14053,1963
1,4,5,17,7,15074,14583,491
1,4,6,17,7,14424,15101,-677
1,4,7,17,7,14208,15779,-1571
1,4,8,17,7,13135,16448,-3313
1,4,9,17,7,12320,16620,-4300
1,4,10,17,7,13409,16185,-2776
1,5,0,17,7,14914,14309,605
1,5,1,17,7,15230,13205,2025
1,5,2,17,7,16202,12306,3896
1,5,3,17,7,16288,13389,2899
1,5,4,17,7,15895,14050,1845
1,5,5,17,7,15016,14530,486
1,5,6,17,7,14498,14965,-467
1,5,7,17,7,14309,15638,-1329
1,5,8,17,7,13205,16309,-3104
1,5,9,17,7,12306,16457,-4151
1,5,10,17,7,13389,16101,-2712
1,6,0,17,7,14625,14496,129
1,6,1,17,7,15014,13304,1710
1,6,2,17,7,16116,12355,3761
1,6,3,17,7,16227,13514,2713
1,6,4,17,7,15836,14184,1652
1,6,5,17,7,15038,14607,431
1,6,6,17,7,14643,14942,-299
1,6,7,17,7,14496,15529,-1033
1,6,8,17,7,13304,16167,-2863
1,6,9,17,7,12355,16219,-3864
1,6,10,17,7,13514,15754,-2240
1,7,0,17,7,14432,14665,-233
1,7,1,17,7,14852,13475,1377
1,7,2,17,7,16066,12495,3571
1,7,3,17,7,16261,13655,2606
1,7,4,17,7,15876,14340,1536
1,7,5,17,7,15087,14743,344
1,7,6,17,7,14772,14998,-226
1,7,7,17,7,14665,15521,-856
1,7,8,17,7,13475,16061,-2586
1,7,9,17,7,12495,16045,-3550
1,7,10,17,7,13655,15482,-1827
1,0,0,18,7,15366,14158,1208
1,0,1,18,7,15871,13132,2739
1,0,2,18,7,16369,12629,3740
1,0,3,18,7,16326,13682,2644
1,0,4,18,7,16302,14262,2040
1,0,5,18,7,15420,15002,418
1,0,6,18,7,14586,15737,-1151
1,0,7,18,7,14158,16284,-2126
1,0,8,18,7,13132,17006,-3874
1,0,9,18,7,12629,17249,-4620
1,0,10,18,7,13682,16675,-2993
1,1,0,18,7,15589,14090,1499
1,1,1,18,7,16104,13041,3063
1,1,2,18,7,16625,12507,4118
1,1,3,18,7,16572,13559,3013
1,1,4,18,7,16435,14222,2213
1,1,5,18,7,15408,14943,465
1,1,6,18,7,14511,15690,-1179
1,1,7,18,7,14090,16367,-2277
1,1,8,18,7,13041,17151,-4110
1,1,9,18,7,12507,17389,-4882
1,1,10,18,7,13559,16865,-3306
1,2,0,18,7,15737,14368,1369
1,2,1,18,7,16160,13332,2828
1,2,2,18,7,16781,12677,4104
1,2,3,18,7,16748,13785,2963
1,2,4,18,7,16537,14495,2042
1,2,5,18,7,15520,15153,367
1,2,6,18,7,14706,15806,-1100
1,2,7,18,7,14368,16506,-2138
1,2,8,18,7,13332,17253,-3921
1,2,9,18,7,12677,17493,-4816
1,2,10,18,7,13785,16995,-3210
1,3,0,18,7,15748,14718,1030
1,3,1,18,7,16148,13595,2553
1,3,2,18,7,16937,12775,4162
1,3,3,18,7,16967,13885,3082
1,3,4,18,7,16677,14562,2115
1,3,5,18,7,15686,15146,540
1,3,6,18,7,14983,15723,-740
1,3,7,18,7,14718,16445,-1727
1,3,8,18,7,13595,17153,-3558
1,3,9,18,7,12775,17369,-4594
1,3,10,18,7,13885,16955,-3070
1,4,0,18,7,15716,14672,1044
1,4,1,18,7,15994,13539,2455
1,4,2,18,7,16901,12634,4267
1,4,3,18,7,16924,13725,3199
1,4,4,18,7,16464,14413,2051
1,4,5,18,7,15504,14954,550
1,4,6,18,7,14910,15468,-558
1,4,7,18,7,14672,16211,-1539
1,4,8,18,7,13539,16945,-3406
1,4,9,18,7,12634,17158,-4524
1,4,10,18,7,13725,16853,-3128
1,5,0,18,7,15403,14934,469
1,5,1,18,7,15717,13768,1949
1,5,2,18,7,16766,12816,3950
1,5,3,18,7,16825,13962,2863
1,5,4,18,7,16382,14623,1759
1,5,5,18,7,15524,15062,462
1,5,6,18,7,15085,15439,-354
1,5,7,18,7,14934,16077,-1143
1,5,8,18,7,13768,16769,-3001
1,5,9,18,7,12816,16873,-4057
1,5,10,18,7,13962,16461,-2499
1,6,0,18,7,15110,15137,-27
1,6,1,18,7,15468,13957,1511
1,6,2,18,7,16627,12976,3651
1,6,3,18,7,16782,14144,2638
1,6,4,18,7,16377,14826,1551
1,6,5,18,7,15570,15231,339
1,6,6,18,7,15242,15504,-262
1,6,7,18,7,15137,16055,-918
1,6,8,18,7,13957,16634,-2677
1,6,9,18,7,12976,16666,-3690
1,6,10,18,7,14144,16141,-1997
1,0,0,19,7,16326,14812,1514
1,0,1,19,7,16837,13761,3076
1,0,2,19,7,17355,13228,4127
1,0,3,19,7,17309,14275,3034
1,0,4,19,7,17176,14938,2238
1,0,5,19,7,16140,15667,473
1,0,6,19,7,15234,16420,-1186
1,0,7,19,7,14812,17092,-2280
1,0,8,19,7,13761,17875,-4114
1,0,9,19,7,13228,18117,-4889
1,0,10,19,7,14275,17597,-3322
1,1,0,19,7,16489,15103,1386
1,1,1,19,7,16913,14065,2848
1,1,2,19,7,17531,13409,4122
1,1,3,19,7,17497,14526,2971
1,1,4,19,7,17284,15239,2045
1,1,5,19,7,16258,15898,360
1,1,6,19,7,15439,16550,-1111
1,1,7,19,7,15103,17247,-2144
1,1,8,19,7,14065,18000,-3935
1,1,9,19,7,13409,18247,-4838
1,1,10,19,7,14526,17736,-3210
1,2,0,19,7,16514,15494,1020
1,2,1,19,7,16926,14363,2563
1,2,2,19,7,17715,13539,4176
1,2,3,19,7,17746,14653,3093
1,2,4,19,7,17458,15330,2128
1,2,5,19,7,16464,15916,548
1,2,6,19,7,15759,16494,-735
1,2,7,19,7,15494,17211,-1717
1,2,8,19,7,14363,17919,-3556
1,2,9,19,7,13539,18139,-4600
1,2,10,19,7,14653,17714,-3061
1,3,0,19,7,16499,15182,1317
1,3,1,19,7,16780,13999,2781
1,3,2,19,7,17642,13089,4553
1,3,3,19,7,17624,14201,3423
1,3,4,19,7,17125,14922,2203
1,3,5,19,7,16116,15517,599
1,3,6,19,7,15469,16090,-621
1,3,7,19,7,15182,16877,-1695
1,3,8,19,7,13999,17650,-3651
1,3,9,19,7,13089,17907,-4818
1,3,10,19,7,14201,17623,-3422
1,4,0,19,7,16205,15297,908
1,4,1,19,7,16481,14102,2379
1,4,2,19,7,17465,13144,4321
1,4,3,19,7,17461,14298,3163
1,4,4,19,7,16951,14986,1965
1,4,5,19,7,16012,15486,526
1,4,6,19,7,15497,15942,-445
1,4,7,19,7,15297,16650,-1353
1,4,8,19,7,14102,17405,-3303
1,4,9,19,7,13144,17574,-4430
1,4,10,19,7,14298,17213,-2915
1,5,0,19,7,15888,15575,313
1,5,1,19,7,16171,14421,1750
1,5,2,19,7,17277,13437,3840
1,5,3,19,7,17380,14592,2788
1,5,4,19,7,16923,15265,1658
1,5,5,19,7,16056,15686,370
1,5,6,19,7,15684,16001,-317
1,5,7,19,7,15575,16603,-1028
1,5,8,19,7,14421,17236,-2815
1,5,9,19,7,13437,17320,-3883
1,5,10,19,7,14592,16848,-2256
1,0,0,20,7,17226,15825,1401
1,0,1,20,7,17646,14785,2861
1,0,2,20,7,18261,14130,4131
1,0,3,20,7,18234,15242,2992
1,0,4,20,7,18025,15955,2070
1,0,5,20,7,16990,16622,368
1,0,6,20,7,16162,17280,-1118
1,0,7,20,7,15825,17972,-2147
1,0,8,20,7,14785,18724,-3939
1,0,9,20,7,14130,18975,-4845
1,0,10,20,7,15242,18468,-3226
1,1,0,20,7,17266,16229,1037
1,1,1,20,7,17679,15096,2583
1,1,2,20,7,18465,14271,4194
1,1,3,20,7,18495,15394,3101
1,1,4,20,7,18205,16074,2131
1,1,5,20,7,17202,16661,541
1,1,6,20,7,16492,17238,-746
1,1,7,20,7,16229,17952,-1723
1,1,8,20,7,15096,18666,-3570
1,1,9,20,7,14271,18893,-4622
1,1,10,20,7,15394,18455,-3061
1,2,0,20,7,17265,15958,1307
1,2,1,20,7,17558,14767,2791
1,2,2,20,7,18420,13853,4567
1,2,3,20,7,18403,14969,3434
1,2,4,20,7,17906,15690,2216
1,2,5,20,7,16894,16287,607
1,2,6,20,7,16245,16861,-616
1,2,7,20,7,15958,17643,-1685
1,2,8,20,7,14767,18416,-3649
1,2,9,20,7,13853,18677,-4824
1,2,10,20,7,14969,18382,-3413
1,3,0,20,7,16988,15807,1181
1,3,1,20,7,17267,14562,2705
1,3,2,20,7,18206,13599,4607
1,3,3,20,7,18161,14774,3387
1,3,4,20,7,17612,15495,2117
1,3,5,20,7,16624,16049,575
1,3,6,20,7,16056,16564,-508
1,3,7,20,7,15807,17316,-1509
1,3,8,20,7,14562,18110,-3548
1,3,9,20,7,13599,18323,-4724
1,3,10,20,7,14774,17983,-3209
1,4,0,20,7,16690,15938,752
1,4,1,20,7,16935,14755,2180
1,4,2,20,7,17976,13765,4211
1,4,3,20,7,18016,14928,3088
1,4,4,20,7,17492,15628,1864
1,4,5,20,7,16544,16110,434
1,4,6,20,7,16096,16504,-408
1,4,7,20,7,15938,17176,-1238
1,4,8,20,7,14755,17872,-3117
1,4,9,20,7,13765,18021,-4256
1,4,10,20,7,14928,17600,-2672
1,0,0,21,7,18003,16951,1052
1,0,1,21,7,18412,15816,2596
1,0,2,21,7,19195,14992,4203
1,0,3,21,7,19232,16110,3122
1,0,4,21,7,18946,16790,2156
1,0,5,21,7,17934,17385,549
1,0,6,21,7,17215,17968,-753
1,0,7,21,7,16951,18677,-1726
1,0,8,21,7,15816,19390,-3574
1,0,9,21,7,14992,19621,-4629
1,0,10,21,7,16110,19187,-3077
1,1,0,21,7,18017,16693,1324
1,1,1,21,7,18311,15500,2811
1,1,2,21,7,19170,14585,4585
1,1,3,21,7,19152,15710,3442
1,1,4,21,7,18653,16434,2219
1,1,5,21,7,17632,17032,600
1,1,6,21,7,16978,17605,-627
1,1,7,21,7,16693,18384,-1691
1,1,8,21,7,15500,19163,-3663
1,1,9,21,7,14585,19431,-4846
1,1,10,21,7,15710,19123,-3413
1,2,0,21,7,17754,16583,1171
1,2,1,21,7,18045,15330,2715
1,2,2,21,7,18984,14363,4621
1,2,3,21,7,18940,15542,3398
1,2,4,21,7,18393,16263,2130
1,2,5,21,7,17402,16819,583
1,2,6,21,7,16832,17335,-503
1,2,7,21,7,16583,18082,-1499
1,2,8,21,7,15330,18876,-3546
1,2,9,21,7,14363,19093,-4730
1,2,10,21,7,15542,18742,-3200
1,3,0,21,7,17473,16448,1025
1,3,1,21,7,17721,15215,2506
1,3,2,21,7,18717,14220,4497
1,3,3,21,7,18716,15404,3312
1,3,4,21,7,18153,16137,2016
1,3,5,21,7,17156,16673,483
1,3,6,21,7,16655,17126,-471
1,3,7,21,7,16448,17842,-1394
1,3,8,21,7,15215,18577,-3362
1,3,9,21,7,14220,18770,-4550
1,3,10,21,7,15404,18370,-2966
1,0,0,22,7,18754,17415,1339
1,0,1,22,7,19044,16220,2824
1,0,2,22,7,19900,15306,4594
1,0,3,22,7,19889,16426,3463
1,0,4,22,7,19394,17150,2244
1,0,5,22,7,18364,17756,608
1,0,6,22,7,17701,18335,-634
1,0,7,22,7,17415,19109,-1694
1,0,8,22,7,16220,19887,-3667
1,0,9,22,7,15306,20159,-4853
1,0,10,22,7,16426,19855,-3429
1,1,0,22,7,18506,17318,1188
1,1,1,22,7,18798,16063,2735
1,1,2,22,7,19734,15095,4639
1,1,3,22,7,19689,16283,3406
1,1,4,22,7,19140,17007,2133
1,1,5,22,7,18140,17564,576
1,1,6,22,7,17565,18079,-514
1,1,7,22,7,17318,18823,-1505
1,1,8,22,7,16063,19623,-3560
1,1,9,22,7,15095,19847,-4752
1,1,10,22,7,16283,19483,-3200
1,2,0,22,7,18239,17224,1015
1,2,1,22,7,18499,15983,2516
1,2,2,22,7,19495,14984,4511
1,2,3,22,7,19495,16172,3323
1,2,4,22,7,18934,16905,2029
1,2,5,22,7,17934,17443,491
1,2,6,22,7,17431,17897,-466
1,2,7,22,7,17224,18608,-1384
1,2,8,22,7,15983,19343,-3360
1,2,9,22,7,14984,19540,-4556
1,2,10,22,7,16172,19129,-2957
1,0,0,23,7,19243,18040,1203
1,0,1,23,7,19531,16783,2748
1,0,2,23,7,20464,15816,4648
1,0,3,23,7,20426,16999,3427
1,0,4,23,7,19881,17723,2158
1,0,5,23,7,18872,18288,584
1,0,6,23,7,18288,18809,-521
1,0,7,23,7,18040,19548,-1508
1,0,8,23,7,16783,20347,-3564
1,0,9,23,7,15816,20575,-4759
1,0,10,23,7,16999,20215,-3216
1,1,0,23,7,18991,17959,1032
1,1,1,23,7,19252,16716,2536
1,1,2,23,7,20245,15716,4529
1,1,3,23,7,20244,16913,3331
1,1,4,23,7,19681,17649,2032
1,1,5,23,7,18672,18188,484
1,1,6,23,7,18164,18641,-477
1,1,7,23,7,17959,19349,-1390
1,1,8,23,7,16716,20090,-3374
1,1,9,23,7,15716,20294,-4578
1,1,10,23,7,16913,19870,-2957
1,0,0,24,7,19728,18681,1047
1,0,1,24,7,19985,17436,2549
1,0,2,24,7,20975,16437,4538
1,0,3,24,7,20981,17629,3352
1,0,4,24,7,20422,18365,2057
1,0,5,24,7,19404,18912,492
1,0,6,24,7,18887,19371,-484
1,0,7,24,7,18681,20074,-1393
1,0,8,24,7,17436,20814,-3378
1,0,9,24,7,16437,21022,-4585
1,0,10,24,7,17629,20602,-2973
1,0,0,1,8,843,825,18
1,0,1,1,8,837,819,18
1,0,2,1,8,833,818,15
1,0,3,1,8,839,826,13
1,0,4,1,8,843,832,11
1,0,5,1,8,834,828,6
1,0,6,1,8,826,828,-2
1,0,7,1,8,826,833,-7
1,0,8,1,8,825,830,-5
1,1,0,1,8,859,840,19
1,1,1,1,8,861,847,14
1,1,2,1,8,856,848,8
1,1,3,1,8,853,848,5
1,1,4,1,8,850,847,3
1,1,5,1,8,841,845,-4
1,1,6,1,8,837,852,-15
1,1,7,1,8,840,861,-21
1,1,8,1,8,840,856,-16
1,2,0,1,8,884,879,5
1,2,1,1,8,893,881,12
1,2,2,1,8,891,877,14
1,2,3,1,8,888,877,11
1,2,4,1,8,888,877,11
1,2,5,1,8,884,874,10
1,2,6,1,8,884,876,8
1,2,7,1,8,886,881,5
1,2,8,1,8,879,876,3
1,3,0,1,8,898,527,371
1,3,1,1,8,858,545,313
1,3,2,1,8,810,575,235
1,3,3,1,8,766,626,140
1,3,4,1,8,724,684,40
1,3,5,1,8,674,729,-55
1,3,6,1,8,622,770,-148
1,3,7,1,8,575,816,-241
1,3,8,1,8,527,860,-333
1,4,0,1,8,878,382,496
1,4,1,1,8,818,387,431
1,4,2,1,8,750,411,339
1,4,3,1,8,684,469,215
1,4,4,1,8,614,547,67
1,4,5,1,8,532,618,-86
1,4,6,1,8,457,683,-226
1,4,7,1,8,410,749,-339
1,4,8,1,8,382,811,-429
1,5,0,1,8,817,530,287
1,5,1,1,8,772,516,256
1,5,2,1,8,718,506,212
1,5,3,1,8,665,520,145
1,5,4,1,8,611,562,49
1,5,5,1,8,551,613,-62
1,5,6,1,8,507,667,-160
1,5,7,1,8,503,720,-217
1,5,8,1,8,530,762,-232
1,6,0,1,8,736,550,186
1,6,1,1,8,685,558,127
1,6,2,1,8,630,555,75
1,6,3,1,8,590,557,33
1,6,4,1,8,570,575,-5
1,6,5,1,8,552,603,-51
1,6,6,1,8,539,641,-102
1,6,7,1,8,540,689,-149
1,6,8,1,8,550,736,-186
1,7,0,1,8,678,777,-99
1,7,1,1,8,643,781,-138
1,7,2,1,8,614,769,-155
1,7,3,1,8,621,751,-130
1,7,4,1,8,671,729,-58
1,7,5,1,8,730,702,28
1,7,6,1,8,771,688,83
1,7,7,1,8,786,701,85
1,7,8,1,8,777,730,47
1,8,0,1,8,879,1097,-218
1,8,1,1,8,880,1104,-224
1,8,2,1,8,874,1100,-226
1,8,3,1,8,883,1099,-216
1,8,4,1,8,942,1055,-113
1,8,5,1,8,1025,1008,17
1,8,6,1,8,1077,990,87
1,8,7,1,8,1080,970,110
1,8,8,1,8,1097,963,134
1,9,0,1,8,494,317,177
1,9,1,1,8,452,312,140
1,9,2,1,8,424,337,87
1,9,3,1,8,384,366,18
1,9,4,1,8,377,377,0
1,9,5,1,8,375,389,-14
1,9,6,1,8,348,421,-73
1,9,7,1,8,331,470,-139
1,9,8,1,8,317,520,-203
1,10,0,1,8,830,1031,-201
1,10,1,1,8,868,1034,-166
1,10,2,1,8,952,1055,-103
1,10,3,1,8,1024,1035,-11
1,10,4,1,8,1067,1036,31
1,10,5,1,8,1044,1026,18
1,10,6,1,8,1058,976,82
1,10,7,1,8,1059,951,108
1,10,8,1,8,1031,928,103
1,11,0,1,8,1333,1530,-197
1,11,1,1,8,1410,1556,-146
1,11,2,1,8,1488,1614,-126
1,11,3,1,8,1592,1604,-12
1,11,4,1,8,1647,1637,10
1,11,5,1,8,1585,1659,-74
1,11,6,1,8,1610,1628,-18
1,11,7,1,8,1571,1617,-46
1,11,8,1,8,1530,1562,-32
1,12,0,1,8,1403,1076,327
1,12,1,1,8,1484,1095,389
1,12,2,1,8,1448,1222,226
1,12,3,1,8,1458,1308,150
1,12,4,1,8,1447,1415,32
1,12,5,1,8,1341,1502,-161
1,12,6,1,8,1251,1588,-337
1,12,7,1,8,1141,1684,-543
1,12,8,1,8,1076,1656,-580
1,13,0,1,8,1381,1002,379
1,13,1,1,8,1484,1002,482
1,13,2,1,8,1425,1119,306
1,13,3,1,8,1421,1231,190
1,13,4,1,8,1391,1351,40
1,13,5,1,8,1314,1418,-104
1,13,6,1,8,1157,1510,-353
1,13,7,1,8,1078,1616,-538
1,13,8,1,8,1002,1593,-591
1,14,0,1,8,1362,1036,326
1,14,1,1,8,1446,1041,405
1,14,2,1,8,1377,1121,256
1,14,3,1,8,1389,1224,165
1,14,4,1,8,1360,1344,16
1,14,5,1,8,1293,1388,-95
1,14,6,1,8,1151,1471,-320
1,14,7,1,8,1112,1568,-456
1,14,8,1,8,1036,1567,-531
1,15,0,1,8,1399,976,423
1,15,1,1,8,1491,993,498
1,15,2,1,8,1405,1081,324
1,15,3,1,8,1416,1210,206
1,15,4,1,8,1391,1339,52
1,15,5,1,8,1289,1383,-94
1,15,6,1,8,1131,1489,-358
1,15,7,1,8,1053,1589,-536
1,15,8,1,8,976,1570,-594
1,16,0,1,8,1262,1068,194
1,16,1,1,8,1393,1083,310
1,16,2,1,8,1386,1146,240
1,16,3,1,8,1428,1218,210
1,16,4,1,8,1403,1341,62
1,16,5,1,8,1311,1370,-59
1,16,6,1,8,1174,1426,-252
1,16,7,1,8,1142,1445,-303
1,16,8,1,8,1068,1411,-343
1,17,0,1,8,1133,811,322
1,17,1,1,8,1221,857,364
1,17,2,1,8,1217,947,270
1,17,3,1,8,1264,912,352
1,17,4,1,8,1185,1005,180
1,17,5,1,8,1061,1096,-35
1,17,6,1,8,953,1179,-226
1,17,7,1,8,902,1211,-309
1,17,8,1,8,811,1226,-415
1,18,0,1,8,1088,711,377
1,18,1,1,8,1078,666,412
1,18,2,1,8,1059,751,308
1,18,3,1,8,1058,749,309
1,18,4,1,8,958,790,168
1,18,5,1,8,827,883,-56
1,18,6,1,8,723,972,-249
1,18,7,1,8,757,950,-193
1,18,8,1,8,711,989,-278
1,19,0,1,8,999,1089,-90
1,19,1,1,8,996,1090,-94
1,19,2,1,8,1029,1175,-146
1,19,3,1,8,1083,1086,-3
1,19,4,1,8,980,1018,-38
1,19,5,1,8,1008,1037,-29
1,19,6,1,8,1085,959,126
1,19,7,1,8,1123,923,200
1,19,8,1,8,1089,1059,30
1,20,0,1,8,956,1106,-150
1,20,1,1,8,1010,1000,10
1,20,2,1,8,1066,988,78
1,20,3,1,8,1151,883,268
1,20,4,1,8,1041,840,201
1,20,5,1,8,1096,851,245
1,20,6,1,8,1199,750,449
1,20,7,1,8,1210,721,489
1,20,8,1,8,1106,857,249
1,21,0,1,8,835,459,376
1,21,1,1,8,777,357,420
1,21,2,1,8,746,386,360
1,21,3,1,8,683,415,268
1,21,4,1,8,492,455,37
1,21,5,1,8,518,468,50
1,21,6,1,8,522,521,1
1,21,7,1,8,488,593,-105
1,21,8,1,8,459,711,-252
1,22,0,1,8,584,661,-77
1,22,1,1,8,638,622,16
1,22,2,1,8,613,643,-30
1,22,3,1,8,607,593,14
1,22,4,1,8,548,590,-42
1,22,5,1,8,624,522,102
1,22,6,1,8,670,493,177
1,22,7,1,8,658,514,144
1,22,8,1,8,661,472,189
1,23,0,1,8,565,747,-182
1,23,1,1,8,580,728,-148
1,23,2,1,8,609,697,-88
1,23,3,1,8,610,684,-74
1,23,4,1,8,601,694,-93
1,23,5,1,8,664,616,48
1,23,6,1,8,689,559,130
1,23,7,1,8,733,541,192
1,23,8,1,8,747,494,253
1,0,0,2,8,1702,1665,37
1,0,1,2,8,1698,1666,32
1,0,2,2,8,1689,1666,23
1,0,3,2,8,1692,1674,18
1,0,4,2,8,1693,1679,14
1,0,5,2,8,1675,1673,2
1,0,6,2,8,1663,1680,-17
1,0,7,2,8,1666,1694,-28
1,0,8,2,8,1665,1686,-21
1,1,0,2,8,1743,1719,24
1,1,1,2,8,1754,1728,26
1,1,2,2,8,1747,1725,22
1,1,3,2,8,1741,1725,16
1,1,4,2,8,1738,1724,14
1,1,5,2,8,1725,1719,6
1,1,6,2,8,1721,1728,-7
1,1,7,2,8,1726,1742,-16
1,1,8,2,8,1719,1732,-13
1,2,0,2,8,1782,1406,376
1,2,1,2,8,1751,1426,325
1,2,2,2,8,1701,1452,249
1,2,3,2,8,1654,1503,151
1,2,4,2,8,1612,1561,51
1,2,5,2,8,1558,1603,-45
1,2,6,2,8,1506,1646,-140
1,2,7,2,8,1461,1697,-236
1,2,8,2,8,1406,1736,-330
1,3,0,2,8,1776,909,867
1,3,1,2,8,1676,932,744
1,3,2,2,8,1560,986,574
1,3,3,2,8,1450,1095,355
1,3,4,2,8,1338,1231,107
1,3,5,2,8,1206,1347,-141
1,3,6,2,8,1079,1453,-374
1,3,7,2,8,985,1565,-580
1,3,8,2,8,909,1671,-762
1,4,0,2,8,1695,912,783
1,4,1,2,8,1590,903,687
1,4,2,2,8,1468,917,551
1,4,3,2,8,1349,989,360
1,4,4,2,8,1225,1109,116
1,4,5,2,8,1083,1231,-148
1,4,6,2,8,964,1350,-386
1,4,7,2,8,913,1469,-556
1,4,8,2,8,912,1573,-661
1,5,0,2,8,1553,1080,473
1,5,1,2,8,1457,1074,383
1,5,2,2,8,1348,1061,287
1,5,3,2,8,1255,1077,178
1,5,4,2,8,1181,1137,44
1,5,5,2,8,1103,1216,-113
1,5,6,2,8,1046,1308,-262
1,5,7,2,8,1043,1409,-366
1,5,8,2,8,1080,1498,-418
1,6,0,2,8,1414,1327,87
1,6,1,2,8,1328,1339,-11
1,6,2,2,8,1244,1324,-80
1,6,3,2,8,1211,1308,-97
1,6,4,2,8,1241,1304,-63
1,6,5,2,8,1282,1305,-23
1,6,6,2,8,1310,1329,-19
1,6,7,2,8,1326,1390,-64
1,6,8,2,8,1327,1466,-139
1,7,0,2,8,1557,1874,-317
1,7,1,2,8,1523,1885,-362
1,7,2,2,8,1488,1869,-381
1,7,3,2,8,1504,1850,-346
1,7,4,2,8,1613,1784,-171
1,7,5,2,8,1755,1710,45
1,7,6,2,8,1848,1678,170
1,7,7,2,8,1866,1671,195
1,7,8,2,8,1874,1693,181
1,8,0,2,8,1373,1414,-41
1,8,1,2,8,1332,1416,-84
1,8,2,2,8,1298,1437,-139
1,8,3,2,8,1267,1465,-198
1,8,4,2,8,1319,1432,-113
1,8,5,2,8,1400,1397,3
1,8,6,2,8,1425,1411,14
1,8,7,2,8,1411,1440,-29
1,8,8,2,8,1414,1483,-69
1,9,0,2,8,1324,1348,-24
1,9,1,2,8,1320,1346,-26
1,9,2,2,8,1376,1392,-16
1,9,3,2,8,1408,1401,7
1,9,4,2,8,1444,1413,31
1,9,5,2,8,1419,1415,4
1,9,6,2,8,1406,1397,9
1,9,7,2,8,1390,1421,-31
1,9,8,2,8,1348,1448,-100
1,10,0,2,8,2163,2561,-398
1,10,1,2,8,2278,2590,-312
1,10,2,2,8,2440,2669,-229
1,10,3,2,8,2616,2639,-23
1,10,4,2,8,2714,2673,41
1,10,5,2,8,2629,2685,-56
1,10,6,2,8,2668,2604,64
1,10,7,2,8,2630,2568,62
1,10,8,2,8,2561,2490,71
1,11,0,2,8,2736,2606,130
1,11,1,2,8,2894,2651,243
1,11,2,2,8,2936,2836,100
1,11,3,2,8,3050,2912,138
1,11,4,2,8,3094,3052,42
1,11,5,2,8,2926,3161,-235
1,11,6,2,8,2861,3216,-355
1,11,7,2,8,2712,3301,-589
1,11,8,2,8,2606,3218,-612
1,12,0,2,8,2784,2078,706
1,12,1,2,8,2968,2097,871
1,12,2,2,8,2873,2341,532
1,12,3,2,8,2879,2539,340
1,12,4,2,8,2838,2766,72
1,12,5,2,8,2655,2920,-265
1,12,6,2,8,2408,3098,-690
1,12,7,2,8,2219,3300,-1081
1,12,8,2,8,2078,3249,-1171
1,13,0,2,8,2743,2038,705
1,13,1,2,8,2930,2043,887
1,13,2,2,8,2802,2240,562
1,13,3,2,8,2810,2455,355
1,13,4,2,8,2751,2695,56
1,13,5,2,8,2607,2806,-199
1,13,6,2,8,2308,2981,-673
1,13,7,2,8,2190,3184,-994
1,13,8,2,8,2038,3160,-1122
1,14,0,2,8,2761,2012,749
1,14,1,2,8,2937,2034,903
1,14,2,2,8,2782,2202,580
1,14,3,2,8,2805,2434,371
1,14,4,2,8,2751,2683,68
1,14,5,2,8,2582,2771,-189
1,14,6,2,8,2282,2960,-678
1,14,7,2,8,2165,3157,-992
1,14,8,2,8,2012,3137,-1125
1,15,0,2,8,2661,2044,617
1,15,1,2,8,2884,2076,808
1,15,2,2,8,2791,2227,564
1,15,3,2,8,2844,2428,416
1,15,4,2,8,2794,2680,114
1,15,5,2,8,2600,2753,-153
1,15,6,2,8,2305,2915,-610
1,15,7,2,8,2195,3034,-839
1,15,8,2,8,2044,2981,-937
1,16,0,2,8,2395,1879,516
1,16,1,2,8,2614,1940,674
1,16,2,2,8,2603,2093,510
1,16,3,2,8,2692,2130,562
1,16,4,2,8,2588,2346,242
1,16,5,2,8,2372,2466,-94
1,16,6,2,8,2127,2605,-478
1,16,7,2,8,2044,2656,-612
1,16,8,2,8,1879,2637,-758
1,17,0,2,8,2221,1522,699
1,17,1,2,8,2299,1523,776
1,17,2,2,8,2276,1698,578
1,17,3,2,8,2322,1661,661
1,17,4,2,8,2143,1795,348
1,17,5,2,8,1888,1979,-91
1,17,6,2,8,1676,2151,-475
1,17,7,2,8,1659,2161,-502
1,17,8,2,8,1522,2215,-693
1,18,0,2,8,2087,1800,287
1,18,1,2,8,2074,1756,318
1,18,2,2,8,2088,1926,162
1,18,3,2,8,2141,1835,306
1,18,4,2,8,1938,1808,130
1,18,5,2,8,1835,1920,-85
1,18,6,2,8,1808,1931,-123
1,18,7,2,8,1880,1873,7
1,18,8,2,8,1800,2048,-248
1,19,0,2,8,1955,2195,-240
1,19,1,2,8,2006,2090,-84
1,19,2,2,8,2095,2163,-68
1,19,3,2,8,2234,1969,265
1,19,4,2,8,2021,1858,163
1,19,5,2,8,2104,1888,216
1,19,6,2,8,2284,1709,575
1,19,7,2,8,2333,1644,689
1,19,8,2,8,2195,1916,279
1,20,0,2,8,1791,1565,226
1,20,1,2,8,1787,1357,430
1,20,2,2,8,1812,1374,438
1,20,3,2,8,1834,1298,536
1,20,4,2,8,1533,1295,238
1,20,5,2,8,1614,1319,295
1,20,6,2,8,1721,1271,450
1,20,7,2,8,1698,1314,384
1,20,8,2,8,1565,1568,-3
1,21,0,2,8,1419,1120,299
1,21,1,2,8,1415,979,436
1,21,2,2,8,1359,1029,330
1,21,3,2,8,1290,1008,282
1,21,4,2,8,1040,1045,-5
1,21,5,2,8,1142,990,152
1,21,6,2,8,1192,1014,178
1,21,7,2,8,1146,1107,39
1,21,8,2,8,1120,1183,-63
1,22,0,2,8,1149,1408,-259
1,22,1,2,8,1218,1350,-132
1,22,2,2,8,1222,1340,-118
1,22,3,2,8,1217,1277,-60
1,22,4,2,8,1149,1284,-135
1,22,5,2,8,1288,1138,150
1,22,6,2,8,1359,1052,307
1,22,7,2,8,1391,1055,336
1,22,8,2,8,1408,966,442
1,0,0,3,8,2586,2544,42
1,0,1,3,8,2591,2547,44
1,0,2,3,8,2580,2543,37
1,0,3,3,8,2580,2551,29
1,0,4,3,8,2581,2556,25
1,0,5,3,8,2559,2547,12
1,0,6,3,8,2547,2556,-9
1,0,7,3,8,2552,2575,-23
1,0,8,3,8,2544,2562,-18
1,1,0,3,8,2641,2246,395
1,1,1,3,8,2612,2273,339
1,1,2,3,8,2557,2300,257
1,1,3,3,8,2507,2351,156
1,1,4,3,8,2462,2408,54
1,1,5,3,8,2399,2448,-49
1,1,6,3,8,2343,2498,-155
1,1,7,3,8,2301,2558,-257
1,1,8,3,8,2246,2592,-346
1,2,0,3,8,2660,1788,872
1,2,1,3,8,2569,1813,756
1,2,2,3,8,2451,1863,588
1,2,3,3,8,2338,1972,366
1,2,4,3,8,2226,2108,118
1,2,5,3,8,2090,2221,-131
1,2,6,3,8,1963,2329,-366
1,2,7,3,8,1871,2446,-575
1,2,8,3,8,1788,2547,-759
1,3,0,3,8,2593,1439,1154
1,3,1,3,8,2448,1448,1000
1,3,2,3,8,2278,1492,786
1,3,3,3,8,2115,1615,500
1,3,4,3,8,1949,1793,156
1,3,5,3,8,1757,1960,-203
1,3,6,3,8,1586,2120,-534
1,3,7,3,8,1488,2285,-797
1,3,8,3,8,1439,2433,-994
1,4,0,3,8,2431,1462,969
1,4,1,3,8,2275,1461,814
1,4,2,3,8,2098,1472,626
1,4,3,3,8,1939,1546,393
1,4,4,3,8,1795,1684,111
1,4,5,3,8,1635,1834,-199
1,4,6,3,8,1503,1991,-488
1,4,7,3,8,1453,2158,-705
1,4,8,3,8,1462,2309,-847
1,5,0,3,8,2231,1857,374
1,5,1,3,8,2100,1855,245
1,5,2,3,8,1962,1830,132
1,5,3,3,8,1876,1828,48
1,5,4,3,8,1852,1866,-14
1,5,5,3,8,1833,1918,-85
1,5,6,3,8,1817,1996,-179
1,5,7,3,8,1829,2110,-281
1,5,8,3,8,1857,2228,-371
1,6,0,3,8,2293,2424,-131
1,6,1,3,8,2208,2443,-235
1,6,2,3,8,2118,2424,-306
1,6,3,3,8,2094,2407,-313
1,6,4,3,8,2183,2359,-176
1,6,5,3,8,2307,2313,-6
1,6,6,3,8,2387,2319,68
1,6,7,3,8,2406,2360,46
1,6,8,3,8,2424,2429,-5
1,7,0,3,8,2051,2191,-140
1,7,1,3,8,1975,2197,-222
1,7,2,3,8,1912,2206,-294
1,7,3,3,8,1888,2216,-328
1,7,4,3,8,1990,2161,-171
1,7,5,3,8,2130,2099,31
1,7,6,3,8,2196,2099,97
1,7,7,3,8,2197,2141,56
1,7,8,3,8,2191,2213,-22
1,8,0,3,8,2203,2445,-242
1,8,1,3,8,2200,2450,-250
1,8,2,3,8,2250,2492,-242
1,8,3,3,8,2291,2500,-209
1,8,4,3,8,2386,2468,-82
1,8,5,3,8,2444,2423,21
1,8,6,3,8,2483,2387,96
1,8,7,3,8,2470,2391,79
1,8,8,3,8,2445,2411,34
1,9,0,3,8,2657,2878,-221
1,9,1,3,8,2730,2902,-172
1,9,2,3,8,2864,3006,-142
1,9,3,3,8,3000,3005,-5
1,9,4,3,8,3091,3050,41
1,9,5,3,8,3004,3074,-70
1,9,6,3,8,3016,3025,-9
1,9,7,3,8,2961,3038,-77
1,9,8,3,8,2878,3010,-132
1,10,0,3,8,3566,3637,-71
1,10,1,3,8,3762,3685,77
1,10,2,3,8,3888,3891,-3
1,10,3,3,8,4074,3947,127
1,10,4,3,8,4161,4088,73
1,10,5,3,8,3970,4187,-217
1,10,6,3,8,3919,4192,-273
1,10,7,3,8,3771,4252,-481
1,10,8,3,8,3637,4146,-509
1,11,0,3,8,4117,3608,509
1,11,1,3,8,4378,3653,725
1,11,2,3,8,4361,3955,406
1,11,3,3,8,4471,4143,328
1,11,4,3,8,4485,4403,82
1,11,5,3,8,4240,4579,-339
1,11,6,3,8,4018,4726,-708
1,11,7,3,8,3790,4917,-1127
1,11,8,3,8,3608,4811,-1203
1,12,0,3,8,4146,3114,1032
1,12,1,3,8,4414,3138,1276
1,12,2,3,8,4250,3462,788
1,12,3,3,8,4268,3763,505
1,12,4,3,8,4198,4110,88
1,12,5,3,8,3948,4308,-360
1,12,6,3,8,3559,4569,-1010
1,12,7,3,8,3331,4868,-1537
1,12,8,3,8,3114,4816,-1702
1,13,0,3,8,4142,3014,1128
1,13,1,3,8,4421,3036,1385
1,13,2,3,8,4207,3321,886
1,13,3,3,8,4226,3665,561
1,13,4,3,8,4142,4034,108
1,13,5,3,8,3896,4189,-293
1,13,6,3,8,3439,4470,-1031
1,13,7,3,8,3243,4773,-1530
1,13,8,3,8,3014,4730,-1716
1,14,0,3,8,4023,3080,943
1,14,1,3,8,4330,3117,1213
1,14,2,3,8,4168,3348,820
1,14,3,3,8,4233,3652,581
1,14,4,3,8,4154,4024,130
1,14,5,3,8,3893,4141,-248
1,14,6,3,8,3456,4386,-930
1,14,7,3,8,3307,4602,-1295
1,14,8,3,8,3080,4548,-1468
1,15,0,3,8,3794,2855,939
1,15,1,3,8,4105,2933,1172
1,15,2,3,8,4008,3174,834
1,15,3,3,8,4108,3340,768
1,15,4,3,8,3979,3685,294
1,15,5,3,8,3661,3849,-188
1,15,6,3,8,3258,4094,-836
1,15,7,3,8,3097,4245,-1148
1,15,8,3,8,2855,4207,-1352
1,16,0,3,8,3483,2590,893
1,16,1,3,8,3692,2606,1086
1,16,2,3,8,3662,2844,818
1,16,3,3,8,3750,2879,871
1,16,4,3,8,3546,3136,410
1,16,5,3,8,3199,3349,-150
1,16,6,3,8,2850,3577,-727
1,16,7,3,8,2801,3606,-805
1,16,8,3,8,2590,3626,-1036
1,17,0,3,8,3220,2611,609
1,17,1,3,8,3295,2613,682
1,17,2,3,8,3305,2873,432
1,17,3,3,8,3405,2747,658
1,17,4,3,8,3123,2813,310
1,17,5,3,8,2896,3016,-120
1,17,6,3,8,2761,3110,-349
1,17,7,3,8,2782,3084,-302
1,17,8,3,8,2611,3274,-663
1,18,0,3,8,3043,2906,137
1,18,1,3,8,3084,2756,328
1,18,2,3,8,3154,2914,240
1,18,3,3,8,3292,2718,574
1,18,4,3,8,2979,2648,331
1,18,5,3,8,2931,2771,160
1,18,6,3,8,3007,2681,326
1,18,7,3,8,3090,2594,496
1,18,8,3,8,2906,2905,1
1,19,0,3,8,2790,2654,136
1,19,1,3,8,2783,2447,336
1,19,2,3,8,2841,2549,292
1,19,3,3,8,2917,2384,533
1,19,4,3,8,2513,2313,200
1,19,5,3,8,2622,2356,266
1,19,6,3,8,2806,2230,576
1,19,7,3,8,2821,2237,584
1,19,8,3,8,2654,2627,27
1,20,0,3,8,2375,2226,149
1,20,1,3,8,2425,1979,446
1,20,2,3,8,2425,2017,408
1,20,3,3,8,2441,1891,550
1,20,4,3,8,2081,1885,196
1,20,5,3,8,2238,1841,397
1,20,6,3,8,2391,1764,627
1,20,7,3,8,2356,1828,528
1,20,8,3,8,2226,2040,186
1,21,0,3,8,1984,1867,117
1,21,1,3,8,1995,1707,288
1,21,2,3,8,1968,1726,242
1,21,3,3,8,1900,1692,208
1,21,4,3,8,1641,1739,-98
1,21,5,3,8,1806,1606,200
1,21,6,3,8,1881,1573,308
1,21,7,3,8,1879,1648,231
1,21,8,3,8,1867,1677,190
1,0,0,4,8,3484,3071,413
1,0,1,4,8,3449,3092,357
1,0,2,4,8,3390,3118,272
1,0,3,4,8,3346,3177,169
1,0,4,4,8,3305,3240,65
1,0,5,4,8,3233,3276,-43
1,0,6,4,8,3169,3326,-157
1,0,7,4,8,3127,3391,-264
1,0,8,4,8,3071,3422,-351
1,1,0,4,8,3519,2628,891
1,1,1,4,8,3430,2660,770
1,1,2,4,8,3307,2711,596
1,1,3,4,8,3191,2820,371
1,1,4,4,8,3076,2955,121
1,1,5,4,8,2931,3066,-135
1,1,6,4,8,2800,3181,-381
1,1,7,4,8,2711,3307,-596
1,1,8,4,8,2628,3403,-775
1,2,0,4,8,3477,2318,1159
1,2,1,4,8,3341,2329,1012
1,2,2,4,8,3169,2369,800
1,2,3,4,8,3003,2492,511
1,2,4,4,8,2837,2670,167
1,2,5,4,8,2641,2834,-193
1,2,6,4,8,2470,2996,-526
1,2,7,4,8,2374,3166,-792
1,2,8,4,8,2318,3309,-991
1,3,0,4,8,3329,1989,1340
1,3,1,4,8,3133,2006,1127
1,3,2,4,8,2908,2047,861
1,3,3,4,8,2705,2172,533
1,3,4,4,8,2519,2368,151
1,3,5,4,8,2309,2563,-254
1,3,6,4,8,2125,2761,-636
1,3,7,4,8,2028,2974,-946
1,3,8,4,8,1989,3169,-1180
1,4,0,4,8,3109,2239,870
1,4,1,4,8,2918,2242,676
1,4,2,4,8,2712,2241,471
1,4,3,4,8,2560,2297,263
1,4,4,4,8,2466,2413,53
1,4,5,4,8,2365,2536,-171
1,4,6,4,8,2274,2679,-405
1,4,7,4,8,2239,2859,-620
1,4,8,4,8,2239,3039,-800
1,5,0,4,8,3110,2954,156
1,5,1,4,8,2980,2959,21
1,5,2,4,8,2836,2930,-94
1,5,3,4,8,2759,2927,-168
1,5,4,4,8,2794,2921,-127
1,5,5,4,8,2858,2926,-68
1,5,6,4,8,2894,2986,-92
1,5,7,4,8,2909,3080,-171
1,5,8,4,8,2954,3191,-237
1,6,0,4,8,2787,2741,46
1,6,1,4,8,2660,2755,-95
1,6,2,4,8,2542,2761,-219
1,6,3,4,8,2478,2773,-295
1,6,4,4,8,2560,2736,-176
1,6,5,4,8,2682,2702,-20
1,6,6,4,8,2735,2740,-5
1,6,7,4,8,2737,2830,-93
1,6,8,4,8,2741,2949,-208
1,7,0,4,8,2881,3222,-341
1,7,1,4,8,2843,3231,-388
1,7,2,4,8,2864,3261,-397
1,7,3,4,8,2912,3251,-339
1,7,4,4,8,3057,3197,-140
1,7,5,4,8,3174,3125,49
1,7,6,4,8,3254,3075,179
1,7,7,4,8,3256,3092,164
1,7,8,4,8,3222,3141,81
1,8,0,4,8,3536,3975,-439
1,8,1,4,8,3610,4006,-396
1,8,2,4,8,3738,4106,-368
1,8,3,4,8,3883,4104,-221
1,8,4,4,8,4033,4105,-72
1,8,5,4,8,4029,4082,-53
1,8,6,4,8,4093,4015,78
1,8,7,4,8,4041,4008,33
1,8,8,4,8,3975,3973,2
1,9,0,4,8,4060,3954,106
1,9,1,4,8,4214,3997,217
1,9,2,4,8,4312,4228,84
1,9,3,4,8,4458,4313,145
1,9,4,4,8,4538,4465,73
1,9,5,4,8,4345,4576,-231
1,9,6,4,8,4267,4613,-346
1,9,7,4,8,4102,4722,-620
1,9,8,4,8,3954,4666,-712
1,10,0,4,8,4947,4639,308
1,10,1,4,8,5246,4687,559
1,10,2,4,8,5313,5010,303
1,10,3,4,8,5495,5178,317
1,10,4,4,8,5552,5439,113
1,10,5,4,8,5284,5605,-321
1,10,6,4,8,5076,5702,-626
1,10,7,4,8,4849,5868,-1019
1,10,8,4,8,4639,5739,-1100
1,11,0,4,8,5479,4644,835
1,11,1,4,8,5824,4694,1130
1,11,2,4,8,5738,5076,662
1,11,3,4,8,5860,5367,493
1,11,4,4,8,5845,5747,98
1,11,5,4,8,5533,5967,-434
1,11,6,4,8,5169,6197,-1028
1,11,7,4,8,4902,6485,-1583
1,11,8,4,8,4644,6378,-1734
1,12,0,4,8,5545,4090,1455
1,12,1,4,8,5905,4131,1774
1,12,2,4,8,5655,4543,1112
1,12,3,4,8,5684,4973,711
1,12,4,4,8,5589,5449,140
1,12,5,4,8,5237,5691,-454
1,12,6,4,8,4690,6058,-1368
1,12,7,4,8,4384,6457,-2073
1,12,8,4,8,4090,6386,-2296
1,13,0,4,8,5404,4082,1322
1,13,1,4,8,5814,4119,1695
1,13,2,4,8,5593,4467,1126
1,13,3,4,8,5654,4883,771
1,13,4,4,8,5545,5375,170
1,13,5,4,8,5207,5559,-352
1,13,6,4,8,4613,5896,-1283
1,13,7,4,8,4385,6218,-1833
1,13,8,4,8,4082,6141,-2059
1,14,0,4,8,5156,3891,1265
1,14,1,4,8,5551,3974,1577
1,14,2,4,8,5385,4295,1090
1,14,3,4,8,5497,4564,933
1,14,4,4,8,5339,5029,310
1,14,5,4,8,4954,5237,-283
1,14,6,4,8,4409,5565,-1156
1,14,7,4,8,4209,5813,-1604
1,14,8,4,8,3891,5774,-1883
1,15,0,4,8,4882,3566,1316
1,15,1,4,8,5183,3599,1584
1,15,2,4,8,5067,3925,1142
1,15,3,4,8,5166,4089,1077
1,15,4,4,8,4937,4475,462
1,15,5,4,8,4488,4732,-244
1,15,6,4,8,3981,5066,-1085
1,15,7,4,8,3854,5195,-1341
1,15,8,4,8,3566,5196,-1630
1,16,0,4,8,4482,3679,803
1,16,1,4,8,4688,3696,992
1,16,2,4,8,4691,4019,672
1,16,3,4,8,4833,3965,868
1,16,4,4,8,4526,4154,372
1,16,5,4,8,4207,4386,-179
1,16,6,4,8,3935,4536,-601
1,16,7,4,8,3924,4529,-605
1,16,8,4,8,3679,4685,-1006
1,17,0,4,8,4176,3717,459
1,17,1,4,8,4305,3613,692
1,17,2,4,8,4371,3861,510
1,17,3,4,8,4556,3630,926
1,17,4,4,8,4164,3653,511
1,17,5,4,8,3992,3867,125
1,17,6,4,8,3960,3860,100
1,17,7,4,8,3992,3805,187
1,17,8,4,8,3717,4131,-414
1,18,0,4,8,3878,3365,513
1,18,1,4,8,3861,3113,748
1,18,2,4,8,3900,3300,600
1,18,3,4,8,3975,3133,842
1,18,4,4,8,3471,3103,368
1,18,5,4,8,3449,3239,210
1,18,6,4,8,3529,3202,327
1,18,7,4,8,3578,3187,391
1,18,8,4,8,3365,3616,-251
1,19,0,4,8,3374,3315,59
1,19,1,4,8,3421,3069,352
1,19,2,4,8,3454,3192,262
1,19,3,4,8,3524,2977,547
1,19,4,4,8,3061,2903,158
1,19,5,4,8,3246,2878,368
1,19,6,4,8,3476,2723,753
1,19,7,4,8,3479,2751,728
1,19,8,4,8,3315,3099,216
1,20,0,4,8,2940,2973,-33
1,20,1,4,8,3005,2707,298
1,20,2,4,8,3034,2714,320
1,20,3,4,8,3051,2575,476
1,20,4,4,8,2682,2579,103
1,20,5,4,8,2902,2457,445
1,20,6,4,8,3080,2323,757
1,20,7,4,8,3089,2369,720
1,20,8,4,8,2973,2534,439
1,0,0,5,8,4362,3453,909
1,0,1,5,8,4267,3479,788
1,0,2,5,8,4140,3529,611
1,0,3,5,8,4030,3646,384
1,0,4,5,8,3919,3787,132
1,0,5,5,8,3765,3894,-129
1,0,6,5,8,3626,4009,-383
1,0,7,5,8,3537,4140,-603
1,0,8,5,8,3453,4233,-780
1,1,0,5,8,4336,3158,1178
1,1,1,5,8,4202,3176,1026
1,1,2,5,8,4025,3217,808
1,1,3,5,8,3856,3340,516
1,1,4,5,8,3687,3517,170
1,1,5,5,8,3482,3679,-197
1,1,6,5,8,3307,3848,-541
1,1,7,5,8,3214,4027,-813
1,1,8,5,8,3158,4165,-1007
1,2,0,5,8,4213,2868,1345
1,2,1,5,8,4026,2887,1139
1,2,2,5,8,3799,2924,875
1,2,3,5,8,3593,3049,544
1,2,4,5,8,3407,3245,162
1,2,5,5,8,3193,3437,-244
1,2,6,5,8,3009,3637,-628
1,2,7,5,8,2914,3855,-941
1,2,8,5,8,2868,4045,-1177
1,3,0,5,8,4007,2766,1241
1,3,1,5,8,3776,2787,989
1,3,2,5,8,3522,2816,706
1,3,3,5,8,3326,2923,403
1,3,4,5,8,3190,3097,93
1,3,5,5,8,3039,3265,-226
1,3,6,5,8,2896,3449,-553
1,3,7,5,8,2814,3675,-861
1,3,8,5,8,2766,3899,-1133
1,4,0,5,8,3988,3336,652
1,4,1,5,8,3798,3346,452
1,4,2,5,8,3586,3341,245
1,4,3,5,8,3443,3396,47
1,4,4,5,8,3408,3468,-60
1,4,5,5,8,3390,3544,-154
1,4,6,5,8,3351,3669,-318
1,4,7,5,8,3319,3829,-510
1,4,8,5,8,3336,4002,-666
1,5,0,5,8,3604,3271,333
1,5,1,5,8,3432,3271,161
1,5,2,5,8,3260,3267,-7
1,5,3,5,8,3143,3293,-150
1,5,4,5,8,3171,3298,-127
1,5,5,5,8,3233,3315,-82
1,5,6,5,8,3242,3407,-165
1,5,7,5,8,3240,3550,-310
1,5,8,5,8,3271,3711,-440
1,6,0,5,8,3617,3772,-155
1,6,1,5,8,3528,3789,-261
1,6,2,5,8,3494,3816,-322
1,6,3,5,8,3502,3808,-306
1,6,4,5,8,3627,3772,-145
1,6,5,5,8,3726,3728,-2
1,6,6,5,8,3793,3716,77
1,6,7,5,8,3796,3781,15
1,6,8,5,8,3772,3877,-105
1,7,0,5,8,4214,4752,-538
1,7,1,5,8,4253,4787,-534
1,7,2,5,8,4352,4875,-523
1,7,3,5,8,4504,4855,-351
1,7,4,5,8,4704,4834,-130
1,7,5,5,8,4759,4784,-25
1,7,6,5,8,4864,4703,161
1,7,7,5,8,4827,4709,118
1,7,8,5,8,4752,4703,49
1,8,0,5,8,4939,5051,-112
1,8,1,5,8,5094,5101,-7
1,8,2,5,8,5186,5328,-142
1,8,3,5,8,5341,5412,-71
1,8,4,5,8,5480,5520,-40
1,8,5,5,8,5370,5584,-214
1,8,6,5,8,5344,5603,-259
1,8,7,5,8,5182,5692,-510
1,8,8,5,8,5051,5629,-578
1,9,0,5,8,5441,4956,485
1,9,1,5,8,5698,4999,699
1,9,2,5,8,5737,5347,390
1,9,3,5,8,5879,5544,335
1,9,4,5,8,5929,5816,113
1,9,5,5,8,5659,5994,-335
1,9,6,5,8,5424,6123,-699
1,9,7,5,8,5180,6338,-1158
1,9,8,5,8,4956,6259,-1303
1,10,0,5,8,6309,5675,634
1,10,1,5,8,6692,5728,964
1,10,2,5,8,6690,6131,559
1,10,3,5,8,6884,6402,482
1,10,4,5,8,6912,6783,129
1,10,5,5,8,6577,6993,-416
1,10,6,5,8,6227,7173,-946
1,10,7,5,8,5961,7436,-1475
1,10,8,5,8,5675,7306,-1631
1,11,0,5,8,6878,5620,1258
1,11,1,5,8,7315,5687,1628
1,11,2,5,8,7143,6157,986
1,11,3,5,8,7276,6577,699
1,11,4,5,8,7236,7086,150
1,11,5,5,8,6822,7350,-528
1,11,6,5,8,6300,7686,-1386
1,11,7,5,8,5955,8074,-2119
1,11,8,5,8,5620,7948,-2328
1,12,0,5,8,6807,5158,1649
1,12,1,5,8,7298,5214,2084
1,12,2,5,8,7041,5689,1352
1,12,3,5,8,7112,6191,921
1,12,4,5,8,6992,6790,202
1,12,5,5,8,6548,7061,-513
1,12,6,5,8,5864,7484,-1620
1,12,7,5,8,5526,7902,-2376
1,12,8,5,8,5158,7797,-2639
1,13,0,5,8,6537,4893,1644
1,13,1,5,8,7035,4976,2059
1,13,2,5,8,6810,5414,1396
1,13,3,5,8,6918,5795,1123
1,13,4,5,8,6730,6380,350
1,13,5,5,8,6268,6655,-387
1,13,6,5,8,5566,7075,-1509
1,13,7,5,8,5287,7429,-2142
1,13,8,5,8,4893,7367,-2474
1,14,0,5,8,6244,4602,1642
1,14,1,5,8,6629,4640,1989
1,14,2,5,8,6444,5046,1398
1,14,3,5,8,6555,5313,1242
1,14,4,5,8,6297,5819,478
1,14,5,5,8,5781,6120,-339
1,14,6,5,8,5132,6537,-1405
1,14,7,5,8,4966,6763,-1797
1,14,8,5,8,4602,6763,-2161
1,15,0,5,8,5881,4655,1226
1,15,1,5,8,6179,4689,1490
1,15,2,5,8,6096,5100,996
1,15,3,5,8,6249,5175,1074
1,15,4,5,8,5917,5493,424
1,15,5,5,8,5496,5769,-273
1,15,6,5,8,5066,6025,-959
1,15,7,5,8,4977,6118,-1141
1,15,8,5,8,4655,6255,-1600
1,16,0,5,8,5438,4785,653
1,16,1,5,8,5698,4696,1002
1,16,2,5,8,5757,5007,750
1,16,3,5,8,5984,4848,1136
1,16,4,5,8,5567,4994,573
1,16,5,5,8,5303,5237,66
1,16,6,5,8,5134,5286,-152
1,16,7,5,8,5134,5250,-116
1,16,8,5,8,4785,5542,-757
1,17,0,5,8,5011,4176,835
1,17,1,5,8,5082,3970,1112
1,17,2,5,8,5117,4247,870
1,17,3,5,8,5239,4045,1194
1,17,4,5,8,4656,4108,548
1,17,5,5,8,4510,4335,175
1,17,6,5,8,4482,4381,101
1,17,7,5,8,4480,4398,82
1,17,8,5,8,4176,4842,-666
1,18,0,5,8,4462,4026,436
1,18,1,5,8,4499,3735,764
1,18,2,5,8,4513,3943,570
1,18,3,5,8,4582,3726,856
1,18,4,5,8,4019,3693,326
1,18,5,5,8,4073,3761,312
1,18,6,5,8,4199,3695,504
1,18,7,5,8,4236,3701,535
1,18,8,5,8,4026,4088,-62
1,19,0,5,8,3939,4062,-123
1,19,1,5,8,4001,3797,204
1,19,2,5,8,4063,3889,174
1,19,3,5,8,4134,3661,473
1,19,4,5,8,3662,3597,65
1,19,5,5,8,3910,3494,416
1,19,6,5,8,4165,3282,883
1,19,7,5,8,4212,3292,920
1,19,8,5,8,4062,3593,469
1,0,0,6,8,5179,3983,1196
1,0,1,6,8,5039,3995,1044
1,0,2,6,8,4858,4035,823
1,0,3,6,8,4695,4166,529
1,0,4,6,8,4530,4349,181
1,0,5,6,8,4316,4507,-191
1,0,6,6,8,4133,4676,-543
1,0,7,6,8,4040,4860,-820
1,0,8,6,8,3983,4995,-1012
1,1,0,6,8,5072,3708,1364
1,1,1,6,8,4887,3734,1153
1,1,2,6,8,4655,3772,883
1,1,3,6,8,4446,3897,549
1,1,4,6,8,4257,4092,165
1,1,5,6,8,4034,4282,-248
1,1,6,6,8,3846,4489,-643
1,1,7,6,8,3754,4716,-962
1,1,8,6,8,3708,4901,-1193
1,2,0,6,8,4891,3645,1246
1,2,1,6,8,4669,3668,1001
1,2,2,6,8,4413,3693,720
1,2,3,6,8,4214,3800,414
1,2,4,6,8,4078,3974,104
1,2,5,6,8,3923,4139,-216
1,2,6,6,8,3780,4325,-545
1,2,7,6,8,3700,4556,-856
1,2,8,6,8,3645,4775,-1130
1,3,0,6,8,4886,3863,1023
1,3,1,6,8,4656,3891,765
1,3,2,6,8,4396,3916,480
1,3,3,6,8,4209,4022,187
1,3,4,6,8,4132,4152,-20
1,3,5,6,8,4064,4273,-209
1,3,6,6,8,3973,4439,-466
1,3,7,6,8,3894,4645,-751
1,3,8,6,8,3863,4862,-999
1,4,0,6,8,4482,3653,829
1,4,1,6,8,4250,3658,592
1,4,2,6,8,4010,3678,332
1,4,3,6,8,3827,3762,65
1,4,4,6,8,3785,3845,-60
1,4,5,6,8,3765,3933,-168
1,4,6,6,8,3699,4090,-391
1,4,7,6,8,3650,4299,-649
1,4,8,6,8,3653,4522,-869
1,5,0,6,8,4434,4302,132
1,5,1,6,8,4300,4305,-5
1,5,2,6,8,4212,4322,-110
1,5,3,6,8,4167,4328,-161
1,5,4,6,8,4238,4334,-96
1,5,5,6,8,4277,4341,-64
1,5,6,6,8,4300,4383,-83
1,5,7,6,8,4299,4501,-202
1,5,8,6,8,4302,4639,-337
1,6,0,6,8,4950,5302,-352
1,6,1,6,8,4938,5345,-407
1,6,2,6,8,4982,5430,-448
1,6,3,6,8,5094,5412,-318
1,6,4,6,8,5274,5409,-135
1,6,5,6,8,5311,5387,-76
1,6,6,6,8,5403,5344,59
1,6,7,6,8,5367,5398,-31
1,6,8,6,8,5302,5439,-137
1,7,0,6,8,5617,5828,-211
1,7,1,6,8,5737,5882,-145
1,7,2,6,8,5800,6097,-297
1,7,3,6,8,5962,6163,-201
1,7,4,6,8,6151,6249,-98
1,7,5,6,8,6100,6286,-186
1,7,6,6,8,6115,6291,-176
1,7,7,6,8,5968,6393,-425
1,7,8,6,8,5828,6359,-531
1,8,0,6,8,6320,6053,267
1,8,1,6,8,6578,6103,475
1,8,2,6,8,6611,6447,164
1,8,3,6,8,6762,6643,119
1,8,4,6,8,6871,6871,0
1,8,5,6,8,6684,7002,-318
1,8,6,6,8,6501,7113,-612
1,8,7,6,8,6260,7308,-1048
1,8,8,6,8,6053,7222,-1169
1,9,0,6,8,6803,5992,811
1,9,1,6,8,7144,6040,1104
1,9,2,6,8,7114,6468,646
1,9,3,6,8,7268,6768,500
1,9,4,6,8,7289,7160,129
1,9,5,6,8,6952,7382,-430
1,9,6,6,8,6575,7594,-1019
1,9,7,6,8,6292,7906,-1614
1,9,8,6,8,5992,7826,-1834
1,10,0,6,8,7708,6651,1057
1,10,1,6,8,8183,6721,1462
1,10,2,6,8,8095,7212,883
1,10,3,6,8,8300,7612,688
1,10,4,6,8,8303,8122,181
1,10,5,6,8,7866,8376,-510
1,10,6,6,8,7358,8662,-1304
1,10,7,6,8,7014,9025,-2011
1,10,8,6,8,6651,8876,-2225
1,11,0,6,8,8140,6688,1452
1,11,1,6,8,8708,6770,1938
1,11,2,6,8,8529,7303,1226
1,11,3,6,8,8704,7795,909
1,11,4,6,8,8639,8427,212
1,11,5,6,8,8133,8720,-587
1,11,6,6,8,7474,9112,-1638
1,11,7,6,8,7097,9519,-2422
1,11,8,6,8,6688,9359,-2671
1,12,0,6,8,7940,5969,1971
1,12,1,6,8,8519,6071,2448
1,12,2,6,8,8258,6636,1622
1,12,3,6,8,8376,7103,1273
1,12,4,6,8,8177,7795,382
1,12,5,6,8,7609,8157,-548
1,12,6,6,8,6817,8663,-1846
1,12,7,6,8,6428,9113,-2685
1,12,8,6,8,5969,9023,-3054
1,13,0,6,8,7625,5604,2021
1,13,1,6,8,8113,5642,2471
1,13,2,6,8,7869,6165,1704
1,13,3,6,8,7976,6544,1432
1,13,4,6,8,7688,7170,518
1,13,5,6,8,7095,7538,-443
1,13,6,6,8,6289,8047,-1758
1,13,7,6,8,6044,8379,-2335
1,13,8,6,8,5604,8356,-2752
1,14,0,6,8,7243,5691,1552
1,14,1,6,8,7625,5730,1895
1,14,2,6,8,7473,6221,1252
1,14,3,6,8,7638,6399,1239
1,14,4,6,8,7277,6837,440
1,14,5,6,8,6789,7157,-368
1,14,6,6,8,6217,7496,-1279
1,14,7,6,8,6089,7686,-1597
1,14,8,6,8,5691,7822,-2131
1,15,0,6,8,6837,5761,1076
1,15,1,6,8,7189,5689,1500
1,15,2,6,8,7162,6088,1074
1,15,3,6,8,7400,6058,1342
1,15,4,6,8,6958,6333,625
1,15,5,6,8,6592,6620,-28
1,15,6,6,8,6265,6775,-510
1,15,7,6,8,6187,6839,-652
1,15,8,6,8,5761,7112,-1351
1,16,0,6,8,6273,5244,1029
1,16,1,6,8,6475,5053,1422
1,16,2,6,8,6503,5393,1110
1,16,3,6,8,6667,5263,1404
1,16,4,6,8,6059,5449,610
1,16,5,6,8,5821,5705,116
1,16,6,6,8,5656,5807,-151
1,16,7,6,8,5622,5843,-221
1,16,8,6,8,5244,6253,-1009
1,17,0,6,8,5595,4837,758
1,17,1,6,8,5720,4592,1128
1,17,2,6,8,5730,4890,840
1,17,3,6,8,5846,4638,1208
1,17,4,6,8,5204,4698,506
1,17,5,6,8,5134,4857,277
1,17,6,6,8,5152,4874,278
1,17,7,6,8,5138,4912,226
1,17,8,6,8,4837,5314,-477
1,18,0,6,8,5027,4773,254
1,18,1,6,8,5079,4463,616
1,18,2,6,8,5122,4640,482
1,18,3,6,8,5192,4410,782
1,18,4,6,8,4620,4387,233
1,18,5,6,8,4737,4377,360
1,18,6,6,8,4888,4254,634
1,18,7,6,8,4969,4242,727
1,18,8,6,8,4773,4582,191
1,0,0,7,8,5915,4533,1382
1,0,1,7,8,5724,4553,1171
1,0,2,7,8,5488,4590,898
1,0,3,7,8,5285,4723,562
1,0,4,7,8,5100,4924,176
1,0,5,7,8,4868,5110,-242
1,0,6,7,8,4672,5317,-645
1,0,7,7,8,4580,5549,-969
1,0,8,7,8,4533,5731,-1198
1,1,0,7,8,5750,4485,1265
1,1,1,7,8,5530,4515,1015
1,1,2,7,8,5269,4541,728
1,1,3,7,8,5067,4648,419
1,1,4,7,8,4928,4821,107
1,1,5,7,8,4764,4984,-220
1,1,6,7,8,4617,5177,-560
1,1,7,7,8,4540,5417,-877
1,1,8,7,8,4485,5631,-1146
1,2,0,7,8,5770,4742,1028
1,2,1,7,8,5549,4772,777
1,2,2,7,8,5287,4793,494
1,2,3,7,8,5097,4899,198
1,2,4,7,8,5020,5029,-9
1,2,5,7,8,4948,5147,-199
1,2,6,7,8,4857,5315,-458
1,2,7,7,8,4780,5526,-746
1,2,8,7,8,4742,5738,-996
1,3,0,7,8,5380,4180,1200
1,3,1,7,8,5108,4203,905
1,3,2,7,8,4820,4253,567
1,3,3,7,8,4593,4388,205
1,3,4,7,8,4509,4529,-20
1,3,5,7,8,4439,4662,-223
1,3,6,7,8,4321,4860,-539
1,3,7,7,8,4225,5115,-890
1,3,8,7,8,4180,5382,-1202
1,4,0,7,8,5312,4684,628
1,4,1,7,8,5118,4692,426
1,4,2,7,8,4962,4733,229
1,4,3,7,8,4851,4797,54
1,4,4,7,8,4852,4881,-29
1,4,5,7,8,4809,4959,-150
1,4,6,7,8,4757,5066,-309
1,4,7,7,8,4709,5250,-541
1,4,8,7,8,4684,5450,-766
1,5,0,7,8,5767,5832,-65
1,5,1,7,8,5710,5861,-151
1,5,2,7,8,5700,5936,-236
1,5,3,7,8,5759,5932,-173
1,5,4,7,8,5885,5971,-86
1,5,5,7,8,5862,6000,-138
1,5,6,7,8,5910,6011,-101
1,5,7,7,8,5870,6118,-248
1,5,8,7,8,5832,6201,-369
1,6,0,7,8,6353,6378,-25
1,6,1,7,8,6422,6440,-18
1,6,2,7,8,6430,6652,-222
1,6,3,7,8,6552,6720,-168
1,6,4,7,8,6721,6824,-103
1,6,5,7,8,6652,6889,-237
1,6,6,7,8,6654,6932,-278
1,6,7,7,8,6508,7082,-574
1,6,8,7,8,6378,7095,-717
1,7,0,7,8,6998,6830,168
1,7,1,7,8,7221,6884,337
1,7,2,7,8,7225,7216,9
1,7,3,7,8,7383,7394,-11
1,7,4,7,8,7542,7600,-58
1,7,5,7,8,7414,7704,-290
1,7,6,7,8,7272,7801,-529
1,7,7,7,8,7046,8009,-963
1,7,8,7,8,6830,7952,-1122
1,8,0,7,8,7682,7089,593
1,8,1,7,8,8024,7144,880
1,8,2,7,8,7988,7568,420
1,8,3,7,8,8151,7867,284
1,8,4,7,8,8231,8215,16
1,8,5,7,8,7977,8390,-413
1,8,6,7,8,7652,8584,-932
1,8,7,7,8,7372,8876,-1504
1,8,8,7,8,7089,8789,-1700
1,9,0,7,8,8202,6968,1234
1,9,1,7,8,8635,7033,1602
1,9,2,7,8,8519,7549,970
1,9,3,7,8,8684,7978,706
1,9,4,7,8,8680,8499,181
1,9,5,7,8,8241,8765,-524
1,9,6,7,8,7706,9083,-1377
1,9,7,7,8,7345,9495,-2150
1,9,8,7,8,6968,9396,-2428
1,10,0,7,8,8970,7719,1251
1,10,1,7,8,9576,7804,1772
1,10,2,7,8,9481,8358,1123
1,10,3,7,8,9728,8830,898
1,10,4,7,8,9706,9463,243
1,10,5,7,8,9177,9746,-569
1,10,6,7,8,8532,10088,-1556
1,10,7,7,8,8156,10470,-2314
1,10,8,7,8,7719,10287,-2568
1,11,0,7,8,9273,7499,1774
1,11,1,7,8,9929,7627,2302
1,11,2,7,8,9746,8250,1496
1,11,3,7,8,9968,8707,1261
1,11,4,7,8,9824,9432,392
1,11,5,7,8,9194,9816,-622
1,11,6,7,8,8427,10291,-1864
1,11,7,7,8,7999,10730,-2731
1,11,8,7,8,7499,10585,-3086
1,12,0,7,8,9028,6680,2348
1,12,1,7,8,9597,6737,2860
1,12,2,7,8,9317,7387,1930
1,12,3,7,8,9434,7852,1582
1,12,4,7,8,9135,8585,550
1,12,5,7,8,8436,9040,-604
1,12,6,7,8,7540,9635,-2095
1,12,7,7,8,7185,10063,-2878
1,12,8,7,8,6680,10012,-3332
1,13,0,7,8,8624,6693,1931
1,13,1,7,8,9109,6732,2377
1,13,2,7,8,8898,7340,1558
1,13,3,7,8,9059,7630,1429
1,13,4,7,8,8668,8188,480
1,13,5,7,8,8103,8575,-472
1,13,6,7,8,7374,9006,-1632
1,13,7,7,8,7167,9302,-2135
1,13,8,7,8,6693,9415,-2722
1,14,0,7,8,8199,6797,1402
1,14,1,7,8,8635,6730,1905
1,14,2,7,8,8539,7209,1330
1,14,3,7,8,8789,7282,1507
1,14,4,7,8,8318,7677,641
1,14,5,7,8,7885,8008,-123
1,14,6,7,8,7416,8246,-830
1,14,7,7,8,7299,8407,-1108
1,14,8,7,8,6797,8679,-1882
1,15,0,7,8,7672,6220,1452
1,15,1,7,8,7966,6046,1920
1,15,2,7,8,7908,6474,1434
1,15,3,7,8,8083,6473,1610
1,15,4,7,8,7450,6788,662
1,15,5,7,8,7110,7088,22
1,15,6,7,8,6787,7296,-509
1,15,7,7,8,6675,7432,-757
1,15,8,7,8,6220,7823,-1603
1,16,0,7,8,6857,5905,952
1,16,1,7,8,7113,5675,1438
1,16,2,7,8,7116,6036,1080
1,16,3,7,8,7274,5856,1418
1,16,4,7,8,6607,6039,568
1,16,5,7,8,6445,6227,218
1,16,6,7,8,6326,6300,26
1,16,7,7,8,6280,6357,-77
1,16,8,7,8,5905,6725,-820
1,17,0,7,8,6160,5584,576
1,17,1,7,8,6300,5320,980
1,17,2,7,8,6339,5587,752
1,17,3,7,8,6456,5322,1134
1,17,4,7,8,5805,5392,413
1,17,5,7,8,5798,5473,325
1,17,6,7,8,5841,5433,408
1,17,7,7,8,5871,5453,418
1,17,8,7,8,5584,5808,-224
1,0,0,8,8,6593,5310,1283
1,0,1,8,8,6367,5334,1033
1,0,2,8,8,6102,5359,743
1,0,3,8,8,5906,5474,432
1,0,4,8,8,5771,5653,118
1,0,5,8,8,5598,5812,-214
1,0,6,8,8,5443,6005,-562
1,0,7,8,8,5366,6250,-884
1,0,8,8,8,5310,6461,-1151
1,1,0,8,8,6629,5582,1047
1,1,1,8,8,6410,5619,791
1,1,2,8,8,6143,5641,502
1,1,3,8,8,5950,5747,203
1,1,4,8,8,5870,5876,-6
1,1,5,8,8,5789,5992,-203
1,1,6,8,8,5694,6167,-473
1,1,7,8,8,5620,6387,-767
1,1,8,8,8,5582,6594,-1012
1,2,0,8,8,6264,5059,1205
1,2,1,8,8,6001,5084,917
1,2,2,8,8,5711,5130,581
1,2,3,8,8,5481,5265,216
1,2,4,8,8,5397,5406,-9
1,2,5,8,8,5323,5536,-213
1,2,6,8,8,5205,5736,-531
1,2,7,8,8,5111,5996,-885
1,2,8,8,8,5059,6258,-1199
1,3,0,8,8,6210,5211,999
1,3,1,8,8,5976,5237,739
1,3,2,8,8,5772,5308,464
1,3,3,8,8,5617,5423,194
1,3,4,8,8,5576,5565,11
1,3,5,8,8,5483,5688,-205
1,3,6,8,8,5379,5836,-457
1,3,7,8,8,5284,6066,-782
1,3,8,8,8,5211,6310,-1099
1,4,0,8,8,6645,6214,431
1,4,1,8,8,6528,6248,280
1,4,2,8,8,6450,6347,103
1,4,3,8,8,6443,6401,42
1,4,4,8,8,6499,6518,-19
1,4,5,8,8,6394,6618,-224
1,4,6,8,8,6367,6694,-327
1,4,7,8,8,6280,6867,-587
1,4,8,8,8,6214,7012,-798
1,5,0,8,8,7170,6908,262
1,5,1,8,8,7194,6956,238
1,5,2,8,8,7148,7158,-10
1,5,3,8,8,7217,7240,-23
1,5,4,8,8,7332,7386,-54
1,5,5,8,8,7203,7502,-299
1,5,6,8,8,7161,7599,-438
1,5,7,8,8,7011,7802,-791
1,5,8,8,8,6908,7857,-949
1,6,0,8,8,7734,7380,354
1,6,1,8,8,7906,7442,464
1,6,2,8,8,7855,7771,84
1,6,3,8,8,7973,7951,22
1,6,4,8,8,8112,8175,-63
1,6,5,8,8,7966,8307,-341
1,6,6,8,8,7811,8442,-631
1,6,7,8,8,7586,8698,-1112
1,6,8,8,8,7380,8688,-1308
1,7,0,8,8,8360,7866,494
1,7,1,8,8,8667,7925,742
1,7,2,8,8,8602,8337,265
1,7,3,8,8,8772,8618,154
1,7,4,8,8,8902,8944,-42
1,7,5,8,8,8707,9092,-385
1,7,6,8,8,8423,9272,-849
1,7,7,8,8,8158,9577,-1419
1,7,8,8,8,7866,9519,-1653
1,8,0,8,8,9081,8065,1016
1,8,1,8,8,9515,8137,1378
1,8,2,8,8,9393,8649,744
1,8,3,8,8,9567,9077,490
1,8,4,8,8,9622,9554,68
1,8,5,8,8,9266,9773,-507
1,8,6,8,8,8783,10073,-1290
1,8,7,8,8,8425,10465,-2040
1,8,8,8,8,8065,10359,-2294
1,9,0,8,8,9464,8036,1428
1,9,1,8,8,10028,8116,1912
1,9,2,8,8,9905,8695,1210
1,9,3,8,8,10112,9196,916
1,9,4,8,8,10083,9840,243
1,9,5,8,8,9552,10135,-583
1,9,6,8,8,8880,10509,-1629
1,9,7,8,8,8487,10940,-2453
1,9,8,8,8,8036,10807,-2771
1,10,0,8,8,10103,8530,1573
1,10,1,8,8,10797,8661,2136
1,10,2,8,8,10698,9305,1393
1,10,3,8,8,10992,9742,1250
1,10,4,8,8,10891,10468,423
1,10,5,8,8,10238,10842,-604
1,10,6,8,8,9485,11267,-1782
1,10,7,8,8,9058,11681,-2623
1,10,8,8,8,8530,11513,-2983
1,11,0,8,8,10361,8210,2151
1,11,1,8,8,11007,8293,2714
1,11,2,8,8,10805,9001,1804
1,11,3,8,8,11026,9456,1570
1,11,4,8,8,10782,10222,560
1,11,5,8,8,10021,10699,-678
1,11,6,8,8,9150,11263,-2113
1,11,7,8,8,8756,11680,-2924
1,11,8,8,8,8210,11574,-3364
1,12,0,8,8,10027,7769,2258
1,12,1,8,8,10593,7827,2766
1,12,2,8,8,10346,8562,1784
1,12,3,8,8,10517,8938,1579
1,12,4,8,8,10115,9603,512
1,12,5,8,8,9444,10077,-633
1,12,6,8,8,8625,10594,-1969
1,12,7,8,8,8308,10986,-2678
1,12,8,8,8,7769,11071,-3302
1,13,0,8,8,9580,7799,1781
1,13,1,8,8,10119,7732,2387
1,13,2,8,8,9964,8328,1636
1,13,3,8,8,10210,8513,1697
1,13,4,8,8,9709,9028,681
1,13,5,8,8,9199,9426,-227
1,13,6,8,8,8573,9756,-1183
1,13,7,8,8,8377,10023,-1646
1,13,8,8,8,7799,10272,-2473
1,14,0,8,8,9034,7256,1778
1,14,1,8,8,9412,7087,2325
1,14,2,8,8,9285,7595,1690
1,14,3,8,8,9472,7697,1775
1,14,4,8,8,8810,8132,678
1,14,5,8,8,8403,8476,-73
1,14,6,8,8,7938,8767,-829
1,14,7,8,8,7787,9000,-1213
1,14,8,8,8,7256,9390,-2134
1,15,0,8,8,8256,6881,1375
1,15,1,8,8,8604,6668,1936
1,15,2,8,8,8521,7117,1404
1,15,3,8,8,8690,7066,1624
1,15,4,8,8,7998,7378,620
1,15,5,8,8,7734,7610,124
1,15,6,8,8,7457,7789,-332
1,15,7,8,8,7333,7946,-613
1,15,8,8,8,6881,8295,-1414
1,16,0,8,8,7422,6652,770
1,16,1,8,8,7693,6403,1290
1,16,2,8,8,7725,6733,992
1,16,3,8,8,7884,6540,1344
1,16,4,8,8,7208,6733,475
1,16,5,8,8,7109,6843,266
1,16,6,8,8,7015,6859,156
1,16,7,8,8,7013,6898,115
1,16,8,8,8,6652,7219,-567
1,0,0,9,8,7472,6407,1065
1,0,1,9,8,7247,6438,809
1,0,2,9,8,6976,6459,517
1,0,3,9,8,6789,6573,216
1,0,4,9,8,6713,6708,5
1,0,5,9,8,6623,6820,-197
1,0,6,9,8,6520,6995,-475
1,0,7,9,8,6446,7220,-774
1,0,8,9,8,6407,7424,-1017
1,1,0,9,8,7123,5899,1224
1,1,1,9,8,6862,5931,931
1,1,2,9,8,6567,5978,589
1,1,3,9,8,6334,6113,221
1,1,4,9,8,6247,6253,-6
1,1,5,9,8,6164,6381,-217
1,1,6,9,8,6042,6588,-546
1,1,7,9,8,5951,6857,-906
1,1,8,9,8,5899,7114,-1215
1,2,0,9,8,7094,6090,1004
1,2,1,9,8,6869,6118,751
1,2,2,9,8,6663,6185,478
1,2,3,9,8,6505,6300,205
1,2,4,9,8,6464,6442,22
1,2,5,9,8,6367,6562,-195
1,2,6,9,8,6263,6712,-449
1,2,7,9,8,6170,6947,-777
1,2,8,9,8,6090,7186,-1096
1,3,0,9,8,7543,6741,802
1,3,1,9,8,7386,6793,593
1,3,2,9,8,7260,6922,338
1,3,3,9,8,7209,7027,182
1,3,4,9,8,7223,7202,21
1,3,5,9,8,7068,7347,-279
1,3,6,9,8,6989,7464,-475
1,3,7,9,8,6855,7683,-828
1,3,8,9,8,6741,7872,-1131
1,4,0,9,8,8048,7290,758
1,4,1,9,8,8012,7343,669
1,4,2,9,8,7898,7569,329
1,4,3,9,8,7901,7709,192
1,4,4,9,8,7946,7933,13
1,4,5,9,8,7735,8120,-385
1,4,6,9,8,7618,8282,-664
1,4,7,9,8,7421,8551,-1130
1,4,8,9,8,7290,8668,-1378
1,5,0,9,8,8551,7910,641
1,5,1,9,8,8678,7958,720
1,5,2,9,8,8573,8277,296
1,5,3,9,8,8638,8471,167
1,5,4,9,8,8723,8737,-14
1,5,5,9,8,8517,8920,-403
1,5,6,9,8,8318,9109,-791
1,5,7,9,8,8089,9418,-1329
1,5,8,9,8,7910,9450,-1540
1,6,0,9,8,9096,8416,680
1,6,1,9,8,9352,8483,869
1,6,2,9,8,9232,8892,340
1,6,3,9,8,9362,9175,187
1,6,4,9,8,9472,9519,-47
1,6,5,9,8,9259,9695,-436
1,6,6,9,8,8962,9913,-951
1,6,7,9,8,8698,10266,-1568
1,6,8,9,8,8416,10255,-1839
1,7,0,9,8,9759,8842,917
1,7,1,9,8,10158,8918,1240
1,7,2,9,8,10007,9418,589
1,7,3,9,8,10188,9828,360
1,7,4,9,8,10293,10283,10
1,7,5,9,8,9996,10475,-479
1,7,6,9,8,9554,10761,-1207
1,7,7,9,8,9211,11166,-1955
1,7,8,9,8,8842,11089,-2247
1,8,0,9,8,10343,9133,1210
1,8,1,9,8,10908,9220,1688
1,8,2,9,8,10779,9795,984
1,8,3,9,8,10995,10295,700
1,8,4,9,8,11025,10895,130
1,8,5,9,8,10577,11143,-566
1,8,6,9,8,9957,11499,-1542
1,8,7,9,8,9567,11910,-2343
1,8,8,9,8,9133,11770,-2637
1,9,0,9,8,10597,8847,1750
1,9,1,9,8,11249,8973,2276
1,9,2,9,8,11122,9642,1480
1,9,3,9,8,11376,10108,1268
1,9,4,9,8,11268,10845,423
1,9,5,9,8,10613,11231,-618
1,9,6,9,8,9833,11688,-1855
1,9,7,9,8,9389,12151,-2762
1,9,8,9,8,8847,12033,-3186
1,10,0,9,8,11191,9241,1950
1,10,1,9,8,11875,9327,2548
1,10,2,9,8,11757,10056,1701
1,10,3,9,8,12050,10491,1559
1,10,4,9,8,11849,11258,591
1,10,5,9,8,11065,11725,-660
1,10,6,9,8,10208,12239,-2031
1,10,7,9,8,9815,12631,-2816
1,10,8,9,8,9241,12502,-3261
1,11,0,9,8,11360,9299,2061
1,11,1,9,8,12003,9383,2620
1,11,2,9,8,11834,10176,1658
1,11,3,9,8,12109,10542,1567
1,11,4,9,8,11762,11240,522
1,11,5,9,8,11029,11736,-707
1,11,6,9,8,10235,12222,-1987
1,11,7,9,8,9879,12603,-2724
1,11,8,9,8,9299,12633,-3334
1,12,0,9,8,10983,8875,2108
1,12,1,9,8,11603,8827,2776
1,12,2,9,8,11412,9550,1862
1,12,3,9,8,11668,9821,1847
1,12,4,9,8,11156,10443,713
1,12,5,9,8,10540,10928,-388
1,12,6,9,8,9824,11344,-1520
1,12,7,9,8,9518,11707,-2189
1,12,8,9,8,8875,11928,-3053
1,13,0,9,8,10415,8258,2157
1,13,1,9,8,10896,8089,2807
1,13,2,9,8,10710,8714,1996
1,13,3,9,8,10893,8928,1965
1,13,4,9,8,10201,9483,718
1,13,5,9,8,9717,9894,-177
1,13,6,9,8,9095,10277,-1182
1,13,7,9,8,8865,10616,-1751
1,13,8,9,8,8258,10983,-2725
1,14,0,9,8,9618,7917,1701
1,14,1,9,8,10050,7709,2341
1,14,2,9,8,9898,8238,1660
1,14,3,9,8,10079,8290,1789
1,14,4,9,8,9358,8722,636
1,14,5,9,8,9027,8998,29
1,14,6,9,8,8608,9260,-652
1,14,7,9,8,8445,9514,-1069
1,14,8,9,8,7917,9862,-1945
1,15,0,9,8,8821,7628,1193
1,15,1,9,8,9184,7396,1788
1,15,2,9,8,9130,7814,1316
1,15,3,9,8,9300,7750,1550
1,15,4,9,8,8599,8072,527
1,15,5,9,8,8398,8226,172
1,15,6,9,8,8146,8348,-202
1,15,7,9,8,8066,8487,-421
1,15,8,9,8,7628,8789,-1161
1,0,0,10,8,7966,6724,1242
1,0,1,10,8,7699,6750,949
1,0,2,10,8,7400,6796,604
1,0,3,10,8,7173,6939,234
1,0,4,10,8,7090,7085,5
1,0,5,10,8,6998,7209,-211
1,0,6,10,8,6868,7416,-548
1,0,7,10,8,6777,7690,-913
1,0,8,10,8,6724,7944,-1220
1,1,0,10,8,7953,6930,1023
1,1,1,10,8,7730,6965,765
1,1,2,10,8,7519,7033,486
1,1,3,10,8,7358,7148,210
1,1,4,10,8,7314,7289,25
1,1,5,10,8,7208,7407,-199
1,1,6,10,8,7100,7564,-464
1,1,7,10,8,7010,7808,-798
1,1,8,10,8,6930,8042,-1112
1,2,0,10,8,8427,7620,807
1,2,1,10,8,8279,7674,605
1,2,2,10,8,8151,7799,352
1,2,3,10,8,8097,7904,193
1,2,4,10,8,8111,8079,32
1,2,5,10,8,7952,8221,-269
1,2,6,10,8,7873,8340,-467
1,2,7,10,8,7741,8564,-823
1,2,8,10,8,7620,8748,-1128
1,3,0,10,8,8946,7817,1129
1,3,1,10,8,8870,7888,982
1,3,2,10,8,8708,8144,564
1,3,3,10,8,8667,8335,332
1,3,4,10,8,8670,8617,53
1,3,5,10,8,8409,8849,-440
1,3,6,10,8,8240,9052,-812
1,3,7,10,8,7996,9367,-1371
1,3,8,10,8,7817,9528,-1711
1,4,0,10,8,9429,8292,1137
1,4,1,10,8,9496,8345,1151
1,4,2,10,8,9323,8688,635
1,4,3,10,8,9322,8940,382
1,4,4,10,8,9337,9284,53
1,4,5,10,8,9049,9538,-489
1,4,6,10,8,8775,9792,-1017
1,4,7,10,8,8499,10167,-1668
1,4,8,10,8,8292,10261,-1969
1,5,0,10,8,9913,8946,967
1,5,1,10,8,10124,8999,1125
1,5,2,10,8,9950,9398,552
1,5,3,10,8,10027,9695,332
1,5,4,10,8,10083,10081,2
1,5,5,10,8,9810,10308,-498
1,5,6,10,8,9469,10580,-1111
1,5,7,10,8,9201,10986,-1785
1,5,8,10,8,8946,11017,-2071
1,6,0,10,8,10495,9392,1103
1,6,1,10,8,10843,9476,1367
1,6,2,10,8,10637,9973,664
1,6,3,10,8,10778,10385,393
1,6,4,10,8,10863,10858,5
1,6,5,10,8,10548,11078,-530
1,6,6,10,8,10093,11402,-1309
1,6,7,10,8,9751,11855,-2104
1,6,8,10,8,9392,11825,-2433
1,7,0,10,8,11021,9910,1111
1,7,1,10,8,11551,10001,1550
1,7,2,10,8,11393,10564,829
1,7,3,10,8,11616,11046,570
1,7,4,10,8,11696,11624,72
1,7,5,10,8,11307,11845,-538
1,7,6,10,8,10728,12187,-1459
1,7,7,10,8,10353,12611,-2258
1,7,8,10,8,9910,12500,-2590
1,8,0,10,8,11476,9944,1532
1,8,1,10,8,12129,10077,2052
1,8,2,10,8,11996,10742,1254
1,8,3,10,8,12259,11207,1052
1,8,4,10,8,12210,11900,310
1,8,5,10,8,11638,12239,-601
1,8,6,10,8,10910,12678,-1768
1,8,7,10,8,10469,13121,-2652
1,8,8,10,8,9944,12996,-3052
1,9,0,10,8,11685,9558,2127
1,9,1,10,8,12327,9639,2688
1,9,2,10,8,12181,10393,1788
1,9,3,10,8,12434,10857,1577
1,9,4,10,8,12226,11635,591
1,9,5,10,8,11440,12114,-674
1,9,6,10,8,10556,12660,-2104
1,9,7,10,8,10146,13101,-2955
1,9,8,10,8,9558,13022,-3464
1,10,0,10,8,12190,10330,1860
1,10,1,10,8,12871,10417,2454
1,10,2,10,8,12786,11231,1555
1,10,3,10,8,13133,11577,1556
1,10,4,10,8,12829,12276,553
1,10,5,10,8,12073,12762,-689
1,10,6,10,8,11293,13198,-1905
1,10,7,10,8,10938,13554,-2616
1,10,8,10,8,10330,13561,-3231
1,11,0,10,8,12316,10405,1911
1,11,1,10,8,13013,10383,2630
1,11,2,10,8,12900,11164,1736
1,11,3,10,8,13260,11425,1835
1,11,4,10,8,12803,12080,723
1,11,5,10,8,12125,12587,-462
1,11,6,10,8,11434,12972,-1538
1,11,7,10,8,11089,13324,-2235
1,11,8,10,8,10405,13490,-3085
1,12,0,10,8,11818,9334,2484
1,12,1,10,8,12380,9184,3196
1,12,2,10,8,12158,9936,2222
1,12,3,10,8,12351,10236,2115
1,12,4,10,8,11648,10898,750
1,12,5,10,8,11058,11396,-338
1,12,6,10,8,10346,11865,-1519
1,12,7,10,8,10006,12300,-2294
1,12,8,10,8,9334,12639,-3305
1,13,0,10,8,10999,8919,2080
1,13,1,10,8,11534,8711,2823
1,13,2,10,8,11323,9357,1966
1,13,3,10,8,11500,9521,1979
1,13,4,10,8,10749,10073,676
1,13,5,10,8,10341,10416,-75
1,13,6,10,8,9765,10770,-1005
1,13,7,10,8,9523,11130,-1607
1,13,8,10,8,8919,11455,-2536
1,14,0,10,8,10183,8664,1519
1,14,1,10,8,10630,8437,2193
1,14,2,10,8,10507,8935,1572
1,14,3,10,8,10689,8974,1715
1,14,4,10,8,9959,9416,543
1,14,5,10,8,9691,9614,77
1,14,6,10,8,9297,9819,-522
1,14,7,10,8,9178,10055,-877
1,14,8,10,8,8664,10356,-1692
1,0,0,11,8,8796,7755,1041
1,0,1,11,8,8567,7784,783
1,0,2,11,8,8352,7851,501
1,0,3,11,8,8197,7974,223
1,0,4,11,8,8157,8121,36
1,0,5,11,8,8042,8235,-193
1,0,6,11,8,7926,8392,-466
1,0,7,11,8,7836,8641,-805
1,0,8,11,8,7755,8872,-1117
1,1,0,11,8,9286,8460,826
1,1,1,11,8,9140,8521,619
1,1,2,11,8,9007,8647,360
1,1,3,11,8,8950,8752,198
1,1,4,11,8,8961,8926,35
1,1,5,11,8,8793,9066,-273
1,1,6,11,8,8710,9192,-482
1,1,7,11,8,8581,9425,-844
1,1,8,11,8,8460,9604,-1144
1,2,0,11,8,9830,8696,1134
1,2,1,11,8,9763,8769,994
1,2,2,11,8,9599,9021,578
1,2,3,11,8,9555,9212,343
1,2,4,11,8,9558,9494,64
1,2,5,11,8,9293,9723,-430
1,2,6,11,8,9124,9928,-804
1,2,7,11,8,8882,10248,-1366
1,2,8,11,8,8696,10404,-1708
1,3,0,11,8,10327,8819,1508
1,3,1,11,8,10354,8890,1464
1,3,2,11,8,10133,9263,870
1,3,3,11,8,10088,9566,522
1,3,4,11,8,10061,9968,93
1,3,5,11,8,9723,10267,-544
1,3,6,11,8,9397,10562,-1165
1,3,7,11,8,9074,10983,-1909
1,3,8,11,8,8819,11121,-2302
1,4,0,11,8,10791,9328,1463
1,4,1,11,8,10942,9386,1556
1,4,2,11,8,10700,9809,891
1,4,3,11,8,10711,10164,547
1,4,4,11,8,10697,10628,69
1,4,5,11,8,10342,10926,-584
1,4,6,11,8,9926,11263,-1337
1,4,7,11,8,9611,11735,-2124
1,4,8,11,8,9328,11828,-2500
1,5,0,11,8,11312,9922,1390
1,5,1,11,8,11615,9992,1623
1,5,2,11,8,11355,10479,876
1,5,3,11,8,11443,10905,538
1,5,4,11,8,11474,11420,54
1,5,5,11,8,11099,11691,-592
1,5,6,11,8,10600,12069,-1469
1,5,7,11,8,10254,12575,-2321
1,5,8,11,8,9922,12587,-2665
1,6,0,11,8,11757,10460,1297
1,6,1,11,8,12236,10559,1677
1,6,2,11,8,12023,11119,904
1,6,3,11,8,12206,11603,603
1,6,4,11,8,12266,12199,67
1,6,5,11,8,11859,12448,-589
1,6,6,11,8,11267,12828,-1561
1,6,7,11,8,10893,13300,-2407
1,6,8,11,8,10460,13236,-2776
1,7,0,11,8,12154,10721,1433
1,7,1,11,8,12772,10858,1914
1,7,2,11,8,12610,11511,1099
1,7,3,11,8,12880,11958,922
1,7,4,11,8,12881,12629,252
1,7,5,11,8,12368,12941,-573
1,7,6,11,8,11681,13366,-1685
1,7,7,11,8,11255,13822,-2567
1,7,8,11,8,10721,13726,-3005
1,8,0,11,8,12564,10655,1909
1,8,1,11,8,13207,10743,2464
1,8,2,11,8,13055,11493,1562
1,8,3,11,8,13317,11956,1361
1,8,4,11,8,13168,12690,478
1,8,5,11,8,12465,13122,-657
1,8,6,11,8,11633,13650,-2017
1,8,7,11,8,11226,14071,-2845
1,8,8,11,8,10655,13985,-3330
1,9,0,11,8,12684,10647,2037
1,9,1,11,8,13323,10729,2594
1,9,2,11,8,13210,11568,1642
1,9,3,11,8,13517,11943,1574
1,9,4,11,8,13206,12653,553
1,9,5,11,8,12448,13151,-703
1,9,6,11,8,11641,13619,-1978
1,9,7,11,8,11269,14024,-2755
1,9,8,11,8,10647,14081,-3434
1,10,0,11,8,13146,11436,1710
1,10,1,11,8,13881,11417,2464
1,10,2,11,8,13852,12219,1633
1,10,3,11,8,14284,12460,1824
1,10,4,11,8,13870,13116,754
1,10,5,11,8,13169,13613,-444
1,10,6,11,8,12492,13948,-1456
1,10,7,11,8,12148,14275,-2127
1,10,8,11,8,11436,14418,-2982
1,11,0,11,8,13151,10864,2287
1,11,1,11,8,13790,10740,3050
1,11,2,11,8,13646,11550,2096
1,11,3,11,8,13943,11840,2103
1,11,4,11,8,13295,12535,760
1,11,5,11,8,12643,13055,-412
1,11,6,11,8,11956,13493,-1537
1,11,7,11,8,11577,13917,-2340
1,11,8,11,8,10864,14201,-3337
1,12,0,11,8,12402,9995,2407
1,12,1,11,8,13018,9806,3212
1,12,2,11,8,12771,10579,2192
1,12,3,11,8,12958,10829,2129
1,12,4,11,8,12196,11488,708
1,12,5,11,8,11682,11918,-236
1,12,6,11,8,11016,12358,-1342
1,12,7,11,8,10664,12814,-2150
1,12,8,11,8,9995,13111,-3116
1,13,0,11,8,11564,9666,1898
1,13,1,11,8,12114,9439,2675
1,13,2,11,8,11932,10054,1878
1,13,3,11,8,12110,10205,1905
1,13,4,11,8,11350,10767,583
1,13,5,11,8,11005,11032,-27
1,13,6,11,8,10454,11329,-875
1,13,7,11,8,10256,11671,-1415
1,13,8,11,8,9666,11949,-2283
1,0,0,12,8,10129,9285,844
1,0,1,12,8,9977,9340,637
1,0,2,12,8,9840,9465,375
1,0,3,12,8,9789,9578,211
1,0,4,12,8,9804,9758,46
1,0,5,12,8,9627,9894,-267
1,0,6,12,8,9536,10020,-484
1,0,7,12,8,9407,10258,-851
1,0,8,12,8,9285,10434,-1149
1,1,0,12,8,10689,9536,1153
1,1,1,12,8,10624,9616,1008
1,1,2,12,8,10455,9869,586
1,1,3,12,8,10408,10060,348
1,1,4,12,8,10408,10341,67
1,1,5,12,8,10134,10568,-434
1,1,6,12,8,9961,10780,-819
1,1,7,12,8,9722,11109,-1387
1,1,8,12,8,9536,11260,-1724
1,2,0,12,8,11211,9698,1513
1,2,1,12,8,11247,9771,1476
1,2,2,12,8,11024,10140,884
1,2,3,12,8,10976,10443,533
1,2,4,12,8,10949,10845,104
1,2,5,12,8,10607,11141,-534
1,2,6,12,8,10281,11438,-1157
1,2,7,12,8,9960,11864,-1904
1,2,8,12,8,9698,11997,-2299
1,3,0,12,8,11689,9855,1834
1,3,1,12,8,11800,9931,1869
1,3,2,12,8,11510,10384,1126
1,3,3,12,8,11477,10790,687
1,3,4,12,8,11421,11312,109
1,3,5,12,8,11016,11655,-639
1,3,6,12,8,10548,12033,-1485
1,3,7,12,8,10186,12551,-2365
1,3,8,12,8,9855,12688,-2833
1,4,0,12,8,12190,10304,1886
1,4,1,12,8,12433,10379,2054
1,4,2,12,8,12105,10890,1215
1,4,3,12,8,12127,11374,753
1,4,4,12,8,12088,11967,121
1,4,5,12,8,11631,12309,-678
1,4,6,12,8,11057,12752,-1695
1,4,7,12,8,10664,13324,-2660
1,4,8,12,8,10304,13398,-3094
1,5,0,12,8,12574,10990,1584
1,5,1,12,8,13008,11075,1933
1,5,2,12,8,12741,11625,1116
1,5,3,12,8,12871,12123,748
1,5,4,12,8,12877,12761,116
1,5,5,12,8,12410,13061,-651
1,5,6,12,8,11774,13495,-1721
1,5,7,12,8,11396,14020,-2624
1,5,8,12,8,10990,13998,-3008
1,6,0,12,8,12890,11271,1619
1,6,1,12,8,13457,11416,2041
1,6,2,12,8,13240,12066,1174
1,6,3,12,8,13470,12515,955
1,6,4,12,8,13451,13204,247
1,6,5,12,8,12920,13544,-624
1,6,6,12,8,12220,14007,-1787
1,6,7,12,8,11795,14511,-2716
1,6,8,12,8,11271,14462,-3191
1,7,0,12,8,13242,11432,1810
1,7,1,12,8,13850,11524,2326
1,7,2,12,8,13669,12262,1407
1,7,3,12,8,13938,12707,1231
1,7,4,12,8,13839,13419,420
1,7,5,12,8,13195,13824,-629
1,7,6,12,8,12404,14338,-1934
1,7,7,12,8,12012,14772,-2760
1,7,8,12,8,11432,14715,-3283
1,8,0,12,8,13563,11744,1819
1,8,1,12,8,14203,11833,2370
1,8,2,12,8,14084,12668,1416
1,8,3,12,8,14400,13042,1358
1,8,4,12,8,14148,13708,440
1,8,5,12,8,13473,14159,-686
1,8,6,12,8,12718,14609,-1891
1,8,7,12,8,12349,14994,-2645
1,8,8,12,8,11744,15044,-3300
1,9,0,12,8,13640,11753,1887
1,9,1,12,8,14333,11729,2604
1,9,2,12,8,14276,12556,1720
1,9,3,12,8,14668,12826,1842
1,9,4,12,8,14247,13493,754
1,9,5,12,8,13544,14002,-458
1,9,6,12,8,12840,14369,-1529
1,9,7,12,8,12479,14745,-2266
1,9,8,12,8,11753,14938,-3185
1,10,0,12,8,13981,11895,2086
1,10,1,12,8,14658,11774,2884
1,10,2,12,8,14598,12605,1993
1,10,3,12,8,14967,12875,2092
1,10,4,12,8,14362,13571,791
1,10,5,12,8,13687,14081,-394
1,10,6,12,8,13014,14469,-1455
1,10,7,12,8,12636,14868,-2232
1,10,8,12,8,11895,15129,-3234
1,11,0,12,8,13735,11525,2210
1,11,1,12,8,14428,11362,3066
1,11,2,12,8,14259,12193,2066
1,11,3,12,8,14550,12433,2117
1,11,4,12,8,13843,13125,718
1,11,5,12,8,13267,13577,-310
1,11,6,12,8,12626,13986,-1360
1,11,7,12,8,12235,14431,-2196
1,11,8,12,8,11525,14673,-3148
1,12,0,12,8,12967,10742,2225
1,12,1,12,8,13598,10534,3064
1,12,2,12,8,13380,11276,2104
1,12,3,12,8,13568,11513,2055
1,12,4,12,8,12797,12182,615
1,12,5,12,8,12346,12534,-188
1,12,6,12,8,11705,12917,-1212
1,12,7,12,8,11397,13355,-1958
1,12,8,12,8,10742,13605,-2863
1,0,0,13,8,11532,10361,1171
1,0,1,13,8,11461,10435,1026
1,0,2,13,8,11288,10687,601
1,0,3,13,8,11247,10886,361
1,0,4,13,8,11251,11173,78
1,0,5,13,8,10968,11396,-428
1,0,6,13,8,10787,11608,-821
1,0,7,13,8,10548,11942,-1394
1,0,8,13,8,10361,12090,-1729
1,1,0,13,8,12070,10538,1532
1,1,1,13,8,12108,10618,1490
1,1,2,13,8,11880,10988,892
1,1,3,13,8,11829,11291,538
1,1,4,13,8,11799,11692,107
1,1,5,13,8,11448,11986,-538
1,1,6,13,8,11118,12290,-1172
1,1,7,13,8,10800,12725,-1925
1,1,8,13,8,10538,12853,-2315
1,2,0,13,8,12573,10734,1839
1,2,1,13,8,12693,10812,1881
1,2,2,13,8,12401,11261,1140
1,2,3,13,8,12365,11667,698
1,2,4,13,8,12309,12189,120
1,2,5,13,8,11900,12529,-629
1,2,6,13,8,11432,12909,-1477
1,2,7,13,8,11072,13432,-2360
1,2,8,13,8,10734,13564,-2830
1,3,0,13,8,13088,10831,2257
1,3,1,13,8,13291,10924,2367
1,3,2,13,8,12915,11465,1450
1,3,3,13,8,12893,12000,893
1,3,4,13,8,12812,12651,161
1,3,5,13,8,12305,13038,-733
1,3,6,13,8,11679,13522,-1843
1,3,7,13,8,11239,14140,-2901
1,3,8,13,8,10831,14258,-3427
1,4,0,13,8,13452,11372,2080
1,4,1,13,8,13826,11462,2364
1,4,2,13,8,13491,12036,1455
1,4,3,13,8,13555,12592,963
1,4,4,13,8,13491,13308,183
1,4,5,13,8,12942,13679,-737
1,4,6,13,8,12231,14178,-1947
1,4,7,13,8,11806,14769,-2963
1,4,8,13,8,11372,14809,-3437
1,5,0,13,8,13707,11801,1906
1,5,1,13,8,14229,11932,2297
1,5,2,13,8,13958,12572,1386
1,5,3,13,8,14135,13035,1100
1,5,4,13,8,14062,13766,296
1,5,5,13,8,13471,14157,-686
1,5,6,13,8,12727,14674,-1947
1,5,7,13,8,12298,15231,-2933
1,5,8,13,8,11801,15224,-3423
1,6,0,13,8,13978,11982,1996
1,6,1,13,8,14535,12082,2453
1,6,2,13,8,14299,12817,1482
1,6,3,13,8,14528,13264,1264
1,6,4,13,8,14409,13994,415
1,6,5,13,8,13747,14427,-680
1,6,6,13,8,12943,14979,-2036
1,6,7,13,8,12552,15461,-2909
1,6,8,13,8,11982,15451,-3469
1,7,0,13,8,14241,12521,1720
1,7,1,13,8,14846,12614,2232
1,7,2,13,8,14698,13437,1261
1,7,3,13,8,15021,13793,1228
1,7,4,13,8,14819,14437,382
1,7,5,13,8,14203,14861,-658
1,7,6,13,8,13489,15297,-1808
1,7,7,13,8,13135,15695,-2560
1,7,8,13,8,12521,15774,-3253
1,8,0,13,8,14519,12850,1669
1,8,1,13,8,15213,12833,2380
1,8,2,13,8,15150,13656,1494
1,8,3,13,8,15551,13925,1626
1,8,4,13,8,15189,14548,641
1,8,5,13,8,14569,15010,-441
1,8,6,13,8,13917,15359,-1442
1,8,7,13,8,13559,15715,-2156
1,8,8,13,8,12850,15901,-3051
1,9,0,13,8,14475,12212,2263
1,9,1,13,8,15110,12086,3024
1,9,2,13,8,15022,12942,2080
1,9,3,13,8,15351,13241,2110
1,9,4,13,8,14739,13948,791
1,9,5,13,8,14062,14470,-408
1,9,6,13,8,13362,14890,-1528
1,9,7,13,8,12967,15338,-2371
1,9,8,13,8,12212,15649,-3437
1,10,0,13,8,14565,12556,2009
1,10,1,13,8,15296,12396,2900
1,10,2,13,8,15211,13248,1963
1,10,3,13,8,15574,13468,2106
1,10,4,13,8,14910,14161,749
1,10,5,13,8,14311,14603,-292
1,10,6,13,8,13684,14962,-1278
1,10,7,13,8,13294,15382,-2088
1,10,8,13,8,12556,15601,-3045
1,11,0,13,8,14300,12272,2028
1,11,1,13,8,15008,12090,2918
1,11,2,13,8,14868,12890,1978
1,11,3,13,8,15160,13117,2043
1,11,4,13,8,14444,13819,625
1,11,5,13,8,13931,14193,-262
1,11,6,13,8,13315,14545,-1230
1,11,7,13,8,12968,14972,-2004
1,11,8,13,8,12272,15167,-2895
1,0,0,14,8,12913,11363,1550
1,0,1,14,8,12945,11437,1508
1,0,2,14,8,12713,11806,907
1,0,3,14,8,12668,12117,551
1,0,4,14,8,12642,12524,118
1,0,5,14,8,12282,12814,-532
1,0,6,14,8,11944,13118,-1174
1,0,7,14,8,11626,13558,-1932
1,0,8,14,8,11363,13683,-2320
1,1,0,14,8,13432,11574,1858
1,1,1,14,8,13554,11659,1895
1,1,2,14,8,13257,12109,1148
1,1,3,14,8,13218,12515,703
1,1,4,14,8,13159,13036,123
1,1,5,14,8,12741,13374,-633
1,1,6,14,8,12269,13761,-1492
1,1,7,14,8,11912,14293,-2381
1,1,8,14,8,11574,14420,-2846
1,2,0,14,8,13972,11710,2262
1,2,1,14,8,14184,11805,2379
1,2,2,14,8,13806,12342,1464
1,2,3,14,8,13781,12877,904
1,2,4,14,8,13700,13528,172
1,2,5,14,8,13189,13912,-723
1,2,6,14,8,12563,14398,-1835
1,2,7,14,8,12125,15021,-2896
1,2,8,14,8,11710,15134,-3424
1,3,0,14,8,14350,11899,2451
1,3,1,14,8,14684,12007,2677
1,3,2,14,8,14301,12611,1690
1,3,3,14,8,14321,13218,1103
1,3,4,14,8,14215,13992,223
1,3,5,14,8,13616,14408,-792
1,3,6,14,8,12853,14948,-2095
1,3,7,14,8,12381,15585,-3204
1,3,8,14,8,11899,15669,-3770
1,4,0,14,8,14585,12183,2402
1,4,1,14,8,15047,12319,2728
1,4,2,14,8,14708,12983,1725
1,4,3,14,8,14819,13504,1315
1,4,4,14,8,14676,14313,363
1,4,5,14,8,14003,14775,-772
1,4,6,14,8,13184,15357,-2173
1,4,7,14,8,12708,15980,-3272
1,4,8,14,8,12183,16035,-3852
1,5,0,14,8,14795,12512,2283
1,5,1,14,8,15307,12598,2709
1,5,2,14,8,15017,13323,1694
1,5,3,14,8,15193,13784,1409
1,5,4,14,8,15020,14556,464
1,5,5,14,8,14298,15040,-742
1,5,6,14,8,13450,15646,-2196
1,5,7,14,8,13055,16181,-3126
1,5,8,14,8,12512,16213,-3701
1,6,0,14,8,14977,13071,1906
1,6,1,14,8,15531,13172,2359
1,6,2,14,8,15328,13992,1336
1,6,3,14,8,15611,14350,1261
1,6,4,14,8,15389,15012,377
1,6,5,14,8,14755,15464,-709
1,6,6,14,8,14028,15938,-1910
1,6,7,14,8,13675,16384,-2709
1,6,8,14,8,13071,16510,-3439
1,7,0,14,8,15197,13627,1570
1,7,1,14,8,15856,13614,2242
1,7,2,14,8,15764,14425,1339
1,7,3,14,8,16172,14676,1496
1,7,4,14,8,15860,15277,583
1,7,5,14,8,15299,15712,-413
1,7,6,14,8,14688,16047,-1359
1,7,7,14,8,14345,16416,-2071
1,7,8,14,8,13627,16631,-3004
1,8,0,14,8,15354,13309,2045
1,8,1,14,8,15990,13190,2800
1,8,2,14,8,15896,14042,1854
1,8,3,14,8,16234,14340,1894
1,8,4,14,8,15681,15003,678
1,8,5,14,8,15087,15478,-391
1,8,6,14,8,14439,15880,-1441
1,8,7,14,8,14047,16308,-2261
1,8,8,14,8,13309,16612,-3303
1,9,0,14,8,15059,12873,2186
1,9,1,14,8,15748,12708,3040
1,9,2,14,8,15635,13585,2050
1,9,3,14,8,15958,13834,2124
1,9,4,14,8,15287,14538,749
1,9,5,14,8,14686,14992,-306
1,9,6,14,8,14032,15383,-1351
1,9,7,14,8,13625,15852,-2227
1,9,8,14,8,12873,16121,-3248
1,10,0,14,8,15130,13303,1827
1,10,1,14,8,15876,13124,2752
1,10,2,14,8,15820,13945,1875
1,10,3,14,8,16184,14152,2032
1,10,4,14,8,15511,14855,656
1,10,5,14,8,14975,15219,-244
1,10,6,14,8,14373,15521,-1148
1,10,7,14,8,14027,15923,-1896
1,10,8,14,8,13303,16095,-2792
1,0,0,15,8,14275,12399,1876
1,0,1,15,8,14391,12478,1913
1,0,2,15,8,14090,12927,1163
1,0,3,15,8,14057,13341,716
1,0,4,15,8,14002,13868,134
1,0,5,15,8,13575,14202,-627
1,0,6,15,8,13095,14589,-1494
1,0,7,15,8,12738,15126,-2388
1,0,8,15,8,12399,15250,-2851
1,1,0,15,8,14831,12550,2281
1,1,1,15,8,15045,12652,2393
1,1,2,15,8,14662,13190,1472
1,1,3,15,8,14634,13725,909
1,1,4,15,8,14550,14375,175
1,1,5,15,8,14030,14757,-727
1,1,6,15,8,13400,15250,-1850
1,1,7,15,8,12965,15882,-2917
1,1,8,15,8,12550,15990,-3440
1,2,0,15,8,15234,12778,2456
1,2,1,15,8,15577,12888,2689
1,2,2,15,8,15192,13488,1704
1,2,3,15,8,15209,14095,1114
1,2,4,15,8,15103,14869,234
1,2,5,15,8,14500,15282,-782
1,2,6,15,8,13737,15824,-2087
1,2,7,15,8,13267,16466,-3199
1,2,8,15,8,12778,16545,-3767
1,3,0,15,8,15483,12710,2773
1,3,1,15,8,15905,12864,3041
1,3,2,15,8,15518,13558,1960
1,3,3,15,8,15585,14130,1455
1,3,4,15,8,15400,14997,403
1,3,5,15,8,14677,15504,-827
1,3,6,15,8,13806,16127,-2321
1,3,7,15,8,13283,16796,-3513
1,3,8,15,8,12710,16895,-4185
1,4,0,15,8,15673,12894,2779
1,4,1,15,8,16125,12985,3140
1,4,2,15,8,15767,13734,2033
1,4,3,15,8,15877,14253,1624
1,4,4,15,8,15634,15103,531
1,4,5,15,8,14830,15658,-828
1,4,6,15,8,13907,16329,-2422
1,4,7,15,8,13465,16930,-3465
1,4,8,15,8,12894,17024,-4130
1,5,0,15,8,15794,13601,2193
1,5,1,15,8,16303,13688,2615
1,5,2,15,8,16046,14498,1548
1,5,3,15,8,16276,14870,1406
1,5,4,15,8,16000,15574,426
1,5,5,15,8,15306,16077,-771
1,5,6,15,8,14535,16605,-2070
1,5,7,15,8,14178,17104,-2926
1,5,8,15,8,13601,17272,-3671
1,6,0,15,8,15933,14177,1756
1,6,1,15,8,16541,14172,2369
1,6,2,15,8,16394,14980,1414
1,6,3,15,8,16762,15233,1529
1,6,4,15,8,16430,15852,578
1,6,5,15,8,15851,16315,-464
1,6,6,15,8,15227,16688,-1461
1,6,7,15,8,14885,17105,-2220
1,6,8,15,8,14177,17367,-3190
1,7,0,15,8,16032,14086,1946
1,7,1,15,8,16633,13971,2662
1,7,2,15,8,16510,14811,1699
1,7,3,15,8,16855,15091,1764
1,7,4,15,8,16352,15732,620
1,7,5,15,8,15817,16180,-363
1,7,6,15,8,15210,16568,-1358
1,7,7,15,8,14833,17009,-2176
1,7,8,15,8,14086,17342,-3256
1,8,0,15,8,15938,13970,1968
1,8,1,15,8,16628,13812,2816
1,8,2,15,8,16509,14685,1824
1,8,3,15,8,16841,14933,1908
1,8,4,15,8,16229,15593,636
1,8,5,15,8,15711,16000,-289
1,8,6,15,8,15109,16373,-1264
1,8,7,15,8,14705,16822,-2117
1,8,8,15,8,13970,17084,-3114
1,9,0,15,8,15624,13620,2004
1,9,1,15,8,16328,13436,2892
1,9,2,15,8,16244,14282,1962
1,9,3,15,8,16568,14518,2050
1,9,4,15,8,15888,15232,656
1,9,5,15,8,15350,15608,-258
1,9,6,15,8,14721,15942,-1221
1,9,7,15,8,14358,16393,-2035
1,9,8,15,8,13620,16615,-2995
1,0,0,16,8,15674,13375,2299
1,0,1,16,8,15882,13471,2411
1,0,2,16,8,15495,14008,1487
1,0,3,16,8,15473,14551,922
1,0,4,16,8,15393,15207,186
1,0,5,16,8,14864,15585,-721
1,0,6,16,8,14226,16078,-1852
1,0,7,16,8,13791,16715,-2924
1,0,8,16,8,13375,16820,-3445
1,1,0,16,8,16093,13618,2475
1,1,1,16,8,16438,13735,2703
1,1,2,16,8,16048,14336,1712
1,1,3,16,8,16062,14943,1119
1,1,4,16,8,15953,15716,237
1,1,5,16,8,15341,16127,-786
1,1,6,16,8,14574,16676,-2102
1,1,7,16,8,14107,17327,-3220
1,1,8,16,8,13618,17401,-3783
1,2,0,16,8,16367,13589,2778
1,2,1,16,8,16798,13745,3053
1,2,2,16,8,16409,14435,1974
1,2,3,16,8,16473,15007,1466
1,2,4,16,8,16288,15874,414
1,2,5,16,8,15561,16378,-817
1,2,6,16,8,14690,17003,-2313
1,2,7,16,8,14169,17677,-3508
1,2,8,16,8,13589,17771,-4182
1,3,0,16,8,16571,13421,3150
1,3,1,16,8,16983,13530,3453
1,3,2,16,8,16577,14309,2268
1,3,3,16,8,16643,14879,1764
1,3,4,16,8,16358,15787,571
1,3,5,16,8,15504,16387,-883
1,3,6,16,8,14529,17099,-2570
1,3,7,16,8,14040,17746,-3706
1,3,8,16,8,13421,17884,-4463
1,4,0,16,8,16672,13983,2689
1,4,1,16,8,17121,14075,3046
1,4,2,16,8,16796,14909,1887
1,4,3,16,8,16960,15339,1621
1,4,4,16,8,16614,16121,493
1,4,5,16,8,15838,16695,-857
1,4,6,16,8,14992,17288,-2296
1,4,7,16,8,14588,17853,-3265
1,4,8,16,8,13983,18083,-4100
1,5,0,16,8,16750,14707,2043
1,5,1,16,8,17313,14688,2625
1,5,2,16,8,17112,15486,1626
1,5,3,16,8,17427,15753,1674
1,5,4,16,8,17041,16414,627
1,5,5,16,8,16402,16928,-526
1,5,6,16,8,15734,17355,-1621
1,5,7,16,8,15388,17825,-2437
1,5,8,16,8,14707,18129,-3422
1,6,0,16,8,16768,14636,2132
1,6,1,16,8,17318,14529,2789
1,6,2,16,8,17140,15366,1774
1,6,3,16,8,17445,15648,1797
1,6,4,16,8,16922,16307,615
1,6,5,16,8,16369,16783,-414
1,6,6,16,8,15749,17209,-1460
1,6,7,16,8,15373,17698,-2325
1,6,8,16,8,14636,18078,-3442
1,7,0,16,8,16616,14747,1869
1,7,1,16,8,17271,14593,2678
1,7,2,16,8,17123,15454,1669
1,7,3,16,8,17462,15684,1778
1,7,4,16,8,16900,16322,578
1,7,5,16,8,16441,16702,-261
1,7,6,16,8,15880,17061,-1181
1,7,7,16,8,15491,17523,-2032
1,7,8,16,8,14747,17814,-3067
1,8,0,16,8,16503,14717,1786
1,8,1,16,8,17208,14540,2668
1,8,2,16,8,17118,15382,1736
1,8,3,16,8,17451,15617,1834
1,8,4,16,8,16830,16287,543
1,8,5,16,8,16375,16616,-241
1,8,6,16,8,15798,16932,-1134
1,8,7,16,8,15438,17363,-1925
1,8,8,16,8,14717,17578,-2861
1,0,0,17,8,16936,14443,2493
1,0,1,17,8,17275,14554,2721
1,0,2,17,8,16881,15154,1727
1,0,3,17,8,16901,15769,1132
1,0,4,17,8,16796,16548,248
1,0,5,17,8,16175,16955,-780
1,0,6,17,8,15400,17504,-2104
1,0,7,17,8,14933,18160,-3227
1,0,8,17,8,14443,18231,-3788
1,1,0,17,8,17226,14429,2797
1,1,1,17,8,17659,14592,3067
1,1,2,17,8,17265,15283,1982
1,1,3,17,8,17326,15855,1471
1,1,4,17,8,17138,16721,417
1,1,5,17,8,16402,17223,-821
1,1,6,17,8,15527,17855,-2328
1,1,7,17,8,15009,18538,-3529
1,1,8,17,8,14429,18627,-4198
1,2,0,17,8,17455,14300,3155
1,2,1,17,8,17876,14411,3465
1,2,2,17,8,17468,15186,2282
1,2,3,17,8,17531,15756,1775
1,2,4,17,8,17246,16664,582
1,2,5,17,8,16388,17261,-873
1,2,6,17,8,15413,17975,-2562
1,2,7,17,8,14926,18627,-3701
1,2,8,17,8,14300,18760,-4460
1,3,0,17,8,17570,14510,3060
1,3,1,17,8,17979,14620,3359
1,3,2,17,8,17606,15484,2122
1,3,3,17,8,17726,15965,1761
1,3,4,17,8,17338,16805,533
1,3,5,17,8,16512,17424,-912
1,3,6,17,8,15614,18058,-2444
1,3,7,17,8,15163,18669,-3506
1,3,8,17,8,14510,18943,-4433
1,4,0,17,8,17628,15089,2539
1,4,1,17,8,18131,15075,3056
1,4,2,17,8,17862,15897,1965
1,4,3,17,8,18111,16222,1889
1,4,4,17,8,17655,16961,694
1,4,5,17,8,16934,17546,-612
1,4,6,17,8,16191,18038,-1847
1,4,7,17,8,15798,18574,-2776
1,4,8,17,8,15089,18940,-3851
1,5,0,17,8,17585,15166,2419
1,5,1,17,8,18090,15045,3045
1,5,2,17,8,17858,15872,1986
1,5,3,17,8,18110,16168,1942
1,5,4,17,8,17533,16869,664
1,5,5,17,8,16920,17396,-476
1,5,6,17,8,16256,17876,-1620
1,5,7,17,8,15876,18418,-2542
1,5,8,17,8,15166,18840,-3674
1,6,0,17,8,17352,15297,2055
1,6,1,17,8,17956,15151,2805
1,6,2,17,8,17753,16009,1744
1,6,3,17,8,18052,16241,1811
1,6,4,17,8,17470,16897,573
1,6,5,17,8,16993,17305,-312
1,6,6,17,8,16419,17702,-1283
1,6,7,17,8,16031,18212,-2181
1,6,8,17,8,15297,18550,-3253
1,7,0,17,8,17181,15494,1687
1,7,1,17,8,17851,15321,2530
1,7,2,17,8,17732,16151,1581
1,7,3,17,8,18072,16368,1704
1,7,4,17,8,17501,17016,485
1,7,5,17,8,17105,17318,-213
1,7,6,17,8,16569,17620,-1051
1,7,7,17,8,16224,18064,-1840
1,7,8,17,8,15494,18308,-2814
1,0,0,18,8,18069,15254,2815
1,0,1,18,8,18496,15411,3085
1,0,2,18,8,18098,16101,1997
1,0,3,18,8,18165,16681,1484
1,0,4,18,8,17981,17553,428
1,0,5,18,8,17236,18051,-815
1,0,6,18,8,16353,18683,-2330
1,0,7,18,8,15835,19371,-3536
1,0,8,18,8,15254,19457,-4203
1,1,0,18,8,18314,15140,3174
1,1,1,18,8,18737,15258,3479
1,1,2,18,8,18324,16034,2290
1,1,3,18,8,18384,16604,1780
1,1,4,18,8,18096,17511,585
1,1,5,18,8,17229,18106,-877
1,1,6,18,8,16250,18827,-2577
1,1,7,18,8,15766,19488,-3722
1,1,8,18,8,15140,19616,-4476
1,2,0,18,8,18454,15389,3065
1,2,1,18,8,18872,15501,3371
1,2,2,18,8,18497,16361,2136
1,2,3,18,8,18614,16842,1772
1,2,4,18,8,18226,17682,544
1,2,5,18,8,17396,18298,-902
1,2,6,18,8,16498,18934,-2436
1,2,7,18,8,16049,19550,-3501
1,2,8,18,8,15389,19819,-4430
1,3,0,18,8,18526,15616,2910
1,3,1,18,8,18989,15620,3369
1,3,2,18,8,18672,16472,2200
1,3,3,18,8,18877,16848,2029
1,3,4,18,8,18379,17645,734
1,3,5,18,8,17608,18275,-667
1,3,6,18,8,16813,18808,-1995
1,3,7,18,8,16373,19390,-3017
1,3,8,18,8,15616,19800,-4184
1,4,0,18,8,18463,15548,2915
1,4,1,18,8,18908,15432,3476
1,4,2,18,8,18608,16283,2325
1,4,3,18,8,18794,16637,2157
1,4,4,18,8,18147,17416,731
1,4,5,18,8,17452,18014,-562
1,4,6,18,8,16713,18559,-1846
1,4,7,18,8,16286,19167,-2881
1,4,8,18,8,15548,19651,-4103
1,5,0,18,8,18169,15827,2342
1,5,1,18,8,18728,15667,3061
1,5,2,18,8,18471,16515,1956
1,5,3,18,8,18717,16761,1956
1,5,4,18,8,18081,17459,622
1,5,5,18,8,17544,17918,-374
1,5,6,18,8,16926,18369,-1443
1,5,7,18,8,16534,18932,-2398
1,5,8,18,8,15827,19312,-3485
1,6,0,18,8,17917,16044,1873
1,6,1,18,8,18536,15879,2657
1,6,2,18,8,18362,16706,1656
1,6,3,18,8,18662,16925,1737
1,6,4,18,8,18071,17591,480
1,6,5,18,8,17657,17921,-264
1,6,6,18,8,17108,18261,-1153
1,6,7,18,8,16764,18753,-1989
1,6,8,18,8,16044,19044,-3000
1,0,0,19,8,19157,15965,3192
1,0,1,19,8,19574,16077,3497
1,0,2,19,8,19157,16852,2305
1,0,3,19,8,19223,17430,1793
1,0,4,19,8,18939,18343,596
1,0,5,19,8,18063,18934,-871
1,0,6,19,8,17076,19655,-2579
1,0,7,19,8,16592,20321,-3729
1,0,8,19,8,15965,20446,-4481
1,1,0,19,8,19313,16229,3084
1,1,1,19,8,19733,16348,3385
1,1,2,19,8,19353,17209,2144
1,1,3,19,8,19467,17690,1777
1,1,4,19,8,19076,18529,547
1,1,5,19,8,18237,19143,-906
1,1,6,19,8,17335,19786,-2451
1,1,7,19,8,16889,20411,-3522
1,1,8,19,8,16229,20675,-4446
1,2,0,19,8,19410,16495,2915
1,2,1,19,8,19882,16501,3381
1,2,2,19,8,19563,17349,2214
1,2,3,19,8,19765,17725,2040
1,2,4,19,8,19267,18522,745
1,2,5,19,8,18492,19149,-657
1,2,6,19,8,17697,19684,-1987
1,2,7,19,8,17259,20271,-3012
1,2,8,19,8,16495,20676,-4181
1,3,0,19,8,19361,16075,3286
1,3,1,19,8,19766,15977,3789
1,3,2,19,8,19418,16858,2560
1,3,3,19,8,19560,17263,2297
1,3,4,19,8,18871,18100,771
1,3,5,19,8,18126,18743,-617
1,3,6,19,8,17335,19329,-1994
1,3,7,19,8,16861,19983,-3122
1,3,8,19,8,16075,20511,-4436
1,4,0,19,8,19047,16209,2838
1,4,1,19,8,19546,16054,3492
1,4,2,19,8,19221,16926,2295
1,4,3,19,8,19401,17230,2171
1,4,4,19,8,18695,18006,689
1,4,5,19,8,18076,18536,-460
1,4,6,19,8,17383,19052,-1669
1,4,7,19,8,16944,19681,-2737
1,4,8,19,8,16209,20123,-3914
1,5,0,19,8,18734,16574,2160
1,5,1,19,8,19308,16395,2913
1,5,2,19,8,19080,17212,1868
1,5,3,19,8,19327,17445,1882
1,5,4,19,8,18682,18153,529
1,5,5,19,8,18208,18534,-326
1,5,6,19,8,17615,18928,-1313
1,5,7,19,8,17267,19473,-2206
1,5,8,19,8,16574,19806,-3232
1,0,0,20,8,20156,17054,3102
1,0,1,20,8,20570,17167,3403
1,0,2,20,8,20186,18027,2159
1,0,3,20,8,20306,18516,1790
1,0,4,20,8,19919,19361,558
1,0,5,20,8,19071,19971,-900
1,0,6,20,8,18161,20614,-2453
1,0,7,20,8,17715,21244,-3529
1,0,8,20,8,17054,21505,-4451
1,1,0,20,8,20269,17335,2934
1,1,1,20,8,20743,17348,3395
1,1,2,20,8,20419,18197,2222
1,1,3,20,8,20618,18573,2045
1,1,4,20,8,20117,19369,748
1,1,5,20,8,19333,19994,-661
1,1,6,20,8,18534,20536,-2002
1,1,7,20,8,18099,21132,-3033
1,1,8,20,8,17335,21532,-4197
1,2,0,20,8,20245,16954,3291
1,2,1,20,8,20659,16858,3801
1,2,2,20,8,20309,17735,2574
1,2,3,20,8,20448,18140,2308
1,2,4,20,8,19759,18977,782
1,2,5,20,8,19010,19617,-607
1,2,6,20,8,18219,20205,-1986
1,2,7,20,8,17747,20864,-3117
1,2,8,20,8,16954,21387,-4433
1,3,0,20,8,19945,16736,3209
1,3,1,20,8,20404,16599,3805
1,3,2,20,8,20031,17501,2530
1,3,3,20,8,20167,17856,2311
1,3,4,20,8,19419,18690,729
1,3,5,20,8,18750,19265,-515
1,3,6,20,8,18005,19822,-1817
1,3,7,20,8,17519,20497,-2978
1,3,8,20,8,16736,20983,-4247
1,4,0,20,8,19612,16956,2656
1,4,1,20,8,20126,16782,3344
1,4,2,20,8,19830,17623,2207
1,4,3,20,8,20011,17914,2097
1,4,4,20,8,19296,18700,596
1,4,5,20,8,18740,19152,-412
1,4,6,20,8,18072,19611,-1539
1,4,7,20,8,17677,20222,-2545
1,4,8,20,8,16956,20617,-3661
1,0,0,21,8,21112,18160,2952
1,0,1,21,8,21580,18167,3413
1,0,2,21,8,21252,19015,2237
1,0,3,21,8,21457,19399,2058
1,0,4,21,8,20960,20201,759
1,0,5,21,8,20167,20822,-655
1,0,6,21,8,19360,21364,-2004
1,0,7,21,8,18925,21965,-3040
1,0,8,21,8,18160,22362,-4202
1,1,0,21,8,21104,17794,3310
1,1,1,21,8,21520,17705,3815
1,1,2,21,8,21165,18583,2582
1,1,3,21,8,21301,18988,2313
1,1,4,21,8,20609,19824,785
1,1,5,21,8,19851,20462,-611
1,1,6,21,8,19056,21057,-2001
1,1,7,21,8,18587,21725,-3138
1,1,8,21,8,17794,22243,-4449
1,2,0,21,8,20829,17615,3214
1,2,1,21,8,21297,17480,3817
1,2,2,21,8,20922,18378,2544
1,2,3,21,8,21055,18733,2322
1,2,4,21,8,20307,19567,740
1,2,5,21,8,19634,20139,-505
1,2,6,21,8,18889,20698,-1809
1,2,7,21,8,18405,21378,-2973
1,2,8,21,8,17615,21859,-4244
1,3,0,21,8,20510,17483,3027
1,3,1,21,8,20984,17327,3657
1,3,2,21,8,20640,18198,2442
1,3,3,21,8,20777,18540,2237
1,3,4,21,8,20020,19384,636
1,3,5,21,8,19414,19881,-467
1,3,6,21,8,18694,20381,-1687
1,3,7,21,8,18252,21038,-2786
1,3,8,21,8,17483,21477,-3994
1,0,0,22,8,21947,18619,3328
1,0,1,22,8,22357,18524,3833
1,0,2,22,8,21998,19401,2597
1,0,3,22,8,22140,19814,2326
1,0,4,22,8,21452,20656,796
1,0,5,22,8,20685,21290,-605
1,0,6,22,8,19882,21885,-2003
1,0,7,22,8,19413,22558,-3145
1,0,8,22,8,18619,23073,-4454
1,1,0,22,8,21688,18455,3233
1,1,1,22,8,22158,18327,3831
1,1,2,22,8,21778,19226,2552
1,1,3,22,8,21908,19581,2327
1,1,4,22,8,21157,20414,743
1,1,5,22,8,20475,20984,-509
1,1,6,22,8,19726,21550,-1824
1,1,7,22,8,19245,22239,-2994
1,1,8,22,8,18455,22715,-4260
1,2,0,22,8,21394,18362,3032
1,2,1,22,8,21877,18208,3669
1,2,2,22,8,21531,19075,2456
1,2,3,22,8,21665,19417,2248
1,2,4,22,8,20908,20261,647
1,2,5,22,8,20298,20755,-457
1,2,6,22,8,19578,21257,-1679
1,2,7,22,8,19138,21919,-2781
1,2,8,22,8,18362,22353,-3991
1,0,0,23,8,22531,19280,3251
1,0,1,23,8,22995,19146,3849
1,0,2,23,8,22611,20044,2567
1,0,3,23,8,22747,20407,2340
1,0,4,23,8,22000,21246,754
1,0,5,23,8,21309,21812,-503
1,0,6,23,8,20552,22378,-1826
1,0,7,23,8,20071,23072,-3001
1,0,8,23,8,19280,23545,-4265
1,1,0,23,8,22253,19202,3051
1,1,1,23,8,22738,19055,3683
1,1,2,23,8,22387,19923,2464
1,1,3,23,8,22518,20265,2253
1,1,4,23,8,21758,21108,650
1,1,5,23,8,21139,21600,-461
1,1,6,23,8,20415,22109,-1694
1,1,7,23,8,19978,22780,-2802
1,1,8,23,8,19202,23209,-4007
1,0,0,24,8,23096,20027,3069
1,0,1,24,8,23575,19874,3701
1,0,2,24,8,23220,20741,2479
1,0,3,24,8,23357,21091,2266
1,0,4,24,8,22601,21940,661
1,0,5,24,8,21973,22428,-455
1,0,6,24,8,21241,22937,-1696
1,0,7,24,8,20804,23613,-2809
1,0,8,24,8,20027,24039,-4012
1,0,0,1,9,947,921,26
1,0,1,1,9,940,928,12
1,0,2,1,9,935,934,1
1,0,3,1,9,941,930,11
1,0,4,1,9,945,931,14
1,0,5,1,9,937,937,0
1,0,6,1,9,930,935,-5
1,1,0,1,9,967,954,13
1,1,1,1,9,967,952,15
1,1,2,1,9,960,950,10
1,1,3,1,9,956,948,8
1,1,4,1,9,953,956,-3
1,1,5,1,9,945,966,-21
1,1,6,1,9,942,963,-21
1,2,0,1,9,999,990,9
1,2,1,1,9,1006,986,20
1,2,2,1,9,1000,984,16
1,2,3,1,9,995,980,15
1,2,4,1,9,994,984,10
1,2,5,1,9,992,991,1
1,2,6,1,9,994,987,7
1,3,0,1,9,970,644,326
1,3,1,1,9,927,692,235
1,3,2,1,9,876,747,129
1,3,3,1,9,829,791,38
1,3,4,1,9,786,833,-47
1,3,5,1,9,737,881,-144
1,3,6,1,9,687,927,-240
1,4,0,1,9,932,462,470
1,4,1,1,9,869,517,352
1,4,2,1,9,798,592,206
1,4,3,1,9,729,662,67
1,4,4,1,9,658,728,-70
1,4,5,1,9,577,796,-219
1,4,6,1,9,504,859,-355
1,5,0,1,9,886,574,312
1,5,1,1,9,840,587,253
1,5,2,1,9,785,627,158
1,5,3,1,9,730,678,52
1,5,4,1,9,676,732,-56
1,5,5,1,9,616,785,-169
1,5,6,1,9,572,828,-256
1,6,0,1,9,805,624,181
1,6,1,1,9,754,626,128
1,6,2,1,9,699,644,55
1,6,3,1,9,659,672,-13
1,6,4,1,9,639,710,-71
1,6,5,1,9,621,757,-136
1,6,6,1,9,607,804,-197
1,7,0,1,9,773,865,-92
1,7,1,1,9,739,848,-109
1,7,2,1,9,711,828,-117
1,7,3,1,9,720,801,-81
1,7,4,1,9,770,786,-16
1,7,5,1,9,828,798,30
1,7,6,1,9,868,826,42
1,8,0,1,9,1006,1235,-229
1,8,1,1,9,1015,1229,-214
1,8,2,1,9,1004,1192,-188
1,8,3,1,9,1020,1154,-134
1,8,4,1,9,1088,1136,-48
1,8,5,1,9,1171,1108,63
1,8,6,1,9,1215,1101,114
1,9,0,1,9,558,378,180
1,9,1,1,9,493,395,98
1,9,2,1,9,453,413,40
1,9,3,1,9,420,428,-8
1,9,4,1,9,416,449,-33
1,9,5,1,9,403,497,-94
1,9,6,1,9,375,573,-198
1,10,0,1,9,972,1183,-211
1,10,1,1,9,996,1167,-171
1,10,2,1,9,1084,1155,-71
1,10,3,1,9,1143,1151,-8
1,10,4,1,9,1192,1108,84
1,10,5,1,9,1176,1075,101
1,10,6,1,9,1182,1057,125
1,11,0,1,9,1549,1792,-243
1,11,1,1,9,1588,1798,-210
1,11,2,1,9,1682,1815,-133
1,11,3,1,9,1770,1850,-80
1,11,4,1,9,1838,1828,10
1,11,5,1,9,1785,1801,-16
1,11,6,1,9,1794,1751,43
1,12,0,1,9,1635,1333,302
1,12,1,1,9,1595,1422,173
1,12,2,1,9,1562,1530,32
1,12,3,1,9,1573,1633,-60
1,12,4,1,9,1578,1699,-121
1,12,5,1,9,1452,1787,-335
1,12,6,1,9,1354,1815,-461
1,13,0,1,9,1630,1219,411
1,13,1,1,9,1584,1337,247
1,13,2,1,9,1531,1444,87
1,13,3,1,9,1514,1528,-14
1,13,4,1,9,1501,1606,-105
1,13,5,1,9,1410,1707,-297
1,13,6,1,9,1248,1750,-502
1,14,0,1,9,1598,1221,377
1,14,1,1,9,1546,1351,195
1,14,2,1,9,1504,1437,67
1,14,3,1,9,1482,1497,-15
1,14,4,1,9,1469,1583,-114
1,14,5,1,9,1405,1672,-267
1,14,6,1,9,1255,1722,-467
1,15,0,1,9,1637,1164,473
1,15,1,1,9,1574,1328,246
1,15,2,1,9,1523,1433,90
1,15,3,1,9,1510,1488,22
1,15,4,1,9,1496,1581,-85
1,15,5,1,9,1381,1675,-294
1,15,6,1,9,1217,1730,-513
1,16,0,1,9,1501,1253,248
1,16,1,1,9,1500,1335,165
1,16,2,1,9,1503,1435,68
1,16,3,1,9,1522,1497,25
1,16,4,1,9,1530,1538,-8
1,16,5,1,9,1423,1543,-120
1,16,6,1,9,1272,1585,-313
1,17,0,1,9,1329,1018,311
1,17,1,1,9,1292,1022,270
1,17,2,1,9,1327,1072,255
1,17,3,1,9,1331,1179,152
1,17,4,1,9,1268,1262,6
1,17,5,1,9,1144,1272,-128
1,17,6,1,9,1014,1366,-352
1,18,0,1,9,1200,824,376
1,18,1,1,9,1151,824,327
1,18,2,1,9,1134,874,260
1,18,3,1,9,1142,990,152
1,18,4,1,9,1065,1047,18
1,18,5,1,9,902,1053,-151
1,18,6,1,9,826,1071,-245
1,19,0,1,9,1186,1298,-112
1,19,1,1,9,1119,1244,-125
1,19,2,1,9,1187,1149,38
1,19,3,1,9,1214,1195,19
1,19,4,1,9,1138,1116,22
1,19,5,1,9,1165,1033,132
1,19,6,1,9,1195,1124,71
1,20,0,1,9,1200,1120,80
1,20,1,1,9,1142,1036,106
1,20,2,1,9,1219,960,259
1,20,3,1,9,1271,1003,268
1,20,4,1,9,1193,896,297
1,20,5,1,9,1242,805,437
1,20,6,1,9,1283,932,351
1,21,0,1,9,980,427,553
1,21,1,1,9,818,441,377
1,21,2,1,9,772,499,273
1,21,3,1,9,727,556,171
1,21,4,1,9,580,557,23
1,21,5,1,9,554,617,-63
1,21,6,1,9,546,766,-220
1,22,0,1,9,735,692,43
1,22,1,1,9,687,663,24
1,22,2,1,9,683,651,32
1,22,3,1,9,668,638,30
1,22,4,1,9,664,576,88
1,22,5,1,9,707,547,160
1,22,6,1,9,703,570,133
1,23,0,1,9,691,795,-104
1,23,1,1,9,678,739,-61
1,23,2,1,9,664,754,-90
1,23,3,1,9,670,748,-78
1,23,4,1,9,733,649,84
1,23,5,1,9,754,633,121
1,23,6,1,9,781,588,193
1,0,0,2,9,1914,1875,39
1,0,1,2,9,1907,1880,27
1,0,2,2,9,1895,1884,11
1,0,3,2,9,1897,1878,19
1,0,4,2,9,1898,1887,11
1,0,5,2,9,1882,1903,-21
1,0,6,2,9,1872,1898,-26
1,1,0,2,9,1966,1944,22
1,1,1,2,9,1973,1938,35
1,1,2,2,9,1960,1934,26
1,1,3,2,9,1951,1928,23
1,1,4,2,9,1947,1940,7
1,1,5,2,9,1937,1957,-20
1,1,6,2,9,1936,1950,-14
1,2,0,2,9,1969,1634,335
1,2,1,2,9,1933,1678,255
1,2,2,2,9,1876,1731,145
1,2,3,2,9,1824,1771,53
1,2,4,2,9,1780,1817,-37
1,2,5,2,9,1729,1872,-143
1,2,6,2,9,1681,1914,-233
1,3,0,2,9,1902,1106,796
1,3,1,2,9,1796,1209,587
1,3,2,2,9,1674,1339,335
1,3,3,2,9,1558,1453,105
1,3,4,2,9,1444,1561,-117
1,3,5,2,9,1314,1677,-363
1,3,6,2,9,1191,1786,-595
1,4,0,2,9,1818,1036,782
1,4,1,2,9,1709,1104,605
1,4,2,2,9,1583,1219,364
1,4,3,2,9,1459,1340,119
1,4,4,2,9,1334,1460,-126
1,4,5,2,9,1193,1581,-388
1,4,6,2,9,1076,1687,-611
1,5,0,2,9,1691,1198,493
1,5,1,2,9,1594,1213,381
1,5,2,2,9,1484,1271,213
1,5,3,2,9,1389,1350,39
1,5,4,2,9,1315,1442,-127
1,5,5,2,9,1237,1542,-305
1,5,6,2,9,1179,1632,-453
1,6,0,2,9,1578,1489,89
1,6,1,2,9,1493,1474,19
1,6,2,2,9,1410,1472,-62
1,6,3,2,9,1379,1473,-94
1,6,4,2,9,1409,1496,-87
1,6,5,2,9,1449,1555,-106
1,6,6,2,9,1475,1630,-155
1,7,0,2,9,1779,2100,-321
1,7,1,2,9,1754,2077,-323
1,7,2,2,9,1715,2020,-305
1,7,3,2,9,1740,1955,-215
1,7,4,2,9,1858,1922,-64
1,7,5,2,9,1999,1906,93
1,7,6,2,9,2083,1927,156
1,8,0,2,9,1564,1613,-49
1,8,1,2,9,1508,1624,-116
1,8,2,2,9,1457,1605,-148
1,8,3,2,9,1440,1582,-142
1,8,4,2,9,1504,1585,-81
1,8,5,2,9,1574,1605,-31
1,8,6,2,9,1590,1674,-84
1,9,0,2,9,1530,1561,-31
1,9,1,2,9,1489,1562,-73
1,9,2,2,9,1537,1568,-31
1,9,3,2,9,1563,1579,-16
1,9,4,2,9,1608,1557,51
1,9,5,2,9,1579,1572,7
1,9,6,2,9,1557,1630,-73
1,10,0,2,9,2521,2975,-454
1,10,1,2,9,2584,2965,-381
1,10,2,2,9,2766,2970,-204
1,10,3,2,9,2913,3001,-88
1,10,4,2,9,3030,2936,94
1,10,5,2,9,2961,2876,85
1,10,6,2,9,2976,2808,168
1,11,0,2,9,3184,3125,59
1,11,1,2,9,3183,3220,-37
1,11,2,2,9,3244,3345,-101
1,11,3,2,9,3343,3483,-140
1,11,4,2,9,3416,3527,-111
1,11,5,2,9,3237,3588,-351
1,11,6,2,9,3148,3566,-418
1,12,0,2,9,3265,2552,713
1,12,1,2,9,3179,2759,420
1,12,2,2,9,3093,2974,119
1,12,3,2,9,3087,3161,-74
1,12,4,2,9,3079,3305,-226
1,12,5,2,9,2862,3494,-632
1,12,6,2,9,2602,3565,-963
1,13,0,2,9,3228,2440,788
1,13,1,2,9,3130,2688,442
1,13,2,2,9,3035,2881,154
1,13,3,2,9,2996,3025,-29
1,13,4,2,9,2970,3189,-219
1,13,5,2,9,2815,3379,-564
1,13,6,2,9,2503,3472,-969
1,14,0,2,9,3235,2385,850
1,14,1,2,9,3120,2679,441
1,14,2,2,9,3027,2870,157
1,14,3,2,9,2992,2985,7
1,14,4,2,9,2965,3164,-199
1,14,5,2,9,2786,3347,-561
1,14,6,2,9,2472,3452,-980
1,15,0,2,9,3138,2417,721
1,15,1,2,9,3074,2663,411
1,15,2,2,9,3026,2868,158
1,15,3,2,9,3032,2985,47
1,15,4,2,9,3026,3119,-93
1,15,5,2,9,2804,3218,-414
1,15,6,2,9,2489,3315,-826
1,16,0,2,9,2830,2271,559
1,16,1,2,9,2792,2357,435
1,16,2,2,9,2830,2507,323
1,16,3,2,9,2853,2676,177
1,16,4,2,9,2798,2800,-2
1,16,5,2,9,2567,2815,-248
1,16,6,2,9,2286,2951,-665
1,17,0,2,9,2529,1842,687
1,17,1,2,9,2443,1846,597
1,17,2,2,9,2461,1946,515
1,17,3,2,9,2473,2169,304
1,17,4,2,9,2333,2309,24
1,17,5,2,9,2046,2325,-279
1,17,6,2,9,1840,2437,-597
1,18,0,2,9,2386,2122,264
1,18,1,2,9,2270,2068,202
1,18,2,2,9,2321,2023,298
1,18,3,2,9,2356,2185,171
1,18,4,2,9,2203,2163,40
1,18,5,2,9,2067,2086,-19
1,18,6,2,9,2021,2195,-174
1,19,0,2,9,2386,2418,-32
1,19,1,2,9,2261,2280,-19
1,19,2,2,9,2406,2109,297
1,19,3,2,9,2485,2198,287
1,19,4,2,9,2331,2012,319
1,19,5,2,9,2407,1838,569
1,19,6,2,9,2478,2056,422
1,20,0,2,9,2180,1547,633
1,20,1,2,9,1960,1477,483
1,20,2,2,9,1991,1459,532
1,20,3,2,9,1998,1559,439
1,20,4,2,9,1773,1453,320
1,20,5,2,9,1796,1422,374
1,20,6,2,9,1829,1698,131
1,21,0,2,9,1715,1119,596
1,21,1,2,9,1505,1104,401
1,21,2,2,9,1455,1150,305
1,21,3,2,9,1395,1194,201
1,21,4,2,9,1244,1133,111
1,21,5,2,9,1261,1164,97
1,21,6,2,9,1249,1336,-87
1,22,0,2,9,1426,1487,-61
1,22,1,2,9,1365,1402,-37
1,22,2,2,9,1347,1405,-58
1,22,3,2,9,1338,1386,-48
1,22,4,2,9,1397,1225,172
1,22,5,2,9,1461,1180,281
1,22,6,2,9,1484,1158,326
1,0,0,3,9,2913,2865,48
1,0,1,3,9,2913,2866,47
1,0,2,3,9,2895,2868,27
1,0,3,3,9,2892,2858,34
1,0,4,3,9,2892,2871,21
1,0,5,3,9,2874,2894,-20
1,0,6,3,9,2866,2885,-19
1,1,0,3,9,2936,2588,348
1,1,1,3,9,2900,2630,270
1,1,2,3,9,2836,2681,155
1,1,3,3,9,2780,2719,61
1,1,4,3,9,2733,2773,-40
1,1,5,3,9,2674,2838,-164
1,1,6,3,9,2623,2877,-254
1,2,0,3,9,2901,2096,805
1,2,1,3,9,2802,2195,607
1,2,2,3,9,2674,2323,351
1,2,3,3,9,2553,2433,120
1,2,4,3,9,2438,2545,-107
1,2,5,3,9,2306,2668,-362
1,2,6,3,9,2185,2773,-588
1,3,0,3,9,2788,1680,1108
1,3,1,3,9,2636,1796,840
1,3,2,3,9,2459,1966,493
1,3,3,3,9,2288,2131,157
1,3,4,3,9,2120,2293,-173
1,3,5,3,9,1930,2462,-532
1,3,6,3,9,1763,2614,-851
1,4,0,3,9,2623,1660,963
1,4,1,3,9,2463,1730,733
1,4,2,3,9,2282,1863,419
1,4,3,3,9,2118,2012,106
1,4,4,3,9,1973,2170,-197
1,4,5,3,9,1814,2338,-524
1,4,6,3,9,1683,2491,-808
1,5,0,3,9,2464,2063,401
1,5,1,3,9,2333,2061,272
1,5,2,3,9,2195,2099,96
1,5,3,3,9,2109,2151,-42
1,5,4,3,9,2085,2228,-143
1,5,5,3,9,2065,2340,-275
1,5,6,3,9,2047,2458,-411
1,6,0,3,9,2584,2724,-140
1,6,1,3,9,2508,2703,-195
1,6,2,3,9,2414,2664,-250
1,6,3,3,9,2399,2627,-228
1,6,4,3,9,2497,2632,-135
1,6,5,3,9,2620,2663,-43
1,6,6,3,9,2690,2731,-41
1,7,0,3,9,2337,2478,-141
1,7,1,3,9,2247,2472,-225
1,7,2,3,9,2168,2433,-265
1,7,3,3,9,2160,2383,-223
1,7,4,3,9,2274,2371,-97
1,7,5,3,9,2402,2403,-1
1,7,6,3,9,2458,2500,-42
1,8,0,3,9,2536,2796,-260
1,8,1,3,9,2504,2791,-287
1,8,2,3,9,2541,2760,-219
1,8,3,3,9,2583,2733,-150
1,8,4,3,9,2696,2693,3
1,8,5,3,9,2750,2680,70
1,8,6,3,9,2772,2731,41
1,9,0,3,9,3079,3353,-274
1,9,1,3,9,3077,3360,-283
1,9,2,3,9,3219,3383,-164
1,9,3,3,9,3333,3429,-96
1,9,4,3,9,3446,3385,61
1,9,5,3,9,3364,3373,-9
1,9,6,3,9,3351,3381,-30
1,10,0,3,9,4156,4308,-152
1,10,1,3,9,4179,4387,-208
1,10,2,3,9,4328,4500,-172
1,10,3,3,9,4486,4634,-148
1,10,4,3,9,4608,4635,-27
1,10,5,3,9,4413,4663,-250
1,10,6,3,9,4330,4623,-293
1,11,0,3,9,4814,4344,470
1,11,1,3,9,4767,4557,210
1,11,2,3,9,4775,4789,-14
1,11,3,3,9,4857,5011,-154
1,11,4,3,9,4917,5133,-216
1,11,5,3,9,4647,5295,-648
1,11,6,3,9,4396,5316,-920
1,12,0,3,9,4863,3773,1090
1,12,1,3,9,4725,4110,615
1,12,2,3,9,4597,4411,186
1,12,3,3,9,4569,4658,-89
1,12,4,3,9,4548,4888,-340
1,12,5,3,9,4267,5166,-899
1,12,6,3,9,3857,5287,-1430
1,13,0,3,9,4865,3604,1261
1,13,1,3,9,4704,4016,688
1,13,2,3,9,4558,4314,244
1,13,3,3,9,4506,4513,-7
1,13,4,3,9,4466,4770,-304
1,13,5,3,9,4196,5054,-858
1,13,6,3,9,3720,5202,-1482
1,14,0,3,9,4736,3638,1098
1,14,1,3,9,4620,4014,606
1,14,2,3,9,4530,4305,225
1,14,3,3,9,4514,4482,32
1,14,4,3,9,4495,4702,-207
1,14,5,3,9,4209,4890,-681
1,14,6,3,9,3744,5037,-1293
1,15,0,3,9,4467,3435,1032
1,15,1,3,9,4366,3685,681
1,15,2,3,9,4353,3940,413
1,15,3,3,9,4363,4164,199
1,15,4,3,9,4294,4381,-87
1,15,5,3,9,3948,4490,-542
1,15,6,3,9,3503,4681,-1178
1,16,0,3,9,4030,3095,935
1,16,1,3,9,3943,3181,762
1,16,2,3,9,3964,3381,583
1,16,3,3,9,3995,3666,329
1,16,4,3,9,3863,3847,16
1,16,5,3,9,3469,3868,-399
1,16,6,3,9,3112,4022,-910
1,17,0,3,9,3715,3140,575
1,17,1,3,9,3562,3090,472
1,17,2,3,9,3648,3095,553
1,17,3,3,9,3687,3364,323
1,17,4,3,9,3471,3425,46
1,17,5,3,9,3211,3358,-147
1,17,6,3,9,3035,3561,-526
1,18,0,3,9,3586,3242,344
1,18,1,3,9,3412,3104,308
1,18,2,3,9,3540,2983,557
1,18,3,3,9,3627,3188,439
1,18,4,3,9,3396,3059,337
1,18,5,3,9,3309,2891,418
1,18,6,3,9,3304,3127,177
1,19,0,3,9,3366,2845,521
1,19,1,3,9,3079,2721,358
1,19,2,3,9,3178,2608,570
1,19,3,3,9,3212,2754,458
1,19,4,3,9,2911,2569,342
1,19,5,3,9,2961,2455,506
1,19,6,3,9,3024,2822,202
1,20,0,3,9,2915,2239,676
1,20,1,3,9,2647,2140,507
1,20,2,3,9,2674,2110,564
1,20,3,3,9,2666,2197,469
1,20,4,3,9,2437,2029,408
1,20,5,3,9,2503,1969,534
1,20,6,3,9,2532,2268,264
1,21,0,3,9,2406,1914,492
1,21,1,3,9,2183,1843,340
1,21,2,3,9,2119,1904,215
1,21,3,3,9,2065,1942,123
1,21,4,3,9,1977,1782,195
1,21,5,3,9,2015,1797,218
1,21,6,3,9,2030,1924,106
1,0,0,4,9,3883,3509,374
1,0,1,4,9,3840,3558,282
1,0,2,4,9,3771,3615,156
1,0,3,4,9,3721,3649,72
1,0,4,4,9,3678,3704,-26
1,0,5,4,9,3611,3775,-164
1,0,6,4,9,3553,3812,-259
1,1,0,4,9,3868,3050,818
1,1,1,4,9,3769,3147,622
1,1,2,4,9,3634,3273,361
1,1,3,4,9,3509,3381,128
1,1,4,4,9,3391,3501,-110
1,1,5,4,9,3251,3634,-383
1,1,6,4,9,3127,3736,-609
1,2,0,4,9,3787,2670,1117
1,2,1,4,9,3642,2782,860
1,2,2,4,9,3459,2950,509
1,2,3,4,9,3283,3111,172
1,2,4,4,9,3114,3277,-163
1,2,5,4,9,2922,3453,-531
1,2,6,4,9,2757,3601,-844
1,3,0,4,9,3593,2304,1289
1,3,1,4,9,3390,2422,968
1,3,2,4,9,3158,2610,548
1,3,3,4,9,2947,2803,144
1,3,4,4,9,2759,3003,-244
1,3,5,4,9,2551,3219,-668
1,3,6,4,9,2370,3418,-1048
1,4,0,4,9,3396,2525,871
1,4,1,4,9,3202,2578,624
1,4,2,4,9,2993,2691,302
1,4,3,4,9,2838,2813,25
1,4,4,4,9,2743,2956,-213
1,4,5,4,9,2642,3136,-494
1,4,6,4,9,2551,3317,-766
1,5,0,4,9,3470,3298,172
1,5,1,4,9,3348,3290,58
1,5,2,4,9,3199,3291,-92
1,5,3,4,9,3129,3305,-176
1,5,4,4,9,3173,3364,-191
1,5,5,4,9,3236,3448,-212
1,5,6,4,9,3262,3559,-297
1,6,0,4,9,3142,3102,40
1,6,1,4,9,3001,3098,-97
1,6,2,4,9,2867,3077,-210
1,6,3,4,9,2819,3055,-236
1,6,4,4,9,2913,3081,-168
1,6,5,4,9,3023,3160,-137
1,6,6,4,9,3065,3304,-239
1,7,0,4,9,3309,3661,-352
1,7,1,4,9,3243,3639,-396
1,7,2,4,9,3252,3588,-336
1,7,3,4,9,3303,3534,-231
1,7,4,4,9,3466,3479,-13
1,7,5,4,9,3578,3478,100
1,7,6,4,9,3640,3557,83
1,8,0,4,9,4085,4588,-503
1,8,1,4,9,4092,4589,-497
1,8,2,4,9,4223,4575,-352
1,8,3,4,9,4353,4583,-230
1,8,4,4,9,4534,4521,13
1,8,5,4,9,4535,4481,54
1,8,6,4,9,4566,4482,84
1,9,0,4,9,4714,4686,28
1,9,1,4,9,4672,4782,-110
1,9,2,4,9,4781,4913,-132
1,9,3,4,9,4906,5062,-156
1,9,4,4,9,5024,5084,-60
1,9,5,4,9,4816,5160,-344
1,9,6,4,9,4705,5196,-491
1,10,0,4,9,5786,5527,259
1,10,1,4,9,5763,5724,39
1,10,2,4,9,5859,5944,-85
1,10,3,4,9,6000,6162,-162
1,10,4,4,9,6109,6241,-132
1,10,5,4,9,5823,6370,-547
1,10,6,4,9,5578,6373,-795
1,11,0,4,9,6412,5565,847
1,11,1,4,9,6313,5908,405
1,11,2,4,9,6279,6226,53
1,11,3,4,9,6339,6508,-169
1,11,4,4,9,6386,6716,-330
1,11,5,4,9,6052,6967,-915
1,11,6,4,9,5651,7038,-1387
1,12,0,4,9,6500,4937,1563
1,12,1,4,9,6299,5438,861
1,12,2,4,9,6120,5844,276
1,12,3,4,9,6079,6146,-67
1,12,4,4,9,6044,6469,-425
1,12,5,4,9,5648,6841,-1193
1,12,6,4,9,5074,7017,-1943
1,13,0,4,9,6366,4857,1509
1,13,1,4,9,6204,5351,853
1,13,2,4,9,6061,5749,312
1,13,3,4,9,6028,6010,18
1,13,4,4,9,5996,6308,-312
1,13,5,4,9,5619,6597,-978
1,13,6,4,9,4992,6787,-1795
1,14,0,4,9,6065,4656,1409
1,14,1,4,9,5912,5036,876
1,14,2,4,9,5857,5377,480
1,14,3,4,9,5845,5661,184
1,14,4,4,9,5763,5964,-201
1,14,5,4,9,5353,6162,-809
1,14,6,4,9,4758,6403,-1645
1,15,0,4,9,5667,4259,1408
1,15,1,4,9,5517,4509,1008
1,15,2,4,9,5487,4814,673
1,15,3,4,9,5505,5154,351
1,15,4,4,9,5359,5428,-69
1,15,5,4,9,4850,5543,-693
1,15,6,4,9,4329,5752,-1423
1,16,0,4,9,5216,4393,823
1,16,1,4,9,5062,4425,637
1,16,2,4,9,5151,4530,621
1,16,3,4,9,5209,4861,348
1,16,4,4,9,5001,4963,38
1,16,5,4,9,4634,4901,-267
1,16,6,4,9,4307,5146,-839
1,17,0,4,9,4915,4260,655
1,17,1,4,9,4704,4126,578
1,17,2,4,9,4867,4055,812
1,17,3,4,9,4958,4367,591
1,17,4,4,9,4664,4321,343
1,17,5,4,9,4453,4163,290
1,17,6,4,9,4318,4493,-175
1,18,0,4,9,4566,3669,897
1,18,1,4,9,4230,3545,685
1,18,2,4,9,4312,3482,830
1,18,3,4,9,4354,3744,610
1,18,4,4,9,3976,3616,360
1,18,5,4,9,3863,3508,355
1,18,6,4,9,3850,3893,-43
1,19,0,4,9,4101,3537,564
1,19,1,4,9,3766,3384,382
1,19,2,4,9,3861,3259,602
1,19,3,4,9,3880,3392,488
1,19,4,4,9,3575,3145,430
1,19,5,4,9,3668,3002,666
1,19,6,4,9,3727,3392,335
1,20,0,4,9,3606,3034,572
1,20,1,4,9,3325,2879,446
1,20,2,4,9,3338,2864,474
1,20,3,4,9,3336,2945,391
1,20,4,4,9,3170,2678,492
1,20,5,4,9,3257,2602,655
1,20,6,4,9,3313,2856,457
1,0,0,5,9,4815,3971,844
1,0,1,5,9,4709,4075,634
1,0,2,5,9,4569,4207,362
1,0,3,5,9,4450,4311,139
1,0,4,5,9,4336,4432,-96
1,0,5,5,9,4188,4571,-383
1,0,6,5,9,4057,4671,-614
1,1,0,5,9,4754,3624,1130
1,1,1,5,9,4609,3734,875
1,1,2,5,9,4419,3900,519
1,1,3,5,9,4239,4059,180
1,1,4,5,9,4067,4233,-166
1,1,5,5,9,3867,4419,-552
1,1,6,5,9,3699,4564,-865
1,2,0,5,9,4592,3294,1298
1,2,1,5,9,4396,3408,988
1,2,2,5,9,4158,3594,564
1,2,3,5,9,3942,3783,159
1,2,4,5,9,3753,3987,-234
1,2,5,5,9,3543,4210,-667
1,2,6,5,9,3364,4405,-1041
1,3,0,5,9,4366,3169,1197
1,3,1,5,9,4129,3270,859
1,3,2,5,9,3869,3438,431
1,3,3,5,9,3667,3604,63
1,3,4,5,9,3529,3789,-260
1,3,5,5,9,3379,4017,-638
1,3,6,5,9,3238,4244,-1006
1,4,0,5,9,4402,3760,642
1,4,1,5,9,4217,3807,410
1,4,2,5,9,3997,3883,114
1,4,3,5,9,3858,3967,-109
1,4,4,5,9,3831,4092,-261
1,4,5,5,9,3813,4244,-431
1,4,6,5,9,3766,4418,-652
1,5,0,5,9,4028,3676,352
1,5,1,5,9,3841,3685,156
1,5,2,5,9,3652,3704,-52
1,5,3,5,9,3549,3733,-184
1,5,4,5,9,3589,3813,-224
1,5,5,5,9,3639,3945,-306
1,5,6,5,9,3637,4132,-495
1,6,0,5,9,4114,4285,-171
1,6,1,5,9,3997,4265,-268
1,6,2,5,9,3951,4232,-281
1,6,3,5,9,3962,4206,-244
1,6,4,5,9,4105,4189,-84
1,6,5,5,9,4199,4235,-36
1,6,6,5,9,4247,4361,-114
1,7,0,5,9,4858,5453,-595
1,7,1,5,9,4831,5437,-606
1,7,2,5,9,4934,5403,-469
1,7,3,5,9,5073,5384,-311
1,7,4,5,9,5304,5307,-3
1,7,5,5,9,5363,5279,84
1,7,6,5,9,5434,5308,126
1,8,0,5,9,5720,5921,-201
1,8,1,5,9,5687,6011,-324
1,8,2,5,9,5785,6105,-320
1,8,3,5,9,5926,6216,-290
1,8,4,5,9,6112,6220,-108
1,8,5,5,9,5987,6268,-281
1,8,6,5,9,5920,6297,-377
1,9,0,5,9,6344,5905,439
1,9,1,5,9,6256,6119,137
1,9,2,5,9,6312,6357,-45
1,9,3,5,9,6420,6590,-170
1,9,4,5,9,6525,6690,-165
1,9,5,5,9,6226,6867,-641
1,9,6,5,9,5953,6946,-993
1,10,0,5,9,7384,6748,636
1,10,1,5,9,7309,7075,234
1,10,2,5,9,7363,7381,-18
1,10,3,5,9,7482,7659,-177
1,10,4,5,9,7578,7824,-246
1,10,5,5,9,7228,8042,-814
1,10,6,5,9,6833,8095,-1262
1,11,0,5,9,8049,6729,1320
1,11,1,5,9,7887,7236,651
1,11,2,5,9,7802,7659,143
1,11,3,5,9,7849,7996,-147
1,11,4,5,9,7882,8297,-415
1,11,5,5,9,7433,8642,-1209
1,11,6,5,9,6868,8768,-1900
1,12,0,5,9,8001,6190,1811
1,12,1,5,9,7799,6773,1026
1,12,2,5,9,7623,7279,344
1,12,3,5,9,7601,7643,-42
1,12,4,5,9,7574,8007,-433
1,12,5,5,9,7071,8384,-1313
1,12,6,5,9,6346,8602,-2256
1,13,0,5,9,7695,5875,1820
1,13,1,5,9,7496,6373,1123
1,13,2,5,9,7388,6821,567
1,13,3,5,9,7359,7189,170
1,13,4,5,9,7264,7570,-306
1,13,5,5,9,6763,7869,-1106
1,13,6,5,9,6006,8153,-2147
1,14,0,5,9,7265,5480,1785
1,14,1,5,9,7063,5860,1203
1,14,2,5,9,6991,6251,740
1,14,3,5,9,6987,6651,336
1,14,4,5,9,6828,7011,-183
1,14,5,5,9,6255,7215,-960
1,14,6,5,9,5584,7474,-1890
1,15,0,5,9,6853,5557,1296
1,15,1,5,9,6636,5753,883
1,15,2,5,9,6674,5963,711
1,15,3,5,9,6719,6349,370
1,15,4,5,9,6497,6544,-47
1,15,5,5,9,6015,6576,-561
1,15,6,5,9,5524,6876,-1352
1,16,0,5,9,6416,5513,903
1,16,1,5,9,6204,5461,743
1,16,2,5,9,6370,5490,880
1,16,3,5,9,6480,5864,616
1,16,4,5,9,6194,5859,335
1,16,5,5,9,5876,5706,170
1,16,6,5,9,5590,6078,-488
1,17,0,5,9,5895,4687,1208
1,17,1,5,9,5522,4567,955
1,17,2,5,9,5639,4554,1085
1,17,3,5,9,5685,4923,762
1,17,4,5,9,5244,4878,366
1,17,5,5,9,5007,4780,227
1,17,6,5,9,4864,5259,-395
1,18,0,5,9,5301,4361,940
1,18,1,5,9,4917,4208,709
1,18,2,5,9,4995,4133,862
1,18,3,5,9,5022,4382,640
1,18,4,5,9,4640,4192,448
1,18,5,5,9,4570,4055,515
1,18,6,5,9,4553,4463,90
1,19,0,5,9,4792,4332,460
1,19,1,5,9,4444,4123,321
1,19,2,5,9,4525,4013,512
1,19,3,5,9,4550,4140,410
1,19,4,5,9,4308,3794,514
1,19,5,5,9,4422,3635,787
1,19,6,5,9,4508,3980,528
1,0,0,6,9,5701,4545,1156
1,0,1,6,9,5549,4662,887
1,0,2,6,9,5354,4834,520
1,0,3,6,9,5180,4989,191
1,0,4,6,9,5012,5164,-152
1,0,5,6,9,4804,5356,-552
1,0,6,6,9,4629,5499,-870
1,1,0,6,9,5559,4248,1311
1,1,1,6,9,5363,4360,1003
1,1,2,6,9,5118,4544,574
1,1,3,6,9,4898,4731,167
1,1,4,6,9,4706,4943,-237
1,1,5,6,9,4488,5176,-688
1,1,6,6,9,4306,5368,-1062
1,2,0,6,9,5365,4159,1206
1,2,1,6,9,5135,4256,879
1,2,2,6,9,4869,4422,447
1,2,3,6,9,4662,4584,78
1,2,4,6,9,4523,4773,-250
1,2,5,6,9,4371,5008,-637
1,2,6,6,9,4232,5231,-999
1,3,0,6,9,5372,4404,968
1,3,1,6,9,5144,4499,645
1,3,2,6,9,4873,4630,243
1,3,3,6,9,4687,4758,-71
1,3,4,6,9,4617,4925,-308
1,3,5,6,9,4550,5125,-575
1,3,6,6,9,4453,5345,-892
1,4,0,6,9,4960,4138,822
1,4,1,6,9,4710,4202,508
1,4,2,6,9,4450,4296,154
1,4,3,6,9,4278,4395,-117
1,4,4,6,9,4247,4541,-294
1,4,5,6,9,4216,4741,-525
1,4,6,6,9,4141,4991,-850
1,5,0,6,9,5000,4859,141
1,5,1,6,9,4837,4852,-15
1,5,2,6,9,4736,4859,-123
1,5,3,6,9,4692,4884,-192
1,5,4,6,9,4781,4921,-140
1,5,5,6,9,4815,5020,-205
1,5,6,6,9,4819,5189,-370
1,6,0,6,9,5663,6077,-414
1,6,1,6,9,5585,6063,-478
1,6,2,6,9,5633,6047,-414
1,6,3,6,9,5732,6056,-324
1,6,4,6,9,5943,6017,-74
1,6,5,6,9,5984,6036,-52
1,6,6,6,9,6041,6112,-71
1,7,0,6,9,6493,6786,-293
1,7,1,6,9,6426,6859,-433
1,7,2,6,9,6496,6933,-437
1,7,3,6,9,6646,7017,-371
1,7,4,6,9,6882,7006,-124
1,7,5,6,9,6815,7066,-251
1,7,6,6,9,6788,7123,-335
1,8,0,6,9,7350,7140,210
1,8,1,6,9,7271,7348,-77
1,8,2,6,9,7316,7549,-233
1,8,3,6,9,7440,7744,-304
1,8,4,6,9,7613,7826,-213
1,8,5,6,9,7397,7975,-578
1,8,6,6,9,7168,8047,-879
1,9,0,6,9,7942,7126,816
1,9,1,6,9,7802,7470,332
1,9,2,6,9,7816,7794,22
1,9,3,6,9,7902,8087,-185
1,9,4,6,9,7994,8273,-279
1,9,5,6,9,7631,8539,-908
1,9,6,6,9,7208,8668,-1460
1,10,0,6,9,9021,7912,1109
1,10,1,6,9,8883,8403,480
1,10,2,6,9,8886,8814,72
1,10,3,6,9,8992,9147,-155
1,10,4,6,9,9074,9405,-331
1,10,5,6,9,8609,9717,-1108
1,10,6,6,9,8050,9825,-1775
1,11,0,6,9,9550,7982,1568
1,11,1,6,9,9387,8571,816
1,11,2,6,9,9305,9094,211
1,11,3,6,9,9371,9493,-122
1,11,4,6,9,9412,9835,-423
1,11,5,6,9,8856,10185,-1329
1,11,6,6,9,8140,10353,-2213
1,12,0,6,9,9330,7208,2122
1,12,1,6,9,9091,7795,1296
1,12,2,6,9,8950,8351,599
1,12,3,6,9,8932,8822,110
1,12,4,6,9,8842,9269,-427
1,12,5,6,9,8215,9656,-1441
1,12,6,6,9,7360,9968,-2608
1,13,0,6,9,8895,6699,2196
1,13,1,6,9,8647,7197,1450
1,13,2,6,9,8522,7695,827
1,13,3,6,9,8501,8179,322
1,13,4,6,9,8329,8617,-288
1,13,5,6,9,7665,8922,-1257
1,13,6,6,9,6832,9224,-2392
1,14,0,6,9,8451,6778,1673
1,14,1,6,9,8182,7104,1078
1,14,2,6,9,8178,7400,778
1,14,3,6,9,8201,7846,355
1,14,4,6,9,7966,8127,-161
1,14,5,6,9,7420,8248,-828
1,14,6,6,9,6779,8598,-1819
1,15,0,6,9,8053,6677,1376
1,15,1,6,9,7778,6789,989
1,15,2,6,9,7893,6923,970
1,15,3,6,9,7990,7352,638
1,15,4,6,9,7690,7440,250
1,15,5,6,9,7257,7381,-124
1,15,6,6,9,6807,7808,-1001
1,16,0,6,9,7396,5940,1456
1,16,1,6,9,7022,5902,1120
1,16,2,6,9,7142,5989,1153
1,16,3,6,9,7207,6420,787
1,16,4,6,9,6774,6416,358
1,16,5,6,9,6430,6323,107
1,16,6,6,9,6136,6844,-708
1,17,0,6,9,6630,5379,1251
1,17,1,6,9,6209,5230,979
1,17,2,6,9,6322,5205,1117
1,17,3,6,9,6353,5561,792
1,17,4,6,9,5908,5454,454
1,17,5,6,9,5714,5327,387
1,17,6,6,9,5567,5829,-262
1,18,0,6,9,5992,5156,836
1,18,1,6,9,5595,4947,648
1,18,2,6,9,5659,4887,772
1,18,3,6,9,5692,5130,562
1,18,4,6,9,5373,4841,532
1,18,5,6,9,5324,4688,636
1,18,6,6,9,5334,5051,283
1,0,0,7,9,6506,5169,1337
1,0,1,7,9,6303,5288,1015
1,0,2,7,9,6053,5478,575
1,0,3,7,9,5839,5661,178
1,0,4,7,9,5651,5874,-223
1,0,5,7,9,5425,6113,-688
1,0,6,7,9,5236,6303,-1067
1,1,0,7,9,6332,5113,1219
1,1,1,7,9,6102,5208,894
1,1,2,7,9,5829,5372,457
1,1,3,7,9,5618,5532,86
1,1,4,7,9,5476,5729,-253
1,1,5,7,9,5316,5974,-658
1,1,6,7,9,5174,6194,-1020
1,2,0,7,9,6371,5394,977
1,2,1,7,9,6150,5485,665
1,2,2,7,9,5873,5614,259
1,2,3,7,9,5682,5738,-56
1,2,4,7,9,5611,5909,-298
1,2,5,7,9,5542,6116,-574
1,2,6,7,9,5447,6332,-885
1,3,0,7,9,5930,4782,1148
1,3,1,7,9,5637,4894,743
1,3,2,7,9,5326,5043,283
1,3,3,7,9,5107,5186,-79
1,3,4,7,9,5033,5374,-341
1,3,5,7,9,4953,5622,-669
1,3,6,7,9,4828,5918,-1090
1,4,0,7,9,5932,5321,611
1,4,1,7,9,5706,5369,337
1,4,2,7,9,5534,5451,83
1,4,3,7,9,5421,5546,-125
1,4,4,7,9,5439,5649,-210
1,4,5,7,9,5392,5816,-424
1,4,6,7,9,5323,6048,-725
1,5,0,7,9,6549,6651,-102
1,5,1,7,9,6425,6650,-225
1,5,2,7,9,6418,6674,-256
1,5,3,7,9,6462,6734,-272
1,5,4,7,9,6619,6749,-130
1,5,5,7,9,6600,6821,-221
1,5,6,7,9,6613,6940,-327
1,6,0,7,9,7298,7410,-112
1,6,1,7,9,7180,7485,-305
1,6,2,7,9,7195,7577,-382
1,6,3,7,9,7305,7689,-384
1,6,4,7,9,7521,7716,-195
1,6,5,7,9,7436,7823,-387
1,6,6,7,9,7395,7927,-532
1,7,0,7,9,8123,8005,118
1,7,1,7,9,8010,8196,-186
1,7,2,7,9,8027,8377,-350
1,7,3,7,9,8160,8545,-385
1,7,4,7,9,8383,8612,-229
1,7,5,7,9,8225,8773,-548
1,7,6,7,9,8036,8873,-837
1,8,0,7,9,8948,8361,587
1,8,1,7,9,8817,8699,118
1,8,2,7,9,8820,8986,-166
1,8,3,7,9,8922,9241,-319
1,8,4,7,9,9082,9409,-327
1,8,5,7,9,8802,9647,-845
1,8,6,7,9,8423,9769,-1346
1,9,0,7,9,9579,8290,1289
1,9,1,7,9,9376,8798,578
1,9,2,7,9,9339,9227,112
1,9,3,7,9,9412,9575,-163
1,9,4,7,9,9490,9854,-364
1,9,5,7,9,9012,10214,-1202
1,9,6,7,9,8425,10398,-1973
1,10,0,7,9,10522,9165,1357
1,10,1,7,9,10383,9738,645
1,10,2,7,9,10389,10249,140
1,10,3,7,9,10514,10644,-130
1,10,4,7,9,10604,10943,-339
1,10,5,7,9,10032,11260,-1228
1,10,6,7,9,9322,11410,-2088
1,11,0,7,9,10879,9000,1879
1,11,1,7,9,10679,9593,1086
1,11,2,7,9,10632,10166,466
1,11,3,7,9,10702,10672,30
1,11,4,7,9,10680,11097,-417
1,11,5,7,9,10000,11457,-1457
1,11,6,7,9,9154,11719,-2565
1,12,0,7,9,10530,8032,2498
1,12,1,7,9,10242,8619,1623
1,12,2,7,9,10084,9225,859
1,12,3,7,9,10074,9812,262
1,12,4,7,9,9907,10316,-409
1,12,5,7,9,9117,10709,-1592
1,12,6,7,9,8186,11039,-2853
1,13,0,7,9,10081,7997,2084
1,13,1,7,9,9766,8441,1325
1,13,2,7,9,9709,8844,865
1,13,3,7,9,9715,9374,341
1,13,4,7,9,9467,9733,-266
1,13,5,7,9,8830,9955,-1125
1,13,6,7,9,8027,10348,-2321
1,14,0,7,9,9651,7898,1753
1,14,1,7,9,9324,8140,1184
1,14,2,7,9,9397,8360,1037
1,14,3,7,9,9472,8849,623
1,14,4,7,9,9159,9023,136
1,14,5,7,9,8662,9053,-391
1,14,6,7,9,8062,9530,-1468
1,15,0,7,9,9033,7104,1929
1,15,1,7,9,8596,7230,1366
1,15,2,7,9,8665,7422,1243
1,15,3,7,9,8717,7908,809
1,15,4,7,9,8270,7997,273
1,15,5,7,9,7811,7998,-187
1,15,6,7,9,7353,8574,-1221
1,16,0,7,9,8131,6632,1499
1,16,1,7,9,7709,6565,1144
1,16,2,7,9,7825,6640,1185
1,16,3,7,9,7875,7058,817
1,16,4,7,9,7438,6992,446
1,16,5,7,9,7137,6870,267
1,16,6,7,9,6839,7414,-575
1,17,0,7,9,7321,6174,1147
1,17,1,7,9,6887,5969,918
1,17,2,7,9,6986,5959,1027
1,17,3,7,9,7023,6309,714
1,17,4,7,9,6641,6103,538
1,17,5,7,9,6468,5960,508
1,17,6,7,9,6348,6417,-69
1,0,0,8,9,7279,6034,1245
1,0,1,8,9,7042,6136,906
1,0,2,8,9,6764,6306,458
1,0,3,8,9,6559,6462,97
1,0,4,8,9,6421,6660,-239
1,0,5,8,9,6253,6911,-658
1,0,6,8,9,6104,7129,-1025
1,1,0,8,9,7338,6348,990
1,1,1,8,9,7117,6437,680
1,1,2,8,9,6833,6564,269
1,1,3,8,9,6638,6686,-48
1,1,4,8,9,6564,6865,-301
1,1,5,8,9,6487,7082,-595
1,1,6,8,9,6389,7295,-906
1,2,0,8,9,6929,5772,1157
1,2,1,8,9,6643,5880,763
1,2,2,8,9,6326,6027,299
1,2,3,8,9,6102,6166,-64
1,2,4,8,9,6027,6358,-331
1,2,5,8,9,5945,6613,-668
1,2,6,8,9,5822,6905,-1083
1,3,0,8,9,6902,5965,937
1,3,1,8,9,6633,6061,572
1,3,2,8,9,6410,6198,212
1,3,3,8,9,6250,6337,-87
1,3,4,8,9,6225,6482,-257
1,3,5,8,9,6129,6697,-568
1,3,6,8,9,6010,6975,-965
1,4,0,8,9,7481,7113,368
1,4,1,8,9,7294,7167,127
1,4,2,8,9,7216,7266,-50
1,4,3,8,9,7191,7396,-205
1,4,4,8,9,7277,7477,-200
1,4,5,8,9,7177,7617,-440
1,4,6,8,9,7117,7799,-682
1,5,0,8,9,8184,7984,200
1,5,1,8,9,8020,8072,-52
1,5,2,8,9,7980,8204,-224
1,5,3,8,9,8035,8367,-332
1,5,4,8,9,8197,8448,-251
1,5,5,8,9,8052,8608,-556
1,5,6,8,9,7967,8755,-788
1,6,0,8,9,8928,8629,299
1,6,1,8,9,8764,8822,-58
1,6,2,8,9,8726,9021,-295
1,6,3,8,9,8819,9217,-398
1,6,4,8,9,9022,9322,-300
1,6,5,8,9,8846,9530,-684
1,6,6,8,9,8643,9677,-1034
1,7,0,8,9,9721,9226,495
1,7,1,8,9,9556,9547,9
1,7,2,8,9,9531,9814,-283
1,7,3,8,9,9642,10042,-400
1,7,4,8,9,9852,10195,-343
1,7,5,8,9,9630,10445,-815
1,7,6,8,9,9291,10595,-1304
1,8,0,8,9,10585,9525,1060
1,8,1,8,9,10391,10027,364
1,8,2,8,9,10343,10419,-76
1,8,3,8,9,10432,10729,-297
1,8,4,8,9,10578,10990,-412
1,8,5,8,9,10183,11322,-1139
1,8,6,8,9,9640,11499,-1859
1,9,0,8,9,11080,9543,1537
1,9,1,8,9,10876,10133,743
1,9,2,8,9,10842,10662,180
1,9,3,8,9,10934,11072,-138
1,9,4,8,9,11020,11392,-372
1,9,5,8,9,10435,11757,-1322
1,9,6,8,9,9697,11983,-2286
1,10,0,8,9,11851,10183,1668
1,10,1,8,9,11675,10760,915
1,10,2,8,9,11716,11321,395
1,10,3,8,9,11845,11823,22
1,10,4,8,9,11872,12205,-333
1,10,5,8,9,11176,12532,-1356
1,10,6,8,9,10336,12776,-2440
1,11,0,8,9,12079,9824,2255
1,11,1,8,9,11830,10417,1413
1,11,2,8,9,11766,11040,726
1,11,3,8,9,11844,11662,182
1,11,4,8,9,11745,12144,-399
1,11,5,8,9,10902,12510,-1608
1,11,6,8,9,9980,12790,-2810
1,12,0,8,9,11716,9330,2386
1,12,1,8,9,11361,9863,1498
1,12,2,8,9,11271,10374,897
1,12,3,8,9,11288,11007,281
1,12,4,8,9,11045,11432,-387
1,12,5,8,9,10282,11742,-1460
1,12,6,8,9,9381,12163,-2782
1,13,0,8,9,11281,9117,2164
1,13,1,8,9,10908,9477,1431
1,13,2,8,9,10928,9804,1124
1,13,3,8,9,10986,10377,609
1,13,4,8,9,10660,10629,31
1,13,5,8,9,10072,10760,-688
1,13,6,8,9,9310,11280,-1970
1,14,0,8,9,10631,8325,2306
1,14,1,8,9,10142,8581,1561
1,14,2,8,9,10169,8859,1310
1,14,3,8,9,10199,9405,794
1,14,4,8,9,9739,9580,159
1,14,5,8,9,9216,9670,-454
1,14,6,8,9,8608,10296,-1688
1,15,0,8,9,9768,7796,1972
1,15,1,8,9,9283,7893,1390
1,15,2,8,9,9348,8073,1275
1,15,3,8,9,9385,8546,839
1,15,4,8,9,8934,8573,361
1,15,5,8,9,8518,8545,-27
1,15,6,8,9,8056,9144,-1088
1,16,0,8,9,8822,7427,1395
1,16,1,8,9,8387,7304,1083
1,16,2,8,9,8489,7394,1095
1,16,3,8,9,8545,7806,739
1,16,4,8,9,8171,7641,530
1,16,5,8,9,7891,7503,388
1,16,6,8,9,7620,8002,-382
1,0,0,9,9,8285,7269,1016
1,0,1,9,9,8057,7365,692
1,0,2,9,9,7768,7498,270
1,0,3,9,9,7579,7616,-37
1,0,4,9,9,7509,7796,-287
1,0,5,9,9,7424,8019,-595
1,0,6,9,9,7319,8230,-911
1,1,0,9,9,7896,6726,1170
1,1,1,9,9,7610,6832,778
1,1,2,9,9,7286,6977,309
1,1,3,9,9,7058,7114,-56
1,1,4,9,9,6980,7314,-334
1,1,5,9,9,6890,7579,-689
1,1,6,9,9,6764,7868,-1104
1,2,0,9,9,7901,6955,946
1,2,1,9,9,7639,7047,592
1,2,2,9,9,7410,7182,228
1,2,3,9,9,7245,7317,-72
1,2,4,9,9,7219,7466,-247
1,2,5,9,9,7121,7688,-567
1,2,6,9,9,7004,7962,-958
1,3,0,9,9,8451,7757,694
1,3,1,9,9,8221,7859,362
1,3,2,9,9,8092,8013,79
1,3,3,9,9,8020,8187,-167
1,3,4,9,9,8063,8310,-247
1,3,5,9,9,7914,8498,-584
1,3,6,9,9,7804,8726,-922
1,4,0,9,9,9116,8446,670
1,4,1,9,9,8889,8589,300
1,4,2,9,9,8778,8796,-18
1,4,3,9,9,8764,9029,-265
1,4,4,9,9,8855,9176,-321
1,4,5,9,9,8629,9404,-775
1,4,6,9,9,8471,9614,-1143
1,5,0,9,9,9814,9203,611
1,5,1,9,9,9604,9409,195
1,5,2,9,9,9511,9648,-137
1,5,3,9,9,9549,9895,-346
1,5,4,9,9,9698,10054,-356
1,5,5,9,9,9462,10315,-853
1,5,6,9,9,9215,10505,-1290
1,6,0,9,9,10526,9850,676
1,6,1,9,9,10310,10173,137
1,6,2,9,9,10230,10458,-228
1,6,3,9,9,10301,10714,-413
1,6,4,9,9,10491,10905,-414
1,6,5,9,9,10251,11202,-951
1,6,6,9,9,9898,11399,-1501
1,7,0,9,9,11358,10390,968
1,7,1,9,9,11130,10875,255
1,7,2,9,9,11054,11247,-193
1,7,3,9,9,11152,11530,-378
1,7,4,9,9,11348,11776,-428
1,7,5,9,9,11011,12120,-1109
1,7,6,9,9,10508,12325,-1817
1,8,0,9,9,12086,10778,1308
1,8,1,9,9,11891,11362,529
1,8,2,9,9,11846,11854,-8
1,8,3,9,9,11954,12226,-272
1,8,4,9,9,12108,12528,-420
1,8,5,9,9,11606,12865,-1259
1,8,6,9,9,10912,13084,-2172
1,9,0,9,9,12409,10561,1848
1,9,1,9,9,12168,11155,1013
1,9,2,9,9,12169,11734,435
1,9,3,9,9,12265,12251,14
1,9,4,9,9,12288,12654,-366
1,9,5,9,9,11579,13029,-1450
1,9,6,9,9,10711,13349,-2638
1,10,0,9,9,13051,11007,2044
1,10,1,9,9,12826,11584,1242
1,10,2,9,9,12850,12195,655
1,10,3,9,9,12987,12813,174
1,10,4,9,9,12937,13252,-315
1,10,5,9,9,12078,13585,-1507
1,10,6,9,9,11162,13847,-2685
1,11,0,9,9,13265,11122,2143
1,11,1,9,9,12949,11661,1288
1,11,2,9,9,12953,12189,764
1,11,3,9,9,13058,12857,201
1,11,4,9,9,12883,13260,-377
1,11,5,9,9,12067,13543,-1476
1,11,6,9,9,11175,13914,-2739
1,12,0,9,9,12916,10450,2466
1,12,1,9,9,12503,10899,1604
1,12,2,9,9,12490,11334,1156
1,12,3,9,9,12559,12010,549
1,12,4,9,9,12238,12328,-90
1,12,5,9,9,11524,12547,-1023
1,12,6,9,9,10664,13095,-2431
1,13,0,9,9,12261,9544,2717
1,13,1,9,9,11726,9918,1808
1,13,2,9,9,11700,10303,1397
1,13,3,9,9,11713,10933,780
1,13,4,9,9,11240,11186,54
1,13,5,9,9,10626,11377,-751
1,13,6,9,9,9856,12046,-2190
1,14,0,9,9,11366,9017,2349
1,14,1,9,9,10829,9244,1585
1,14,2,9,9,10852,9510,1342
1,14,3,9,9,10867,10043,824
1,14,4,9,9,10403,10156,247
1,14,5,9,9,9923,10217,-294
1,14,6,9,9,9311,10866,-1555
1,15,0,9,9,10459,8591,1868
1,15,1,9,9,9961,8632,1329
1,15,2,9,9,10012,8827,1185
1,15,3,9,9,10055,9294,761
1,15,4,9,9,9667,9222,445
1,15,5,9,9,9272,9178,94
1,15,6,9,9,8837,9732,-895
1,0,0,10,9,8843,7647,1196
1,0,1,10,9,8550,7760,790
1,0,2,10,9,8221,7911,310
1,0,3,10,9,7999,8044,-45
1,0,4,10,9,7925,8245,-320
1,0,5,10,9,7827,8516,-689
1,0,6,10,9,7694,8803,-1109
1,1,0,10,9,8868,7909,959
1,1,1,10,9,8606,7999,607
1,1,2,10,9,8370,8132,238
1,1,3,10,9,8201,8265,-64
1,1,4,10,9,8172,8422,-250
1,1,5,10,9,8066,8654,-588
1,1,6,10,9,7946,8925,-979
1,2,0,10,9,9450,8747,703
1,2,1,10,9,9227,8845,382
1,2,2,10,9,9092,8997,95
1,2,3,10,9,9015,9167,-152
1,2,4,10,9,9057,9294,-237
1,2,5,10,9,8906,9489,-583
1,2,6,10,9,8798,9713,-915
1,3,0,10,9,10086,9090,996
1,3,1,10,9,9816,9281,535
1,3,2,10,9,9654,9543,111
1,3,3,10,9,9593,9820,-227
1,3,4,10,9,9641,10009,-368
1,3,5,10,9,9366,10285,-919
1,3,6,10,9,9158,10541,-1383
1,4,0,10,9,10746,9665,1081
1,4,1,10,9,10473,9926,547
1,4,2,10,9,10309,10240,69
1,4,3,10,9,10278,10557,-279
1,4,4,10,9,10356,10782,-426
1,4,5,10,9,10039,11111,-1072
1,4,6,10,9,9719,11364,-1645
1,5,0,10,9,11412,10424,988
1,5,1,10,9,11150,10760,390
1,5,2,10,9,11015,11085,-70
1,5,3,10,9,11031,11392,-361
1,5,4,10,9,11167,11637,-470
1,5,5,10,9,10867,11987,-1120
1,5,6,10,9,10470,12227,-1757
1,6,0,10,9,12163,11014,1149
1,6,1,10,9,11884,11501,383
1,6,2,10,9,11753,11891,-138
1,6,3,10,9,11811,12202,-391
1,6,4,10,9,11987,12486,-499
1,6,5,10,9,11632,12877,-1245
1,6,6,10,9,11115,13129,-2014
1,7,0,10,9,12859,11643,1216
1,7,1,10,9,12630,12210,420
1,7,2,10,9,12557,12682,-125
1,7,3,10,9,12674,13027,-353
1,7,4,10,9,12878,13314,-436
1,7,5,10,9,12434,13663,-1229
1,7,6,10,9,11780,13910,-2130
1,8,0,10,9,13415,11796,1619
1,8,1,10,9,13183,12384,799
1,8,2,10,9,13173,12926,247
1,8,3,10,9,13285,13405,-120
1,8,4,10,9,13376,13790,-414
1,8,5,10,9,12750,14137,-1387
1,8,6,10,9,11926,14450,-2524
1,9,0,10,9,13609,11385,2224
1,9,1,10,9,13319,11979,1340
1,9,2,10,9,13303,12608,695
1,9,3,10,9,13407,13241,166
1,9,4,10,9,13353,13701,-348
1,9,5,10,9,12481,14082,-1601
1,9,6,10,9,11537,14420,-2883
1,10,0,10,9,14237,12305,1932
1,10,1,10,9,13945,12828,1117
1,10,2,10,9,14037,13344,693
1,10,3,10,9,14201,14008,193
1,10,4,10,9,14075,14368,-293
1,10,5,10,9,13243,14618,-1375
1,10,6,10,9,12357,14971,-2614
1,11,0,10,9,14465,12242,2223
1,11,1,10,9,14091,12697,1394
1,11,2,10,9,14172,13149,1023
1,11,3,10,9,14329,13860,469
1,11,4,10,9,14076,14156,-80
1,11,5,10,9,13309,14348,-1039
1,11,6,10,9,12458,14846,-2388
1,12,0,10,9,13896,10877,3019
1,12,1,10,9,13321,11340,1981
1,12,2,10,9,13262,11833,1429
1,12,3,10,9,13286,12566,720
1,12,4,10,9,12818,12885,-67
1,12,5,10,9,12078,13164,-1086
1,12,6,10,9,11210,13861,-2651
1,13,0,10,9,12996,10236,2760
1,13,1,10,9,12413,10581,1832
1,13,2,10,9,12383,10954,1429
1,13,3,10,9,12381,11571,810
1,13,4,10,9,11904,11762,142
1,13,5,10,9,11333,11924,-591
1,13,6,10,9,10559,12616,-2057
1,14,0,10,9,12057,9812,2245
1,14,1,10,9,11507,9983,1524
1,14,2,10,9,11516,10264,1252
1,14,3,10,9,11537,10791,746
1,14,4,10,9,11136,10805,331
1,14,5,10,9,10677,10850,-173
1,14,6,10,9,10092,11454,-1362
1,0,0,11,9,9815,8830,985
1,0,1,11,9,9546,8927,619
1,0,2,11,9,9305,9066,239
1,0,3,11,9,9142,9195,-53
1,0,4,11,9,9117,9353,-236
1,0,5,11,9,9003,9591,-588
1,0,6,11,9,8876,9860,-984
1,1,0,11,9,10417,9701,716
1,1,1,11,9,10194,9797,397
1,1,2,11,9,10052,9947,105
1,1,3,11,9,9971,10115,-144
1,1,4,11,9,10010,10250,-240
1,1,5,11,9,9851,10455,-604
1,1,6,11,9,9740,10676,-936
1,2,0,11,9,11085,10080,1005
1,2,1,11,9,10822,10267,555
1,2,2,11,9,10654,10527,127
1,2,3,11,9,10588,10800,-212
1,2,4,11,9,10635,10993,-358
1,2,5,11,9,10358,11276,-918
1,2,6,11,9,10152,11528,-1376
1,3,0,11,9,11716,10309,1407
1,3,1,11,9,11400,10618,782
1,3,2,11,9,11185,10987,198
1,3,3,11,9,11107,11348,-241
1,3,4,11,9,11142,11615,-473
1,3,5,11,9,10776,11992,-1216
1,3,6,11,9,10406,12291,-1885
1,4,0,11,9,12344,10886,1458
1,4,1,11,9,12019,11277,742
1,4,2,11,9,11813,11677,136
1,4,3,11,9,11760,12054,-294
1,4,4,11,9,11825,12365,-540
1,4,5,11,9,11444,12783,-1339
1,4,6,11,9,10974,13086,-2112
1,5,0,11,9,13049,11588,1461
1,5,1,11,9,12724,12088,636
1,5,2,11,9,12538,12518,20
1,5,3,11,9,12541,12880,-339
1,5,4,11,9,12663,13218,-555
1,5,5,11,9,12248,13662,-1414
1,5,6,11,9,11687,13957,-2270
1,6,0,11,9,13664,12267,1397
1,6,1,11,9,13384,12836,548
1,6,2,11,9,13256,13326,-70
1,6,3,11,9,13333,13699,-366
1,6,4,11,9,13517,14024,-507
1,6,5,11,9,13055,14420,-1365
1,6,6,11,9,12387,14714,-2327
1,7,0,11,9,14188,12661,1527
1,7,1,11,9,13922,13232,690
1,7,2,11,9,13884,13754,130
1,7,3,11,9,14005,14206,-201
1,7,4,11,9,14146,14576,-430
1,7,5,11,9,13578,14935,-1357
1,7,6,11,9,12794,15276,-2482
1,8,0,11,9,14615,12620,1995
1,8,1,11,9,14334,13208,1126
1,8,2,11,9,14307,13800,507
1,8,3,11,9,14427,14395,32
1,8,4,11,9,14441,14837,-396
1,8,5,11,9,13652,15190,-1538
1,8,6,11,9,12752,15521,-2769
1,9,0,11,9,14795,12683,2112
1,9,1,11,9,14438,13223,1215
1,9,2,11,9,14490,13757,733
1,9,3,11,9,14621,14436,185
1,9,4,11,9,14491,14817,-326
1,9,5,11,9,13646,15115,-1469
1,9,6,11,9,12732,15544,-2812
1,10,0,11,9,15437,13425,2012
1,10,1,11,9,15087,13864,1223
1,10,2,11,9,15256,14304,952
1,10,3,11,9,15472,15011,461
1,10,4,11,9,15268,15264,4
1,10,5,11,9,14485,15423,-938
1,10,6,11,9,13640,15903,-2263
1,11,0,11,9,15445,12669,2776
1,11,1,11,9,14909,13138,1771
1,11,2,11,9,14944,13648,1296
1,11,3,11,9,15056,14416,640
1,11,4,11,9,14656,14713,-57
1,11,5,11,9,13863,14965,-1102
1,11,6,11,9,13004,15612,-2608
1,12,0,11,9,14631,11569,3062
1,12,1,11,9,14008,12003,2005
1,12,2,11,9,13945,12484,1461
1,12,3,11,9,13954,13204,750
1,12,4,11,9,13482,13461,21
1,12,5,11,9,12785,13711,-926
1,12,6,11,9,11913,14431,-2518
1,13,0,11,9,13687,11031,2656
1,13,1,11,9,13091,11320,1771
1,13,2,11,9,13047,11708,1339
1,13,3,11,9,13051,12319,732
1,13,4,11,9,12637,12411,226
1,13,5,11,9,12087,12557,-470
1,13,6,11,9,11340,13204,-1864
1,0,0,12,9,11364,10622,742
1,0,1,12,9,11134,10725,409
1,0,2,12,9,10987,10881,106
1,0,3,12,9,10912,11045,-133
1,0,4,12,9,10955,11181,-226
1,0,5,12,9,10788,11392,-604
1,0,6,12,9,10670,11611,-941
1,1,0,12,9,12052,11034,1018
1,1,1,12,9,11789,11219,570
1,1,2,12,9,11614,11477,137
1,1,3,12,9,11544,11748,-204
1,1,4,12,9,11588,11949,-361
1,1,5,12,9,11303,12242,-939
1,1,6,12,9,11094,12491,-1397
1,2,0,12,9,12715,11299,1416
1,2,1,12,9,12406,11604,802
1,2,2,12,9,12185,11971,214
1,2,3,12,9,12102,12328,-226
1,2,4,12,9,12136,12599,-463
1,2,5,12,9,11768,12983,-1215
1,2,6,12,9,11400,13278,-1878
1,3,0,12,9,13314,11530,1784
1,3,1,12,9,12946,11969,977
1,3,2,12,9,12689,12424,265
1,3,3,12,9,12589,12845,-256
1,3,4,12,9,12611,13198,-587
1,3,5,12,9,12181,13664,-1483
1,3,6,12,9,11661,14013,-2352
1,4,0,12,9,13981,12050,1931
1,4,1,12,9,13593,12605,988
1,4,2,12,9,13336,13110,226
1,4,3,12,9,13270,13542,-272
1,4,4,12,9,13321,13946,-625
1,4,5,12,9,12825,14458,-1633
1,4,6,12,9,12191,14816,-2625
1,5,0,12,9,14550,12841,1709
1,5,1,12,9,14224,13423,801
1,5,2,12,9,14041,13953,88
1,5,3,12,9,14063,14377,-314
1,5,4,12,9,14193,14756,-563
1,5,5,12,9,13671,15205,-1534
1,5,6,12,9,12959,15542,-2583
1,6,0,12,9,14993,13285,1708
1,6,1,12,9,14676,13858,818
1,6,2,12,9,14583,14398,185
1,6,3,12,9,14664,14878,-214
1,6,4,12,9,14785,15286,-501
1,6,5,12,9,14199,15692,-1493
1,6,6,12,9,13401,16080,-2679
1,7,0,12,9,15388,13485,1903
1,7,1,12,9,15073,14056,1017
1,7,2,12,9,15018,14628,390
1,7,3,12,9,15147,15196,-49
1,7,4,12,9,15211,15623,-412
1,7,5,12,9,14480,15988,-1508
1,7,6,12,9,13620,16347,-2727
1,8,0,12,9,15801,13918,1883
1,8,1,12,9,15453,14452,1001
1,8,2,12,9,15494,14949,545
1,8,3,12,9,15641,15590,51
1,8,4,12,9,15579,15953,-374
1,8,5,12,9,14817,16223,-1406
1,8,6,12,9,13947,16645,-2698
1,9,0,12,9,15995,13803,2192
1,9,1,12,9,15580,14259,1321
1,9,2,12,9,15709,14717,992
1,9,3,12,9,15892,15439,453
1,9,4,12,9,15684,15713,-29
1,9,5,12,9,14888,15920,-1032
1,9,6,12,9,14015,16476,-2461
1,10,0,12,9,16417,13852,2565
1,10,1,12,9,15905,14305,1600
1,10,2,12,9,16028,14803,1225
1,10,3,12,9,16199,15567,632
1,10,4,12,9,15848,15821,27
1,10,5,12,9,15039,16040,-1001
1,10,6,12,9,14186,16669,-2483
1,11,0,12,9,16180,13361,2819
1,11,1,12,9,15596,13801,1795
1,11,2,12,9,15627,14299,1328
1,11,3,12,9,15724,15054,670
1,11,4,12,9,15320,15289,31
1,11,5,12,9,14570,15512,-942
1,11,6,12,9,13707,16182,-2475
1,12,0,12,9,15322,12364,2958
1,12,1,12,9,14686,12742,1944
1,12,2,12,9,14609,13238,1371
1,12,3,12,9,14624,13952,672
1,12,4,12,9,14215,14110,105
1,12,5,12,9,13539,14344,-805
1,12,6,12,9,12694,15019,-2325
1,0,0,13,9,12999,11955,1044
1,0,1,13,9,12729,12147,582
1,0,2,13,9,12549,12411,138
1,0,3,13,9,12485,12678,-193
1,0,4,13,9,12533,12880,-347
1,0,5,13,9,12240,13179,-939
1,0,6,13,9,12024,13426,-1402
1,1,0,13,9,13682,12253,1429
1,1,1,13,9,13373,12556,817
1,1,2,13,9,13145,12921,224
1,1,3,13,9,13058,13276,-218
1,1,4,13,9,13089,13555,-466
1,1,5,13,9,12713,13949,-1236
1,1,6,13,9,12342,14241,-1899
1,2,0,13,9,14313,12520,1793
1,2,1,13,9,13952,12955,997
1,2,2,13,9,13689,13408,281
1,2,3,13,9,13584,13825,-241
1,2,4,13,9,13605,14182,-577
1,2,5,13,9,13173,14655,-1482
1,2,6,13,9,12655,15000,-2345
1,3,0,13,9,14951,12694,2257
1,3,1,13,9,14520,13297,1223
1,3,2,13,9,14212,13857,355
1,3,3,13,9,14099,14333,-234
1,3,4,13,9,14107,14779,-672
1,3,5,13,9,13562,15339,-1777
1,3,6,13,9,12878,15743,-2865
1,4,0,13,9,15482,13303,2179
1,4,1,13,9,15093,13940,1153
1,4,2,13,9,14839,14545,294
1,4,3,13,9,14792,15039,-247
1,4,4,13,9,14851,15484,-633
1,4,5,13,9,14248,16001,-1753
1,4,6,13,9,13463,16401,-2938
1,5,0,13,9,15879,13859,2020
1,5,1,13,9,15516,14445,1071
1,5,2,13,9,15368,15025,343
1,5,3,13,9,15394,15556,-162
1,5,4,13,9,15461,16018,-557
1,5,5,13,9,14815,16477,-1662
1,5,6,13,9,13973,16908,-2935
1,6,0,13,9,16193,14109,2084
1,6,1,13,9,15827,14682,1145
1,6,2,13,9,15717,15272,445
1,6,3,13,9,15806,15868,-62
1,6,4,13,9,15850,16333,-483
1,6,5,13,9,15101,16745,-1644
1,6,6,13,9,14227,17151,-2924
1,7,0,13,9,16574,14783,1791
1,7,1,13,9,16192,15300,892
1,7,2,13,9,16205,15777,428
1,7,3,13,9,16361,16391,-30
1,7,4,13,9,16349,16739,-390
1,7,5,13,9,15645,17021,-1376
1,7,6,13,9,14815,17471,-2656
1,8,0,13,9,17001,15038,1963
1,8,1,13,9,16595,15488,1107
1,8,2,13,9,16713,15909,804
1,8,3,13,9,16912,16593,319
1,8,4,13,9,16772,16849,-77
1,8,5,13,9,16059,17028,-969
1,8,6,13,9,15230,17577,-2347
1,9,0,13,9,16975,14230,2745
1,9,1,13,9,16398,14700,1698
1,9,2,13,9,16481,15216,1265
1,9,3,13,9,16619,15995,624
1,9,4,13,9,16264,16270,-6
1,9,5,13,9,15442,16537,-1095
1,9,6,13,9,14561,17242,-2681
1,10,0,13,9,17152,14544,2608
1,10,1,13,9,16592,14968,1624
1,10,2,13,9,16711,15454,1257
1,10,3,13,9,16867,16205,662
1,10,4,13,9,16512,16397,115
1,10,5,13,9,15746,16587,-841
1,10,6,13,9,14889,17239,-2350
1,11,0,13,9,16871,14156,2715
1,11,1,13,9,16274,14540,1734
1,11,2,13,9,16291,15053,1238
1,11,3,13,9,16394,15802,592
1,11,4,13,9,16053,15938,115
1,11,5,13,9,15324,16145,-821
1,11,6,13,9,14488,16770,-2282
1,0,0,14,9,14629,13174,1455
1,0,1,14,9,14313,13484,829
1,0,2,14,9,14080,13855,225
1,0,3,14,9,13999,14206,-207
1,0,4,14,9,14034,14486,-452
1,0,5,14,9,13650,14886,-1236
1,0,6,14,9,13272,15176,-1904
1,1,0,14,9,15280,13474,1806
1,1,1,14,9,14919,13907,1012
1,1,2,14,9,14649,14358,291
1,1,3,14,9,14540,14773,-233
1,1,4,14,9,14558,15138,-580
1,1,5,14,9,14118,15621,-1503
1,1,6,14,9,13597,15963,-2366
1,2,0,14,9,15950,13684,2266
1,2,1,14,9,15526,14283,1243
1,2,2,14,9,15212,14841,371
1,2,3,14,9,15094,15313,-219
1,2,4,14,9,15101,15763,-662
1,2,5,14,9,14554,16330,-1776
1,2,6,14,9,13872,16730,-2858
1,3,0,14,9,16452,13947,2505
1,3,1,14,9,16020,14632,1388
1,3,2,14,9,15715,15292,423
1,3,3,14,9,15621,15830,-209
1,3,4,14,9,15637,16317,-680
1,3,5,14,9,14985,16882,-1897
1,3,6,14,9,14150,17328,-3178
1,4,0,14,9,16811,14321,2490
1,4,1,14,9,16385,14962,1423
1,4,2,14,9,16166,15617,549
1,4,3,14,9,16123,16218,-95
1,4,4,14,9,16119,16746,-627
1,4,5,14,9,15392,17273,-1881
1,4,6,14,9,14477,17767,-3290
1,5,0,14,9,17079,14683,2396
1,5,1,14,9,16667,15269,1398
1,5,2,14,9,16502,15899,603
1,5,3,14,9,16536,16546,-10
1,5,4,14,9,16526,17065,-539
1,5,5,14,9,15717,17530,-1813
1,5,6,14,9,14799,17979,-3180
1,6,0,14,9,17379,15407,1972
1,6,1,14,9,16946,15926,1020
1,6,2,14,9,16904,16421,483
1,6,3,14,9,17020,17063,-43
1,6,4,14,9,16988,17449,-461
1,6,5,14,9,16266,17778,-1512
1,6,6,14,9,15422,18275,-2853
1,7,0,14,9,17774,15903,1871
1,7,1,14,9,17334,16336,998
1,7,2,14,9,17424,16737,687
1,7,3,14,9,17632,17394,238
1,7,4,14,9,17542,17635,-93
1,7,5,14,9,16887,17826,-939
1,7,6,14,9,16098,18403,-2305
1,8,0,14,9,17981,15465,2516
1,8,1,14,9,17413,15929,1484
1,8,2,14,9,17485,16408,1077
1,8,3,14,9,17639,17149,490
1,8,4,14,9,17352,17406,-54
1,8,5,14,9,16613,17645,-1032
1,8,6,14,9,15776,18343,-2567
1,9,0,14,9,17710,14922,2788
1,9,1,14,9,17085,15363,1722
1,9,2,14,9,17164,15867,1297
1,9,3,14,9,17287,16633,654
1,9,4,14,9,16928,16846,82
1,9,5,14,9,16149,17084,-935
1,9,6,14,9,15264,17812,-2548
1,10,0,14,9,17843,15339,2504
1,10,1,14,9,17270,15707,1563
1,10,2,14,9,17375,16208,1167
1,10,3,14,9,17537,16953,584
1,10,4,14,9,17245,17046,199
1,10,5,14,9,16500,17220,-720
1,10,6,14,9,15670,17827,-2157
1,0,0,15,9,16227,14395,1832
1,0,1,15,9,15859,14835,1024
1,0,2,15,9,15584,15292,292
1,0,3,15,9,15481,15703,-222
1,0,4,15,9,15503,16069,-566
1,0,5,15,9,15055,16558,-1503
1,0,6,15,9,14527,16898,-2371
1,1,0,15,9,16917,14638,2279
1,1,1,15,9,16493,15235,1258
1,1,2,15,9,16172,15791,381
1,1,3,15,9,16050,16261,-211
1,1,4,15,9,16054,16719,-665
1,1,5,15,9,15499,17296,-1797
1,1,6,15,9,14814,17693,-2879
1,2,0,15,9,17451,14937,2514
1,2,1,15,9,17026,15618,1408
1,2,2,15,9,16715,16276,439
1,2,3,15,9,16616,16810,-194
1,2,4,15,9,16631,17301,-670
1,2,5,15,9,15977,17873,-1896
1,2,6,15,9,15144,18315,-3171
1,3,0,15,9,17781,14965,2816
1,3,1,15,9,17312,15654,1658
1,3,2,15,9,17042,16364,678
1,3,3,15,9,16952,17009,-57
1,3,4,15,9,16905,17579,-674
1,3,5,15,9,16129,18154,-2025
1,3,6,15,9,15164,18694,-3530
1,4,0,15,9,18011,15145,2866
1,4,1,15,9,17536,15786,1750
1,4,2,15,9,17300,16491,809
1,4,3,15,9,17265,17208,57
1,4,4,15,9,17184,17793,-609
1,4,5,15,9,16294,18326,-2032
1,4,6,15,9,15303,18838,-3535
1,5,0,15,9,18265,15981,2284
1,5,1,15,9,17786,16513,1273
1,5,2,15,9,17689,17048,641
1,5,3,15,9,17750,17741,9
1,5,4,15,9,17664,18181,-517
1,5,5,15,9,16882,18563,-1681
1,5,6,15,9,15994,19103,-3109
1,6,0,15,9,18579,16527,2052
1,6,1,15,9,18088,16962,1126
1,6,2,15,9,18123,17381,742
1,6,3,15,9,18291,18066,225
1,6,4,15,9,18181,18345,-164
1,6,5,15,9,17508,18583,-1075
1,6,6,15,9,16705,19207,-2502
1,7,0,15,9,18754,16330,2424
1,7,1,15,9,18152,16777,1375
1,7,2,15,9,18196,17236,960
1,7,3,15,9,18359,17950,409
1,7,4,15,9,18122,18192,-70
1,7,5,15,9,17441,18443,-1002
1,7,6,15,9,16644,19169,-2525
1,8,0,15,9,18716,16157,2559
1,8,1,15,9,18100,16592,1508
1,8,2,15,9,18168,17059,1109
1,8,3,15,9,18307,17787,520
1,8,4,15,9,18016,17982,34
1,8,5,15,9,17320,18192,-872
1,8,6,15,9,16479,18913,-2434
1,9,0,15,9,18401,15717,2684
1,9,1,15,9,17763,16102,1661
1,9,2,15,9,17828,16621,1207
1,9,3,15,9,17957,17381,576
1,9,4,15,9,17661,17495,166
1,9,5,15,9,16903,17717,-814
1,9,6,15,9,16045,18400,-2355
1,0,0,16,9,17864,15559,2305
1,0,1,16,9,17433,16163,1270
1,0,2,16,9,17107,16725,382
1,0,3,16,9,16991,17191,-200
1,0,4,16,9,16999,17650,-651
1,0,5,16,9,16436,18233,-1797
1,0,6,16,9,15744,18628,-2884
1,1,0,16,9,18418,15891,2527
1,1,1,16,9,17993,16570,1423
1,1,2,16,9,17675,17226,449
1,1,3,16,9,17572,17758,-186
1,1,4,16,9,17584,18257,-673
1,1,5,16,9,16922,18839,-1917
1,1,6,16,9,16086,19278,-3192
1,2,0,16,9,18780,15955,2825
1,2,1,16,9,18318,16640,1678
1,2,2,16,9,18042,17348,694
1,2,3,16,9,17947,17989,-42
1,2,4,16,9,17899,18563,-664
1,2,5,16,9,17121,19145,-2024
1,2,6,16,9,16158,19681,-3523
1,3,0,16,9,18981,15789,3192
1,3,1,16,9,18463,16478,1985
1,3,2,16,9,18176,17238,938
1,3,3,16,9,18094,17999,95
1,3,4,16,9,17970,18626,-656
1,3,5,16,9,17031,19207,-2176
1,3,6,16,9,15990,19765,-3775
1,4,0,16,9,19197,16443,2754
1,4,1,16,9,18655,17030,1625
1,4,2,16,9,18487,17640,847
1,4,3,16,9,18479,18403,76
1,4,4,16,9,18322,18909,-587
1,4,5,16,9,17459,19359,-1900
1,4,6,16,9,16498,19962,-3464
1,5,0,16,9,19465,17101,2364
1,5,1,16,9,18928,17549,1379
1,5,2,16,9,18908,18008,900
1,5,3,16,9,19021,18744,277
1,5,4,16,9,18857,19077,-220
1,5,5,16,9,18124,19368,-1244
1,5,6,16,9,17277,20035,-2758
1,6,0,16,9,19559,16954,2605
1,6,1,16,9,18906,17403,1503
1,6,2,16,9,18895,17880,1015
1,6,3,16,9,19018,18622,396
1,6,4,16,9,18761,18902,-141
1,6,5,16,9,18062,19200,-1138
1,6,6,16,9,17251,19973,-2722
1,7,0,16,9,19489,17022,2467
1,7,1,16,9,18839,17440,1399
1,7,2,16,9,18879,17887,992
1,7,3,16,9,19027,18588,439
1,7,4,16,9,18786,18768,18
1,7,5,16,9,18148,18990,-842
1,7,6,16,9,17347,19739,-2392
1,8,0,16,9,19407,16952,2455
1,8,1,16,9,18778,17331,1447
1,8,2,16,9,18832,17813,1019
1,8,3,16,9,18977,18535,442
1,8,4,16,9,18749,18631,118
1,8,5,16,9,18074,18825,-751
1,8,6,16,9,17260,19501,-2241
1,0,0,17,9,19365,16812,2553
1,0,1,17,9,18933,17498,1435
1,0,2,17,9,18610,18160,450
1,0,3,17,9,18513,18688,-175
1,0,4,17,9,18529,19188,-659
1,0,5,17,9,17859,19776,-1917
1,0,6,17,9,17016,20213,-3197
1,1,0,17,9,19747,16909,2838
1,1,1,17,9,19285,17592,1693
1,1,2,17,9,19002,18298,704
1,1,3,17,9,18903,18937,-34
1,1,4,17,9,18852,19519,-667
1,1,5,17,9,18066,20111,-2045
1,1,6,17,9,17100,20644,-3544
1,2,0,17,9,19980,16779,3201
1,2,1,17,9,19469,17464,2005
1,2,2,17,9,19176,18222,954
1,2,3,17,9,19089,18979,110
1,2,4,17,9,18964,19610,-646
1,2,5,17,9,18023,20198,-2175
1,2,6,17,9,16984,20752,-3768
1,3,0,17,9,20167,17087,3080
1,3,1,17,9,19582,17722,1860
1,3,2,17,9,19363,18387,976
1,3,3,17,9,19308,19194,114
1,3,4,17,9,19108,19742,-634
1,3,5,17,9,18196,20240,-2044
1,3,6,17,9,17185,20889,-3704
1,4,0,17,9,20397,17563,2834
1,4,1,17,9,19797,18066,1731
1,4,2,17,9,19706,18600,1106
1,4,3,17,9,19750,19406,344
1,4,4,17,9,19515,19805,-290
1,4,5,17,9,18701,20164,-1463
1,4,6,17,9,17781,20894,-3113
1,5,0,17,9,20445,17528,2917
1,5,1,17,9,19746,17990,1756
1,5,2,17,9,19680,18507,1173
1,5,3,17,9,19748,19300,448
1,5,4,17,9,19437,19634,-197
1,5,5,17,9,18678,19985,-1307
1,5,6,17,9,17823,20801,-2978
1,6,0,17,9,20294,17646,2648
1,6,1,17,9,19593,18066,1527
1,6,2,17,9,19578,18531,1047
1,6,3,17,9,19686,19260,426
1,6,4,17,9,19425,19478,-53
1,6,5,17,9,18769,19747,-978
1,6,6,17,9,17954,20543,-2589
1,7,0,17,9,20180,17817,2363
1,7,1,17,9,19517,18179,1338
1,7,2,17,9,19543,18641,902
1,7,3,17,9,19697,19336,361
1,7,4,17,9,19519,19417,102
1,7,5,17,9,18902,19623,-721
1,7,6,17,9,18128,20327,-2199
1,0,0,18,9,20694,17830,2864
1,0,1,18,9,20225,18520,1705
1,0,2,18,9,19937,19232,705
1,0,3,18,9,19844,19867,-23
1,0,4,18,9,19797,20450,-653
1,0,5,18,9,19003,21048,-2045
1,0,6,18,9,18030,21579,-3549
1,1,0,18,9,20947,17733,3214
1,1,1,18,9,20436,18416,2020
1,1,2,18,9,20136,19172,964
1,1,3,18,9,20045,19927,118
1,1,4,18,9,19917,20566,-649
1,1,5,18,9,18968,21164,-2196
1,1,6,18,9,17926,21715,-3789
1,2,0,18,9,21166,18077,3089
1,2,1,18,9,20588,18708,1880
1,2,2,18,9,20363,19371,992
1,2,3,18,9,20303,20174,129
1,2,4,18,9,20102,20726,-624
1,2,5,18,9,19188,21231,-2043
1,2,6,18,9,18179,21876,-3697
1,3,0,18,9,21367,18207,3160
1,3,1,18,9,20724,18758,1966
1,3,2,18,9,20582,19347,1235
1,3,3,18,9,20579,20197,382
1,3,4,18,9,20301,20638,-337
1,3,5,18,9,19438,21045,-1607
1,3,6,18,9,18468,21821,-3353
1,4,0,18,9,21377,17990,3387
1,4,1,18,9,20615,18507,2108
1,4,2,18,9,20478,19099,1379
1,4,3,18,9,20477,19962,515
1,4,4,18,9,20095,20362,-267
1,4,5,18,9,19255,20781,-1526
1,4,6,18,9,18327,21660,-3333
1,5,0,18,9,21180,18220,2960
1,5,1,18,9,20433,18653,1780
1,5,2,18,9,20363,19158,1205
1,5,3,18,9,20416,19938,478
1,5,4,18,9,20101,20210,-109
1,5,5,18,9,19385,20532,-1147
1,5,6,18,9,18526,21371,-2845
1,6,0,18,9,20985,18441,2544
1,6,1,18,9,20271,18805,1466
1,6,2,18,9,20242,19285,957
1,6,3,18,9,20356,20008,348
1,6,4,18,9,20158,20127,31
1,6,5,18,9,19523,20380,-857
1,6,6,18,9,18735,21131,-2396
1,0,0,19,9,21894,18654,3240
1,0,1,19,9,21376,19344,2032
1,0,2,19,9,21071,20106,965
1,0,3,19,9,20986,20857,129
1,0,4,19,9,20862,21497,-635
1,0,5,19,9,19905,22101,-2196
1,0,6,19,9,18856,22650,-3794
1,1,0,19,9,22133,19031,3102
1,1,1,19,9,21555,19660,1895
1,1,2,19,9,21323,20321,1002
1,1,3,19,9,21259,21122,137
1,1,4,19,9,21055,21682,-627
1,1,5,19,9,20133,22197,-2064
1,1,6,19,9,19121,22839,-3718
1,2,0,19,9,22366,19197,3169
1,2,1,19,9,21730,19744,1986
1,2,2,19,9,21582,20331,1251
1,2,3,19,9,21574,21177,397
1,2,4,19,9,21295,21622,-327
1,2,5,19,9,20430,22036,-1606
1,2,6,19,9,19462,22808,-3346
1,3,0,19,9,22347,18634,3713
1,3,1,19,9,21542,19199,2343
1,3,2,19,9,21354,19846,1508
1,3,3,19,9,21306,20753,553
1,3,4,19,9,20881,21195,-314
1,3,5,19,9,19992,21662,-1670
1,3,6,19,9,19014,22587,-3573
1,4,0,19,9,22112,18682,3430
1,4,1,19,9,21302,19170,2132
1,4,2,19,9,21161,19750,1411
1,4,3,19,9,21145,20600,545
1,4,4,19,9,20759,20938,-179
1,4,5,19,9,19962,21328,-1366
1,4,6,19,9,19030,22230,-3200
1,5,0,19,9,21871,19015,2856
1,5,1,19,9,21111,19392,1719
1,5,2,19,9,21027,19912,1115
1,5,3,19,9,21086,20686,400
1,5,4,19,9,20834,20859,-25
1,5,5,19,9,20139,21165,-1026
1,5,6,19,9,19307,21959,-2652
1,0,0,20,9,23080,19952,3128
1,0,1,20,9,22495,20588,1907
1,0,2,20,9,22258,21255,1003
1,0,3,20,9,22200,22052,148
1,0,4,20,9,22000,22613,-613
1,0,5,20,9,21070,23134,-2064
1,0,6,20,9,20051,23774,-3723
1,1,0,20,9,23333,20151,3182
1,1,1,20,9,22697,20696,2001
1,1,2,20,9,22542,21281,1261
1,1,3,20,9,22530,22125,405
1,1,4,20,9,22248,22578,-330
1,1,5,20,9,21375,23002,-1627
1,1,6,20,9,20404,23771,-3367
1,2,0,20,9,23346,19624,3722
1,2,1,20,9,22548,20185,2363
1,2,2,20,9,22354,20830,1524
1,2,3,20,9,22301,21733,568
1,2,4,20,9,21875,22179,-304
1,2,5,20,9,20984,22653,-1669
1,2,6,20,9,20008,23574,-3566
1,3,0,20,9,23082,19326,3756
1,3,1,20,9,22229,19862,2367
1,3,2,20,9,22037,20497,1540
1,3,3,20,9,21974,21391,583
1,3,4,20,9,21545,21771,-226
1,3,5,20,9,20699,22209,-1510
1,3,6,20,9,19717,23157,-3440
1,4,0,20,9,22803,19477,3326
1,4,1,20,9,21980,19909,2071
1,4,2,20,9,21825,20504,1321
1,4,3,20,9,21815,21348,467
1,4,4,20,9,21492,21587,-95
1,4,5,20,9,20716,21961,-1245
1,4,6,20,9,19811,22818,-3007
1,0,0,21,9,24280,21072,3208
1,0,1,21,9,23637,21624,2013
1,0,2,21,9,23477,22215,1262
1,0,3,21,9,23471,23055,416
1,0,4,21,9,23193,23509,-316
1,0,5,21,9,22312,23939,-1627
1,0,6,21,9,21334,24706,-3372
1,1,0,21,9,24313,20578,3735
1,1,1,21,9,23515,21137,2378
1,1,2,21,9,23314,21780,1534
1,1,3,21,9,23257,22681,576
1,1,4,21,9,22828,23135,-307
1,1,5,21,9,21929,23619,-1690
1,1,6,21,9,20950,24537,-3587
1,2,0,21,9,24081,20316,3765
1,2,1,21,9,23235,20848,2387
1,2,2,21,9,23037,21481,1556
1,2,3,21,9,22969,22371,598
1,2,4,21,9,22539,22755,-216
1,2,5,21,9,21691,23200,-1509
1,2,6,21,9,20711,24144,-3433
1,3,0,21,9,23773,20121,3652
1,3,1,21,9,22907,20601,2306
1,3,2,21,9,22701,21251,1450
1,3,3,21,9,22644,22139,505
1,3,4,21,9,22278,22420,-142
1,3,5,21,9,21453,22842,-1389
1,3,6,21,9,20498,23745,-3247
1,0,0,22,9,25260,21499,3761
1,0,1,22,9,24455,22065,2390
1,0,2,22,9,24249,22714,1535
1,0,3,22,9,24198,23611,587
1,0,4,22,9,23773,24066,-293
1,0,5,22,9,22866,24556,-1690
1,0,6,22,9,21880,25472,-3592
1,1,0,22,9,25048,21270,3778
1,1,1,22,9,24202,21800,2402
1,1,2,22,9,23997,22431,1566
1,1,3,22,9,23925,23319,606
1,1,4,22,9,23492,23711,-219
1,1,5,22,9,22636,24166,-1530
1,1,6,22,9,21653,25107,-3454
1,2,0,22,9,24772,21111,3661
1,2,1,22,9,23913,21587,2326
1,2,2,22,9,23701,22235,1466
1,2,3,22,9,23639,23119,520
1,2,4,22,9,23272,23404,-132
1,2,5,22,9,22445,23833,-1388
1,2,6,22,9,21492,24732,-3240
1,0,0,23,9,25995,22191,3804
1,0,1,23,9,25142,22728,2414
1,0,2,23,9,24932,23365,1567
1,0,3,23,9,24866,24249,617
1,0,4,23,9,24437,24642,-205
1,0,5,23,9,23573,25103,-1530
1,0,6,23,9,22583,26042,-3459
1,1,0,23,9,25739,22065,3674
1,1,1,23,9,24880,22539,2341
1,1,2,23,9,24661,23185,1476
1,1,3,23,9,24595,24067,528
1,1,4,23,9,24225,24360,-135
1,1,5,23,9,23390,24799,-1409
1,1,6,23,9,22434,25695,-3261
1,0,0,24,9,26686,22986,3700
1,0,1,24,9,25820,23467,2353
1,0,2,24,9,25596,24119,1477
1,0,3,24,9,25536,24997,539
1,0,4,24,9,25170,25291,-121
1,0,5,24,9,24327,25736,-1409
1,0,6,24,9,23364,26630,-3266
1,0,0,1,10,1050,1036,14
1,0,1,1,10,1042,1032,10
1,0,2,1,10,1037,1033,4
1,0,3,1,10,1043,1040,3
1,0,4,1,10,1048,1039,9
1,1,0,1,10,1073,1054,19
1,1,1,1,10,1071,1051,20
1,1,2,1,10,1063,1059,4
1,1,3,1,10,1059,1070,-11
1,1,4,1,10,1057,1068,-11
1,2,0,1,10,1112,1093,19
1,2,1,1,10,1115,1087,28
1,2,2,1,10,1107,1090,17
1,2,3,1,10,1101,1099,2
1,2,4,1,10,1102,1097,5
1,3,0,1,10,1039,813,226
1,3,1,1,10,993,854,139
1,3,2,1,10,939,895,44
1,3,3,1,10,891,944,-53
1,3,4,1,10,849,992,-143
1,4,0,1,10,983,640,343
1,4,1,1,10,917,707,210
1,4,2,1,10,843,772,71
1,4,3,1,10,773,841,-68
1,4,4,1,10,703,906,-203
1,5,0,1,10,954,694,260
1,5,1,1,10,907,743,164
1,5,2,1,10,850,797,53
1,5,3,1,10,795,850,-55
1,5,4,1,10,741,893,-152
1,6,0,1,10,874,713,161
1,6,1,1,10,823,741,82
1,6,2,1,10,768,779,-11
1,6,3,1,10,728,826,-98
1,6,4,1,10,708,872,-164
1,7,0,1,10,869,925,-56
1,7,1,1,10,836,900,-64
1,7,2,1,10,810,885,-75
1,7,3,1,10,819,896,-77
1,7,4,1,10,868,923,-55
1,8,0,1,10,1141,1322,-181
1,8,1,1,10,1145,1291,-146
1,8,2,1,10,1141,1282,-141
1,8,3,1,10,1166,1254,-88
1,8,4,1,10,1234,1239,-5
1,9,0,1,10,599,442,157
1,9,1,1,10,522,464,58
1,9,2,1,10,489,488,1
1,9,3,1,10,459,525,-66
1,9,4,1,10,444,600,-156
1,10,0,1,10,1100,1287,-187
1,10,1,1,10,1128,1270,-142
1,10,2,1,10,1203,1233,-30
1,10,3,1,10,1268,1207,61
1,10,4,1,10,1324,1181,143
1,11,0,1,10,1727,2009,-282
1,11,1,1,10,1782,2028,-246
1,11,2,1,10,1860,2019,-159
1,11,3,1,10,1961,2001,-40
1,11,4,1,10,2038,1935,103
1,12,0,1,10,1746,1644,102
1,12,1,1,10,1709,1748,-39
1,12,2,1,10,1677,1830,-153
1,12,3,1,10,1704,1898,-194
1,12,4,1,10,1689,1918,-229
1,13,0,1,10,1730,1550,180
1,13,1,1,10,1690,1621,69
1,13,2,1,10,1624,1716,-92
1,13,3,1,10,1624,1803,-179
1,13,4,1,10,1597,1841,-244
1,14,0,1,10,1698,1564,134
1,14,1,1,10,1673,1590,83
1,14,2,1,10,1597,1692,-95
1,14,3,1,10,1591,1784,-193
1,14,4,1,10,1581,1826,-245
1,15,0,1,10,1720,1551,169
1,15,1,1,10,1692,1582,110
1,15,2,1,10,1617,1686,-69
1,15,3,1,10,1615,1767,-152
1,15,4,1,10,1588,1816,-228
1,16,0,1,10,1608,1552,56
1,16,1,1,10,1617,1591,26
1,16,2,1,10,1597,1665,-68
1,16,3,1,10,1649,1655,-6
1,16,4,1,10,1642,1683,-41
1,17,0,1,10,1400,1182,218
1,17,1,1,10,1402,1246,156
1,17,2,1,10,1394,1345,49
1,17,3,1,10,1414,1355,59
1,17,4,1,10,1351,1427,-76
1,18,0,1,10,1273,949,324
1,18,1,1,10,1226,1074,152
1,18,2,1,10,1218,1154,64
1,18,3,1,10,1249,1128,121
1,18,4,1,10,1140,1174,-34
1,19,0,1,10,1309,1307,2
1,19,1,1,10,1277,1326,-49
1,19,2,1,10,1318,1274,44
1,19,3,1,10,1372,1190,182
1,19,4,1,10,1295,1234,61
1,20,0,1,10,1332,1113,219
1,20,1,1,10,1295,1123,172
1,20,2,1,10,1339,1048,291
1,20,3,1,10,1423,951,472
1,20,4,1,10,1339,1016,323
1,21,0,1,10,1021,525,496
1,21,1,1,10,844,600,244
1,21,2,1,10,816,645,171
1,21,3,1,10,815,653,162
1,21,4,1,10,616,790,-174
1,22,0,1,10,784,721,63
1,22,1,1,10,757,699,58
1,22,2,1,10,744,692,52
1,22,3,1,10,784,630,154
1,22,4,1,10,747,603,144
1,23,0,1,10,789,809,-20
1,23,1,1,10,733,808,-75
1,23,2,1,10,724,781,-57
1,23,3,1,10,802,723,79
1,23,4,1,10,823,680,143
1,0,0,2,10,2123,2090,33
1,0,1,2,10,2113,2083,30
1,0,2,2,10,2100,2092,8
1,0,3,2,10,2102,2110,-8
1,0,4,2,10,2105,2107,-2
1,1,0,2,10,2185,2147,38
1,1,1,2,10,2186,2138,48
1,1,2,2,10,2170,2149,21
1,1,3,2,10,2160,2169,-9
1,1,4,2,10,2159,2165,-6
1,2,0,2,10,2151,1906,245
1,2,1,2,10,2108,1941,167
1,2,2,2,10,2046,1985,61
1,2,3,2,10,1992,2043,-51
1,2,4,2,10,1951,2089,-138
1,3,0,2,10,2022,1453,569
1,3,1,2,10,1910,1561,349
1,3,2,2,10,1782,1667,115
1,3,3,2,10,1664,1785,-121
1,3,4,2,10,1552,1898,-346
1,4,0,2,10,1937,1334,603
1,4,1,2,10,1824,1450,374
1,4,2,2,10,1693,1569,124
1,4,3,2,10,1568,1691,-123
1,4,4,2,10,1444,1799,-355
1,5,0,2,10,1828,1407,421
1,5,1,2,10,1730,1484,246
1,5,2,2,10,1618,1576,42
1,5,3,2,10,1523,1676,-153
1,5,4,2,10,1449,1765,-316
1,6,0,2,10,1743,1638,105
1,6,1,2,10,1659,1641,18
1,6,2,2,10,1578,1664,-86
1,6,3,2,10,1547,1722,-175
1,6,4,2,10,1576,1795,-219
1,7,0,2,10,2010,2247,-237
1,7,1,2,10,1981,2191,-210
1,7,2,2,10,1951,2167,-216
1,7,3,2,10,1985,2150,-165
1,7,4,2,10,2102,2162,-60
1,8,0,2,10,1740,1764,-24
1,8,1,2,10,1667,1755,-88
1,8,2,2,10,1630,1770,-140
1,8,3,2,10,1625,1779,-154
1,8,4,2,10,1678,1839,-161
1,9,0,2,10,1699,1729,-30
1,9,1,2,10,1650,1734,-84
1,9,2,2,10,1692,1721,-29
1,9,3,2,10,1727,1732,-5
1,9,4,2,10,1768,1781,-13
1,10,0,2,10,2827,3296,-469
1,10,1,2,10,2910,3298,-388
1,10,2,2,10,3063,3252,-189
1,10,3,2,10,3229,3208,21
1,10,4,2,10,3362,3116,246
1,11,0,2,10,3473,3653,-180
1,11,1,2,10,3491,3776,-285
1,11,2,2,10,3537,3849,-312
1,11,3,2,10,3665,3899,-234
1,11,4,2,10,3727,3853,-126
1,12,0,2,10,3476,3194,282
1,12,1,2,10,3399,3369,30
1,12,2,2,10,3301,3546,-245
1,12,3,2,10,3328,3701,-373
1,12,4,2,10,3286,3759,-473
1,13,0,2,10,3428,3114,314
1,13,1,2,10,3363,3211,152
1,13,2,2,10,3221,3408,-187
1,13,3,2,10,3215,3587,-372
1,13,4,2,10,3178,3667,-489
1,14,0,2,10,3418,3115,303
1,14,1,2,10,3365,3172,193
1,14,2,2,10,3214,3378,-164
1,14,3,2,10,3206,3551,-345
1,14,4,2,10,3169,3642,-473
1,15,0,2,10,3328,3103,225
1,15,1,2,10,3309,3173,136
1,15,2,2,10,3214,3351,-137
1,15,3,2,10,3264,3422,-158
1,15,4,2,10,3230,3499,-269
1,16,0,2,10,3008,2734,274
1,16,1,2,10,3019,2837,182
1,16,2,2,10,2991,3010,-19
1,16,3,2,10,3063,3010,53
1,16,4,2,10,2993,3110,-117
1,17,0,2,10,2673,2131,542
1,17,1,2,10,2628,2320,308
1,17,2,2,10,2612,2499,113
1,17,3,2,10,2663,2483,180
1,17,4,2,10,2491,2601,-110
1,18,0,2,10,2582,2256,326
1,18,1,2,10,2503,2400,103
1,18,2,2,10,2536,2428,108
1,18,3,2,10,2621,2318,303
1,18,4,2,10,2435,2408,27
1,19,0,2,10,2641,2420,221
1,19,1,2,10,2572,2449,123
1,19,2,2,10,2657,2322,335
1,19,3,2,10,2795,2141,654
1,19,4,2,10,2634,2250,384
1,20,0,2,10,2353,1638,715
1,20,1,2,10,2139,1723,416
1,20,2,2,10,2155,1693,462
1,20,3,2,10,2238,1604,634
1,20,4,2,10,1955,1806,149
1,21,0,2,10,1805,1246,559
1,21,1,2,10,1601,1299,302
1,21,2,2,10,1560,1337,223
1,21,3,2,10,1599,1283,316
1,21,4,2,10,1363,1393,-30
1,22,0,2,10,1573,1530,43
1,22,1,2,10,1490,1507,-17
1,22,2,2,10,1468,1473,-5
1,22,3,2,10,1586,1353,233
1,22,4,2,10,1570,1283,287
1,0,0,3,10,3235,3183,52
1,0,1,3,10,3228,3170,58
1,0,2,3,10,3207,3182,25
1,0,3,3,10,3203,3209,-6
1,0,4,3,10,3207,3204,3
1,1,0,3,10,3224,2960,264
1,1,1,3,10,3179,2992,187
1,1,2,3,10,3109,3044,65
1,1,3,3,10,3051,3113,-62
1,1,4,3,10,3008,3157,-149
1,2,0,3,10,3134,2546,588
1,2,1,3,10,3025,2648,377
1,2,2,3,10,2889,2757,132
1,2,3,3,10,2765,2884,-119
1,2,4,3,10,2654,2995,-341
1,3,0,3,10,2976,2147,829
1,3,1,3,10,2817,2304,513
1,3,2,3,10,2632,2464,168
1,3,3,3,10,2459,2635,-176
1,3,4,3,10,2293,2791,-498
1,4,0,3,10,2811,2047,764
1,4,1,3,10,2647,2191,456
1,4,2,3,10,2461,2348,113
1,4,3,3,10,2296,2517,-221
1,4,4,3,10,2152,2671,-519
1,5,0,3,10,2697,2332,365
1,5,1,3,10,2566,2384,182
1,5,2,3,10,2428,2461,-33
1,5,3,3,10,2342,2572,-230
1,5,4,3,10,2317,2688,-371
1,6,0,3,10,2884,2960,-76
1,6,1,3,10,2804,2932,-128
1,6,2,3,10,2719,2946,-227
1,6,3,3,10,2713,2976,-263
1,6,4,3,10,2810,3034,-224
1,7,0,3,10,2609,2689,-80
1,7,1,3,10,2503,2655,-152
1,7,2,3,10,2440,2655,-215
1,7,3,3,10,2444,2675,-231
1,7,4,3,10,2546,2762,-216
1,8,0,3,10,2840,3051,-211
1,8,1,3,10,2795,3025,-230
1,8,2,3,10,2833,3003,-170
1,8,3,3,10,2893,2986,-93
1,8,4,3,10,3002,3020,-18
1,9,0,3,10,3426,3738,-312
1,9,1,3,10,3432,3762,-330
1,9,2,3,10,3552,3740,-188
1,9,3,3,10,3688,3733,-45
1,9,4,3,10,3806,3716,90
1,10,0,3,10,4573,4940,-367
1,10,1,3,10,4619,5046,-427
1,10,2,3,10,4740,5082,-342
1,10,3,3,10,4933,5106,-173
1,10,4,3,10,5051,5034,17
1,11,0,3,10,5203,5203,0
1,11,1,3,10,5181,5397,-216
1,11,2,3,10,5161,5565,-404
1,11,3,3,10,5289,5702,-413
1,11,4,3,10,5324,5694,-370
1,12,0,3,10,5174,4758,416
1,12,1,3,10,5072,4959,113
1,12,2,3,10,4898,5238,-340
1,12,3,3,10,4919,5485,-566
1,12,4,3,10,4867,5585,-718
1,13,0,3,10,5148,4665,483
1,13,1,3,10,5055,4793,262
1,13,2,3,10,4838,5094,-256
1,13,3,3,10,4830,5354,-524
1,13,4,3,10,4766,5483,-717
1,14,0,3,10,5026,4667,359
1,14,1,3,10,4982,4763,219
1,14,2,3,10,4811,5043,-232
1,14,3,3,10,4855,5206,-351
1,14,4,3,10,4811,5325,-514
1,15,0,3,10,4728,4285,443
1,15,1,3,10,4711,4419,292
1,15,2,3,10,4608,4696,-88
1,15,3,3,10,4678,4777,-99
1,15,4,3,10,4581,4926,-345
1,16,0,3,10,4281,3683,598
1,16,1,3,10,4245,3911,334
1,16,2,3,10,4209,4164,45
1,16,3,3,10,4312,4138,174
1,16,4,3,10,4133,4284,-151
1,17,0,3,10,3982,3438,544
1,17,1,3,10,3905,3646,259
1,17,2,3,10,3930,3773,157
1,17,3,3,10,4035,3673,362
1,17,4,3,10,3786,3835,-49
1,18,0,3,10,3914,3369,545
1,18,1,3,10,3798,3523,275
1,18,2,3,10,3875,3476,399
1,18,3,3,10,4044,3269,775
1,18,4,3,10,3774,3424,350
1,19,0,3,10,3662,2945,717
1,19,1,3,10,3416,3049,367
1,19,2,3,10,3473,2967,506
1,19,3,3,10,3610,2794,816
1,19,4,3,10,3250,3040,210
1,20,0,3,10,3137,2359,778
1,20,1,3,10,2896,2422,474
1,20,2,3,10,2899,2385,514
1,20,3,3,10,3022,2234,788
1,20,4,3,10,2702,2409,293
1,21,0,3,10,2594,2055,539
1,21,1,3,10,2334,2107,227
1,21,2,3,10,2284,2118,166
1,21,3,3,10,2401,2006,395
1,21,4,3,10,2186,2073,113
1,0,0,4,10,4274,3996,278
1,0,1,4,10,4221,4024,197
1,0,2,4,10,4146,4077,69
1,0,3,4,10,4094,4153,-59
1,0,4,4,10,4056,4196,-140
1,1,0,4,10,4207,3600,607
1,1,1,4,10,4096,3699,397
1,1,2,4,10,3952,3816,136
1,1,3,4,10,3824,3954,-130
1,1,4,4,10,3711,4063,-352
1,2,0,4,10,4088,3240,848
1,2,1,4,10,3932,3391,541
1,2,2,4,10,3739,3554,185
1,2,3,4,10,3560,3734,-174
1,2,4,4,10,3395,3888,-493
1,3,0,4,10,3850,2860,990
1,3,1,4,10,3640,3045,595
1,3,2,4,10,3400,3243,157
1,3,3,4,10,3187,3461,-274
1,3,4,4,10,3001,3663,-662
1,4,0,4,10,3680,2972,708
1,4,1,4,10,3483,3091,392
1,4,2,4,10,3271,3233,38
1,4,3,4,10,3115,3413,-298
1,4,4,4,10,3020,3594,-574
1,5,0,4,10,3838,3654,184
1,5,1,4,10,3711,3675,36
1,5,2,4,10,3569,3743,-174
1,5,3,4,10,3508,3826,-318
1,5,4,4,10,3551,3927,-376
1,6,0,4,10,3483,3402,81
1,6,1,4,10,3326,3396,-70
1,6,2,4,10,3208,3434,-226
1,6,3,4,10,3172,3501,-329
1,6,4,4,10,3254,3634,-380
1,7,0,4,10,3709,3976,-267
1,7,1,4,10,3631,3925,-294
1,7,2,4,10,3643,3888,-245
1,7,3,4,10,3712,3882,-170
1,7,4,4,10,3870,3943,-73
1,8,0,4,10,4567,5060,-493
1,8,1,4,10,4577,5053,-476
1,8,2,4,10,4693,5022,-329
1,8,3,4,10,4854,4987,-133
1,8,4,4,10,5040,4955,85
1,9,0,4,10,5172,5382,-210
1,9,1,4,10,5141,5510,-369
1,9,2,4,10,5229,5570,-341
1,9,3,4,10,5392,5631,-239
1,9,4,4,10,5495,5634,-139
1,10,0,4,10,6303,6490,-187
1,10,1,4,10,6309,6667,-358
1,10,2,4,10,6364,6798,-434
1,10,3,4,10,6557,6909,-352
1,10,4,4,10,6648,6875,-227
1,11,0,4,10,6901,6767,134
1,11,1,4,10,6854,6987,-133
1,11,2,4,10,6758,7257,-499
1,11,3,4,10,6880,7486,-606
1,11,4,4,10,6905,7520,-615
1,12,0,4,10,6894,6309,585
1,12,1,4,10,6764,6541,223
1,12,2,4,10,6515,6924,-409
1,12,3,4,10,6534,7252,-718
1,12,4,4,10,6455,7401,-946
1,13,0,4,10,6756,6217,539
1,13,1,4,10,6672,6384,288
1,13,2,4,10,6435,6759,-324
1,13,3,4,10,6479,7009,-530
1,13,4,4,10,6408,7166,-758
1,14,0,4,10,6426,5849,577
1,14,1,4,10,6384,6009,375
1,14,2,4,10,6205,6388,-183
1,14,3,4,10,6269,6561,-292
1,14,4,4,10,6162,6752,-590
1,15,0,4,10,6001,5234,767
1,15,1,4,10,5937,5493,444
1,15,2,4,10,5826,5850,-24
1,15,3,4,10,5927,5905,22
1,15,4,4,10,5721,6100,-379
1,16,0,4,10,5590,4990,600
1,16,1,4,10,5522,5237,285
1,16,2,4,10,5527,5438,89
1,16,3,4,10,5684,5328,356
1,16,4,4,10,5428,5518,-90
1,17,0,4,10,5314,4551,763
1,17,1,4,10,5200,4769,431
1,17,2,4,10,5269,4821,448
1,17,3,4,10,5458,4624,834
1,17,4,4,10,5125,4851,274
1,18,0,4,10,4935,3894,1041
1,18,1,4,10,4642,4123,519
1,18,2,4,10,4691,4121,570
1,18,3,4,10,4859,3922,937
1,18,4,4,10,4390,4214,176
1,19,0,4,10,4446,3666,780
1,19,1,4,10,4173,3748,425
1,19,2,4,10,4217,3659,558
1,19,3,4,10,4394,3424,970
1,19,4,4,10,3997,3643,354
1,20,0,4,10,3926,3168,758
1,20,1,4,10,3629,3230,399
1,20,2,4,10,3623,3166,457
1,20,3,4,10,3824,2957,867
1,20,4,4,10,3525,3089,436
1,0,0,5,10,5257,4636,621
1,0,1,5,10,5138,4731,407
1,0,2,5,10,4989,4849,140
1,0,3,5,10,4867,4994,-127
1,0,4,5,10,4759,5102,-343
1,1,0,5,10,5161,4294,867
1,1,1,5,10,5003,4442,561
1,1,2,5,10,4802,4613,189
1,1,3,5,10,4619,4804,-185
1,1,4,5,10,4452,4956,-504
1,2,0,5,10,4962,3953,1009
1,2,1,5,10,4755,4132,623
1,2,2,5,10,4507,4333,174
1,2,3,5,10,4288,4560,-272
1,2,4,5,10,4103,4760,-657
1,3,0,5,10,4719,3785,934
1,3,1,5,10,4476,3945,531
1,3,2,5,10,4210,4128,82
1,3,3,5,10,4006,4357,-351
1,3,4,5,10,3869,4586,-717
1,4,0,5,10,4821,4294,527
1,4,1,5,10,4628,4382,246
1,4,2,5,10,4412,4515,-103
1,4,3,5,10,4281,4667,-386
1,4,4,5,10,4254,4833,-579
1,5,0,5,10,4437,4096,341
1,5,1,5,10,4233,4139,94
1,5,2,5,10,4058,4231,-173
1,5,3,5,10,3967,4351,-384
1,5,4,5,10,3995,4527,-532
1,6,0,5,10,4583,4689,-106
1,6,1,5,10,4454,4666,-212
1,6,2,5,10,4411,4667,-256
1,6,3,5,10,4440,4708,-268
1,6,4,5,10,4578,4815,-237
1,7,0,5,10,5436,5985,-549
1,7,1,5,10,5413,5953,-540
1,7,2,5,10,5503,5907,-404
1,7,3,5,10,5673,5883,-210
1,7,4,5,10,5908,5878,30
1,8,0,5,10,6313,6704,-391
1,8,1,5,10,6286,6801,-515
1,8,2,5,10,6370,6852,-482
1,8,3,5,10,6558,6885,-327
1,8,4,5,10,6729,6873,-144
1,9,0,5,10,6902,6932,-30
1,9,1,5,10,6831,7131,-300
1,9,2,5,10,6853,7286,-433
1,9,3,5,10,7016,7434,-418
1,9,4,5,10,7092,7475,-383
1,10,0,5,10,8001,8054,-53
1,10,1,5,10,7982,8257,-275
1,10,2,5,10,7961,8490,-529
1,10,3,5,10,8148,8693,-545
1,10,4,5,10,8229,8701,-472
1,11,0,5,10,8621,8318,303
1,11,1,5,10,8546,8569,-23
1,11,2,5,10,8375,8943,-568
1,11,3,5,10,8495,9253,-758
1,11,4,5,10,8493,9336,-843
1,12,0,5,10,8502,7861,641
1,12,1,5,10,8381,8132,249
1,12,2,5,10,8112,8589,-477
1,12,3,5,10,8183,8907,-724
1,12,4,5,10,8097,9084,-987
1,13,0,5,10,8156,7399,757
1,13,1,5,10,8074,7630,444
1,13,2,5,10,7829,8104,-275
1,13,3,5,10,7893,8364,-471
1,13,4,5,10,7759,8593,-834
1,14,0,5,10,7699,6798,901
1,14,1,5,10,7610,7083,527
1,14,2,5,10,7423,7542,-119
1,14,3,5,10,7518,7689,-171
1,14,4,5,10,7302,7926,-624
1,15,0,5,10,7310,6541,769
1,15,1,5,10,7214,6819,395
1,15,2,5,10,7144,7124,20
1,15,3,5,10,7299,7095,204
1,15,4,5,10,7016,7334,-318
1,16,0,5,10,6922,6103,819
1,16,1,5,10,6817,6360,457
1,16,2,5,10,6866,6486,380
1,16,3,5,10,7107,6279,828
1,16,4,5,10,6767,6534,233
1,17,0,5,10,6335,5076,1259
1,17,1,5,10,6044,5369,675
1,17,2,5,10,6085,5466,619
1,17,3,5,10,6273,5277,996
1,17,4,5,10,5741,5641,100
1,18,0,5,10,5719,4615,1104
1,18,1,5,10,5399,4822,577
1,18,2,5,10,5435,4813,622
1,18,3,5,10,5643,4552,1091
1,18,4,5,10,5137,4817,320
1,19,0,5,10,5235,4475,760
1,19,1,5,10,4906,4556,350
1,19,2,5,10,4941,4440,501
1,19,3,5,10,5196,4147,1049
1,19,4,5,10,4820,4323,497
1,0,0,6,10,6211,5330,881
1,0,1,6,10,6045,5474,571
1,0,2,6,10,5839,5646,193
1,0,3,6,10,5662,5844,-182
1,0,4,6,10,5500,5995,-495
1,1,0,6,10,6035,5007,1028
1,1,1,6,10,5826,5183,643
1,1,2,6,10,5570,5392,178
1,1,3,6,10,5347,5630,-283
1,1,4,6,10,5160,5828,-668
1,2,0,6,10,5831,4878,953
1,2,1,6,10,5591,5032,559
1,2,2,6,10,5317,5218,99
1,2,3,6,10,5107,5456,-349
1,2,4,6,10,4971,5683,-712
1,3,0,6,10,5860,5107,753
1,3,1,6,10,5621,5236,385
1,3,2,6,10,5351,5410,-59
1,3,3,6,10,5172,5611,-439
1,3,4,6,10,5103,5825,-722
1,4,0,6,10,5420,4736,684
1,4,1,6,10,5150,4846,304
1,4,2,6,10,4901,5003,-102
1,4,3,6,10,4740,5192,-452
1,4,4,6,10,4698,5433,-735
1,5,0,6,10,5537,5383,154
1,5,1,6,10,5361,5409,-48
1,5,2,6,10,5261,5464,-203
1,5,3,6,10,5235,5558,-323
1,5,4,6,10,5319,5708,-389
1,6,0,6,10,6310,6698,-388
1,6,1,6,10,6236,6694,-458
1,6,2,6,10,6271,6686,-415
1,6,3,6,10,6401,6709,-308
1,6,4,6,10,6616,6750,-134
1,7,0,6,10,7182,7629,-447
1,7,1,6,10,7122,7701,-579
1,7,2,6,10,7180,7737,-557
1,7,3,6,10,7377,7781,-404
1,7,4,6,10,7597,7796,-199
1,8,0,6,10,8043,8254,-211
1,8,1,6,10,7976,8422,-446
1,8,2,6,10,7994,8568,-574
1,8,3,6,10,8182,8688,-506
1,8,4,6,10,8326,8714,-388
1,9,0,6,10,8600,8496,104
1,9,1,6,10,8504,8721,-217
1,9,2,6,10,8450,8978,-528
1,9,3,6,10,8607,9218,-611
1,9,4,6,10,8673,9301,-628
1,10,0,6,10,9721,9605,116
1,10,1,6,10,9674,9839,-165
1,10,2,6,10,9578,10176,-598
1,10,3,6,10,9763,10460,-697
1,10,4,6,10,9817,10517,-700
1,11,0,6,10,10229,9870,359
1,11,1,6,10,10163,10160,3
1,11,2,6,10,9972,10608,-636
1,11,3,6,10,10144,10908,-764
1,11,4,6,10,10135,11019,-884
1,12,0,6,10,9902,9043,859
1,12,1,6,10,9783,9378,405
1,12,2,6,10,9506,9934,-428
1,12,3,6,10,9597,10262,-665
1,12,4,6,10,9448,10511,-1063
1,13,0,6,10,9429,8348,1081
1,13,1,6,10,9300,8704,596
1,13,2,6,10,9047,9258,-211
1,13,3,6,10,9142,9492,-350
1,13,4,6,10,8899,9767,-868
1,14,0,6,10,9008,8105,903
1,14,1,6,10,8887,8409,478
1,14,2,6,10,8741,8816,-75
1,14,3,6,10,8890,8879,11
1,14,4,6,10,8597,9160,-563
1,15,0,6,10,8642,7654,988
1,15,1,6,10,8509,7942,567
1,15,2,6,10,8483,8172,311
1,15,3,6,10,8722,8046,676
1,15,4,6,10,8355,8350,5
1,16,0,6,10,7943,6628,1315
1,16,1,6,10,7661,6960,701
1,16,2,6,10,7682,7131,551
1,16,3,6,10,7922,6932,990
1,16,4,6,10,7383,7324,59
1,17,0,6,10,7119,5797,1322
1,17,1,6,10,6801,6068,733
1,17,2,6,10,6829,6158,671
1,17,3,6,10,7057,5907,1150
1,17,4,6,10,6488,6244,244
1,18,0,6,10,6508,5424,1084
1,18,1,6,10,6132,5630,502
1,18,2,6,10,6159,5594,565
1,18,3,6,10,6445,5275,1170
1,18,4,6,10,5960,5497,463
1,0,0,7,10,7085,6043,1042
1,0,1,7,10,6868,6215,653
1,0,2,7,10,6607,6425,182
1,0,3,7,10,6390,6670,-280
1,0,4,7,10,6208,6867,-659
1,1,0,7,10,6904,5932,972
1,1,1,7,10,6662,6083,579
1,1,2,7,10,6380,6277,103
1,1,3,7,10,6166,6526,-360
1,1,4,7,10,6028,6751,-723
1,2,0,7,10,6972,6200,772
1,2,1,7,10,6736,6323,413
1,2,2,7,10,6458,6500,-42
1,2,3,7,10,6273,6710,-437
1,2,4,7,10,6205,6922,-717
1,3,0,7,10,6459,5549,910
1,3,1,7,10,6143,5700,443
1,3,2,7,10,5840,5898,-58
1,3,3,7,10,5631,6136,-505
1,3,4,7,10,5547,6425,-878
1,4,0,7,10,6520,6023,497
1,4,1,7,10,6278,6116,162
1,4,2,7,10,6104,6236,-132
1,4,3,7,10,6008,6399,-391
1,4,4,7,10,6022,6614,-592
1,5,0,7,10,7264,7392,-128
1,5,1,7,10,7143,7437,-294
1,5,2,7,10,7121,7483,-362
1,5,3,7,10,7196,7559,-363
1,5,4,7,10,7357,7643,-286
1,6,0,7,10,8056,8342,-286
1,6,1,7,10,7945,8442,-497
1,6,2,7,10,7948,8516,-568
1,6,3,7,10,8105,8607,-502
1,6,4,7,10,8305,8668,-363
1,7,0,7,10,8912,9179,-267
1,7,1,7,10,8812,9322,-510
1,7,2,7,10,8804,9453,-649
1,7,3,7,10,9001,9584,-583
1,7,4,7,10,9194,9637,-443
1,8,0,7,10,9741,9818,-77
1,8,1,7,10,9649,10012,-363
1,8,2,7,10,9591,10260,-669
1,8,3,7,10,9773,10472,-699
1,8,4,7,10,9907,10540,-633
1,9,0,7,10,10320,10047,273
1,9,1,7,10,10196,10303,-107
1,9,2,7,10,10067,10664,-597
1,9,3,7,10,10222,10985,-763
1,9,4,7,10,10261,11117,-856
1,10,0,7,10,11329,11157,172
1,10,1,7,10,11291,11430,-139
1,10,2,7,10,11175,11841,-666
1,10,3,7,10,11412,12115,-703
1,10,4,7,10,11459,12200,-741
1,11,0,7,10,11629,11052,577
1,11,1,7,10,11565,11406,159
1,11,2,7,10,11366,11953,-587
1,11,3,7,10,11558,12263,-705
1,11,4,7,10,11486,12446,-960
1,12,0,7,10,11175,9992,1183
1,12,1,7,10,11009,10452,557
1,12,2,7,10,10724,11088,-364
1,12,3,7,10,10846,11390,-544
1,12,4,7,10,10588,11685,-1097
1,13,0,7,10,10738,9655,1083
1,13,1,7,10,10577,10030,547
1,13,2,7,10,10365,10532,-167
1,13,3,7,10,10514,10682,-168
1,13,4,7,10,10194,11001,-807
1,14,0,7,10,10340,9218,1122
1,14,1,7,10,10182,9532,650
1,14,2,7,10,10080,9864,216
1,14,3,7,10,10313,9830,483
1,14,4,7,10,9936,10176,-240
1,15,0,7,10,9663,8179,1484
1,15,1,7,10,9353,8542,811
1,15,2,7,10,9299,8817,482
1,15,3,7,10,9537,8699,838
1,15,4,7,10,8971,9140,-169
1,16,0,7,10,8727,7349,1378
1,16,1,7,10,8418,7659,759
1,16,2,7,10,8426,7823,603
1,16,3,7,10,8706,7562,1144
1,16,4,7,10,8130,7927,203
1,17,0,7,10,7908,6606,1302
1,17,1,7,10,7534,6876,658
1,17,2,7,10,7553,6939,614
1,17,3,7,10,7859,6630,1229
1,17,4,7,10,7311,6924,387
1,0,0,8,10,7954,6968,986
1,0,1,8,10,7704,7115,589
1,0,2,8,10,7417,7310,107
1,0,3,8,10,7209,7566,-357
1,0,4,8,10,7076,7790,-714
1,1,0,8,10,8045,7254,791
1,1,1,8,10,7807,7374,433
1,1,2,8,10,7521,7559,-38
1,1,3,8,10,7332,7780,-448
1,1,4,8,10,7262,7990,-728
1,2,0,8,10,7571,6642,929
1,2,1,8,10,7258,6787,471
1,2,2,8,10,6947,6988,-41
1,2,3,8,10,6732,7235,-503
1,2,4,8,10,6649,7522,-873
1,3,0,8,10,7559,6836,723
1,3,1,8,10,7271,6970,301
1,3,2,8,10,7043,7131,-88
1,3,3,8,10,6899,7343,-444
1,3,4,8,10,6871,7606,-735
1,4,0,8,10,8247,8032,215
1,4,1,8,10,8060,8144,-84
1,4,2,8,10,7964,8255,-291
1,4,3,8,10,7969,8400,-431
1,4,4,8,10,8060,8549,-489
1,5,0,8,10,9010,9036,-26
1,5,1,8,10,8852,9185,-333
1,5,2,8,10,8798,9313,-515
1,5,3,8,10,8900,9457,-557
1,5,4,8,10,9046,9561,-515
1,6,0,8,10,9786,9892,-106
1,6,1,8,10,9635,10063,-428
1,6,2,8,10,9572,10232,-660
1,6,3,8,10,9729,10410,-681
1,6,4,8,10,9902,10509,-607
1,7,0,8,10,10610,10743,-133
1,7,1,8,10,10485,10912,-427
1,7,2,8,10,10401,11145,-744
1,7,3,8,10,10592,11368,-776
1,7,4,8,10,10775,11463,-688
1,8,0,8,10,11461,11369,92
1,8,1,8,10,11341,11594,-253
1,8,2,8,10,11208,11946,-738
1,8,3,8,10,11388,12239,-851
1,8,4,8,10,11495,12356,-861
1,9,0,8,10,11928,11599,329
1,9,1,8,10,11813,11894,-81
1,9,2,8,10,11664,12329,-665
1,9,3,8,10,11871,12640,-769
1,9,4,8,10,11903,12800,-897
1,10,0,8,10,12729,12339,390
1,10,1,8,10,12693,12676,17
1,10,2,8,10,12569,13186,-617
1,10,3,8,10,12826,13470,-644
1,10,4,8,10,12810,13627,-817
1,11,0,8,10,12902,12001,901
1,11,1,8,10,12791,12480,311
1,11,2,8,10,12584,13107,-523
1,11,3,8,10,12807,13391,-584
1,11,4,8,10,12626,13620,-994
1,12,0,8,10,12484,11299,1185
1,12,1,8,10,12286,11778,508
1,12,2,8,10,12042,12362,-320
1,12,3,8,10,12218,12580,-362
1,12,4,8,10,11883,12919,-1036
1,13,0,8,10,12070,10768,1302
1,13,1,8,10,11872,11153,719
1,13,2,8,10,11704,11580,124
1,13,3,8,10,11937,11633,304
1,13,4,8,10,11533,12017,-484
1,14,0,8,10,11361,9743,1618
1,14,1,8,10,11026,10132,894
1,14,2,8,10,10896,10509,387
1,14,3,8,10,11128,10483,645
1,14,4,8,10,10552,10966,-414
1,15,0,8,10,10447,8900,1547
1,15,1,8,10,10110,9241,869
1,15,2,8,10,10043,9509,534
1,15,3,8,10,10321,9329,992
1,15,4,8,10,9718,9743,-25
1,16,0,8,10,9516,8158,1358
1,16,1,8,10,9151,8467,684
1,16,2,8,10,9150,8604,546
1,16,3,8,10,9508,8285,1223
1,16,4,8,10,8953,8607,346
1,0,0,9,10,9095,8290,805
1,0,1,9,10,8849,8406,443
1,0,2,9,10,8558,8592,-34
1,0,3,9,10,8375,8820,-445
1,0,4,9,10,8310,9029,-719
1,1,0,9,10,8644,7696,948
1,1,1,9,10,8329,7838,491
1,1,2,9,10,8010,8047,-37
1,1,3,9,10,7791,8305,-514
1,1,4,9,10,7706,8590,-884
1,2,0,9,10,8671,7929,742
1,2,1,9,10,8386,8057,329
1,2,2,9,10,8150,8221,-71
1,2,3,9,10,8000,8442,-442
1,2,4,9,10,7973,8703,-730
1,3,0,9,10,9286,8845,441
1,3,1,9,10,9053,8998,55
1,3,2,9,10,8903,9150,-247
1,3,3,9,10,8860,9344,-484
1,3,4,9,10,8909,9541,-632
1,4,0,9,10,9993,9676,317
1,4,1,9,10,9769,9892,-123
1,4,2,9,10,9641,10085,-444
1,4,3,9,10,9673,10298,-625
1,4,4,9,10,9749,10467,-718
1,5,0,9,10,10740,10586,154
1,5,1,9,10,10542,10806,-264
1,5,2,9,10,10422,11029,-607
1,5,3,9,10,10524,11260,-736
1,5,4,9,10,10643,11402,-759
1,6,0,9,10,11484,11456,28
1,6,1,9,10,11308,11653,-345
1,6,2,9,10,11169,11924,-755
1,6,3,9,10,11320,12194,-874
1,6,4,9,10,11483,12335,-852
1,7,0,9,10,12330,12294,36
1,7,1,9,10,12177,12494,-317
1,7,2,9,10,12018,12831,-813
1,7,3,9,10,12207,13135,-928
1,7,4,9,10,12363,13279,-916
1,8,0,9,10,13069,12921,148
1,8,1,9,10,12958,13185,-227
1,8,2,9,10,12805,13611,-806
1,8,3,9,10,13037,13894,-857
1,8,4,9,10,13137,14039,-902
1,9,0,9,10,13328,12781,547
1,9,1,9,10,13215,13140,75
1,9,2,9,10,13058,13674,-616
1,9,3,9,10,13285,13995,-710
1,9,4,9,10,13254,14227,-973
1,10,0,9,10,14002,13288,714
1,10,1,9,10,13919,13750,169
1,10,2,9,10,13787,14340,-553
1,10,3,9,10,14075,14598,-523
1,10,4,9,10,13950,14801,-851
1,11,0,9,10,14211,13308,903
1,11,1,9,10,14068,13806,262
1,11,2,9,10,13902,14381,-479
1,11,3,9,10,14179,14581,-402
1,11,4,9,10,13921,14854,-933
1,12,0,9,10,13816,12412,1404
1,12,1,9,10,13581,12901,680
1,12,2,9,10,13381,13410,-29
1,12,3,9,10,13641,13531,110
1,12,4,9,10,13222,13935,-713
1,13,0,9,10,13091,11293,1798
1,13,1,9,10,12716,11753,963
1,13,2,9,10,12520,12225,295
1,13,3,9,10,12752,12286,466
1,13,4,9,10,12149,12807,-658
1,14,0,9,10,12145,10464,1681
1,14,1,9,10,11783,10831,952
1,14,2,9,10,11640,11201,439
1,14,3,9,10,11912,11113,799
1,14,4,9,10,11299,11569,-270
1,15,0,9,10,11236,9709,1527
1,15,1,9,10,10843,10049,794
1,15,2,9,10,10767,10290,477
1,15,3,9,10,11123,10052,1071
1,15,4,9,10,10541,10423,118
1,0,0,10,10,9694,8732,962
1,0,1,10,10,9371,8870,501
1,0,2,10,10,9047,9080,-33
1,0,3,10,10,8834,9345,-511
1,0,4,10,10,8754,9629,-875
1,1,0,10,10,9744,8983,761
1,1,1,10,10,9457,9108,349
1,1,2,10,10,9213,9280,-67
1,1,3,10,10,9059,9512,-453
1,1,4,10,10,9030,9771,-741
1,2,0,10,10,10398,9938,460
1,2,1,10,10,10168,10085,83
1,2,2,10,10,10010,10240,-230
1,2,3,10,10,9961,10443,-482
1,2,4,10,10,10011,10638,-627
1,3,0,10,10,11032,10489,543
1,3,1,10,10,10762,10746,16
1,3,2,10,10,10580,10980,-400
1,3,3,10,10,10564,11242,-678
1,3,4,10,10,10598,11459,-861
1,4,0,10,10,11723,11226,497
1,4,1,10,10,11459,11513,-54
1,4,2,10,10,11265,11801,-536
1,4,3,10,10,11297,12101,-804
1,4,4,10,10,11346,12308,-962
1,5,0,10,10,12438,12150,288
1,5,1,10,10,12215,12396,-181
1,5,2,10,10,12019,12721,-702
1,5,3,10,10,12115,13044,-929
1,5,4,10,10,12224,13228,-1004
1,6,0,10,10,13204,13007,197
1,6,1,10,10,13000,13235,-235
1,6,2,10,10,12786,13610,-824
1,6,3,10,10,12935,13961,-1026
1,6,4,10,10,13071,14151,-1080
1,7,0,10,10,13938,13846,92
1,7,1,10,10,13794,14085,-291
1,7,2,10,10,13615,14496,-881
1,7,3,10,10,13856,14790,-934
1,7,4,10,10,14005,14962,-957
1,8,0,10,10,14469,14103,366
1,8,1,10,10,14360,14431,-71
1,8,2,10,10,14199,14956,-757
1,8,3,10,10,14451,15249,-798
1,8,4,10,10,14488,15466,-978
1,9,0,10,10,14601,13730,871
1,9,1,10,10,14441,14214,227
1,9,2,10,10,14276,14828,-552
1,9,3,10,10,14534,15123,-589
1,9,4,10,10,14394,15401,-1007
1,10,0,10,10,15311,14595,716
1,10,1,10,10,15196,15076,120
1,10,2,10,10,15105,15614,-509
1,10,3,10,10,15447,15788,-341
1,10,4,10,10,15245,16035,-790
1,11,0,10,10,15543,14421,1122
1,11,1,10,10,15363,14929,434
1,11,2,10,10,15241,15429,-188
1,11,3,10,10,15602,15532,70
1,11,4,10,10,15260,15870,-610
1,12,0,10,10,14837,12937,1900
1,12,1,10,10,14425,13501,924
1,12,2,10,10,14197,14055,142
1,12,3,10,10,14456,14184,272
1,12,4,10,10,13838,14725,-887
1,13,0,10,10,13875,12014,1861
1,13,1,10,10,13473,12452,1021
1,13,2,10,10,13264,12917,347
1,13,3,10,10,13536,12916,620
1,13,4,10,10,12896,13410,-514
1,14,0,10,10,12934,11273,1661
1,14,1,10,10,12516,11639,877
1,14,2,10,10,12364,11982,382
1,14,3,10,10,12714,11836,878
1,14,4,10,10,12122,12249,-127
1,0,0,11,10,10794,10019,775
1,0,1,11,10,10499,10140,359
1,0,2,11,10,10250,10313,-63
1,0,3,11,10,10102,10552,-450
1,0,4,11,10,10078,10810,-732
1,1,0,11,10,11471,10992,479
1,1,1,11,10,11239,11136,103
1,1,2,11,10,11073,11299,-226
1,1,3,11,10,11020,11513,-493
1,1,4,11,10,11068,11706,-638
1,2,0,11,10,12144,11582,562
1,2,1,11,10,11877,11833,44
1,2,2,11,10,11687,12070,-383
1,2,3,11,10,11665,12341,-676
1,2,4,11,10,11700,12556,-856
1,3,0,11,10,12762,12039,723
1,3,1,11,10,12452,12367,85
1,3,2,11,10,12204,12696,-492
1,3,3,11,10,12188,13045,-857
1,3,4,11,10,12195,13300,-1105
1,4,0,11,10,13421,12790,631
1,4,1,11,10,13132,13103,29
1,4,2,11,10,12862,13493,-631
1,4,3,11,10,12888,13885,-997
1,4,4,11,10,12927,14134,-1207
1,5,0,11,10,14158,13701,457
1,5,1,11,10,13907,13978,-71
1,5,2,11,10,13636,14407,-771
1,5,3,11,10,13730,14811,-1081
1,5,4,11,10,13812,15044,-1232
1,6,0,11,10,14812,14559,253
1,6,1,11,10,14617,14826,-209
1,6,2,11,10,14383,15275,-892
1,6,3,11,10,14584,15616,-1032
1,6,4,11,10,14713,15834,-1121
1,7,0,11,10,15338,15028,310
1,7,1,11,10,15196,15331,-135
1,7,2,11,10,15009,15841,-832
1,7,3,11,10,15270,16145,-875
1,7,4,11,10,15356,16389,-1033
1,8,0,11,10,15742,15052,690
1,8,1,11,10,15586,15505,81
1,8,2,11,10,15417,16110,-693
1,8,3,11,10,15700,16377,-677
1,8,4,11,10,15628,16640,-1012
1,9,0,11,10,15910,15037,873
1,9,1,11,10,15718,15540,178
1,9,2,11,10,15594,16102,-508
1,9,3,11,10,15906,16313,-407
1,9,4,11,10,15689,16635,-946
1,10,0,11,10,16643,15708,935
1,10,1,11,10,16491,16199,292
1,10,2,11,10,16444,16662,-218
1,10,3,11,10,16870,16739,131
1,10,4,11,10,16584,17051,-467
1,11,0,11,10,16564,14946,1618
1,11,1,11,10,16207,15529,678
1,11,2,11,10,16057,16074,-17
1,11,3,11,10,16417,16185,232
1,11,4,11,10,15876,16660,-784
1,12,0,11,10,15621,13658,1963
1,12,1,11,10,15182,14200,982
1,12,2,11,10,14941,14747,194
1,12,3,11,10,15240,14814,426
1,12,4,11,10,14585,15328,-743
1,13,0,11,10,14664,12823,1841
1,13,1,11,10,14206,13260,946
1,13,2,11,10,13988,13698,290
1,13,3,11,10,14338,13639,699
1,13,4,11,10,13719,14090,-371
1,0,0,12,10,12521,12028,493
1,0,1,12,10,12281,12168,113
1,0,2,12,10,12110,12332,-222
1,0,3,12,10,12063,12553,-490
1,0,4,12,10,12116,12745,-629
1,1,0,12,10,13217,12636,581
1,1,1,12,10,12948,12884,64
1,1,2,12,10,12750,13129,-379
1,1,3,12,10,12724,13411,-687
1,1,4,12,10,12757,13624,-867
1,2,0,12,10,13874,13132,742
1,2,1,12,10,13567,13454,113
1,2,2,12,10,13311,13786,-475
1,2,3,12,10,13289,14144,-855
1,2,4,12,10,13297,14397,-1100
1,3,0,12,10,14460,13603,857
1,3,1,12,10,14125,13957,168
1,3,2,12,10,13801,14388,-587
1,3,3,12,10,13779,14829,-1050
1,3,4,12,10,13776,15126,-1350
1,4,0,12,10,15141,14341,800
1,4,1,12,10,14824,14685,139
1,4,2,12,10,14479,15179,-700
1,4,3,12,10,14503,15652,-1149
1,4,4,12,10,14515,15950,-1435
1,5,0,12,10,15766,15253,513
1,5,1,12,10,15524,15569,-45
1,5,2,12,10,15233,16072,-839
1,5,3,12,10,15379,16466,-1087
1,5,4,12,10,15454,16727,-1273
1,6,0,12,10,16212,15741,471
1,6,1,12,10,16019,16072,-53
1,6,2,12,10,15777,16620,-843
1,6,3,12,10,15998,16971,-973
1,6,4,12,10,16064,17261,-1197
1,7,0,12,10,16611,15977,634
1,7,1,12,10,16422,16405,17
1,7,2,12,10,16227,16995,-768
1,7,3,12,10,16519,17273,-754
1,7,4,12,10,16496,17563,-1067
1,8,0,12,10,17051,16359,692
1,8,1,12,10,16863,16831,32
1,8,2,12,10,16735,17384,-649
1,8,3,12,10,17072,17567,-495
1,8,4,12,10,16923,17874,-951
1,9,0,12,10,17242,16150,1092
1,9,1,12,10,17013,16663,350
1,9,2,12,10,16933,17150,-217
1,9,3,12,10,17329,17264,65
1,9,4,12,10,17028,17651,-623
1,10,0,12,10,17664,16233,1431
1,10,1,12,10,17335,16799,536
1,10,2,12,10,17260,17307,-47
1,10,3,12,10,17685,17392,293
1,10,4,12,10,17200,17841,-641
1,11,0,12,10,17348,15667,1681
1,11,1,12,10,16964,16228,736
1,11,2,12,10,16801,16766,35
1,11,3,12,10,17201,16815,386
1,11,4,12,10,16623,17263,-640
1,12,0,12,10,16410,14467,1943
1,12,1,12,10,15915,15008,907
1,12,2,12,10,15665,15528,137
1,12,3,12,10,16042,15537,505
1,12,4,12,10,15408,16008,-600
1,0,0,13,10,14267,13672,595
1,0,1,13,10,13990,13916,74
1,0,2,13,10,13787,14162,-375
1,0,3,13,10,13767,14451,-684
1,0,4,13,10,13805,14663,-858
1,1,0,13,10,14947,14186,761
1,1,1,13,10,14638,14505,133
1,1,2,13,10,14374,14845,-471
1,1,3,13,10,14348,15214,-866
1,1,4,13,10,14354,15465,-1111
1,2,0,13,10,15572,14696,876
1,2,1,13,10,15240,15044,196
1,2,2,13,10,14908,15478,-570
1,2,3,13,10,14880,15928,-1048
1,2,4,13,10,14878,16223,-1345
1,3,0,13,10,16180,15154,1026
1,3,1,13,10,15817,15539,278
1,3,2,13,10,15418,16074,-656
1,3,3,13,10,15394,16596,-1202
1,3,4,13,10,15364,16942,-1578
1,4,0,13,10,16749,15893,856
1,4,1,13,10,16441,16276,165
1,4,2,13,10,16076,16844,-768
1,4,3,13,10,16152,17307,-1155
1,4,4,13,10,16157,17633,-1476
1,5,0,13,10,17166,16435,731
1,5,1,13,10,16926,16815,111
1,5,2,13,10,16627,17417,-790
1,5,3,13,10,16793,17821,-1028
1,5,4,13,10,16805,18154,-1349
1,6,0,13,10,17485,16690,795
1,6,1,13,10,17245,17146,99
1,6,2,13,10,16995,17774,-779
1,6,3,13,10,17247,18099,-852
1,6,4,13,10,17204,18435,-1231
1,7,0,13,10,17920,17284,636
1,7,1,13,10,17699,17731,-32
1,7,2,13,10,17545,18269,-724
1,7,3,13,10,17891,18463,-572
1,7,4,13,10,17791,18797,-1006
1,8,0,13,10,18383,17472,911
1,8,1,13,10,18158,17954,204
1,8,2,13,10,18074,18432,-358
1,8,3,13,10,18495,18518,-23
1,8,4,13,10,18262,18890,-628
1,9,0,13,10,18263,16675,1588
1,9,1,13,10,17857,17263,594
1,9,2,13,10,17749,17795,-46
1,9,3,13,10,18144,17917,227
1,9,4,13,10,17644,18441,-797
1,10,0,13,10,18448,16954,1494
1,10,1,13,10,18092,17498,594
1,10,2,13,10,18004,17999,5
1,10,3,13,10,18469,18022,447
1,10,4,13,10,17947,18444,-497
1,11,0,13,10,18137,16476,1661
1,11,1,13,10,17697,17036,661
1,11,2,13,10,17525,17547,-22
1,11,3,13,10,18003,17538,465
1,11,4,13,10,17446,17943,-497
1,0,0,14,10,15997,15222,775
1,0,1,14,10,15680,15537,143
1,0,2,14,10,15411,15878,-467
1,0,3,14,10,15391,16254,-863
1,0,4,14,10,15402,16504,-1102
1,1,0,14,10,16645,15750,895
1,1,1,14,10,16311,16095,216
1,1,2,14,10,15971,16537,-566
1,1,3,14,10,15939,16998,-1059
1,1,4,14,10,15935,17291,-1356
1,2,0,14,10,17292,16247,1045
1,2,1,14,10,16932,16626,306
1,2,2,14,10,16525,17164,-639
1,2,3,14,10,16495,17695,-1200
1,2,4,14,10,16466,18039,-1573
1,3,0,14,10,17788,16706,1082
1,3,1,14,10,17434,17130,304
1,3,2,14,10,17015,17739,-724
1,3,3,14,10,17043,18251,-1208
1,3,4,14,10,17006,18625,-1619
1,4,0,14,10,18149,17075,1074
1,4,1,14,10,17843,17522,321
1,4,2,14,10,17470,18189,-719
1,4,3,14,10,17566,18662,-1096
1,4,4,14,10,17508,19060,-1552
1,5,0,14,10,18439,17384,1055
1,5,1,14,10,18152,17889,263
1,5,2,14,10,17845,18571,-726
1,5,3,14,10,18042,18949,-907
1,5,4,14,10,17945,19328,-1383
1,6,0,14,10,18794,17997,797
1,6,1,14,10,18522,18472,50
1,6,2,14,10,18313,19048,-735
1,6,3,14,10,18619,19289,-670
1,6,4,14,10,18499,19669,-1170
1,7,0,14,10,19252,18397,855
1,7,1,14,10,18994,18854,140
1,7,2,14,10,18884,19317,-433
1,7,3,14,10,19314,19414,-100
1,7,4,14,10,19130,19813,-683
1,8,0,14,10,19404,17997,1407
1,8,1,14,10,19002,18554,448
1,8,2,14,10,18890,19077,-187
1,8,3,14,10,19310,19171,139
1,8,4,14,10,18878,19680,-802
1,9,0,14,10,19047,17396,1651
1,9,1,14,10,18614,17962,652
1,9,2,14,10,18493,18487,6
1,9,3,14,10,18928,18547,381
1,9,4,14,10,18391,19044,-653
1,10,0,14,10,19237,17763,1474
1,10,1,14,10,18825,18306,519
1,10,2,14,10,18728,18780,-52
1,10,3,14,10,19271,18745,526
1,10,4,14,10,18770,19124,-354
1,0,0,15,10,17695,16786,909
1,0,1,15,10,17353,17127,226
1,0,2,15,10,17008,17570,-562
1,0,3,15,10,16982,18038,-1056
1,0,4,15,10,16983,18330,-1347
1,1,0,15,10,18365,17301,1064
1,1,1,15,10,18003,17677,326
1,1,2,15,10,17588,18223,-635
1,1,3,15,10,17554,18765,-1211
1,1,4,15,10,17523,19107,-1584
1,2,0,15,10,18900,17799,1101
1,2,1,15,10,18549,18217,332
1,2,2,15,10,18122,18829,-707
1,2,3,15,10,18144,19350,-1206
1,2,4,15,10,18108,19722,-1614
1,3,0,15,10,19188,17888,1300
1,3,1,15,10,18836,18376,460
1,3,2,15,10,18409,19084,-675
1,3,3,15,10,18457,19606,-1149
1,3,4,15,10,18357,20052,-1695
1,4,0,15,10,19422,18024,1398
1,4,1,15,10,19069,18596,473
1,4,2,15,10,18688,19343,-655
1,4,3,15,10,18815,19790,-975
1,4,4,15,10,18648,20234,-1586
1,5,0,15,10,19748,18691,1057
1,5,1,15,10,19429,19215,214
1,5,2,15,10,19163,19845,-682
1,5,3,15,10,19414,20139,-725
1,5,4,15,10,19240,20562,-1322
1,6,0,15,10,20126,19110,1016
1,6,1,15,10,19817,19595,222
1,6,2,15,10,19652,20096,-444
1,6,3,15,10,20042,20240,-198
1,6,4,15,10,19838,20685,-847
1,7,0,15,10,20273,18922,1351
1,7,1,15,10,19838,19454,384
1,7,2,15,10,19700,19962,-262
1,7,3,15,10,20129,20067,62
1,7,4,15,10,19746,20603,-857
1,8,0,15,10,20188,18718,1470
1,8,1,15,10,19759,19253,506
1,8,2,15,10,19634,19769,-135
1,8,3,15,10,20094,19801,293
1,8,4,15,10,19625,20283,-658
1,9,0,15,10,19836,18205,1631
1,9,1,15,10,19347,18770,577
1,9,2,15,10,19217,19268,-51
1,9,3,15,10,19730,19270,460
1,9,4,15,10,19214,19724,-510
1,0,0,16,10,19415,18337,1078
1,0,1,16,10,19045,18709,336
1,0,2,16,10,18625,19256,-631
1,0,3,16,10,18597,19805,-1208
1,0,4,16,10,18571,20146,-1575
1,1,0,16,10,19973,18853,1120
1,1,1,16,10,19620,19268,352
1,1,2,16,10,19185,19888,-703
1,1,3,16,10,19203,20420,-1217
1,1,4,16,10,19165,20790,-1625
1,2,0,16,10,20300,18981,1319
1,2,1,16,10,19951,19463,488
1,2,2,16,10,19516,20174,-658
1,2,3,16,10,19558,20705,-1147
1,2,4,16,10,19459,21149,-1690
1,3,0,16,10,20461,18837,1624
1,3,1,16,10,20062,19450,612
1,3,2,16,10,19627,20238,-611
1,3,3,16,10,19706,20734,-1028
1,3,4,16,10,19497,21226,-1729
1,4,0,16,10,20731,19331,1400
1,4,1,16,10,20346,19922,424
1,4,2,16,10,20006,20617,-611
1,4,3,16,10,20187,20980,-793
1,4,4,16,10,19943,21468,-1525
1,5,0,16,10,21080,19804,1276
1,5,1,16,10,20724,20338,386
1,5,2,16,10,20502,20893,-391
1,5,3,16,10,20837,21090,-253
1,5,4,16,10,20579,21578,-999
1,6,0,16,10,21147,19635,1512
1,6,1,16,10,20661,20195,466
1,6,2,16,10,20468,20741,-273
1,6,3,16,10,20857,20893,-36
1,6,4,16,10,20454,21475,-1021
1,7,0,16,10,21057,19643,1414
1,7,1,16,10,20595,20153,442
1,7,2,16,10,20444,20654,-210
1,7,3,16,10,20913,20697,216
1,7,4,16,10,20493,21206,-713
1,8,0,16,10,20977,19527,1450
1,8,1,16,10,20492,20061,431
1,8,2,16,10,20358,20550,-192
1,8,3,16,10,20896,20524,372
1,8,4,16,10,20448,20963,-515
1,0,0,17,10,21023,19889,1134
1,0,1,17,10,20662,20300,362
1,0,2,17,10,20222,20921,-699
1,0,3,17,10,20246,21460,-1214
1,0,4,17,10,20213,21829,-1616
1,1,0,17,10,21373,20035,1338
1,1,1,17,10,21022,20514,508
1,1,2,17,10,20579,21233,-654
1,1,3,17,10,20617,21775,-1158
1,1,4,17,10,20516,22217,-1701
1,2,0,17,10,21573,19930,1643
1,2,1,17,10,21177,20537,640
1,2,2,17,10,20734,21328,-594
1,2,3,17,10,20807,21833,-1026
1,2,4,17,10,20599,22323,-1724
1,3,0,17,10,21770,20144,1626
1,3,1,17,10,21339,20776,563
1,3,2,17,10,20945,21512,-567
1,3,3,17,10,21078,21924,-846
1,3,4,17,10,20792,22460,-1668
1,4,0,17,10,22063,20444,1619
1,4,1,17,10,21641,21045,596
1,4,2,17,10,21345,21665,-320
1,4,3,17,10,21610,21931,-321
1,4,4,17,10,21282,22484,-1202
1,5,0,17,10,22101,20329,1772
1,5,1,17,10,21568,20938,630
1,5,2,17,10,21318,21538,-220
1,5,3,17,10,21652,21743,-91
1,5,4,17,10,21195,22368,-1173
1,6,0,17,10,21931,20356,1575
1,6,1,17,10,21418,20894,524
1,6,2,17,10,21212,21433,-221
1,6,3,17,10,21641,21523,118
1,6,4,17,10,21201,22078,-877
1,7,0,17,10,21846,20452,1394
1,7,1,17,10,21328,20961,367
1,7,2,17,10,21168,21435,-267
1,7,3,17,10,21715,21420,295
1,7,4,17,10,21316,21886,-570
1,0,0,18,10,22423,21071,1352
1,0,1,18,10,22064,21546,518
1,0,2,18,10,21616,22266,-650
1,0,3,18,10,21660,22815,-1155
1,0,4,18,10,21564,23256,-1692
1,1,0,18,10,22646,20984,1662
1,1,1,18,10,22248,21588,660
1,1,2,18,10,21797,22387,-590
1,1,3,18,10,21866,22903,-1037
1,1,4,18,10,21656,23391,-1735
1,2,0,18,10,22882,21237,1645
1,2,1,18,10,22454,21863,591
1,2,2,18,10,22052,22602,-550
1,2,3,18,10,22179,23023,-844
1,2,4,18,10,21894,23557,-1663
1,3,0,18,10,23102,21257,1845
1,3,1,18,10,22634,21899,735
1,3,2,18,10,22284,22560,-276
1,3,3,18,10,22501,22875,-374
1,3,4,18,10,22131,23476,-1345
1,4,0,18,10,23084,20969,2115
1,4,1,18,10,22485,21645,840
1,4,2,18,10,22161,22310,-149
1,4,3,18,10,22425,22584,-159
1,4,4,18,10,21898,23274,-1376
1,5,0,18,10,22885,21050,1835
1,5,1,18,10,22325,21637,688
1,5,2,18,10,22062,22230,-168
1,5,3,18,10,22436,22373,63
1,5,4,18,10,21942,22971,-1029
1,6,0,18,10,22720,21165,1555
1,6,1,18,10,22151,21702,449
1,6,2,18,10,21936,22214,-278
1,6,3,18,10,22443,22246,197
1,6,4,18,10,22024,22758,-734
1,0,0,19,10,23696,22020,1676
1,0,1,19,10,23290,22620,670
1,0,2,19,10,22834,23420,-586
1,0,3,19,10,22909,23943,-1034
1,0,4,19,10,22704,24430,-1726
1,1,0,19,10,23955,22291,1664
1,1,1,19,10,23525,22914,611
1,1,2,19,10,23115,23661,-546
1,1,3,19,10,23238,24093,-855
1,1,4,19,10,22951,24625,-1674
1,2,0,19,10,24214,22350,1864
1,2,1,19,10,23749,22986,763
1,2,2,19,10,23391,23650,-259
1,2,3,19,10,23602,23974,-372
1,2,4,19,10,23233,24573,-1340
1,3,0,19,10,24123,21782,2341
1,3,1,19,10,23478,22499,979
1,3,2,19,10,23100,23205,-105
1,3,3,19,10,23316,23528,-212
1,3,4,19,10,22747,24266,-1519
1,4,0,19,10,23868,21690,2178
1,4,1,19,10,23242,22344,898
1,4,2,19,10,22905,23002,-97
1,4,3,19,10,23209,23214,-5
1,4,4,19,10,22645,23877,-1232
1,5,0,19,10,23674,21859,1815
1,5,1,19,10,23058,22445,613
1,5,2,19,10,22786,23011,-225
1,5,3,19,10,23238,23096,142
1,5,4,19,10,22765,23651,-886
1,0,0,20,10,25005,23327,1678
1,0,1,20,10,24567,23946,621
1,0,2,20,10,24152,24694,-542
1,0,3,20,10,24281,25133,-852
1,0,4,20,10,23999,25664,-1665
1,1,0,20,10,25287,23404,1883
1,1,1,20,10,24820,24037,783
1,1,2,20,10,24454,24709,-255
1,1,3,20,10,24661,25044,-383
1,1,4,20,10,24290,25641,-1351
1,2,0,20,10,25235,22875,2360
1,2,1,20,10,24593,23586,1007
1,2,2,20,10,24207,24295,-88
1,2,3,20,10,24417,24627,-210
1,2,4,20,10,23849,25363,-1514
1,3,0,20,10,24907,22503,2404
1,3,1,20,10,24235,23198,1037
1,3,2,20,10,23844,23897,-53
1,3,3,20,10,24100,24158,-58
1,3,4,20,10,23494,24869,-1375
1,4,0,20,10,24657,22499,2158
1,4,1,20,10,23975,23152,823
1,4,2,20,10,23629,23783,-154
1,4,3,20,10,24011,23937,74
1,4,4,20,10,23468,24557,-1089
1,0,0,21,10,26337,24440,1897
1,0,1,21,10,25862,25069,793
1,0,2,21,10,25491,25742,-251
1,0,3,21,10,25704,26084,-380
1,0,4,21,10,25338,26680,-1342
1,1,0,21,10,26308,23929,2379
1,1,1,21,10,25664,24637,1027
1,1,2,21,10,25270,25354,-84
1,1,3,21,10,25476,25697,-221
1,1,4,21,10,24906,26431,-1525
1,2,0,21,10,26019,23596,2423
1,2,1,21,10,25350,24285,1065
1,2,2,21,10,24951,24987,-36
1,2,3,21,10,25201,25257,-56
1,2,4,21,10,24596,25966,-1370
1,3,0,21,10,25696,23312,2384
1,3,1,21,10,24968,24006,962
1,3,2,21,10,24568,24678,-110
1,3,3,21,10,24902,24881,21
1,3,4,21,10,24317,25549,-1232
1,0,0,22,10,27358,24965,2393
1,0,1,22,10,26706,25669,1037
1,0,2,22,10,26307,26387,-80
1,0,3,22,10,26519,26737,-218
1,0,4,22,10,25954,27470,-1516
1,1,0,22,10,27092,24650,2442
1,1,1,22,10,26421,25336,1085
1,1,2,22,10,26014,26046,-32
1,1,3,22,10,26260,26327,-67
1,1,4,22,10,25653,27034,-1381
1,2,0,22,10,26808,24405,2403
1,2,1,22,10,26083,25093,990
1,2,2,22,10,25675,25768,-93
1,2,3,22,10,26003,25980,23
1,2,4,22,10,25419,26646,-1227
1,0,0,23,10,28142,25686,2456
1,0,1,23,10,27463,26368,1095
1,0,2,23,10,27051,27079,-28
1,0,3,23,10,27303,27367,-64
1,0,4,23,10,26701,28073,-1372
1,1,0,23,10,27881,25459,2422
1,1,1,23,10,27154,26144,1010
1,1,2,23,10,26738,26827,-89
1,1,3,23,10,27062,27050,12
1,1,4,23,10,26476,27714,-1238
1,0,0,24,10,28931,26495,2436
1,0,1,24,10,28196,27176,1020
1,0,2,24,10,27775,27860,-85
1,0,3,24,10,28105,28090,15
1,0,4,24,10,27524,28753,-1229
1,0,0,1,11,1152,1135,17
1,0,1,1,11,1144,1142,2
1,0,2,1,11,1139,1142,-3
1,1,0,1,11,1177,1162,15
1,1,1,1,11,1174,1173,1
1,1,2,1,11,1166,1172,-6
1,2,0,1,11,1221,1197,24
1,2,1,1,11,1222,1205,17
1,2,2,1,11,1213,1205,8
1,3,0,1,11,1105,958,147
1,3,1,1,11,1056,1006,50
1,3,2,1,11,1001,1055,-54
1,4,0,1,11,1031,817,214
1,4,1,1,11,962,885,77
1,4,2,1,11,887,951,-64
1,5,0,1,11,1021,862,159
1,5,1,1,11,972,915,57
1,5,2,1,11,915,958,-43
1,6,0,1,11,943,848,95
1,6,1,1,11,892,895,-3
1,6,2,1,11,837,941,-104
1,7,0,1,11,966,984,-18
1,7,1,1,11,935,995,-60
1,7,2,1,11,909,1021,-112
1,8,0,1,11,1271,1419,-148
1,8,1,1,11,1282,1400,-118
1,8,2,1,11,1287,1385,-98
1,9,0,1,11,628,524,104
1,9,1,1,11,558,564,-6
1,9,2,1,11,528,628,-100
1,10,0,1,11,1232,1352,-120
1,10,1,1,11,1247,1332,-85
1,10,2,1,11,1328,1313,15
1,11,0,1,11,1921,2197,-276
1,11,1,1,11,1960,2192,-232
1,11,2,1,11,2051,2135,-84
1,12,0,1,11,1860,1945,-85
1,12,1,1,11,1824,2029,-205
1,12,2,1,11,1808,2029,-221
1,13,0,1,11,1836,1809,27
1,13,1,1,11,1783,1913,-130
1,13,2,1,11,1734,1937,-203
1,14,0,1,11,1825,1785,40
1,14,1,1,11,1766,1893,-127
1,14,2,1,11,1706,1938,-232
1,15,0,1,11,1838,1780,58
1,15,1,1,11,1786,1872,-86
1,15,2,1,11,1722,1908,-186
1,16,0,1,11,1725,1759,-34
1,16,1,1,11,1711,1782,-71
1,16,2,1,11,1724,1795,-71
1,17,0,1,11,1510,1412,98
1,17,1,1,11,1469,1438,31
1,17,2,1,11,1477,1510,-33
1,18,0,1,11,1348,1238,110
1,18,1,1,11,1310,1235,75
1,18,2,1,11,1325,1249,76
1,19,0,1,11,1467,1405,62
1,19,1,1,11,1408,1348,60
1,19,2,1,11,1476,1391,85
1,20,0,1,11,1485,1168,317
1,20,1,1,11,1415,1103,312
1,20,2,1,11,1491,1162,329
1,21,0,1,11,1047,689,358
1,21,1,1,11,888,741,147
1,21,2,1,11,904,826,78
1,22,0,1,11,854,753,101
1,22,1,1,11,818,746,72
1,22,2,1,11,860,686,174
1,23,0,1,11,844,841,3
1,23,1,1,11,793,855,-62
1,23,2,1,11,856,770,86
1,0,0,2,11,2329,2297,32
1,0,1,2,11,2318,2315,3
1,0,2,2,11,2305,2314,-9
1,1,0,2,11,2398,2359,39
1,1,1,2,11,2396,2378,18
1,1,2,2,11,2379,2377,2
1,2,0,2,11,2326,2155,171
1,2,1,2,11,2278,2211,67
1,2,2,2,11,2214,2260,-46
1,3,0,2,11,2136,1775,361
1,3,1,2,11,2018,1891,127
1,3,2,2,11,1888,2006,-118
1,4,0,2,11,2052,1679,373
1,4,1,2,11,1934,1800,134
1,4,2,2,11,1802,1909,-107
1,5,0,2,11,1964,1710,254
1,5,1,2,11,1864,1810,54
1,5,2,2,11,1752,1899,-147
1,6,0,2,11,1909,1832,77
1,6,1,2,11,1827,1890,-63
1,6,2,2,11,1746,1962,-216
1,7,0,2,11,2237,2403,-166
1,7,1,2,11,2217,2395,-178
1,7,2,2,11,2196,2406,-210
1,8,0,2,11,1899,1943,-44
1,8,1,2,11,1840,1964,-124
1,8,2,2,11,1815,2013,-198
1,9,0,2,11,1860,1876,-16
1,9,1,2,11,1805,1896,-91
1,9,2,2,11,1856,1941,-85
1,10,0,2,11,3153,3549,-396
1,10,1,2,11,3207,3524,-317
1,10,2,2,11,3379,3448,-69
1,11,0,2,11,3781,4142,-361
1,11,1,2,11,3784,4221,-437
1,11,2,2,11,3859,4164,-305
1,12,0,2,11,3696,3754,-58
1,12,1,2,11,3607,3942,-335
1,12,2,2,11,3542,3966,-424
1,13,0,2,11,3661,3594,67
1,13,1,2,11,3549,3806,-257
1,13,2,2,11,3440,3875,-435
1,14,0,2,11,3663,3565,98
1,14,1,2,11,3552,3765,-213
1,14,2,2,11,3428,3846,-418
1,15,0,2,11,3563,3539,24
1,15,1,2,11,3497,3654,-157
1,15,2,2,11,3446,3703,-257
1,16,0,2,11,3235,3171,64
1,16,1,2,11,3180,3220,-40
1,16,2,2,11,3201,3305,-104
1,17,0,2,11,2858,2650,208
1,17,1,2,11,2779,2673,106
1,17,2,2,11,2802,2759,43
1,18,0,2,11,2815,2643,172
1,18,1,2,11,2718,2583,135
1,18,2,2,11,2801,2640,161
1,19,0,2,11,2952,2573,379
1,19,1,2,11,2823,2451,372
1,19,2,2,11,2967,2553,414
1,20,0,2,11,2532,1857,675
1,20,1,2,11,2303,1844,459
1,20,2,2,11,2395,1988,407
1,21,0,2,11,1901,1442,459
1,21,1,2,11,1706,1487,219
1,21,2,2,11,1764,1512,252
1,22,0,2,11,1698,1594,104
1,22,1,2,11,1611,1601,10
1,22,2,2,11,1716,1456,260
1,0,0,3,11,3550,3494,56
1,0,1,3,11,3540,3520,20
1,0,2,3,11,3518,3519,-1
1,1,0,3,11,3503,3317,186
1,1,1,3,11,3452,3384,68
1,1,2,3,11,3380,3432,-52
1,2,0,3,11,3357,2972,385
1,2,1,3,11,3240,3096,144
1,2,2,3,11,3101,3211,-110
1,3,0,3,11,3157,2637,520
1,3,1,3,11,2990,2806,184
1,3,2,3,11,2803,2964,-161
1,4,0,3,11,2995,2527,468
1,4,1,3,11,2826,2695,131
1,4,2,3,11,2639,2850,-211
1,5,0,3,11,2930,2694,236
1,5,1,3,11,2799,2805,-6
1,5,2,3,11,2661,2920,-259
1,6,0,3,11,3180,3251,-71
1,6,1,3,11,3109,3290,-181
1,6,2,3,11,3033,3347,-314
1,7,0,3,11,2865,2927,-62
1,7,1,3,11,2775,2959,-184
1,7,2,3,11,2724,3034,-310
1,8,0,3,11,3131,3295,-164
1,8,1,3,11,3087,3296,-209
1,8,2,3,11,3143,3326,-183
1,9,0,3,11,3781,4073,-292
1,9,1,3,11,3765,4088,-323
1,9,2,3,11,3907,4076,-169
1,10,0,3,11,5013,5494,-481
1,10,1,3,11,5031,5553,-522
1,10,2,3,11,5187,5477,-290
1,11,0,3,11,5617,5951,-334
1,11,1,3,11,5567,6134,-567
1,11,2,3,11,5593,6101,-508
1,12,0,3,11,5521,5539,-18
1,12,1,3,11,5373,5835,-462
1,12,2,3,11,5248,5904,-656
1,13,0,3,11,5499,5374,125
1,13,1,3,11,5335,5678,-343
1,13,2,3,11,5162,5783,-621
1,14,0,3,11,5388,5324,64
1,14,1,3,11,5263,5547,-284
1,14,2,3,11,5152,5641,-489
1,15,0,3,11,5073,4951,122
1,15,1,3,11,4966,5092,-126
1,15,2,3,11,4923,5213,-290
1,16,0,3,11,4583,4409,174
1,16,1,3,11,4490,4455,35
1,16,2,3,11,4526,4554,-28
1,17,0,3,11,4325,4055,270
1,17,1,3,11,4187,4021,166
1,17,2,3,11,4278,4150,128
1,18,0,3,11,4300,3811,489
1,18,1,3,11,4133,3686,447
1,18,2,3,11,4292,3802,490
1,19,0,3,11,3999,3262,737
1,19,1,3,11,3711,3192,519
1,19,2,3,11,3871,3379,492
1,20,0,3,11,3386,2610,776
1,20,1,3,11,3121,2590,531
1,20,2,3,11,3255,2674,581
1,21,0,3,11,2745,2283,462
1,21,1,3,11,2499,2342,157
1,21,2,3,11,2620,2282,338
1,0,0,4,11,4655,4452,203
1,0,1,4,11,4596,4526,70
1,0,2,4,11,4519,4574,-55
1,1,0,4,11,4534,4134,400
1,1,1,4,11,4414,4269,145
1,1,2,4,11,4267,4383,-116
1,2,0,4,11,4378,3834,544
1,2,1,4,11,4212,4011,201
1,2,2,4,11,4016,4169,-153
1,3,0,4,11,4100,3485,615
1,3,1,4,11,3882,3701,181
1,3,2,4,11,3640,3905,-265
1,4,0,4,11,3961,3511,450
1,4,1,4,11,3761,3690,71
1,4,2,4,11,3548,3871,-323
1,5,0,4,11,4201,4113,88
1,5,1,4,11,4081,4205,-124
1,5,2,4,11,3948,4305,-357
1,6,0,4,11,3808,3775,33
1,6,1,4,11,3667,3854,-187
1,6,2,4,11,3561,3975,-414
1,7,0,4,11,4097,4279,-182
1,7,1,4,11,4022,4291,-269
1,7,2,4,11,4052,4347,-295
1,8,0,4,11,5052,5492,-440
1,8,1,4,11,5047,5488,-441
1,8,2,4,11,5194,5461,-267
1,9,0,4,11,5641,6018,-377
1,9,1,4,11,5589,6117,-528
1,9,2,4,11,5715,6105,-390
1,10,0,4,11,6849,7303,-454
1,10,1,4,11,6814,7466,-652
1,10,2,4,11,6921,7414,-493
1,11,0,4,11,7442,7736,-294
1,11,1,4,11,7333,8027,-694
1,11,2,4,11,7299,8039,-740
1,12,0,4,11,7359,7319,40
1,12,1,4,11,7159,7707,-548
1,12,2,4,11,6970,7812,-842
1,13,0,4,11,7224,7133,91
1,13,1,4,11,7046,7460,-414
1,13,2,4,11,6886,7578,-692
1,14,0,4,11,6898,6736,162
1,14,1,4,11,6732,6985,-253
1,14,2,4,11,6629,7151,-522
1,15,0,4,11,6421,6189,232
1,15,1,4,11,6276,6327,-51
1,15,2,4,11,6248,6462,-214
1,16,0,4,11,6050,5814,236
1,16,1,4,11,5898,5803,95
1,16,2,4,11,6002,5945,57
1,17,0,4,11,5810,5223,587
1,17,1,4,11,5602,5124,478
1,17,2,4,11,5769,5312,457
1,18,0,4,11,5347,4500,847
1,18,1,4,11,5021,4427,594
1,18,2,4,11,5196,4628,568
1,19,0,4,11,4853,4015,838
1,19,1,4,11,4529,3938,591
1,19,2,4,11,4731,4065,666
1,20,0,4,11,4230,3451,779
1,20,1,4,11,3914,3445,469
1,20,2,4,11,4111,3444,667
1,0,0,5,11,5686,5269,417
1,0,1,5,11,5558,5411,147
1,0,2,5,11,5406,5525,-119
1,1,0,5,11,5555,4996,559
1,1,1,5,11,5386,5184,202
1,1,2,5,11,5182,5341,-159
1,2,0,5,11,5321,4682,639
1,2,1,5,11,5104,4906,198
1,2,2,5,11,4853,5110,-257
1,3,0,5,11,5066,4469,597
1,3,1,5,11,4817,4696,121
1,3,2,5,11,4549,4926,-377
1,4,0,5,11,5232,4930,302
1,4,1,5,11,5043,5090,-47
1,4,2,5,11,4835,5256,-421
1,5,0,5,11,4829,4637,192
1,5,1,5,11,4639,4769,-130
1,5,2,5,11,4476,4933,-457
1,6,0,5,11,5040,5127,-87
1,6,1,5,11,4914,5186,-272
1,6,2,5,11,4889,5288,-399
1,7,0,5,11,6018,6476,-458
1,7,1,5,11,5982,6483,-501
1,7,2,5,11,6103,6482,-379
1,8,0,5,11,6912,7437,-525
1,8,1,5,11,6871,7517,-646
1,8,2,5,11,7002,7490,-488
1,9,0,5,11,7477,7827,-350
1,9,1,5,11,7372,8030,-658
1,9,2,5,11,7449,8042,-593
1,10,0,5,11,8674,9088,-414
1,10,1,5,11,8580,9359,-779
1,10,2,5,11,8627,9352,-725
1,11,0,5,11,9280,9516,-236
1,11,1,5,11,9119,9899,-780
1,11,2,5,11,9021,9947,-926
1,12,0,5,11,9084,9078,6
1,12,1,5,11,8870,9489,-619
1,12,2,5,11,8694,9607,-913
1,13,0,5,11,8734,8545,189
1,13,1,5,11,8515,8898,-383
1,13,2,5,11,8363,9088,-725
1,14,0,5,11,8246,7974,272
1,14,1,5,11,8042,8220,-178
1,14,2,5,11,7954,8400,-446
1,15,0,5,11,7888,7594,294
1,15,1,5,11,7684,7675,9
1,15,2,5,11,7724,7853,-129
1,16,0,5,11,7535,6982,553
1,16,1,5,11,7313,6906,407
1,16,2,5,11,7493,7107,386
1,17,0,5,11,6857,5912,945
1,17,1,5,11,6490,5865,625
1,17,2,5,11,6673,6138,535
1,18,0,5,11,6201,5253,948
1,18,1,5,11,5839,5173,666
1,18,2,5,11,6056,5314,742
1,19,0,5,11,5697,4856,841
1,19,1,5,11,5322,4793,529
1,19,2,5,11,5587,4835,752
1,0,0,6,11,6707,6131,576
1,0,1,6,11,6530,6326,204
1,0,2,6,11,6321,6483,-162
1,1,0,6,11,6498,5844,654
1,1,1,6,11,6278,6079,199
1,1,2,6,11,6019,6282,-263
1,2,0,6,11,6287,5666,621
1,2,1,6,11,6039,5901,138
1,2,2,6,11,5762,6131,-369
1,3,0,6,11,6337,5888,449
1,3,1,6,11,6099,6096,3
1,3,2,6,11,5836,6311,-475
1,4,0,6,11,5860,5454,406
1,4,1,6,11,5601,5654,-53
1,4,2,6,11,5363,5884,-521
1,5,0,6,11,6061,5989,72
1,5,1,6,11,5886,6101,-215
1,5,2,6,11,5804,6246,-442
1,6,0,6,11,6961,7324,-363
1,6,1,6,11,6874,7378,-504
1,6,2,6,11,6940,7423,-483
1,7,0,6,11,7878,8421,-543
1,7,1,6,11,7806,8512,-706
1,7,2,6,11,7911,8511,-600
1,8,0,6,11,8748,9246,-498
1,8,1,6,11,8654,9430,-776
1,8,2,6,11,8736,9427,-691
1,9,0,6,11,9302,9612,-310
1,9,1,6,11,9138,9923,-785
1,9,2,6,11,9155,9980,-825
1,10,0,6,11,10512,10868,-356
1,10,1,6,11,10366,11231,-865
1,10,2,6,11,10349,11260,-911
1,11,0,6,11,11005,11275,-270
1,11,1,6,11,10830,11681,-851
1,11,2,6,11,10745,11742,-997
1,12,0,6,11,10594,10490,104
1,12,1,6,11,10339,10927,-588
1,12,2,6,11,10171,11117,-946
1,13,0,6,11,10082,9783,299
1,13,1,6,11,9825,10133,-308
1,13,2,6,11,9688,10337,-649
1,14,0,6,11,9713,9379,334
1,14,1,6,11,9450,9568,-118
1,14,2,6,11,9430,9791,-361
1,15,0,6,11,9373,8762,611
1,15,1,6,11,9099,8778,321
1,15,2,6,11,9215,9015,200
1,16,0,6,11,8582,7671,911
1,16,1,6,11,8201,7647,554
1,16,2,6,11,8397,7933,464
1,17,0,6,11,7711,6665,1046
1,17,1,6,11,7308,6611,697
1,17,2,6,11,7533,6824,709
1,18,0,6,11,7045,6094,951
1,18,1,6,11,6632,6028,604
1,18,2,6,11,6912,6084,828
1,0,0,7,11,7650,6979,671
1,0,1,7,11,7422,7221,201
1,0,2,7,11,7158,7424,-266
1,1,0,7,11,7464,6828,636
1,1,1,7,11,7213,7074,139
1,1,2,7,11,6928,7303,-375
1,2,0,7,11,7558,7085,473
1,2,1,7,11,7321,7301,20
1,2,2,7,11,7049,7516,-467
1,3,0,7,11,6965,6412,553
1,3,1,7,11,6657,6660,-3
1,3,2,7,11,6364,6939,-575
1,4,0,7,11,7092,6806,286
1,4,1,7,11,6848,6986,-138
1,4,2,7,11,6691,7197,-506
1,5,0,7,11,7982,8186,-204
1,5,1,7,11,7846,8293,-447
1,5,2,7,11,7855,8381,-526
1,6,0,7,11,8821,9269,-448
1,6,1,7,11,8698,9407,-709
1,6,2,7,11,8748,9452,-704
1,7,0,7,11,9714,10230,-516
1,7,1,7,11,9589,10425,-836
1,7,2,7,11,9645,10448,-803
1,8,0,7,11,10573,11031,-458
1,8,1,7,11,10420,11323,-903
1,8,2,7,11,10442,11365,-923
1,9,0,7,11,11140,11392,-252
1,9,1,7,11,10924,11795,-871
1,9,2,7,11,10877,11888,-1011
1,10,0,7,11,12237,12627,-390
1,10,1,7,11,12077,13013,-936
1,10,2,7,11,12073,13055,-982
1,11,0,7,11,12515,12687,-172
1,11,1,7,11,12299,13119,-820
1,11,2,7,11,12222,13252,-1030
1,12,0,7,11,11942,11728,214
1,12,1,7,11,11649,12162,-513
1,12,2,7,11,11496,12366,-870
1,13,0,7,11,11549,11188,361
1,13,1,7,11,11233,11481,-248
1,13,2,7,11,11164,11728,-564
1,14,0,7,11,11198,10547,651
1,14,1,7,11,10865,10671,194
1,14,2,7,11,10921,10953,-32
1,15,0,7,11,10420,9451,969
1,15,1,7,11,9987,9519,468
1,15,2,7,11,10119,9841,278
1,16,0,7,11,9436,8424,1012
1,16,1,7,11,9019,8393,626
1,16,2,7,11,9257,8619,638
1,17,0,7,11,8555,7506,1049
1,17,1,7,11,8101,7466,635
1,17,2,7,11,8389,7594,795
1,0,0,8,11,8616,7963,653
1,0,1,8,11,8357,8216,141
1,0,2,8,11,8067,8445,-378
1,1,0,8,11,8735,8247,488
1,1,1,8,11,8495,8474,21
1,1,2,8,11,8215,8688,-473
1,2,0,8,11,8186,7609,577
1,2,1,8,11,7879,7865,14
1,2,2,8,11,7577,8144,-567
1,3,0,8,11,8197,7764,433
1,3,1,8,11,7904,7992,-88
1,3,2,8,11,7692,8252,-560
1,4,0,8,11,9013,9003,10
1,4,1,8,11,8808,9178,-370
1,4,2,8,11,8742,9332,-590
1,5,0,8,11,9842,10131,-289
1,5,1,8,11,9670,10322,-652
1,5,2,8,11,9663,10410,-747
1,6,0,8,11,10657,11078,-421
1,6,1,8,11,10481,11320,-839
1,6,2,8,11,10482,11389,-907
1,7,0,8,11,11539,12015,-476
1,7,1,8,11,11355,12318,-963
1,7,2,8,11,11351,12386,-1035
1,8,0,8,11,12411,12811,-400
1,8,1,8,11,12206,13195,-989
1,8,2,8,11,12164,13273,-1109
1,9,0,8,11,12865,13151,-286
1,9,1,8,11,12635,13577,-942
1,9,2,8,11,12601,13683,-1082
1,10,0,8,11,13747,14039,-292
1,10,1,8,11,13546,14451,-905
1,10,2,8,11,13550,14565,-1015
1,11,0,8,11,13863,13925,-62
1,11,1,8,11,13609,14354,-745
1,11,2,8,11,13547,14501,-954
1,12,0,8,11,13409,13133,276
1,12,1,8,11,13057,13510,-453
1,12,2,8,11,12972,13757,-785
1,13,0,8,11,13034,12356,678
1,13,1,8,11,12648,12584,64
1,13,2,8,11,12655,12890,-235
1,14,0,8,11,12245,11236,1009
1,14,1,8,11,11753,11412,341
1,14,2,8,11,11825,11779,46
1,15,0,8,11,11274,10204,1070
1,15,1,8,11,10805,10265,540
1,15,2,8,11,10979,10527,452
1,16,0,8,11,10280,9265,1015
1,16,1,8,11,9812,9248,564
1,16,2,8,11,10113,9389,724
1,0,0,9,11,9887,9382,505
1,0,1,9,11,9639,9616,23
1,0,2,9,11,9354,9830,-476
1,1,0,9,11,9363,8771,592
1,1,1,9,11,9053,9038,15
1,1,2,9,11,8743,9316,-573
1,2,0,9,11,9418,8961,457
1,2,1,9,11,9126,9197,-71
1,2,2,9,11,8905,9457,-552
1,3,0,9,11,10118,9961,157
1,3,1,9,11,9864,10184,-320
1,3,2,9,11,9743,10387,-644
1,4,0,9,11,10873,10948,-75
1,4,1,9,11,10632,11207,-575
1,4,2,9,11,10550,11361,-811
1,5,0,9,11,11678,11940,-262
1,5,1,9,11,11453,12235,-782
1,5,2,9,11,11397,12347,-950
1,6,0,9,11,12482,12863,-381
1,6,1,9,11,12247,13213,-966
1,6,2,9,11,12188,13327,-1139
1,7,0,9,11,13377,13795,-418
1,7,1,9,11,13141,14190,-1049
1,7,2,9,11,13073,14294,-1221
1,8,0,9,11,14136,14570,-434
1,8,1,9,11,13917,14977,-1060
1,8,2,9,11,13888,15068,-1180
1,9,0,9,11,14375,14563,-188
1,9,1,9,11,14104,15015,-911
1,9,2,9,11,14078,15193,-1115
1,10,0,9,11,15095,15277,-182
1,10,1,9,11,14856,15686,-830
1,10,2,9,11,14875,15814,-939
1,11,0,9,11,15330,15330,0
1,11,1,9,11,15017,15702,-685
1,11,2,9,11,15023,15892,-869
1,12,0,9,11,14894,14301,593
1,12,1,9,11,14472,14613,-141
1,12,2,9,11,14463,14919,-456
1,13,0,9,11,14081,13045,1036
1,13,1,9,11,13536,13325,211
1,13,2,9,11,13559,13716,-157
1,14,0,9,11,13099,11989,1110
1,14,1,9,11,12571,12158,413
1,14,2,9,11,12685,12465,220
1,15,0,9,11,12118,11045,1073
1,15,1,9,11,11598,11120,478
1,15,2,9,11,11835,11297,538
1,0,0,10,11,10515,9906,609
1,0,1,10,11,10197,10180,17
1,0,2,10,11,9882,10458,-576
1,1,0,10,11,10595,10123,472
1,1,1,10,11,10300,10370,-70
1,1,2,10,11,10071,10629,-558
1,2,0,10,11,11339,11158,181
1,2,1,10,11,11086,11389,-303
1,2,2,10,11,10956,11592,-636
1,3,0,10,11,11978,11906,72
1,3,1,10,11,11688,12213,-525
1,3,2,10,11,11551,12416,-865
1,4,0,10,11,12709,12757,-48
1,4,1,10,11,12415,13120,-705
1,4,2,10,11,12284,13298,-1014
1,5,0,10,11,13503,13725,-222
1,5,1,10,11,13219,14128,-909
1,5,2,10,11,13103,14285,-1182
1,6,0,10,11,14320,14643,-323
1,6,1,10,11,14033,15085,-1052
1,6,2,10,11,13910,15235,-1325
1,7,0,10,11,15102,15554,-452
1,7,1,10,11,14852,15972,-1120
1,7,2,10,11,14797,16089,-1292
1,8,0,10,11,15646,15982,-336
1,8,1,10,11,15386,16415,-1029
1,8,2,10,11,15365,16578,-1213
1,9,0,10,11,15723,15801,-78
1,9,1,10,11,15414,16250,-836
1,9,2,10,11,15403,16442,-1039
1,10,0,10,11,16562,16682,-120
1,10,1,10,11,16264,17034,-770
1,10,2,10,11,16351,17205,-854
1,11,0,10,11,16815,16498,317
1,11,1,10,11,16432,16805,-373
1,11,2,10,11,16514,17054,-540
1,12,0,10,11,15941,14990,951
1,12,1,10,11,15360,15354,6
1,12,2,10,11,15367,15745,-378
1,13,0,10,11,14935,13798,1137
1,13,1,10,11,14354,14071,283
1,13,2,10,11,14419,14402,17
1,14,0,10,11,13943,12830,1113
1,14,1,10,11,13364,13013,351
1,14,2,10,11,13541,13235,306
1,0,0,11,11,11747,11258,489
1,0,1,11,11,11444,11512,-68
1,0,2,11,11,11210,11771,-561
1,1,0,11,11,12516,12320,196
1,1,1,11,11,12260,12562,-302
1,1,2,11,11,12122,12764,-642
1,2,0,11,11,13199,13103,96
1,2,1,11,11,12910,13418,-508
1,2,2,11,11,12764,13621,-857
1,3,0,11,11,13814,13715,99
1,3,1,11,11,13471,14126,-655
1,3,2,11,11,13285,14353,-1068
1,4,0,11,11,14534,14542,-8
1,4,1,11,11,14181,15013,-832
1,4,2,11,11,13990,15236,-1246
1,5,0,11,11,15341,15505,-164
1,5,1,11,11,15005,16000,-995
1,5,2,11,11,14825,16193,-1368
1,6,0,11,11,16045,16402,-357
1,6,1,11,11,15744,16867,-1123
1,6,2,11,11,15634,17030,-1396
1,7,0,11,11,16612,16966,-354
1,7,1,11,11,16321,17410,-1089
1,7,2,11,11,16274,17599,-1325
1,8,0,11,11,16994,17220,-226
1,8,1,11,11,16696,17650,-954
1,8,2,11,11,16690,17827,-1137
1,9,0,11,11,17190,17206,-16
1,9,1,11,11,16822,17598,-776
1,9,2,11,11,16879,17833,-954
1,10,0,11,11,18047,17850,197
1,10,1,11,11,17679,18137,-458
1,10,2,11,11,17842,18367,-525
1,11,0,11,11,17862,17187,675
1,11,1,11,11,17320,17546,-226
1,11,2,11,11,17418,17880,-462
1,12,0,11,11,16795,15743,1052
1,12,1,11,11,16178,16100,78
1,12,2,11,11,16227,16431,-204
1,13,0,11,11,15779,14639,1140
1,13,1,11,11,15147,14926,221
1,13,2,11,11,15275,15172,103
1,0,0,12,11,13668,13455,213
1,0,1,12,11,13404,13704,-300
1,0,2,12,11,13261,13906,-645
1,1,0,12,11,14376,14265,111
1,1,1,12,11,14084,14591,-507
1,1,2,12,11,13930,14793,-863
1,2,0,12,11,15035,14912,123
1,2,1,12,11,14693,15331,-638
1,2,2,12,11,14498,15558,-1060
1,3,0,12,11,15639,15500,139
1,3,1,12,11,15237,16019,-782
1,3,2,12,11,14991,16291,-1300
1,4,0,12,11,16372,16322,50
1,4,1,12,11,15967,16885,-918
1,4,2,12,11,15712,17144,-1432
1,5,0,12,11,17066,17264,-198
1,5,1,12,11,16716,17782,-1066
1,5,2,12,11,16549,17988,-1439
1,6,0,12,11,17555,17814,-259
1,6,1,12,11,17213,18305,-1092
1,6,2,12,11,17111,18540,-1429
1,7,0,12,11,17960,18204,-244
1,7,1,12,11,17631,18645,-1014
1,7,2,12,11,17599,18848,-1249
1,8,0,12,11,18461,18625,-164
1,8,1,12,11,18104,18998,-894
1,8,2,12,11,18166,19218,-1052
1,9,0,12,11,18675,18374,301
1,9,1,12,11,18237,18701,-464
1,9,2,12,11,18370,18995,-625
1,10,0,12,11,19094,18539,555
1,10,1,12,11,18567,18878,-311
1,10,2,12,11,18746,19193,-447
1,11,0,12,11,18716,17940,776
1,11,1,12,11,18138,18292,-154
1,11,2,12,11,18278,18566,-288
1,12,0,12,11,17639,16584,1055
1,12,1,12,11,16971,16955,16
1,12,2,12,11,17083,17201,-118
1,0,0,13,11,15528,15400,128
1,0,1,13,11,15228,15733,-505
1,0,2,13,11,15069,15935,-866
1,1,0,13,11,16212,16074,138
1,1,1,13,11,15867,16504,-637
1,1,2,13,11,15664,16730,-1066
1,2,0,13,11,16860,16697,163
1,2,1,13,11,16459,17224,-765
1,2,2,13,11,16204,17496,-1292
1,3,0,13,11,17477,17280,197
1,3,1,13,11,17023,17891,-868
1,3,2,13,11,16713,18199,-1486
1,4,0,13,11,18097,18081,16
1,4,1,13,11,17678,18667,-989
1,4,2,13,11,17436,18939,-1503
1,5,0,13,11,18576,18676,-100
1,5,1,13,11,18185,19220,-1035
1,5,2,13,11,18026,19498,-1472
1,6,0,13,11,18903,19052,-149
1,6,1,13,11,18523,19540,-1017
1,6,2,13,11,18436,19789,-1353
1,7,0,13,11,19427,19609,-182
1,7,1,13,11,19039,19993,-954
1,7,2,13,11,19075,20239,-1164
1,8,0,13,11,19946,19793,153
1,8,1,13,11,19519,20101,-582
1,8,2,13,11,19657,20380,-723
1,9,0,13,11,19722,19063,659
1,9,1,13,11,19125,19442,-317
1,9,2,13,11,19274,19821,-547
1,10,0,13,11,19948,19292,656
1,10,1,13,11,19385,19624,-239
1,10,2,13,11,19606,19879,-273
1,11,0,13,11,19560,18781,779
1,11,1,13,11,18931,19147,-216
1,11,2,13,11,19134,19336,-202
1,0,0,14,11,17364,17209,155
1,0,1,14,11,17011,17646,-635
1,0,2,14,11,16803,17872,-1069
1,1,0,14,11,18037,17859,178
1,1,1,14,11,17633,18397,-764
1,1,2,14,11,17370,18668,-1298
1,2,0,14,11,18698,18477,221
1,2,1,14,11,18245,19096,-851
1,2,2,14,11,17926,19404,-1478
1,3,0,14,11,19202,19039,163
1,3,1,14,11,18734,19673,-939
1,3,2,14,11,18437,19994,-1557
1,4,0,14,11,19607,19493,114
1,4,1,14,11,19147,20105,-958
1,4,2,14,11,18913,20449,-1536
1,5,0,14,11,19924,19914,10
1,5,1,14,11,19495,20455,-960
1,5,2,14,11,19351,20747,-1396
1,6,0,14,11,20370,20457,-87
1,6,1,14,11,19931,20888,-957
1,6,2,14,11,19912,21180,-1268
1,7,0,14,11,20912,20777,135
1,7,1,14,11,20454,21096,-642
1,7,2,14,11,20566,21401,-835
1,8,0,14,11,20993,20482,511
1,8,1,14,11,20407,20842,-435
1,8,2,14,11,20561,21206,-645
1,9,0,14,11,20576,19816,760
1,9,1,14,11,19943,20188,-245
1,9,2,14,11,20134,20507,-373
1,10,0,14,11,20792,20133,659
1,10,1,14,11,20178,20479,-301
1,10,2,14,11,20462,20649,-187
1,0,0,15,11,19189,18994,195
1,0,1,15,11,18777,19539,-762
1,0,2,15,11,18509,19810,-1301
1,1,0,15,11,19875,19639,236
1,1,1,15,11,19419,20269,-850
1,1,2,15,11,19092,20576,-1484
1,2,0,15,11,20423,20236,187
1,2,1,15,11,19956,20878,-922
1,2,2,15,11,19650,21199,-1549
1,3,0,15,11,20712,20451,261
1,3,1,15,11,20203,21111,-908
1,3,2,15,11,19914,21504,-1590
1,4,0,15,11,20955,20731,224
1,4,1,15,11,20457,21340,-883
1,4,2,15,11,20238,21698,-1460
1,5,0,15,11,21391,21319,72
1,5,1,15,11,20903,21803,-900
1,5,2,15,11,20827,22138,-1311
1,6,0,15,11,21855,21625,230
1,6,1,15,11,21346,21991,-645
1,6,2,15,11,21403,22342,-939
1,7,0,15,11,21959,21466,493
1,7,1,15,11,21342,21837,-495
1,7,2,15,11,21470,22227,-757
1,8,0,15,11,21847,21235,612
1,8,1,15,11,21225,21588,-363
1,8,2,15,11,21421,21892,-471
1,9,0,15,11,21420,20657,763
1,9,1,15,11,20736,21043,-307
1,9,2,15,11,20990,21277,-287
1,0,0,16,11,21027,20774,253
1,0,1,16,11,20563,21411,-848
1,0,2,16,11,20231,21718,-1487
1,1,0,16,11,21600,21398,202
1,1,1,16,11,21130,22051,-921
1,1,2,16,11,20816,22371,-1555
1,2,0,16,11,21933,21648,285
1,2,1,16,11,21425,22316,-891
1,2,2,16,11,21127,22709,-1582
1,3,0,16,11,22060,21689,371
1,3,1,16,11,21513,22346,-833
1,3,2,16,11,21239,22753,-1514
1,4,0,16,11,22422,22136,286
1,4,1,16,11,21865,22688,-823
1,4,2,16,11,21714,23089,-1375
1,5,0,16,11,22876,22487,389
1,5,1,16,11,22318,22906,-588
1,5,2,16,11,22318,23300,-982
1,6,0,16,11,22902,22314,588
1,6,1,16,11,22234,22732,-498
1,6,2,16,11,22307,23168,-861
1,7,0,16,11,22813,22219,594
1,7,1,16,11,22160,22583,-423
1,7,2,16,11,22330,22913,-583
1,8,0,16,11,22691,22076,615
1,8,1,16,11,22018,22443,-425
1,8,2,16,11,22277,22662,-385
1,0,0,17,11,22752,22533,219
1,0,1,17,11,22274,23193,-919
1,0,2,17,11,21955,23513,-1558
1,1,0,17,11,23110,22810,300
1,1,1,17,11,22599,23489,-890
1,1,2,17,11,22293,23881,-1588
1,2,0,17,11,23281,22886,395
1,2,1,17,11,22735,23551,-816
1,2,2,17,11,22452,23958,-1506
1,3,0,17,11,23527,23094,433
1,3,1,17,11,22921,23694,-773
1,3,2,17,11,22715,24144,-1429
1,4,0,17,11,23907,23304,603
1,4,1,17,11,23280,23791,-511
1,4,2,17,11,23205,24251,-1046
1,5,0,17,11,23923,23176,747
1,5,1,17,11,23206,23647,-441
1,5,2,17,11,23222,24126,-904
1,6,0,17,11,23756,23067,689
1,6,1,17,11,23052,23478,-426
1,6,2,17,11,23167,23854,-687
1,7,0,17,11,23657,23060,597
1,7,1,17,11,22953,23438,-485
1,7,2,17,11,23186,23683,-497
1,0,0,18,11,24262,23945,317
1,0,1,18,11,23743,24631,-888
1,0,2,18,11,23432,25023,-1591
1,1,0,18,11,24458,24048,410
1,1,1,18,11,23909,24724,-815
1,1,2,18,11,23618,25130,-1512
1,2,0,18,11,24748,24291,457
1,2,1,18,11,24143,24899,-756
1,2,2,18,11,23928,25349,-1421
1,3,0,18,11,25012,24262,750
1,3,1,18,11,24336,24797,-461
1,3,2,18,11,24206,25306,-1100
1,4,0,18,11,24954,23993,961
1,4,1,18,11,24168,24532,-364
1,4,2,18,11,24109,25077,-968
1,5,0,18,11,24777,23929,848
1,5,1,18,11,24024,24393,-369
1,5,2,18,11,24082,24812,-730
1,6,0,18,11,24600,23908,692
1,6,1,18,11,23845,24333,-488
1,6,2,18,11,24023,24624,-601
1,0,0,19,11,25610,25183,427
1,0,1,19,11,25053,25866,-813
1,0,2,19,11,24757,26272,-1515
1,1,0,19,11,25925,25453,472
1,1,1,19,11,25317,26072,-755
1,1,2,19,11,25094,26521,-1427
1,2,0,19,11,26233,25459,774
1,2,1,19,11,25558,26002,-444
1,2,2,19,11,25419,26511,-1092
1,3,0,19,11,26059,24951,1108
1,3,1,19,11,25224,25538,-314
1,3,2,19,11,25110,26132,-1022
1,4,0,19,11,25808,24746,1062
1,4,1,19,11,24986,25278,-292
1,4,2,19,11,24969,25763,-794
1,5,0,19,11,25621,24770,851
1,5,1,19,11,24817,25248,-431
1,5,2,19,11,24938,25582,-644
1,0,0,20,11,27077,26588,489
1,0,1,20,11,26461,27214,-753
1,0,2,20,11,26233,27663,-1430
1,1,0,20,11,27410,26621,789
1,1,1,20,11,26732,27175,-443
1,1,2,20,11,26585,27683,-1098
1,2,0,20,11,27280,26148,1132
1,2,1,20,11,26446,26743,-297
1,2,2,20,11,26323,27337,-1014
1,3,0,20,11,26913,25704,1209
1,3,1,20,11,26042,26284,-242
1,3,2,20,11,25970,26818,-848
1,4,0,20,11,26652,25587,1065
1,4,1,20,11,25779,26133,-354
1,4,2,20,11,25825,26533,-708
1,0,0,21,11,28562,27756,806
1,0,1,21,11,27876,28317,-441
1,0,2,21,11,27724,28825,-1101
1,1,0,21,11,28457,27310,1147
1,1,1,21,11,27620,27916,-296
1,1,2,21,11,27489,28509,-1020
1,2,0,21,11,28134,26901,1233
1,2,1,21,11,27264,27489,-225
1,2,2,21,11,27183,28023,-840
1,3,0,21,11,27757,26545,1212
1,3,1,21,11,26835,27139,-304
1,3,2,21,11,26826,27588,-762
1,0,0,22,11,29609,28445,1164
1,0,1,22,11,28764,29058,-294
1,0,2,22,11,28628,29651,-1023
1,1,0,22,11,29311,28063,1248
1,1,1,22,11,28438,28662,-224
1,1,2,22,11,28349,29195,-846
1,2,0,22,11,28978,27742,1236
1,2,1,22,11,28057,28344,-287
1,2,2,22,11,28039,28793,-754
1,0,0,23,11,30463,29198,1265
1,0,1,23,11,29582,29804,-222
1,0,2,23,11,29488,30337,-849
1,1,0,23,11,30155,28904,1251
1,1,1,23,11,29231,29517,-286
1,1,2,23,11,29205,29965,-760
1,0,0,24,11,31307,30039,1268
1,0,1,24,11,30375,30659,-284
1,0,2,24,11,30344,31107,-763
1,0,0,1,12,1254,1244,10
1,1,0,1,12,1280,1275,5
1,2,0,1,12,1328,1311,17
1,3,0,1,12,1168,1117,51
1,4,0,1,12,1076,995,81
1,5,0,1,12,1086,1023,63
1,6,0,1,12,1012,1010,2
1,7,0,1,12,1065,1120,-55
1,8,0,1,12,1408,1531,-123
1,9,0,1,12,664,667,-3
1,10,0,1,12,1351,1438,-87
1,11,0,1,12,2099,2326,-227
1,12,0,1,12,1975,2160,-185
1,13,0,1,12,1929,2047,-118
1,14,0,1,12,1918,2047,-129
1,15,0,1,12,1932,2013,-81
1,16,0,1,12,1819,1922,-103
1,17,0,1,12,1577,1593,-16
1,18,0,1,12,1432,1356,76
1,19,0,1,12,1598,1549,49
1,20,0,1,12,1605,1314,291
1,21,0,1,12,1091,914,177
1,22,0,1,12,915,802,113
1,23,0,1,12,904,902,2
1,0,0,2,12,2534,2519,15
1,1,0,2,12,2608,2586,22
1,2,0,2,12,2496,2428,68
1,3,0,2,12,2244,2112,132
1,4,0,2,12,2162,2018,144
1,5,0,2,12,2098,2033,65
1,6,0,2,12,2077,2130,-53
1,7,0,2,12,2473,2651,-178
1,8,0,2,12,2072,2198,-126
1,9,0,2,12,2015,2105,-90
1,10,0,2,12,3450,3764,-314
1,11,0,2,12,4074,4486,-412
1,12,0,2,12,3904,4207,-303
1,13,0,2,12,3847,4094,-247
1,14,0,2,12,3850,4060,-210
1,15,0,2,12,3751,3935,-184
1,16,0,2,12,3396,3515,-119
1,17,0,2,12,3009,2949,60
1,18,0,2,12,3030,2905,125
1,19,0,2,12,3203,2863,340
1,20,0,2,12,2696,2228,468
1,21,0,2,12,2006,1716,290
1,22,0,2,12,1819,1704,115
1,0,0,3,12,3862,3830,32
1,1,0,3,12,3776,3703,73
1,2,0,3,12,3572,3423,149
1,3,0,3,12,3330,3135,195
1,4,0,3,12,3174,3028,146
1,5,0,3,12,3163,3153,10
1,6,0,3,12,3485,3661,-176
1,7,0,3,12,3137,3318,-181
1,8,0,3,12,3423,3636,-213
1,9,0,3,12,4114,4431,-317
1,10,0,3,12,5425,5924,-499
1,11,0,3,12,6003,6533,-530
1,12,0,3,12,5822,6254,-432
1,13,0,3,12,5779,6107,-328
1,14,0,3,12,5669,5982,-313
1,15,0,3,12,5328,5528,-200
1,16,0,3,12,4828,4871,-43
1,17,0,3,12,4607,4498,109
1,18,0,3,12,4635,4219,416
1,19,0,3,12,4294,3777,517
1,20,0,3,12,3611,3030,581
1,21,0,3,12,2910,2618,292
1,0,0,4,12,5030,4947,83
1,1,0,4,12,4852,4698,154
1,2,0,4,12,4658,4446,212
1,3,0,4,12,4342,4145,197
1,4,0,4,12,4239,4148,91
1,5,0,4,12,4571,4684,-113
1,6,0,4,12,4149,4328,-179
1,7,0,4,12,4488,4756,-268
1,8,0,4,12,5522,5962,-440
1,9,0,4,12,6089,6591,-502
1,10,0,4,12,7354,7971,-617
1,11,0,4,12,7921,8580,-659
1,12,0,4,12,7754,8267,-513
1,13,0,4,12,7598,8029,-431
1,14,0,4,12,7246,7575,-329
1,15,0,4,12,6760,6884,-124
1,16,0,4,12,6426,6420,6
1,17,0,4,12,6212,5812,400
1,18,0,4,12,5726,5133,593
1,19,0,4,12,5209,4579,630
1,20,0,4,12,4515,3932,583
1,0,0,5,12,6106,5942,164
1,1,0,5,12,5938,5721,217
1,2,0,5,12,5670,5456,214
1,3,0,5,12,5407,5265,142
1,4,0,5,12,5647,5679,-32
1,5,0,5,12,5235,5351,-116
1,6,0,5,12,5500,5766,-266
1,7,0,5,12,6587,7082,-495
1,8,0,5,12,7497,8122,-625
1,9,0,5,12,8018,8638,-620
1,10,0,5,12,9272,10018,-746
1,11,0,5,12,9853,10593,-740
1,12,0,5,12,9573,10189,-616
1,13,0,5,12,9175,9622,-447
1,14,0,5,12,8678,8931,-253
1,15,0,5,12,8358,8433,-75
1,16,0,5,12,8031,7734,297
1,17,0,5,12,7303,6726,577
1,18,0,5,12,6641,5935,706
1,19,0,5,12,6113,5481,632
1,0,0,6,12,7192,6965,227
1,1,0,6,12,6950,6731,219
1,2,0,6,12,6735,6576,159
1,3,0,6,12,6815,6796,19
1,4,0,6,12,6311,6346,-35
1,5,0,6,12,6586,6789,-203
1,6,0,6,12,7599,8092,-493
1,7,0,6,12,8562,9242,-680
1,8,0,6,12,9426,10169,-743
1,9,0,6,12,9936,10685,-749
1,10,0,6,12,11204,12031,-827
1,11,0,6,12,11672,12515,-843
1,12,0,6,12,11150,11782,-632
1,13,0,6,12,10607,10978,-371
1,14,0,6,12,10276,10480,-204
1,15,0,6,12,9963,9747,216
1,16,0,6,12,9122,8648,474
1,17,0,6,12,8218,7528,690
1,18,0,6,12,7545,6837,708
1,0,0,7,12,8204,7975,229
1,1,0,7,12,8015,7851,164
1,2,0,7,12,8143,8107,36
1,3,0,7,12,7479,7463,16
1,4,0,7,12,7662,7784,-122
1,5,0,7,12,8685,9115,-430
1,6,0,7,12,9574,10252,-678
1,7,0,7,12,10491,11289,-798
1,8,0,7,12,11344,12216,-872
1,9,0,7,12,11868,12698,-830
1,10,0,7,12,13023,13953,-930
1,11,0,7,12,13249,14108,-859
1,12,0,7,12,12582,13138,-556
1,13,0,7,12,12205,12527,-322
1,14,0,7,12,11881,11794,87
1,15,0,7,12,11054,10661,393
1,16,0,7,12,10037,9450,587
1,17,0,7,12,9122,8430,692
1,0,0,8,12,9269,9095,174
1,1,0,8,12,9423,9382,41
1,2,0,8,12,8807,8774,33
1,3,0,8,12,8830,8901,-71
1,4,0,8,12,9761,10110,-349
1,5,0,8,12,10660,11275,-615
1,6,0,8,12,11503,12299,-796
1,7,0,8,12,12409,13336,-927
1,8,0,8,12,13276,14229,-953
1,9,0,8,12,13687,14620,-933
1,10,0,8,12,14600,15546,-946
1,11,0,8,12,14681,15464,-783
1,12,0,8,12,14180,14687,-507
1,13,0,8,12,13810,13841,-31
1,14,0,8,12,12972,12708,264
1,15,0,8,12,11969,11463,506
1,16,0,8,12,10941,10352,589
1,0,0,9,12,10677,10626,51
1,1,0,9,12,10087,10049,38
1,2,0,9,12,10158,10212,-54
1,3,0,9,12,10929,11227,-298
1,4,0,9,12,11736,12270,-534
1,5,0,9,12,12589,13322,-733
1,6,0,9,12,13421,14346,-925
1,7,0,9,12,14341,15349,-1008
1,8,0,9,12,15095,16151,-1056
1,9,0,9,12,15264,16213,-949
1,10,0,9,12,16032,16902,-870
1,11,0,9,12,16279,17013,-734
1,12,0,9,12,15785,16001,-216
1,13,0,9,12,14901,14755,146
1,14,0,9,12,13887,13510,377
1,15,0,9,12,12873,12365,508
1,0,0,10,12,11341,11293,48
1,1,0,10,12,11438,11487,-49
1,2,0,10,12,12257,12538,-281
1,3,0,10,12,12904,13387,-483
1,4,0,10,12,13665,14317,-652
1,5,0,10,12,14507,15369,-862
1,6,0,10,12,15353,16359,-1006
1,7,0,10,12,16160,17271,-1111
1,8,0,10,12,16672,17744,-1072
1,9,0,10,12,16696,17569,-873
1,10,0,10,12,17630,18451,-821
1,11,0,10,12,17884,18327,-443
1,12,0,10,12,16876,16915,-39
1,13,0,10,12,15816,15557,259
1,14,0,10,12,14791,14412,379
1,0,0,11,12,12692,12731,-39
1,1,0,11,12,13537,13813,-276
1,2,0,11,12,14232,14698,-466
1,3,0,11,12,14833,15434,-601
1,4,0,11,12,15583,16364,-781
1,5,0,11,12,16439,17382,-943
1,6,0,11,12,17172,18281,-1109
1,7,0,11,12,17737,18864,-1127
1,8,0,11,12,18104,19100,-996
1,9,0,11,12,18294,19118,-824
1,10,0,11,12,19235,19765,-530
1,11,0,11,12,18975,19241,-266
1,12,0,11,12,17791,17717,74
1,13,0,11,12,16720,16459,261
1,0,0,12,12,14791,15057,-266
1,1,0,12,12,15512,15973,-461
1,2,0,12,12,16161,16745,-584
1,3,0,12,12,16751,17481,-730
1,4,0,12,12,17515,18377,-862
1,5,0,12,12,18258,19304,-1046
1,6,0,12,12,18749,19874,-1125
1,7,0,12,12,19169,20220,-1051
1,8,0,12,12,19702,20649,-947
1,9,0,12,12,19899,20432,-533
1,10,0,12,12,20326,20679,-353
1,11,0,12,12,19890,20043,-153
1,12,0,12,12,18695,18619,76
1,0,0,13,12,16766,17217,-451
1,1,0,13,12,17441,18020,-579
1,2,0,13,12,18079,18792,-713
1,3,0,13,12,18683,19494,-811
1,4,0,13,12,19334,20299,-965
1,5,0,13,12,19835,20897,-1062
1,6,0,13,12,20181,21230,-1049
1,7,0,13,12,20767,21769,-1002
1,8,0,13,12,21307,21963,-656
1,9,0,13,12,20990,21346,-356
1,10,0,13,12,21241,21481,-240
1,11,0,13,12,20794,20945,-151
1,0,0,14,12,18695,19264,-569
1,1,0,14,12,19359,20067,-708
1,2,0,14,12,20011,20805,-794
1,3,0,14,12,20502,21416,-914
1,4,0,14,12,20911,21892,-981
1,5,0,14,12,21267,22253,-986
1,6,0,14,12,21779,22779,-1000
1,7,0,14,12,22372,23083,-711
1,8,0,14,12,22398,22877,-479
1,9,0,14,12,21905,22148,-243
1,10,0,14,12,22145,22383,-238
1,0,0,15,12,20613,21311,-698
1,1,0,15,12,21291,22080,-789
1,2,0,15,12,21830,22727,-897
1,3,0,15,12,22079,23009,-930
1,4,0,15,12,22343,23248,-905
1,5,0,15,12,22865,23802,-937
1,6,0,15,12,23384,24093,-709
1,7,0,15,12,23463,23997,-534
1,8,0,15,12,23313,23679,-366
1,9,0,15,12,22809,23050,-241
1,0,0,16,12,22545,23324,-779
1,1,0,16,12,23110,24002,-892
1,2,0,16,12,23407,24320,-913
1,3,0,16,12,23511,24365,-854
1,4,0,16,12,23941,24797,-856
1,5,0,16,12,24470,25116,-646
1,6,0,16,12,24475,25007,-532
1,7,0,16,12,24378,24799,-421
1,8,0,16,12,24217,24581,-364
1,0,0,17,12,24364,25246,-882
1,1,0,17,12,24687,25595,-908
1,2,0,17,12,24839,25676,-837
1,3,0,17,12,25109,25914,-805
1,4,0,17,12,25546,26111,-565
1,5,0,17,12,25561,26030,-469
1,6,0,17,12,25390,25809,-419
1,7,0,17,12,25282,25701,-419
1,0,0,18,12,25941,26839,-898
1,1,0,18,12,26119,26951,-832
1,2,0,18,12,26437,27225,-788
1,3,0,18,12,26714,27228,-514
1,4,0,18,12,26637,27025,-388
1,5,0,18,12,26476,26832,-356
1,6,0,18,12,26294,26711,-417
1,0,0,19,12,27373,28195,-822
1,1,0,19,12,27717,28500,-783
1,2,0,19,12,28042,28539,-497
1,3,0,19,12,27805,28142,-337
1,4,0,19,12,27552,27827,-275
1,5,0,19,12,27380,27734,-354
1,0,0,20,12,28971,29744,-773
1,1,0,20,12,29322,29814,-492
1,2,0,20,12,29133,29453,-320
1,3,0,20,12,28720,28944,-224
1,4,0,20,12,28456,28729,-273
1,0,0,21,12,30576,31058,-482
1,1,0,21,12,30413,30728,-315
1,2,0,21,12,30048,30255,-207
1,3,0,21,12,29624,29846,-222
1,0,0,22,12,31667,31972,-305
1,1,0,22,12,31328,31530,-202
1,2,0,22,12,30952,31157,-205
1,0,0,23,12,32582,32774,-192
1,1,0,23,12,32232,32432,-200
1,0,0,24,12,33486,33676,-190
2,0,0,1,1,110,106,4
2,0,1,1,1,107,111,-4
2,0,2,1,1,96,107,-11
2,0,3,1,1,98,106,-8
2,0,4,1,1,111,112,-1
2,0,5,1,1,111,108,3
2,0,6,1,1,104,102,2
2,0,7,1,1,106,107,-1
2,0,8,1,1,104,108,-4
2,0,9,1,1,103,106,-3
2,0,10,1,1,102,104,-2
2,0,11,1,1,102,103,-1
2,0,12,1,1,102,103,-1
2,0,13,1,1,103,104,-1
2,0,14,1,1,104,105,-1
2,0,15,1,1,105,107,-2
2,0,16,1,1,98,115,-17
2,0,17,1,1,102,107,-5
2,0,18,1,1,110,104,6
2,0,19,1,1,108,102,6
2,0,20,1,1,98,101,-3
2,0,21,1,1,103,111,-8
2,0,22,1,1,109,114,-5
2,0,23,1,1,102,102,0
2,1,0,1,1,106,106,0
2,1,1,1,1,111,115,-4
2,1,2,1,1,107,112,-5
2,1,3,1,1,106,107,-1
2,1,4,1,1,112,110,2
2,1,5,1,1,108,108,0
2,1,6,1,1,102,108,-6
2,1,7,1,1,107,118,-11
2,1,8,1,1,108,115,-7
2,1,9,1,1,106,113,-7
2,1,10,1,1,104,109,-5
2,1,11,1,1,103,107,-4
2,1,12,1,1,103,106,-3
2,1,13,1,1,104,108,-4
2,1,14,1,1,105,110,-5
2,1,15,1,1,107,111,-4
2,1,16,1,1,115,117,-2
2,1,17,1,1,107,109,-2
2,1,18,1,1,104,109,-5
2,1,19,1,1,102,107,-5
2,1,20,1,1,101,103,-2
2,1,21,1,1,111,110,1
2,1,22,1,1,114,115,-1
2,1,23,1,1,102,106,-4
2,2,0,1,1,106,112,-6
2,2,1,1,1,115,117,-2
2,2,2,1,1,112,110,2
2,2,3,1,1,107,105,2
2,2,4,1,1,110,112,-2
2,2,5,1,1,108,115,-7
2,2,6,1,1,108,112,-4
2,2,7,1,1,118,115,3
2,2,8,1,1,115,72,43
2,2,9,1,1,113,69,44
2,2,10,1,1,109,66,43
2,2,11,1,1,107,63,44
2,2,12,1,1,106,62,44
2,2,13,1,1,108,63,45
2,2,14,1,1,110,65,45
2,2,15,1,1,111,67,44
2,2,16,1,1,117,90,27
2,2,17,1,1,109,99,10
2,2,18,1,1,109,117,-8
2,2,19,1,1,107,121,-14
2,2,20,1,1,103,107,-4
2,2,21,1,1,110,104,6
2,2,22,1,1,115,111,4
2,2,23,1,1,106,111,-5
2,3,0,1,1,112,114,-2
2,3,1,1,1,117,119,-2
2,3,2,1,1,110,114,-4
2,3,3,1,1,105,115,-10
2,3,4,1,1,112,126,-14
2,3,5,1,1,115,120,-5
2,3,6,1,1,112,94,18
2,3,7,1,1,115,76,39
2,3,8,1,1,72,54,18
2,3,9,1,1,69,51,18
2,3,10,1,1,66,48,18
2,3,11,1,1,63,45,18
2,3,12,1,1,62,44,18
2,3,13,1,1,63,45,18
2,3,14,1,1,65,47,18
2,3,15,1,1,67,48,19
2,3,16,1,1,90,59,31
2,3,17,1,1,99,75,24
2,3,18,1,1,117,106,11
2,3,19,1,1,121,123,-2
2,3,20,1,1,107,115,-8
2,3,21,1,1,104,110,-6
2,3,22,1,1,111,113,-2
2,3,23,1,1,111,110,1
2,4,0,1,1,114,114,0
2,4,1,1,1,119,122,-3
2,4,2,1,1,114,120,-6
2,4,3,1,1,115,119,-4
2,4,4,1,1,126,125,1
2,4,5,1,1,120,109,11
2,4,6,1,1,94,69,25
2,4,7,1,1,76,39,37
2,4,8,1,1,54,69,-15
2,4,9,1,1,51,68,-17
2,4,10,1,1,48,67,-19
2,4,11,1,1,45,65,-20
2,4,12,1,1,44,65,-21
2,4,13,1,1,45,65,-20
2,4,14,1,1,47,65,-18
2,4,15,1,1,48,66,-18
2,4,16,1,1,59,55,4
2,4,17,1,1,75,58,17
2,4,18,1,1,106,81,25
2,4,19,1,1,123,107,16
2,4,20,1,1,115,116,-1
2,4,21,1,1,110,119,-9
2,4,22,1,1,113,118,-5
2,4,23,1,1,110,108,2
2,5,0,1,1,114,120,-6
2,5,1,1,1,122,124,-2
2,5,2,1,1,120,109,11
2,5,3,1,1,119,89,30
2,5,4,1,1,125,87,38
2,5,5,1,1,109,82,27
2,5,6,1,1,69,67,2
2,5,7,1,1,39,58,-19
2,5,8,1,1,69,69,0
2,5,9,1,1,68,69,-1
2,5,10,1,1,67,69,-2
2,5,11,1,1,65,69,-4
2,5,12,1,1,65,69,-4
2,5,13,1,1,65,69,-4
2,5,14,1,1,65,68,-3
2,5,15,1,1,66,68,-2
2,5,16,1,1,55,77,-22
2,5,17,1,1,58,66,-8
2,5,18,1,1,81,71,10
2,5,19,1,1,107,87,20
2,5,20,1,1,116,97,19
2,5,21,1,1,119,107,12
2,5,22,1,1,118,116,2
2,5,23,1,1,108,115,-7
2,6,0,1,1,120,130,-10
2,6,1,1,1,124,125,-1
2,6,2,1,1,109,90,19
2,6,3,1,1,89,49,40
2,6,4,1,1,87,40,47
2,6,5,1,1,82,57,25
2,6,6,1,1,67,82,-15
2,6,7,1,1,58,105,-47
2,6,8,1,1,69,95,-26
2,6,9,1,1,69,96,-27
2,6,10,1,1,69,97,-28
2,6,11,1,1,69,99,-30
2,6,12,1,1,69,99,-30
2,6,13,1,1,69,98,-29
2,6,14,1,1,68,97,-29
2,6,15,1,1,68,96,-28
2,6,16,1,1,77,99,-22
2,6,17,1,1,66,84,-18
2,6,18,1,1,71,79,-8
2,6,19,1,1,87,77,10
2,6,20,1,1,97,72,25
2,6,21,1,1,107,84,23
2,6,22,1,1,116,110,6
2,6,23,1,1,115,125,-10
2,7,0,1,1,130,126,4
2,7,1,1,1,125,141,-16
2,7,2,1,1,90,121,-31
2,7,3,1,1,49,78,-29
2,7,4,1,1,40,63,-23
2,7,5,1,1,57,94,-37
2,7,6,1,1,82,135,-53
2,7,7,1,1,105,121,-16
2,7,8,1,1,95,127,-32
2,7,9,1,1,96,135,-39
2,7,10,1,1,97,130,-33
2,7,11,1,1,99,137,-38
2,7,12,1,1,99,146,-47
2,7,13,1,1,98,146,-48
2,7,14,1,1,97,138,-41
2,7,15,1,1,96,138,-42
2,7,16,1,1,99,134,-35
2,7,17,1,1,84,131,-47
2,7,18,1,1,79,129,-50
2,7,19,1,1,77,93,-16
2,7,20,1,1,72,99,-27
2,7,21,1,1,84,128,-44
2,7,22,1,1,110,118,-8
2,7,23,1,1,125,131,-6
2,8,0,1,1,126,106,20
2,8,1,1,1,141,69,72
2,8,2,1,1,121,69,52
2,8,3,1,1,78,43,35
2,8,4,1,1,63,41,22
2,8,5,1,1,94,55,39
2,8,6,1,1,135,44,91
2,8,7,1,1,121,67,54
2,8,8,1,1,127,64,63
2,8,9,1,1,135,41,94
2,8,10,1,1,130,29,101
2,8,11,1,1,137,36,101
2,8,12,1,1,146,39,107
2,8,13,1,1,146,28,118
2,8,14,1,1,138,27,111
2,8,15,1,1,138,53,85
2,8,16,1,1,134,59,75
2,8,17,1,1,131,66,65
2,8,18,1,1,129,58,71
2,8,19,1,1,93,47,46
2,8,20,1,1,99,51,48
2,8,21,1,1,128,60,68
2,8,22,1,1,118,76,42
2,8,23,1,1,131,103,28
2,9,0,1,1,106,104,2
2,9,1,1,1,69,44,25
2,9,2,1,1,69,60,9
2,9,3,1,1,43,76,-33
2,9,4,1,1,41,148,-107
2,9,5,1,1,55,118,-63
2,9,6,1,1,44,123,-79
2,9,7,1,1,67,157,-90
2,9,8,1,1,64,142,-78
2,9,9,1,1,41,128,-87
2,9,10,1,1,29,132,-103
2,9,11,1,1,36,119,-83
2,9,12,1,1,39,125,-86
2,9,13,1,1,28,132,-104
2,9,14,1,1,27,124,-97
2,9,15,1,1,53,129,-76
2,9,16,1,1,59,145,-86
2,9,17,1,1,66,149,-83
2,9,18,1,1,58,112,-54
2,9,19,1,1,47,120,-73
2,9,20,1,1,51,115,-64
2,9,21,1,1,60,82,-22
2,9,22,1,1,76,99,-23
2,9,23,1,1,103,106,-3
2,10,0,1,1,104,139,-35
2,10,1,1,1,44,100,-56
2,10,2,1,1,60,90,-30
2,10,3,1,1,76,123,-47
2,10,4,1,1,148,253,-105
2,10,5,1,1,118,175,-57
2,10,6,1,1,123,223,-100
2,10,7,1,1,157,230,-73
2,10,8,1,1,142,216,-74
2,10,9,1,1,128,178,-50
2,10,10,1,1,132,194,-62
2,10,11,1,1,119,178,-59
2,10,12,1,1,125,191,-66
2,10,13,1,1,132,200,-68
2,10,14,1,1,124,184,-60
2,10,15,1,1,129,189,-60
2,10,16,1,1,145,242,-97
2,10,17,1,1,149,236,-87
2,10,18,1,1,112,184,-72
2,10,19,1,1,120,211,-91
2,10,20,1,1,115,213,-98
2,10,21,1,1,82,169,-87
2,10,22,1,1,99,173,-74
2,10,23,1,1,106,134,-28
2,11,0,1,1,139,151,-12
2,11,1,1,1,100,147,-47
2,11,2,1,1,90,104,-14
2,11,3,1,1,123,126,-3
2,11,4,1,1,253,237,16
2,11,5,1,1,175,201,-26
2,11,6,1,1,223,213,10
2,11,7,1,1,230,224,6
2,11,8,1,1,216,232,-16
2,11,9,1,1,178,111,67
2,11,10,1,1,194,114,80
2,11,11,1,1,178,115,63
2,11,12,1,1,191,131,60
2,11,13,1,1,200,111,89
2,11,14,1,1,184,103,81
2,11,15,1,1,189,159,30
2,11,16,1,1,242,251,-9
2,11,17,1,1,236,238,-2
2,11,18,1,1,184,200,-16
2,11,19,1,1,211,222,-11
2,11,20,1,1,213,218,-5
2,11,21,1,1,169,197,-28
2,11,22,1,1,173,199,-26
2,11,23,1,1,134,131,3
2,12,0,1,1,151,146,5
2,12,1,1,1,147,159,-12
2,12,2,1,1,104,110,-6
2,12,3,1,1,126,123,3
2,12,4,1,1,237,187,50
2,12,5,1,1,201,253,-52
2,12,6,1,1,213,170,43
2,12,7,1,1,224,233,-9
2,12,8,1,1,232,249,-17
2,12,9,1,1,111,100,11
2,12,10,1,1,114,106,8
2,12,11,1,1,115,93,22
2,12,12,1,1,131,110,21
2,12,13,1,1,111,96,15
2,12,14,1,1,103,91,12
2,12,15,1,1,159,157,2
2,12,16,1,1,251,249,2
2,12,17,1,1,238,217,21
2,12,18,1,1,200,218,-18
2,12,19,1,1,222,213,9
2,12,20,1,1,218,177,41
2,12,21,1,1,197,188,9
2,12,22,1,1,199,197,2
2,12,23,1,1,131,134,-3
2,13,0,1,1,146,152,-6
2,13,1,1,1,159,169,-10
2,13,2,1,1,110,115,-5
2,13,3,1,1,123,122,1
2,13,4,1,1,187,176,11
2,13,5,1,1,253,254,-1
2,13,6,1,1,170,143,27
2,13,7,1,1,233,231,2
2,13,8,1,1,249,236,13
2,13,9,1,1,100,100,0
2,13,10,1,1,106,127,-21
2,13,11,1,1,93,93,0
2,13,12,1,1,110,109,1
2,13,13,1,1,96,112,-16
2,13,14,1,1,91,104,-13
2,13,15,1,1,157,155,2
2,13,16,1,1,249,241,8
2,13,17,1,1,217,180,37
2,13,18,1,1,218,230,-12
2,13,19,1,1,213,213,0
2,13,20,1,1,177,153,24
2,13,21,1,1,188,195,-7
2,13,22,1,1,197,201,-4
2,13,23,1,1,134,154,-20
2,14,0,1,1,152,146,6
2,14,1,1,1,169,169,0
2,14,2,1,1,115,107,8
2,14,3,1,1,122,119,3
2,14,4,1,1,176,207,-31
2,14,5,1,1,254,250,4
2,14,6,1,1,143,164,-21
2,14,7,1,1,231,237,-6
2,14,8,1,1,236,238,-2
2,14,9,1,1,100,83,17
2,14,10,1,1,127,118,9
2,14,11,1,1,93,94,-1
2,14,12,1,1,109,105,4
2,14,13,1,1,112,92,20
2,14,14,1,1,104,86,18
2,14,15,1,1,155,160,-5
2,14,16,1,1,241,255,-14
2,14,17,1,1,180,171,9
2,14,18,1,1,230,247,-17
2,14,19,1,1,213,223,-10
2,14,20,1,1,153,149,4
2,14,21,1,1,195,198,-3
2,14,22,1,1,201,186,15
2,14,23,1,1,154,141,13
2,15,0,1,1,146,108,38
2,15,1,1,1,169,114,55
2,15,2,1,1,107,75,32
2,15,3,1,1,119,119,0
2,15,4,1,1,207,219,-12
2,15,5,1,1,250,249,1
2,15,6,1,1,164,130,34
2,15,7,1,1,237,248,-11
2,15,8,1,1,238,239,-1
2,15,9,1,1,83,107,-24
2,15,10,1,1,118,117,1
2,15,11,1,1,94,94,0
2,15,12,1,1,105,127,-22
2,15,13,1,1,92,112,-20
2,15,14,1,1,86,98,-12
2,15,15,1,1,160,174,-14
2,15,16,1,1,255,254,1
2,15,17,1,1,171,170,1
2,15,18,1,1,247,189,58
2,15,19,1,1,223,217,6
2,15,20,1,1,149,156,-7
2,15,21,1,1,198,168,30
2,15,22,1,1,186,117,69
2,15,23,1,1,141,140,1
2,16,0,1,1,108,108,0
2,16,1,1,1,114,75,39
2,16,2,1,1,75,63,12
2,16,3,1,1,119,146,-27
2,16,4,1,1,219,207,12
2,16,5,1,1,249,191,58
2,16,6,1,1,130,112,18
2,16,7,1,1,248,231,17
2,16,8,1,1,239,196,43
2,16,9,1,1,107,71,36
2,16,10,1,1,117,110,7
2,16,11,1,1,94,67,27
2,16,12,1,1,127,83,44
2,16,13,1,1,112,83,29
2,16,14,1,1,98,61,37
2,16,15,1,1,174,140,34
2,16,16,1,1,254,242,12
2,16,17,1,1,170,161,9
2,16,18,1,1,189,75,114
2,16,19,1,1,217,160,57
2,16,20,1,1,156,174,-18
2,16,21,1,1,168,166,2
2,16,22,1,1,117,93,24
2,16,23,1,1,140,155,-15
2,17,0,1,1,108,122,-14
2,17,1,1,1,75,92,-17
2,17,2,1,1,63,76,-13
2,17,3,1,1,146,184,-38
2,17,4,1,1,207,238,-31
2,17,5,1,1,191,179,12
2,17,6,1,1,112,69,43
2,17,7,1,1,231,128,103
2,17,8,1,1,196,112,84
2,17,9,1,1,71,73,-2
2,17,10,1,1,110,75,35
2,17,11,1,1,67,84,-17
2,17,12,1,1,83,107,-24
2,17,13,1,1,83,75,8
2,17,14,1,1,61,103,-42
2,17,15,1,1,140,82,58
2,17,16,1,1,242,67,175
2,17,17,1,1,161,158,3
2,17,18,1,1,75,73,2
2,17,19,1,1,160,125,35
2,17,20,1,1,174,200,-26
2,17,21,1,1,166,164,2
2,17,22,1,1,93,81,12
2,17,23,1,1,155,121,34
2,18,0,1,1,122,190,-68
2,18,1,1,1,92,90,2
2,18,2,1,1,76,104,-28
2,18,3,1,1,184,234,-50
2,18,4,1,1,238,130,108
2,18,5,1,1,179,80,99
2,18,6,1,1,69,72,-3
2,18,7,1,1,128,99,29
2,18,8,1,1,112,187,-75
2,18,9,1,1,73,123,-50
2,18,10,1,1,75,158,-83
2,18,11,1,1,84,131,-47
2,18,12,1,1,107,158,-51
2,18,13,1,1,75,157,-82
2,18,14,1,1,103,110,-7
2,18,15,1,1,82,65,17
2,18,16,1,1,67,188,-121
2,18,17,1,1,158,208,-50
2,18,18,1,1,73,69,4
2,18,19,1,1,125,63,62
2,18,20,1,1,200,177,23
2,18,21,1,1,164,79,85
2,18,22,1,1,81,74,7
2,18,23,1,1,121,201,-80
2,19,0,1,1,190,190,0
2,19,1,1,1,90,76,14
2,19,2,1,1,104,68,36
2,19,3,1,1,234,230,4
2,19,4,1,1,130,97,33
2,19,5,1,1,80,43,37
2,19,6,1,1,72,73,-1
2,19,7,1,1,99,179,-80
2,19,8,1,1,187,244,-57
2,19,9,1,1,123,132,-9
2,19,10,1,1,158,153,5
2,19,11,1,1,131,120,11
2,19,12,1,1,158,152,6
2,19,13,1,1,157,146,11
2,19,14,1,1,110,84,26
2,19,15,1,1,65,75,-10
2,19,16,1,1,188,138,50
2,19,17,1,1,208,120,88
2,19,18,1,1,69,48,21
2,19,19,1,1,63,77,-14
2,19,20,1,1,177,163,14
2,19,21,1,1,79,45,34
2,19,22,1,1,74,55,19
2,19,23,1,1,201,211,-10
2,20,0,1,1,190,203,-13
2,20,1,1,1,76,72,4
2,20,2,1,1,68,89,-21
2,20,3,1,1,230,235,-5
2,20,4,1,1,97,62,35
2,20,5,1,1,43,32,11
2,20,6,1,1,73,58,15
2,20,7,1,1,179,84,95
2,20,8,1,1,244,145,99
2,20,9,1,1,132,41,91
2,20,10,1,1,153,26,127
2,20,11,1,1,120,44,76
2,20,12,1,1,152,88,64
2,20,13,1,1,146,36,110
2,20,14,1,1,84,24,60
2,20,15,1,1,75,55,20
2,20,16,1,1,138,43,95
2,20,17,1,1,120,70,50
2,20,18,1,1,48,55,-7
2,20,19,1,1,77,84,-7
2,20,20,1,1,163,101,62
2,20,21,1,1,45,89,-44
2,20,22,1,1,55,96,-41
2,20,23,1,1,211,173,38
2,21,0,1,1,203,97,106
2,21,1,1,1,72,74,-2
2,21,2,1,1,89,76,13
2,21,3,1,1,235,120,115
2,21,4,1,1,62,40,22
2,21,5,1,1,32,37,-5
2,21,6,1,1,58,45,13
2,21,7,1,1,84,95,-11
2,21,8,1,1,145,151,-6
2,21,9,1,1,41,49,-8
2,21,10,1,1,26,70,-44
2,21,11,1,1,44,61,-17
2,21,12,1,1,88,116,-28
2,21,13,1,1,36,83,-47
2,21,14,1,1,24,33,-9
2,21,15,1,1,55,98,-43
2,21,16,1,1,43,112,-69
2,21,17,1,1,70,70,0
2,21,18,1,1,55,20,35
2,21,19,1,1,84,58,26
2,21,20,1,1,101,48,53
2,21,21,1,1,89,54,35
2,21,22,1,1,96,54,42
2,21,23,1,1,173,56,117
2,22,0,1,1,97,111,-14
2,22,1,1,1,74,69,5
2,22,2,1,1,76,54,22
2,22,3,1,1,120,69,51
2,22,4,1,1,40,69,-29
2,22,5,1,1,37,65,-28
2,22,6,1,1,45,48,-3
2,22,7,1,1,95,80,15
2,22,8,1,1,151,126,25
2,22,9,1,1,49,98,-49
2,22,10,1,1,70,55,15
2,22,11,1,1,61,60,1
2,22,12,1,1,116,132,-16
2,22,13,1,1,83,90,-7
2,22,14,1,1,33,92,-59
2,22,15,1,1,98,94,4
2,22,16,1,1,112,107,5
2,22,17,1,1,70,67,3
2,22,18,1,1,20,42,-22
2,22,19,1,1,58,70,-12
2,22,20,1,1,48,54,-6
2,22,21,1,1,54,33,21
2,22,22,1,1,54,74,-20
2,22,23,1,1,56,47,9
2,0,0,2,1,216,218,-2
2,0,1,2,1,218,232,-14
2,0,2,2,1,203,222,-19
2,0,3,2,1,204,212,-8
2,0,4,2,1,223,222,1
2,0,5,2,1,219,223,-4
2,0,6,2,1,206,220,-14
2,0,7,2,1,213,233,-20
2,0,8,2,1,212,187,25
2,0,9,2,1,209,182,27
2,0,10,2,1,206,175,31
2,0,11,2,1,205,170,35
2,0,12,2,1,205,168,37
2,0,13,2,1,207,171,36
2,0,14,2,1,209,175,34
2,0,15,2,1,212,178,34
2,0,16,2,1,213,207,6
2,0,17,2,1,209,208,1
2,0,18,2,1,214,226,-12
2,0,19,2,1,210,228,-18
2,0,20,2,1,199,210,-11
2,0,21,2,1,214,214,0
2,0,22,2,1,223,226,-3
2,0,23,2,1,204,217,-13
2,1,0,2,1,212,226,-14
2,1,1,2,1,226,236,-10
2,1,2,2,1,219,224,-5
2,1,3,2,1,213,220,-7
2,1,4,2,1,222,238,-16
2,1,5,2,1,216,235,-19
2,1,6,2,1,210,206,4
2,1,7,2,1,225,191,34
2,1,8,2,1,223,126,97
2,1,9,2,1,219,120,99
2,1,10,2,1,213,114,99
2,1,11,2,1,210,108,102
2,1,12,2,1,209,106,103
2,1,13,2,1,212,108,104
2,1,14,2,1,215,112,103
2,1,15,2,1,218,115,103
2,1,16,2,1,232,149,83
2,1,17,2,1,216,174,42
2,1,18,2,1,213,223,-10
2,1,19,2,1,209,244,-35
2,1,20,2,1,204,222,-18
2,1,21,2,1,221,214,7
2,1,22,2,1,229,224,5
2,1,23,2,1,208,221,-13
2,2,0,2,1,218,228,-10
2,2,1,2,1,232,241,-9
2,2,2,2,1,222,234,-12
2,2,3,2,1,212,234,-22
2,2,4,2,1,222,251,-29
2,2,5,2,1,223,229,-6
2,2,6,2,1,220,163,57
2,2,7,2,1,233,115,118
2,2,8,2,1,187,123,64
2,2,9,2,1,182,119,63
2,2,10,2,1,175,115,60
2,2,11,2,1,170,110,60
2,2,12,2,1,168,109,59
2,2,13,2,1,171,110,61
2,2,14,2,1,175,112,63
2,2,15,2,1,178,114,64
2,2,16,2,1,207,114,93
2,2,17,2,1,208,133,75
2,2,18,2,1,226,187,39
2,2,19,2,1,228,230,-2
2,2,20,2,1,210,231,-21
2,2,21,2,1,214,229,-15
2,2,22,2,1,226,231,-5
2,2,23,2,1,217,218,-1
2,3,0,2,1,226,234,-8
2,3,1,2,1,236,246,-10
2,3,2,2,1,224,229,-5
2,3,3,2,1,220,208,12
2,3,4,2,1,238,212,26
2,3,5,2,1,235,191,44
2,3,6,2,1,206,136,70
2,3,7,2,1,191,97,94
2,3,8,2,1,126,138,-12
2,3,9,2,1,120,137,-17
2,3,10,2,1,114,136,-22
2,3,11,2,1,108,134,-26
2,3,12,2,1,106,134,-28
2,3,13,2,1,108,134,-26
2,3,14,2,1,112,133,-21
2,3,15,2,1,115,134,-19
2,3,16,2,1,149,132,17
2,3,17,2,1,174,124,50
2,3,18,2,1,223,152,71
2,3,19,2,1,244,194,50
2,3,20,2,1,222,213,9
2,3,21,2,1,214,226,-12
2,3,22,2,1,224,234,-10
2,3,23,2,1,221,223,-2
2,4,0,2,1,228,250,-22
2,4,1,2,1,241,249,-8
2,4,2,2,1,234,199,35
2,4,3,2,1,234,138,96
2,4,4,2,1,251,127,124
2,4,5,2,1,229,139,90
2,4,6,2,1,163,149,14
2,4,7,2,1,115,163,-48
2,4,8,2,1,123,164,-41
2,4,9,2,1,119,165,-46
2,4,10,2,1,115,166,-51
2,4,11,2,1,110,168,-58
2,4,12,2,1,109,168,-59
2,4,13,2,1,110,167,-57
2,4,14,2,1,112,165,-53
2,4,15,2,1,114,164,-50
2,4,16,2,1,114,176,-62
2,4,17,2,1,133,150,-17
2,4,18,2,1,187,150,37
2,4,19,2,1,230,164,66
2,4,20,2,1,231,169,62
2,4,21,2,1,229,191,38
2,4,22,2,1,231,226,5
2,4,23,2,1,218,240,-22
2,5,0,2,1,234,256,-22
2,5,1,2,1,246,266,-20
2,5,2,2,1,229,211,18
2,5,3,2,1,208,127,81
2,5,4,2,1,212,103,109
2,5,5,2,1,191,151,40
2,5,6,2,1,136,217,-81
2,5,7,2,1,97,226,-129
2,5,8,2,1,138,222,-84
2,5,9,2,1,137,231,-94
2,5,10,2,1,136,227,-91
2,5,11,2,1,134,236,-102
2,5,12,2,1,134,245,-111
2,5,13,2,1,134,244,-110
2,5,14,2,1,133,235,-102
2,5,15,2,1,134,234,-100
2,5,16,2,1,132,233,-101
2,5,17,2,1,124,215,-91
2,5,18,2,1,152,208,-56
2,5,19,2,1,194,170,24
2,5,20,2,1,213,171,42
2,5,21,2,1,226,212,14
2,5,22,2,1,234,228,6
2,5,23,2,1,223,256,-33
2,6,0,2,1,250,232,18
2,6,1,2,1,249,210,39
2,6,2,2,1,199,190,9
2,6,3,2,1,138,121,17
2,6,4,2,1,127,104,23
2,6,5,2,1,139,149,-10
2,6,6,2,1,149,179,-30
2,6,7,2,1,163,188,-25
2,6,8,2,1,164,191,-27
2,6,9,2,1,165,176,-11
2,6,10,2,1,166,159,7
2,6,11,2,1,168,173,-5
2,6,12,2,1,168,185,-17
2,6,13,2,1,167,174,-7
2,6,14,2,1,165,165,0
2,6,15,2,1,164,191,-27
2,6,16,2,1,176,193,-17
2,6,17,2,1,150,197,-47
2,6,18,2,1,150,187,-37
2,6,19,2,1,164,140,24
2,6,20,2,1,169,150,19
2,6,21,2,1,191,188,3
2,6,22,2,1,226,194,32
2,6,23,2,1,240,234,6
2,7,0,2,1,256,210,46
2,7,1,2,1,266,113,153
2,7,2,2,1,211,129,82
2,7,3,2,1,127,119,8
2,7,4,2,1,103,189,-86
2,7,5,2,1,151,173,-22
2,7,6,2,1,217,167,50
2,7,7,2,1,226,224,2
2,7,8,2,1,222,206,16
2,7,9,2,1,231,169,62
2,7,10,2,1,227,161,66
2,7,11,2,1,236,155,81
2,7,12,2,1,245,164,81
2,7,13,2,1,244,160,84
2,7,14,2,1,235,151,84
2,7,15,2,1,234,182,52
2,7,16,2,1,233,204,29
2,7,17,2,1,215,215,0
2,7,18,2,1,208,170,38
2,7,19,2,1,170,167,3
2,7,20,2,1,171,166,5
2,7,21,2,1,212,142,70
2,7,22,2,1,228,175,53
2,7,23,2,1,256,209,47
2,8,0,2,1,232,243,-11
2,8,1,2,1,210,144,66
2,8,2,2,1,190,150,40
2,8,3,2,1,121,199,-78
2,8,4,2,1,104,401,-297
2,8,5,2,1,149,293,-144
2,8,6,2,1,179,346,-167
2,8,7,2,1,188,387,-199
2,8,8,2,1,191,358,-167
2,8,9,2,1,176,306,-130
2,8,10,2,1,159,326,-167
2,8,11,2,1,173,297,-124
2,8,12,2,1,185,316,-131
2,8,13,2,1,174,332,-158
2,8,14,2,1,165,308,-143
2,8,15,2,1,191,318,-127
2,8,16,2,1,193,387,-194
2,8,17,2,1,197,385,-188
2,8,18,2,1,187,296,-109
2,8,19,2,1,140,331,-191
2,8,20,2,1,150,328,-178
2,8,21,2,1,188,251,-63
2,8,22,2,1,194,272,-78
2,8,23,2,1,234,240,-6
2,9,0,2,1,210,290,-80
2,9,1,2,1,113,247,-134
2,9,2,2,1,129,194,-65
2,9,3,2,1,119,249,-130
2,9,4,2,1,189,490,-301
2,9,5,2,1,173,376,-203
2,9,6,2,1,167,436,-269
2,9,7,2,1,224,454,-230
2,9,8,2,1,206,448,-242
2,9,9,2,1,169,289,-120
2,9,10,2,1,161,308,-147
2,9,11,2,1,155,293,-138
2,9,12,2,1,164,322,-158
2,9,13,2,1,160,311,-151
2,9,14,2,1,151,287,-136
2,9,15,2,1,182,348,-166
2,9,16,2,1,204,493,-289
2,9,17,2,1,215,474,-259
2,9,18,2,1,170,384,-214
2,9,19,2,1,167,433,-266
2,9,20,2,1,166,431,-265
2,9,21,2,1,142,366,-224
2,9,22,2,1,175,372,-197
2,9,23,2,1,209,265,-56
2,10,0,2,1,243,297,-54
2,10,1,2,1,144,306,-162
2,10,2,2,1,150,214,-64
2,10,3,2,1,199,249,-50
2,10,4,2,1,401,424,-23
2,10,5,2,1,293,454,-161
2,10,6,2,1,346,383,-37
2,10,7,2,1,387,457,-70
2,10,8,2,1,358,481,-123
2,10,9,2,1,306,211,95
2,10,10,2,1,326,220,106
2,10,11,2,1,297,208,89
2,10,12,2,1,316,241,75
2,10,13,2,1,332,207,125
2,10,14,2,1,308,194,114
2,10,15,2,1,318,316,2
2,10,16,2,1,387,500,-113
2,10,17,2,1,385,455,-70
2,10,18,2,1,296,418,-122
2,10,19,2,1,331,435,-104
2,10,20,2,1,328,395,-67
2,10,21,2,1,251,385,-134
2,10,22,2,1,272,396,-124
2,10,23,2,1,240,265,-25
2,11,0,2,1,290,298,-8
2,11,1,2,1,247,328,-81
2,11,2,2,1,194,225,-31
2,11,3,2,1,249,245,4
2,11,4,2,1,490,363,127
2,11,5,2,1,376,507,-131
2,11,6,2,1,436,313,123
2,11,7,2,1,454,464,-10
2,11,8,2,1,448,485,-37
2,11,9,2,1,289,200,89
2,11,10,2,1,308,233,75
2,11,11,2,1,293,186,107
2,11,12,2,1,322,219,103
2,11,13,2,1,311,208,103
2,11,14,2,1,287,195,92
2,11,15,2,1,348,312,36
2,11,16,2,1,493,490,3
2,11,17,2,1,474,397,77
2,11,18,2,1,384,448,-64
2,11,19,2,1,433,426,7
2,11,20,2,1,431,330,101
2,11,21,2,1,366,383,-17
2,11,22,2,1,372,398,-26
2,11,23,2,1,265,288,-23
2,12,0,2,1,297,298,-1
2,12,1,2,1,306,338,-32
2,12,2,2,1,214,222,-8
2,12,3,2,1,249,241,8
2,12,4,2,1,424,383,41
2,12,5,2,1,454,504,-50
2,12,6,2,1,383,307,76
2,12,7,2,1,457,468,-11
2,12,8,2,1,481,474,7
2,12,9,2,1,211,183,28
2,12,10,2,1,220,245,-25
2,12,11,2,1,208,187,21
2,12,12,2,1,241,214,27
2,12,13,2,1,207,204,3
2,12,14,2,1,194,190,4
2,12,15,2,1,316,315,1
2,12,16,2,1,500,496,4
2,12,17,2,1,455,351,104
2,12,18,2,1,418,477,-59
2,12,19,2,1,435,436,-1
2,12,20,2,1,395,302,93
2,12,21,2,1,385,393,-8
2,12,22,2,1,396,387,9
2,12,23,2,1,265,295,-30
2,13,0,2,1,298,254,44
2,13,1,2,1,328,283,45
2,13,2,2,1,225,182,43
2,13,3,2,1,245,238,7
2,13,4,2,1,363,426,-63
2,13,5,2,1,507,499,8
2,13,6,2,1,313,294,19
2,13,7,2,1,464,485,-21
2,13,8,2,1,485,477,8
2,13,9,2,1,200,190,10
2,13,10,2,1,233,235,-2
2,13,11,2,1,186,188,-2
2,13,12,2,1,219,232,-13
2,13,13,2,1,208,204,4
2,13,14,2,1,195,184,11
2,13,15,2,1,312,334,-22
2,13,16,2,1,490,509,-19
2,13,17,2,1,397,341,56
2,13,18,2,1,448,436,12
2,13,19,2,1,426,440,-14
2,13,20,2,1,330,305,25
2,13,21,2,1,383,366,17
2,13,22,2,1,398,303,95
2,13,23,2,1,288,281,7
2,14,0,2,1,298,216,82
2,14,1,2,1,338,189,149
2,14,2,2,1,222,138,84
2,14,3,2,1,241,265,-24
2,14,4,2,1,383,426,-43
2,14,5,2,1,504,440,64
2,14,6,2,1,307,242,65
2,14,7,2,1,468,479,-11
2,14,8,2,1,474,435,39
2,14,9,2,1,183,178,5
2,14,10,2,1,245,227,18
2,14,11,2,1,187,161,26
2,14,12,2,1,214,210,4
2,14,13,2,1,204,195,9
2,14,14,2,1,190,159,31
2,14,15,2,1,315,314,1
2,14,16,2,1,496,496,0
2,14,17,2,1,351,331,20
2,14,18,2,1,477,264,213
2,14,19,2,1,436,377,59
2,14,20,2,1,302,330,-28
2,14,21,2,1,393,334,59
2,14,22,2,1,387,210,177
2,14,23,2,1,295,295,0
2,15,0,2,1,254,230,24
2,15,1,2,1,283,167,116
2,15,2,2,1,182,139,43
2,15,3,2,1,238,330,-92
2,15,4,2,1,426,445,-19
2,15,5,2,1,499,370,129
2,15,6,2,1,294,181,113
2,15,7,2,1,485,359,126
2,15,8,2,1,477,308,169
2,15,9,2,1,190,144,46
2,15,10,2,1,235,185,50
2,15,11,2,1,188,151,37
2,15,12,2,1,232,190,42
2,15,13,2,1,204,158,46
2,15,14,2,1,184,164,20
2,15,15,2,1,334,222,112
2,15,16,2,1,509,309,200
2,15,17,2,1,341,319,22
2,15,18,2,1,436,148,288
2,15,19,2,1,440,285,155
2,15,20,2,1,305,374,-69
2,15,21,2,1,366,330,36
2,15,22,2,1,303,174,129
2,15,23,2,1,281,276,5
2,16,0,2,1,216,312,-96
2,16,1,2,1,189,182,7
2,16,2,2,1,138,180,-42
2,16,3,2,1,265,418,-153
2,16,4,2,1,426,368,58
2,16,5,2,1,440,259,181
2,16,6,2,1,242,141,101
2,16,7,2,1,479,227,252
2,16,8,2,1,435,299,136
2,16,9,2,1,178,196,-18
2,16,10,2,1,227,233,-6
2,16,11,2,1,161,215,-54
2,16,12,2,1,210,265,-55
2,16,13,2,1,195,232,-37
2,16,14,2,1,159,213,-54
2,16,15,2,1,314,147,167
2,16,16,2,1,496,255,241
2,16,17,2,1,331,366,-35
2,16,18,2,1,264,142,122
2,16,19,2,1,377,188,189
2,16,20,2,1,330,377,-47
2,16,21,2,1,334,243,91
2,16,22,2,1,210,155,55
2,16,23,2,1,295,322,-27
2,17,0,2,1,230,380,-150
2,17,1,2,1,167,166,1
2,17,2,2,1,139,172,-33
2,17,3,2,1,330,464,-134
2,17,4,2,1,445,227,218
2,17,5,2,1,370,123,247
2,17,6,2,1,181,145,36
2,17,7,2,1,359,278,81
2,17,8,2,1,308,431,-123
2,17,9,2,1,144,255,-111
2,17,10,2,1,185,311,-126
2,17,11,2,1,151,251,-100
2,17,12,2,1,190,310,-120
2,17,13,2,1,158,303,-145
2,17,14,2,1,164,194,-30
2,17,15,2,1,222,140,82
2,17,16,2,1,309,326,-17
2,17,17,2,1,319,328,-9
2,17,18,2,1,148,117,31
2,17,19,2,1,285,140,145
2,17,20,2,1,374,340,34
2,17,21,2,1,330,124,206
2,17,22,2,1,174,129,45
2,17,23,2,1,276,412,-136
2,18,0,2,1,312,393,-81
2,18,1,2,1,182,148,34
2,18,2,2,1,180,157,23
2,18,3,2,1,418,465,-47
2,18,4,2,1,368,159,209
2,18,5,2,1,259,75,184
2,18,6,2,1,141,131,10
2,18,7,2,1,227,263,-36
2,18,8,2,1,299,389,-90
2,18,9,2,1,196,173,23
2,18,10,2,1,233,179,54
2,18,11,2,1,215,164,51
2,18,12,2,1,265,240,25
2,18,13,2,1,232,182,50
2,18,14,2,1,213,108,105
2,18,15,2,1,147,130,17
2,18,16,2,1,255,181,74
2,18,17,2,1,366,190,176
2,18,18,2,1,142,103,39
2,18,19,2,1,188,161,27
2,18,20,2,1,377,264,113
2,18,21,2,1,243,134,109
2,18,22,2,1,155,151,4
2,18,23,2,1,322,384,-62
2,19,0,2,1,380,300,80
2,19,1,2,1,166,146,20
2,19,2,2,1,172,165,7
2,19,3,2,1,464,355,109
2,19,4,2,1,227,102,125
2,19,5,2,1,123,69,54
2,19,6,2,1,145,103,42
2,19,7,2,1,278,179,99
2,19,8,2,1,431,296,135
2,19,9,2,1,255,90,165
2,19,10,2,1,311,96,215
2,19,11,2,1,251,105,146
2,19,12,2,1,310,204,106
2,19,13,2,1,303,119,184
2,19,14,2,1,194,57,137
2,19,15,2,1,140,153,-13
2,19,16,2,1,326,155,171
2,19,17,2,1,328,140,188
2,19,18,2,1,117,75,42
2,19,19,2,1,140,142,-2
2,19,20,2,1,340,149,191
2,19,21,2,1,124,143,-19
2,19,22,2,1,129,150,-21
2,19,23,2,1,412,229,183
2,20,0,2,1,393,208,185
2,20,1,2,1,148,143,5
2,20,2,2,1,157,130,27
2,20,3,2,1,465,189,276
2,20,4,2,1,159,109,50
2,20,5,2,1,75,102,-27
2,20,6,2,1,131,93,38
2,20,7,2,1,263,175,88
2,20,8,2,1,389,277,112
2,20,9,2,1,173,147,26
2,20,10,2,1,179,125,54
2,20,11,2,1,164,121,43
2,20,12,2,1,240,248,-8
2,20,13,2,1,182,173,9
2,20,14,2,1,108,125,-17
2,20,15,2,1,130,192,-62
2,20,16,2,1,181,219,-38
2,20,17,2,1,190,137,53
2,20,18,2,1,103,62,41
2,20,19,2,1,161,128,33
2,20,20,2,1,264,102,162
2,20,21,2,1,134,87,47
2,20,22,2,1,151,128,23
2,20,23,2,1,384,103,281
2,0,0,3,1,322,340,-18
2,0,1,3,1,333,358,-25
2,0,2,3,1,315,344,-29
2,0,3,3,1,311,339,-28
2,0,4,3,1,333,363,-30
2,0,5,3,1,327,344,-17
2,0,6,3,1,314,275,39
2,0,7,3,1,331,230,101
2,0,8,3,1,327,195,132
2,0,9,3,1,322,188,134
2,0,10,3,1,315,181,134
2,0,11,3,1,312,173,139
2,0,12,3,1,311,171,140
2,0,13,3,1,315,173,142
2,0,14,3,1,319,177,142
2,0,15,3,1,323,181,142
2,0,16,3,1,330,204,126
2,0,17,3,1,318,232,86
2,0,18,3,1,323,304,19
2,0,19,3,1,317,351,-34
2,0,20,3,1,302,338,-36
2,0,21,3,1,324,333,-9
2,0,22,3,1,338,342,-4
2,0,23,3,1,310,329,-19
2,1,0,3,1,324,348,-24
2,1,1,3,1,343,365,-22
2,1,2,3,1,329,343,-14
2,1,3,3,1,318,323,-5
2,1,4,3,1,334,338,-4
2,1,5,3,1,331,311,20
2,1,6,3,1,322,230,92
2,1,7,3,1,340,173,167
2,1,8,3,1,295,192,103
2,1,9,3,1,288,188,100
2,1,10,3,1,279,184,95
2,1,11,3,1,273,179,94
2,1,12,3,1,271,178,93
2,1,13,3,1,275,179,96
2,1,14,3,1,280,180,100
2,1,15,3,1,285,182,103
2,1,16,3,1,322,191,131
2,1,17,3,1,315,199,116
2,1,18,3,1,330,258,72
2,1,19,3,1,330,317,13
2,1,20,3,1,311,328,-17
2,1,21,3,1,325,336,-11
2,1,22,3,1,340,347,-7
2,1,23,3,1,319,333,-14
2,2,0,3,1,332,364,-32
2,2,1,3,1,351,371,-20
2,2,2,3,1,336,319,17
2,2,3,3,1,327,257,70
2,2,4,3,1,348,252,96
2,2,5,3,1,343,248,95
2,2,6,3,1,314,218,96
2,2,7,3,1,309,202,107
2,2,8,3,1,241,233,8
2,2,9,3,1,233,233,0
2,2,10,3,1,223,233,-10
2,2,11,3,1,215,233,-18
2,2,12,3,1,212,233,-21
2,2,13,3,1,216,232,-16
2,2,14,3,1,222,230,-8
2,2,15,3,1,226,230,-4
2,2,16,3,1,266,231,35
2,2,17,3,1,283,208,75
2,2,18,3,1,332,231,101
2,2,19,3,1,351,271,80
2,2,20,3,1,325,285,40
2,2,21,3,1,324,310,14
2,2,22,3,1,339,344,-5
2,2,23,3,1,327,348,-21
2,3,0,3,1,340,376,-36
2,3,1,3,1,358,390,-32
2,3,2,3,1,344,320,24
2,3,3,3,1,339,216,123
2,3,4,3,1,363,190,173
2,3,5,3,1,344,233,111
2,3,6,3,1,275,284,-9
2,3,7,3,1,230,284,-54
2,3,8,3,1,195,291,-96
2,3,9,3,1,188,300,-112
2,3,10,3,1,181,296,-115
2,3,11,3,1,173,305,-132
2,3,12,3,1,171,314,-143
2,3,13,3,1,173,313,-140
2,3,14,3,1,177,303,-126
2,3,15,3,1,181,302,-121
2,3,16,3,1,204,310,-106
2,3,17,3,1,232,281,-49
2,3,18,3,1,304,279,25
2,3,19,3,1,351,257,94
2,3,20,3,1,338,268,70
2,3,21,3,1,333,319,14
2,3,22,3,1,342,344,-2
2,3,23,3,1,329,371,-42
2,4,0,3,1,348,362,-14
2,4,1,3,1,365,335,30
2,4,2,3,1,343,280,63
2,4,3,3,1,323,170,153
2,4,4,3,1,338,144,194
2,4,5,3,1,311,206,105
2,4,6,3,1,230,261,-31
2,4,7,3,1,173,293,-120
2,4,8,3,1,192,286,-94
2,4,9,3,1,188,272,-84
2,4,10,3,1,184,256,-72
2,4,11,3,1,179,272,-93
2,4,12,3,1,178,284,-106
2,4,13,3,1,179,272,-93
2,4,14,3,1,180,262,-82
2,4,15,3,1,182,287,-105
2,4,16,3,1,191,292,-101
2,4,17,3,1,199,281,-82
2,4,18,3,1,258,266,-8
2,4,19,3,1,317,217,100
2,4,20,3,1,328,222,106
2,4,21,3,1,336,272,64
2,4,22,3,1,347,304,43
2,4,23,3,1,333,359,-26
2,5,0,3,1,364,336,28
2,5,1,3,1,371,254,117
2,5,2,3,1,319,250,69
2,5,3,3,1,257,197,60
2,5,4,3,1,252,252,0
2,5,5,3,1,248,267,-19
2,5,6,3,1,218,302,-84
2,5,7,3,1,202,345,-143
2,5,8,3,1,233,333,-100
2,5,9,3,1,233,304,-71
2,5,10,3,1,233,291,-58
2,5,11,3,1,233,292,-59
2,5,12,3,1,233,310,-77
2,5,13,3,1,232,306,-74
2,5,14,3,1,230,289,-59
2,5,15,3,1,230,320,-90
2,5,16,3,1,231,338,-107
2,5,17,3,1,208,346,-138
2,5,18,3,1,231,299,-68
2,5,19,3,1,271,260,11
2,5,20,3,1,285,265,20
2,5,21,3,1,310,270,40
2,5,22,3,1,344,293,51
2,5,23,3,1,348,340,8
2,6,0,3,1,376,349,27
2,6,1,3,1,390,213,177
2,6,2,3,1,320,219,101
2,6,3,3,1,216,242,-26
2,6,4,3,1,190,442,-252
2,6,5,3,1,233,348,-115
2,6,6,3,1,284,390,-106
2,6,7,3,1,284,454,-170
2,6,8,3,1,291,422,-131
2,6,9,3,1,300,347,-47
2,6,10,3,1,296,355,-59
2,6,11,3,1,305,333,-28
2,6,12,3,1,314,355,-41
2,6,13,3,1,313,360,-47
2,6,14,3,1,303,335,-32
2,6,15,3,1,302,371,-69
2,6,16,3,1,310,446,-136
2,6,17,3,1,281,451,-170
2,6,18,3,1,279,354,-75
2,6,19,3,1,257,378,-121
2,6,20,3,1,268,379,-111
2,6,21,3,1,319,311,8
2,6,22,3,1,344,348,-4
2,6,23,3,1,371,343,28
2,7,0,3,1,362,394,-32
2,7,1,3,1,335,291,44
2,7,2,3,1,280,254,26
2,7,3,3,1,170,325,-155
2,7,4,3,1,144,638,-494
2,7,5,3,1,206,494,-288
2,7,6,3,1,261,559,-298
2,7,7,3,1,293,611,-318
2,7,8,3,1,286,590,-304
2,7,9,3,1,272,417,-145
2,7,10,3,1,256,440,-184
2,7,11,3,1,272,412,-140
2,7,12,3,1,284,447,-163
2,7,13,3,1,272,443,-171
2,7,14,3,1,262,411,-149
2,7,15,3,1,287,477,-190
2,7,16,3,1,292,638,-346
2,7,17,3,1,281,623,-342
2,7,18,3,1,266,496,-230
2,7,19,3,1,217,553,-336
2,7,20,3,1,222,546,-324
2,7,21,3,1,272,448,-176
2,7,22,3,1,304,471,-167
2,7,23,3,1,359,371,-12
2,8,0,3,1,336,436,-100
2,8,1,3,1,254,406,-152
2,8,2,3,1,250,304,-54
2,8,3,3,1,197,372,-175
2,8,4,3,1,252,677,-425
2,8,5,3,1,267,629,-362
2,8,6,3,1,302,606,-304
2,8,7,3,1,345,687,-342
2,8,8,3,1,333,697,-364
2,8,9,3,1,304,389,-85
2,8,10,3,1,291,414,-123
2,8,11,3,1,292,386,-94
2,8,12,3,1,310,432,-122
2,8,13,3,1,306,407,-101
2,8,14,3,1,289,378,-89
2,8,15,3,1,320,505,-185
2,8,16,3,1,338,742,-404
2,8,17,3,1,346,691,-345
2,8,18,3,1,299,602,-303
2,8,19,3,1,260,646,-386
2,8,20,3,1,265,608,-343
2,8,21,3,1,270,554,-284
2,8,22,3,1,293,569,-276
2,8,23,3,1,340,399,-59
2,9,0,3,1,349,449,-100
2,9,1,3,1,213,475,-262
2,9,2,3,1,219,329,-110
2,9,3,3,1,242,371,-129
2,9,4,3,1,442,600,-158
2,9,5,3,1,348,708,-360
2,9,6,3,1,390,526,-136
2,9,7,3,1,454,688,-234
2,9,8,3,1,422,717,-295
2,9,9,3,1,347,311,36
2,9,10,3,1,355,347,8
2,9,11,3,1,333,301,32
2,9,12,3,1,355,350,5
2,9,13,3,1,360,319,41
2,9,14,3,1,335,298,37
2,9,15,3,1,371,471,-100
2,9,16,3,1,446,741,-295
2,9,17,3,1,451,635,-184
2,9,18,3,1,354,648,-294
2,9,19,3,1,378,648,-270
2,9,20,3,1,379,548,-169
2,9,21,3,1,311,580,-269
2,9,22,3,1,348,597,-249
2,9,23,3,1,343,419,-76
2,10,0,3,1,394,444,-50
2,10,1,3,1,291,497,-206
2,10,2,3,1,254,332,-78
2,10,3,3,1,325,364,-39
2,10,4,3,1,638,570,68
2,10,5,3,1,494,757,-263
2,10,6,3,1,559,477,82
2,10,7,3,1,611,701,-90
2,10,8,3,1,590,723,-133
2,10,9,3,1,417,283,134
2,10,10,3,1,440,351,89
2,10,11,3,1,412,280,132
2,10,12,3,1,447,324,123
2,10,13,3,1,443,300,143
2,10,14,3,1,411,281,130
2,10,15,3,1,477,472,5
2,10,16,3,1,638,745,-107
2,10,17,3,1,623,568,55
2,10,18,3,1,496,695,-199
2,10,19,3,1,553,649,-96
2,10,20,3,1,546,479,67
2,10,21,3,1,448,581,-133
2,10,22,3,1,471,584,-113
2,10,23,3,1,371,429,-58
2,11,0,3,1,436,406,30
2,11,1,3,1,406,452,-46
2,11,2,3,1,304,297,7
2,11,3,3,1,372,360,12
2,11,4,3,1,677,602,75
2,11,5,3,1,629,753,-124
2,11,6,3,1,606,437,169
2,11,7,3,1,687,716,-29
2,11,8,3,1,697,713,-16
2,11,9,3,1,389,290,99
2,11,10,3,1,414,362,52
2,11,11,3,1,386,281,105
2,11,12,3,1,432,341,91
2,11,13,3,1,407,316,91
2,11,14,3,1,378,288,90
2,11,15,3,1,505,489,16
2,11,16,3,1,742,750,-8
2,11,17,3,1,691,521,170
2,11,18,3,1,602,666,-64
2,11,19,3,1,646,653,-7
2,11,20,3,1,608,458,150
2,11,21,3,1,554,561,-7
2,11,22,3,1,569,504,65
2,11,23,3,1,399,435,-36
2,12,0,3,1,449,362,87
2,12,1,3,1,475,358,117
2,12,2,3,1,329,245,84
2,12,3,3,1,371,384,-13
2,12,4,3,1,600,633,-33
2,12,5,3,1,708,690,18
2,12,6,3,1,526,406,120
2,12,7,3,1,688,716,-28
2,12,8,3,1,717,673,44
2,12,9,3,1,311,261,50
2,12,10,3,1,347,345,2
2,12,11,3,1,301,255,46
2,12,12,3,1,350,315,35
2,12,13,3,1,319,287,32
2,12,14,3,1,298,245,53
2,12,15,3,1,471,474,-3
2,12,16,3,1,741,751,-10
2,12,17,3,1,635,502,133
2,12,18,3,1,648,511,137
2,12,19,3,1,648,600,48
2,12,20,3,1,548,479,69
2,12,21,3,1,580,532,48
2,12,22,3,1,597,396,201
2,12,23,3,1,419,436,-17
2,13,0,3,1,444,338,106
2,13,1,3,1,497,281,216
2,13,2,3,1,332,214,118
2,13,3,3,1,364,449,-85
2,13,4,3,1,570,664,-94
2,13,5,3,1,757,619,138
2,13,6,3,1,477,311,166
2,13,7,3,1,701,607,94
2,13,8,3,1,723,547,176
2,13,9,3,1,283,251,32
2,13,10,3,1,351,302,49
2,13,11,3,1,280,245,35
2,13,12,3,1,324,317,7
2,13,13,3,1,300,270,30
2,13,14,3,1,281,262,19
2,13,15,3,1,472,396,76
2,13,16,3,1,745,563,182
2,13,17,3,1,568,489,79
2,13,18,3,1,695,337,358
2,13,19,3,1,649,502,147
2,13,20,3,1,479,530,-51
2,13,21,3,1,581,498,83
2,13,22,3,1,584,291,293
2,13,23,3,1,429,416,13
2,14,0,3,1,406,420,-14
2,14,1,3,1,452,257,195
2,14,2,3,1,297,243,54
2,14,3,3,1,360,564,-204
2,14,4,3,1,602,575,27
2,14,5,3,1,753,450,303
2,14,6,3,1,437,253,184
2,14,7,3,1,716,458,258
2,14,8,3,1,713,495,218
2,14,9,3,1,290,267,23
2,14,10,3,1,362,343,19
2,14,11,3,1,281,282,-1
2,14,12,3,1,341,348,-7
2,14,13,3,1,316,315,1
2,14,14,3,1,288,274,14
2,14,15,3,1,489,287,202
2,14,16,3,1,750,497,253
2,14,17,3,1,521,527,-6
2,14,18,3,1,666,217,449
2,14,19,3,1,653,348,305
2,14,20,3,1,458,551,-93
2,14,21,3,1,561,409,152
2,14,22,3,1,504,248,256
2,14,23,3,1,435,477,-42
2,15,0,3,1,362,502,-140
2,15,1,3,1,358,258,100
2,15,2,3,1,245,248,-3
2,15,3,3,1,384,648,-264
2,15,4,3,1,633,465,168
2,15,5,3,1,690,302,388
2,15,6,3,1,406,214,192
2,15,7,3,1,716,406,310
2,15,8,3,1,673,543,130
2,15,9,3,1,261,328,-67
2,15,10,3,1,345,386,-41
2,15,11,3,1,255,335,-80
2,15,12,3,1,315,417,-102
2,15,13,3,1,287,378,-91
2,15,14,3,1,245,297,-52
2,15,15,3,1,474,222,252
2,15,16,3,1,751,393,358
2,15,17,3,1,502,486,16
2,15,18,3,1,511,190,321
2,15,19,3,1,600,265,335
2,15,20,3,1,479,540,-61
2,15,21,3,1,532,288,244
2,15,22,3,1,396,210,186
2,15,23,3,1,436,533,-97
2,16,0,3,1,338,583,-245
2,16,1,3,1,281,238,43
2,16,2,3,1,214,261,-47
2,16,3,3,1,449,699,-250
2,16,4,3,1,664,289,375
2,16,5,3,1,619,155,464
2,16,6,3,1,311,203,108
2,16,7,3,1,607,362,245
2,16,8,3,1,547,576,-29
2,16,9,3,1,251,296,-45
2,16,10,3,1,302,337,-35
2,16,11,3,1,245,295,-50
2,16,12,3,1,317,398,-81
2,16,13,3,1,270,339,-69
2,16,14,3,1,262,218,44
2,16,15,3,1,396,195,201
2,16,16,3,1,563,369,194
2,16,17,3,1,489,398,91
2,16,18,3,1,337,172,165
2,16,19,3,1,502,224,278
2,16,20,3,1,530,441,89
2,16,21,3,1,498,213,285
2,16,22,3,1,291,225,66
2,16,23,3,1,416,585,-169
2,17,0,3,1,420,490,-70
2,17,1,3,1,257,222,35
2,17,2,3,1,243,233,10
2,17,3,3,1,564,585,-21
2,17,4,3,1,575,199,376
2,17,5,3,1,450,112,338
2,17,6,3,1,253,176,77
2,17,7,3,1,458,358,100
2,17,8,3,1,495,540,-45
2,17,9,3,1,267,222,45
2,17,10,3,1,343,249,94
2,17,11,3,1,282,225,57
2,17,12,3,1,348,356,-8
2,17,13,3,1,315,265,50
2,17,14,3,1,274,141,133
2,17,15,3,1,287,228,59
2,17,16,3,1,497,293,204
2,17,17,3,1,527,260,267
2,17,18,3,1,217,123,94
2,17,19,3,1,348,219,129
2,17,20,3,1,551,312,239
2,17,21,3,1,409,188,221
2,17,22,3,1,248,205,43
2,17,23,3,1,477,440,37
2,18,0,3,1,502,411,91
2,18,1,3,1,258,215,43
2,18,2,3,1,248,219,29
2,18,3,3,1,648,424,224
2,18,4,3,1,465,171,294
2,18,5,3,1,302,134,168
2,18,6,3,1,214,151,63
2,18,7,3,1,406,259,147
2,18,8,3,1,543,422,121
2,18,9,3,1,328,188,140
2,18,10,3,1,386,151,235
2,18,11,3,1,335,165,170
2,18,12,3,1,417,336,81
2,18,13,3,1,378,209,169
2,18,14,3,1,297,149,148
2,18,15,3,1,222,247,-25
2,18,16,3,1,393,262,131
2,18,17,3,1,486,207,279
2,18,18,3,1,190,117,73
2,18,19,3,1,265,212,53
2,18,20,3,1,540,203,337
2,18,21,3,1,288,176,112
2,18,22,3,1,210,224,-14
2,18,23,3,1,533,276,257
2,0,0,4,1,434,478,-44
2,0,1,4,1,450,490,-40
2,0,2,4,1,425,433,-8
2,0,3,4,1,416,372,44
2,0,4,4,1,445,378,67
2,0,5,4,1,442,368,74
2,0,6,4,1,426,312,114
2,0,7,4,1,446,278,168
2,0,8,4,1,399,287,112
2,0,9,4,1,391,284,107
2,0,10,4,1,381,281,100
2,0,11,4,1,375,278,97
2,0,12,4,1,373,277,96
2,0,13,4,1,378,277,101
2,0,14,4,1,384,277,107
2,0,15,4,1,390,278,112
2,0,16,4,1,420,290,130
2,0,17,4,1,417,283,134
2,0,18,4,1,440,337,103
2,0,19,4,1,438,394,44
2,0,20,4,1,409,400,9
2,0,21,4,1,428,420,8
2,0,22,4,1,449,457,-8
2,0,23,4,1,421,458,-37
2,1,0,4,1,438,490,-52
2,1,1,4,1,462,512,-50
2,1,2,4,1,443,440,3
2,1,3,4,1,433,335,98
2,1,4,4,1,460,315,145
2,1,5,4,1,451,342,109
2,1,6,4,1,416,353,63
2,1,7,4,1,416,323,93
2,1,8,4,1,349,360,-11
2,1,9,4,1,339,368,-29
2,1,10,4,1,327,363,-36
2,1,11,4,1,318,370,-52
2,1,12,4,1,315,379,-64
2,1,13,4,1,320,378,-58
2,1,14,4,1,327,368,-41
2,1,15,4,1,333,368,-35
2,1,16,4,1,381,365,16
2,1,17,4,1,390,339,51
2,1,18,4,1,436,360,76
2,1,19,4,1,453,364,89
2,1,20,4,1,426,384,42
2,1,21,4,1,435,438,-3
2,1,22,4,1,453,462,-9
2,1,23,4,1,429,479,-50
2,2,0,4,1,446,482,-36
2,2,1,4,1,473,459,14
2,2,2,4,1,456,389,67
2,2,3,4,1,446,259,187
2,2,4,4,1,473,231,242
2,2,5,4,1,452,288,164
2,2,6,4,1,383,328,55
2,2,7,4,1,348,351,-3
2,2,8,4,1,310,355,-45
2,2,9,4,1,301,341,-40
2,2,10,4,1,290,325,-35
2,2,11,4,1,280,341,-61
2,2,12,4,1,277,353,-76
2,2,13,4,1,281,341,-60
2,2,14,4,1,287,330,-43
2,2,15,4,1,292,355,-63
2,2,16,4,1,321,369,-48
2,2,17,4,1,341,347,-6
2,2,18,4,1,413,337,76
2,2,19,4,1,458,304,154
2,2,20,4,1,441,319,122
2,2,21,4,1,443,379,64
2,2,22,4,1,457,420,37
2,2,23,4,1,435,474,-39
2,3,0,4,1,460,466,-6
2,3,1,4,1,482,379,103
2,3,2,4,1,453,340,113
2,3,3,4,1,428,246,182
2,3,4,4,1,450,292,158
2,3,5,4,1,426,324,102
2,3,6,4,1,342,384,-42
2,3,7,4,1,288,450,-162
2,3,8,4,1,264,428,-164
2,3,9,4,1,257,400,-143
2,3,10,4,1,250,388,-138
2,3,11,4,1,242,391,-149
2,3,12,4,1,240,409,-169
2,3,13,4,1,242,404,-162
2,3,14,4,1,245,386,-141
2,3,15,4,1,249,416,-167
2,3,16,4,1,281,437,-156
2,3,17,4,1,298,430,-132
2,3,18,4,1,375,378,-3
2,3,19,4,1,438,337,101
2,3,20,4,1,435,337,98
2,3,21,4,1,440,354,86
2,3,22,4,1,458,403,55
2,3,23,4,1,444,465,-21
2,4,0,4,1,478,475,3
2,4,1,4,1,490,354,136
2,4,2,4,1,433,340,93
2,4,3,4,1,372,320,52
2,4,4,4,1,378,505,-127
2,4,5,4,1,368,442,-74
2,4,6,4,1,312,525,-213
2,4,7,4,1,278,575,-297
2,4,8,4,1,287,549,-262
2,4,9,4,1,284,482,-198
2,4,10,4,1,281,485,-204
2,4,11,4,1,278,470,-192
2,4,12,4,1,277,501,-224
2,4,13,4,1,277,506,-229
2,4,14,4,1,277,473,-196
2,4,15,4,1,278,509,-231
2,4,16,4,1,290,580,-290
2,4,17,4,1,283,582,-299
2,4,18,4,1,337,483,-146
2,4,19,4,1,394,471,-77
2,4,20,4,1,400,478,-78
2,4,21,4,1,420,439,-19
2,4,22,4,1,457,466,-9
2,4,23,4,1,458,474,-16
2,5,0,4,1,490,500,-10
2,5,1,4,1,512,360,152
2,5,2,4,1,440,323,117
2,5,3,4,1,335,368,-33
2,5,4,4,1,315,679,-364
2,5,5,4,1,342,549,-207
2,5,6,4,1,353,603,-250
2,5,7,4,1,323,678,-355
2,5,8,4,1,360,654,-294
2,5,9,4,1,368,458,-90
2,5,10,4,1,363,469,-106
2,5,11,4,1,370,448,-78
2,5,12,4,1,379,486,-107
2,5,13,4,1,378,471,-93
2,5,14,4,1,368,438,-70
2,5,15,4,1,368,530,-162
2,5,16,4,1,365,697,-332
2,5,17,4,1,339,689,-350
2,5,18,4,1,360,554,-194
2,5,19,4,1,364,600,-236
2,5,20,4,1,384,597,-213
2,5,21,4,1,438,508,-70
2,5,22,4,1,462,547,-85
2,5,23,4,1,479,474,5
2,6,0,4,1,482,540,-58
2,6,1,4,1,459,450,9
2,6,2,4,1,389,364,25
2,6,3,4,1,259,448,-189
2,6,4,4,1,231,825,-594
2,6,5,4,1,288,747,-459
2,6,6,4,1,328,729,-401
2,6,7,4,1,351,844,-493
2,6,8,4,1,355,839,-484
2,6,9,4,1,341,517,-176
2,6,10,4,1,325,546,-221
2,6,11,4,1,341,505,-164
2,6,12,4,1,353,557,-204
2,6,13,4,1,341,539,-198
2,6,14,4,1,330,502,-172
2,6,15,4,1,355,634,-279
2,6,16,4,1,369,887,-518
2,6,17,4,1,347,840,-493
2,6,18,4,1,337,714,-377
2,6,19,4,1,304,766,-462
2,6,20,4,1,319,723,-404
2,6,21,4,1,379,636,-257
2,6,22,4,1,420,668,-248
2,6,23,4,1,474,505,-31
2,7,0,4,1,466,588,-122
2,7,1,4,1,379,575,-196
2,7,2,4,1,340,419,-79
2,7,3,4,1,246,494,-248
2,7,4,4,1,292,853,-561
2,7,5,4,1,324,883,-559
2,7,6,4,1,384,749,-365
2,7,7,4,1,450,918,-468
2,7,8,4,1,428,933,-505
2,7,9,4,1,400,489,-89
2,7,10,4,1,388,541,-153
2,7,11,4,1,391,479,-88
2,7,12,4,1,409,541,-132
2,7,13,4,1,404,519,-115
2,7,14,4,1,386,482,-96
2,7,15,4,1,416,660,-244
2,7,16,4,1,437,983,-546
2,7,17,4,1,430,871,-441
2,7,18,4,1,378,832,-454
2,7,19,4,1,337,859,-522
2,7,20,4,1,337,761,-424
2,7,21,4,1,354,749,-395
2,7,22,4,1,403,770,-367
2,7,23,4,1,465,553,-88
2,8,0,4,1,475,595,-120
2,8,1,4,1,354,644,-290
2,8,2,4,1,340,436,-96
2,8,3,4,1,320,490,-170
2,8,4,4,1,505,807,-302
2,8,5,4,1,442,958,-516
2,8,6,4,1,525,690,-165
2,8,7,4,1,575,925,-350
2,8,8,4,1,549,955,-406
2,8,9,4,1,482,394,88
2,8,10,4,1,485,465,20
2,8,11,4,1,470,395,75
2,8,12,4,1,501,455,46
2,8,13,4,1,506,411,95
2,8,14,4,1,473,384,89
2,8,15,4,1,509,631,-122
2,8,16,4,1,580,996,-416
2,8,17,4,1,582,806,-224
2,8,18,4,1,483,895,-412
2,8,19,4,1,471,871,-400
2,8,20,4,1,478,697,-219
2,8,21,4,1,439,778,-339
2,8,22,4,1,466,783,-317
2,8,23,4,1,474,560,-86
2,9,0,4,1,500,552,-52
2,9,1,4,1,360,611,-251
2,9,2,4,1,323,407,-84
2,9,3,4,1,368,483,-115
2,9,4,4,1,679,789,-110
2,9,5,4,1,549,1006,-457
2,9,6,4,1,603,607,-4
2,9,7,4,1,678,949,-271
2,9,8,4,1,654,962,-308
2,9,9,4,1,458,390,68
2,9,10,4,1,469,468,1
2,9,11,4,1,448,374,74
2,9,12,4,1,486,451,35
2,9,13,4,1,471,412,59
2,9,14,4,1,438,379,59
2,9,15,4,1,530,646,-116
2,9,16,4,1,697,999,-302
2,9,17,4,1,689,738,-49
2,9,18,4,1,554,884,-330
2,9,19,4,1,600,866,-266
2,9,20,4,1,597,635,-38
2,9,21,4,1,508,749,-241
2,9,22,4,1,547,701,-154
2,9,23,4,1,474,569,-95
2,10,0,4,1,540,514,26
2,10,1,4,1,450,527,-77
2,10,2,4,1,364,360,4
2,10,3,4,1,448,506,-58
2,10,4,4,1,825,809,16
2,10,5,4,1,747,944,-197
2,10,6,4,1,729,549,180
2,10,7,4,1,844,947,-103
2,10,8,4,1,839,909,-70
2,10,9,4,1,517,361,156
2,10,10,4,1,546,472,74
2,10,11,4,1,505,348,157
2,10,12,4,1,557,424,133
2,10,13,4,1,539,399,140
2,10,14,4,1,502,349,153
2,10,15,4,1,634,629,5
2,10,16,4,1,887,992,-105
2,10,17,4,1,840,682,158
2,10,18,4,1,714,741,-27
2,10,19,4,1,766,813,-47
2,10,20,4,1,723,632,91
2,10,21,4,1,636,727,-91
2,10,22,4,1,668,597,71
2,10,23,4,1,505,590,-85
2,11,0,4,1,588,484,104
2,11,1,4,1,575,450,125
2,11,2,4,1,419,321,98
2,11,3,4,1,494,568,-74
2,11,4,4,1,853,871,-18
2,11,5,4,1,883,869,14
2,11,6,4,1,749,475,274
2,11,7,4,1,918,844,74
2,11,8,4,1,933,785,148
2,11,9,4,1,489,334,155
2,11,10,4,1,541,420,121
2,11,11,4,1,479,339,140
2,11,12,4,1,541,422,119
2,11,13,4,1,519,362,157
2,11,14,4,1,482,348,134
2,11,15,4,1,660,556,104
2,11,16,4,1,983,818,165
2,11,17,4,1,871,660,211
2,11,18,4,1,832,584,248
2,11,19,4,1,859,725,134
2,11,20,4,1,761,679,82
2,11,21,4,1,749,696,53
2,11,22,4,1,770,477,293
2,11,23,4,1,553,557,-4
2,12,0,4,1,595,528,67
2,12,1,4,1,644,371,273
2,12,2,4,1,436,318,118
2,12,3,4,1,490,683,-193
2,12,4,4,1,807,794,13
2,12,5,4,1,958,699,259
2,12,6,4,1,690,383,307
2,12,7,4,1,925,706,219
2,12,8,4,1,955,734,221
2,12,9,4,1,394,374,20
2,12,10,4,1,465,460,5
2,12,11,4,1,395,376,19
2,12,12,4,1,455,475,-20
2,12,13,4,1,411,427,-16
2,12,14,4,1,384,372,12
2,12,15,4,1,631,461,170
2,12,16,4,1,996,751,245
2,12,17,4,1,806,697,109
2,12,18,4,1,895,406,489
2,12,19,4,1,871,565,306
2,12,20,4,1,697,707,-10
2,12,21,4,1,778,577,201
2,12,22,4,1,783,365,418
2,12,23,4,1,560,617,-57
2,13,0,4,1,552,610,-58
2,13,1,4,1,611,333,278
2,13,2,4,1,407,311,96
2,13,3,4,1,483,794,-311
2,13,4,4,1,789,672,117
2,13,5,4,1,1006,493,513
2,13,6,4,1,607,326,281
2,13,7,4,1,949,637,312
2,13,8,4,1,962,739,223
2,13,9,4,1,390,399,-9
2,13,10,4,1,468,496,-28
2,13,11,4,1,374,402,-28
2,13,12,4,1,451,500,-49
2,13,13,4,1,412,461,-49
2,13,14,4,1,379,358,21
2,13,15,4,1,646,362,284
2,13,16,4,1,999,635,364
2,13,17,4,1,738,647,91
2,13,18,4,1,884,265,619
2,13,19,4,1,866,425,441
2,13,20,4,1,635,714,-79
2,13,21,4,1,749,454,295
2,13,22,4,1,701,303,398
2,13,23,4,1,569,688,-119
2,14,0,4,1,514,705,-191
2,14,1,4,1,527,330,197
2,14,2,4,1,360,337,23
2,14,3,4,1,506,883,-377
2,14,4,4,1,809,527,282
2,14,5,4,1,944,334,610
2,14,6,4,1,549,272,277
2,14,7,4,1,947,490,457
2,14,8,4,1,909,688,221
2,14,9,4,1,361,369,-8
2,14,10,4,1,472,412,60
2,14,11,4,1,348,379,-31
2,14,12,4,1,424,505,-81
2,14,13,4,1,399,414,-15
2,14,14,4,1,349,321,28
2,14,15,4,1,629,277,352
2,14,16,4,1,992,436,556
2,14,17,4,1,682,556,126
2,14,18,4,1,741,245,496
2,14,19,4,1,813,349,464
2,14,20,4,1,632,641,-9
2,14,21,4,1,727,377,350
2,14,22,4,1,597,306,291
2,14,23,4,1,590,706,-116
2,15,0,4,1,484,680,-196
2,15,1,4,1,450,312,138
2,15,2,4,1,321,337,-16
2,15,3,4,1,568,819,-251
2,15,4,4,1,871,329,542
2,15,5,4,1,869,192,677
2,15,6,4,1,475,248,227
2,15,7,4,1,844,457,387
2,15,8,4,1,785,727,58
2,15,9,4,1,334,345,-11
2,15,10,4,1,420,407,13
2,15,11,4,1,339,356,-17
2,15,12,4,1,422,514,-92
2,15,13,4,1,362,422,-60
2,15,14,4,1,348,251,97
2,15,15,4,1,556,293,263
2,15,16,4,1,818,481,337
2,15,17,4,1,660,468,192
2,15,18,4,1,584,192,392
2,15,19,4,1,725,282,443
2,15,20,4,1,679,489,190
2,15,21,4,1,696,267,429
2,15,22,4,1,477,279,198
2,15,23,4,1,557,641,-84
2,16,0,4,1,528,601,-73
2,16,1,4,1,371,291,80
2,16,2,4,1,318,287,31
2,16,3,4,1,683,654,29
2,16,4,4,1,794,268,526
2,16,5,4,1,699,177,522
2,16,6,4,1,383,224,159
2,16,7,4,1,706,438,268
2,16,8,4,1,734,666,68
2,16,9,4,1,374,320,54
2,16,10,4,1,460,304,156
2,16,11,4,1,376,285,91
2,16,12,4,1,475,488,-13
2,16,13,4,1,427,355,72
2,16,14,4,1,372,233,139
2,16,15,4,1,461,322,139
2,16,16,4,1,751,400,351
2,16,17,4,1,697,327,370
2,16,18,4,1,406,165,241
2,16,19,4,1,565,289,276
2,16,20,4,1,707,366,341
2,16,21,4,1,577,221,356
2,16,22,4,1,365,279,86
2,16,23,4,1,617,487,130
2,0,0,5,1,548,596,-48
2,0,1,5,1,569,581,-12
2,0,2,5,1,539,509,30
2,0,3,5,1,531,378,153
2,0,4,5,1,571,356,215
2,0,5,5,1,562,397,165
2,0,6,5,1,520,397,123
2,0,7,5,1,522,390,132
2,0,8,5,1,453,424,29
2,0,9,5,1,442,409,33
2,0,10,5,1,429,392,37
2,0,11,5,1,420,406,14
2,0,12,5,1,417,418,-1
2,0,13,5,1,423,406,17
2,0,14,5,1,431,395,36
2,0,15,5,1,438,421,17
2,0,16,5,1,479,424,55
2,0,17,5,1,492,405,87
2,0,18,5,1,546,418,128
2,0,19,5,1,561,411,150
2,0,20,5,1,524,435,89
2,0,21,5,1,538,498,40
2,0,22,5,1,562,538,24
2,0,23,5,1,531,582,-51
2,1,0,5,1,552,586,-34
2,1,1,5,1,584,503,81
2,1,2,5,1,563,449,114
2,1,3,5,1,552,335,217
2,1,4,5,1,585,379,206
2,1,5,5,1,560,406,154
2,1,6,5,1,485,451,34
2,1,7,5,1,455,508,-53
2,1,8,5,1,418,497,-79
2,1,9,5,1,407,469,-62
2,1,10,5,1,394,457,-63
2,1,11,5,1,383,460,-77
2,1,12,5,1,380,478,-98
2,1,13,5,1,385,473,-88
2,1,14,5,1,392,454,-62
2,1,15,5,1,399,484,-85
2,1,16,5,1,436,514,-78
2,1,17,5,1,448,496,-48
2,1,18,5,1,517,449,68
2,1,19,5,1,560,424,136
2,1,20,5,1,542,434,108
2,1,21,5,1,554,461,93
2,1,22,5,1,571,519,52
2,1,23,5,1,537,580,-43
2,2,0,5,1,566,605,-39
2,2,1,5,1,597,479,118
2,2,2,5,1,565,430,135
2,2,3,5,1,535,369,166
2,2,4,5,1,560,545,15
2,2,5,5,1,534,499,35
2,2,6,5,1,450,607,-157
2,2,7,5,1,406,680,-274
2,2,8,5,1,379,644,-265
2,2,9,5,1,370,578,-208
2,2,10,5,1,359,582,-223
2,2,11,5,1,349,569,-220
2,2,12,5,1,346,600,-254
2,2,13,5,1,350,604,-254
2,2,14,5,1,355,570,-215
2,2,15,5,1,360,605,-245
2,2,16,5,1,398,679,-281
2,2,17,5,1,407,666,-259
2,2,18,5,1,484,562,-78
2,2,19,5,1,545,548,-3
2,2,20,5,1,538,550,-12
2,2,21,5,1,550,523,27
2,2,22,5,1,573,576,-3
2,2,23,5,1,550,599,-49
2,3,0,5,1,590,626,-36
2,3,1,5,1,607,501,106
2,3,2,5,1,543,444,99
2,3,3,5,1,477,446,31
2,3,4,5,1,490,742,-252
2,3,5,5,1,483,643,-160
2,3,6,5,1,424,738,-314
2,3,7,5,1,393,799,-406
2,3,8,5,1,359,781,-422
2,3,9,5,1,353,593,-240
2,3,10,5,1,347,599,-252
2,3,11,5,1,341,585,-244
2,3,12,5,1,339,632,-293
2,3,13,5,1,340,617,-277
2,3,14,5,1,342,576,-234
2,3,15,5,1,345,668,-323
2,3,16,5,1,380,831,-451
2,3,17,5,1,382,820,-438
2,3,18,5,1,454,683,-229
2,3,19,5,1,515,693,-178
2,3,20,5,1,507,696,-189
2,3,21,5,1,524,636,-112
2,3,22,5,1,568,665,-97
2,3,23,5,1,569,605,-36
2,4,0,5,1,604,646,-42
2,4,1,5,1,631,519,112
2,4,2,5,1,554,433,121
2,4,3,5,1,450,491,-41
2,4,4,5,1,441,866,-425
2,4,5,5,1,462,802,-340
2,4,6,5,1,447,773,-326
2,4,7,5,1,399,911,-512
2,4,8,5,1,414,903,-489
2,4,9,5,1,419,558,-139
2,4,10,5,1,411,575,-164
2,4,11,5,1,415,541,-126
2,4,12,5,1,423,596,-173
2,4,13,5,1,423,567,-144
2,4,14,5,1,415,529,-114
2,4,15,5,1,416,687,-271
2,4,16,5,1,424,946,-522
2,4,17,5,1,414,906,-492
2,4,18,5,1,466,772,-306
2,4,19,5,1,487,813,-326
2,4,20,5,1,499,774,-275
2,4,21,5,1,548,696,-148
2,4,22,5,1,575,744,-169
2,4,23,5,1,589,608,-19
2,5,0,5,1,596,692,-96
2,5,1,5,1,581,619,-38
2,5,2,5,1,509,479,30
2,5,3,5,1,378,570,-192
2,5,4,5,1,356,1001,-645
2,5,5,5,1,397,1001,-604
2,5,6,5,1,397,872,-475
2,5,7,5,1,390,1075,-685
2,5,8,5,1,424,1075,-651
2,5,9,5,1,409,617,-208
2,5,10,5,1,392,673,-281
2,5,11,5,1,406,598,-192
2,5,12,5,1,418,666,-248
2,5,13,5,1,406,651,-245
2,5,14,5,1,395,606,-211
2,5,15,5,1,421,789,-368
2,5,16,5,1,424,1128,-704
2,5,17,5,1,405,1020,-615
2,5,18,5,1,418,944,-526
2,5,19,5,1,411,979,-568
2,5,20,5,1,435,876,-441
2,5,21,5,1,498,831,-333
2,5,22,5,1,538,869,-331
2,5,23,5,1,582,659,-77
2,6,0,5,1,586,734,-148
2,6,1,5,1,503,744,-241
2,6,2,5,1,449,526,-77
2,6,3,5,1,335,613,-278
2,6,4,5,1,379,1060,-681
2,6,5,5,1,406,1133,-727
2,6,6,5,1,451,913,-462
2,6,7,5,1,508,1155,-647
2,6,8,5,1,497,1171,-674
2,6,9,5,1,469,572,-103
2,6,10,5,1,457,659,-202
2,6,11,5,1,460,573,-113
2,6,12,5,1,478,646,-168
2,6,13,5,1,473,611,-138
2,6,14,5,1,454,568,-114
2,6,15,5,1,484,820,-336
2,6,16,5,1,514,1238,-724
2,6,17,5,1,496,1042,-546
2,6,18,5,1,449,1079,-630
2,6,19,5,1,424,1082,-658
2,6,20,5,1,434,910,-476
2,6,21,5,1,461,947,-486
2,6,22,5,1,519,956,-437
2,6,23,5,1,580,694,-114
2,7,0,5,1,605,703,-98
2,7,1,5,1,479,758,-279
2,7,2,5,1,430,511,-81
2,7,3,5,1,369,609,-240
2,7,4,5,1,545,1026,-481
2,7,5,5,1,499,1207,-708
2,7,6,5,1,607,820,-213
2,7,7,5,1,680,1173,-493
2,7,8,5,1,644,1194,-550
2,7,9,5,1,578,501,77
2,7,10,5,1,582,582,0
2,7,11,5,1,569,489,80
2,7,12,5,1,600,582,18
2,7,13,5,1,604,523,81
2,7,14,5,1,570,482,88
2,7,15,5,1,605,805,-200
2,7,16,5,1,679,1250,-571
2,7,17,5,1,666,976,-310
2,7,18,5,1,562,1084,-522
2,7,19,5,1,548,1088,-540
2,7,20,5,1,550,853,-303
2,7,21,5,1,523,946,-423
2,7,22,5,1,576,900,-324
2,7,23,5,1,599,700,-101
2,8,0,5,1,626,660,-34
2,8,1,5,1,501,686,-185
2,8,2,5,1,444,470,-26
2,8,3,5,1,446,629,-183
2,8,4,5,1,742,996,-254
2,8,5,5,1,643,1197,-554
2,8,6,5,1,738,719,19
2,8,7,5,1,799,1180,-381
2,8,8,5,1,781,1158,-377
2,8,9,5,1,593,461,132
2,8,10,5,1,599,578,21
2,8,11,5,1,585,441,144
2,8,12,5,1,632,534,98
2,8,13,5,1,617,495,122
2,8,14,5,1,576,440,136
2,8,15,5,1,668,786,-118
2,8,16,5,1,831,1241,-410
2,8,17,5,1,820,899,-79
2,8,18,5,1,683,959,-276
2,8,19,5,1,693,1026,-333
2,8,20,5,1,696,809,-113
2,8,21,5,1,636,915,-279
2,8,22,5,1,665,794,-129
2,8,23,5,1,605,724,-119
2,9,0,5,1,646,636,10
2,9,1,5,1,519,619,-100
2,9,2,5,1,433,436,-3
2,9,3,5,1,491,690,-199
2,9,4,5,1,866,1047,-181
2,9,5,5,1,802,1123,-321
2,9,6,5,1,773,618,155
2,9,7,5,1,911,1075,-164
2,9,8,5,1,903,1021,-118
2,9,9,5,1,558,434,124
2,9,10,5,1,575,547,28
2,9,11,5,1,541,432,109
2,9,12,5,1,596,531,65
2,9,13,5,1,567,474,93
2,9,14,5,1,529,452,77
2,9,15,5,1,687,711,-24
2,9,16,5,1,946,1059,-113
2,9,17,5,1,906,840,66
2,9,18,5,1,772,814,-42
2,9,19,5,1,813,938,-125
2,9,20,5,1,774,832,-58
2,9,21,5,1,696,891,-195
2,9,22,5,1,744,678,66
2,9,23,5,1,608,711,-103
2,10,0,5,1,692,674,18
2,10,1,5,1,619,540,79
2,10,2,5,1,479,425,54
2,10,3,5,1,570,802,-232
2,10,4,5,1,1001,1001,0
2,10,5,5,1,1001,949,52
2,10,6,5,1,872,547,325
2,10,7,5,1,1075,943,132
2,10,8,5,1,1075,972,103
2,10,9,5,1,617,457,160
2,10,10,5,1,673,578,95
2,10,11,5,1,598,470,128
2,10,12,5,1,666,580,86
2,10,13,5,1,651,519,132
2,10,14,5,1,606,458,148
2,10,15,5,1,789,621,168
2,10,16,5,1,1128,1006,122
2,10,17,5,1,1020,868,152
2,10,18,5,1,944,653,291
2,10,19,5,1,979,788,191
2,10,20,5,1,876,856,20
2,10,21,5,1,831,775,56
2,10,22,5,1,869,551,318
2,10,23,5,1,659,758,-99
2,11,0,5,1,734,718,16
2,11,1,5,1,744,447,297
2,11,2,5,1,526,386,140
2,11,3,5,1,613,913,-300
2,11,4,5,1,1060,891,169
2,11,5,5,1,1133,742,391
2,11,6,5,1,913,456,457
2,11,7,5,1,1155,885,270
2,11,8,5,1,1171,978,193
2,11,9,5,1,572,506,66
2,11,10,5,1,659,613,46
2,11,11,5,1,573,496,77
2,11,12,5,1,646,627,19
2,11,13,5,1,611,573,38
2,11,14,5,1,568,456,112
2,11,15,5,1,820,536,284
2,11,16,5,1,1238,889,349
2,11,17,5,1,1042,817,225
2,11,18,5,1,1079,454,625
2,11,19,5,1,1082,642,440
2,11,20,5,1,910,870,40
2,11,21,5,1,947,622,325
2,11,22,5,1,956,420,536
2,11,23,5,1,694,828,-134
2,12,0,5,1,703,813,-110
2,12,1,5,1,758,405,353
2,12,2,5,1,511,400,111
2,12,3,5,1,609,1029,-420
2,12,4,5,1,1026,734,292
2,12,5,5,1,1207,525,682
2,12,6,5,1,820,384,436
2,12,7,5,1,1173,721,452
2,12,8,5,1,1194,884,310
2,12,9,5,1,501,440,61
2,12,10,5,1,582,522,60
2,12,11,5,1,489,446,43
2,12,12,5,1,582,588,-6
2,12,13,5,1,523,497,26
2,12,14,5,1,482,382,100
2,12,15,5,1,805,417,388
2,12,16,5,1,1250,678,572
2,12,17,5,1,976,717,259
2,12,18,5,1,1084,320,764
2,12,19,5,1,1088,509,579
2,12,20,5,1,853,815,38
2,12,21,5,1,946,543,403
2,12,22,5,1,900,399,501
2,12,23,5,1,700,861,-161
2,13,0,5,1,660,802,-142
2,13,1,5,1,686,404,282
2,13,2,5,1,470,413,57
2,13,3,5,1,629,1003,-374
2,13,4,5,1,996,567,429
2,13,5,5,1,1197,371,826
2,13,6,5,1,719,317,402
2,13,7,5,1,1180,585,595
2,13,8,5,1,1158,839,319
2,13,9,5,1,461,418,43
2,13,10,5,1,578,482,96
2,13,11,5,1,441,440,1
2,13,12,5,1,534,621,-87
2,13,13,5,1,495,497,-2
2,13,14,5,1,440,354,86
2,13,15,5,1,786,375,411
2,13,16,5,1,1241,548,693
2,13,17,5,1,899,626,273
2,13,18,5,1,959,265,694
2,13,19,5,1,1026,407,619
2,13,20,5,1,809,689,120
2,13,21,5,1,915,431,484
2,13,22,5,1,794,360,434
2,13,23,5,1,724,762,-38
2,14,0,5,1,636,791,-155
2,14,1,5,1,619,381,238
2,14,2,5,1,436,391,45
2,14,3,5,1,690,888,-198
2,14,4,5,1,1047,398,649
2,14,5,5,1,1123,257,866
2,14,6,5,1,618,296,322
2,14,7,5,1,1075,537,538
2,14,8,5,1,1021,853,168
2,14,9,5,1,434,443,-9
2,14,10,5,1,547,462,85
2,14,11,5,1,432,416,16
2,14,12,5,1,531,646,-115
2,14,13,5,1,474,512,-38
2,14,14,5,1,452,343,109
2,14,15,5,1,711,387,324
2,14,16,5,1,1059,588,471
2,14,17,5,1,840,535,305
2,14,18,5,1,814,234,580
2,14,19,5,1,938,352,586
2,14,20,5,1,832,543,289
2,14,21,5,1,891,300,591
2,14,22,5,1,678,353,325
2,14,23,5,1,711,688,23
2,0,0,6,1,662,725,-63
2,0,1,6,1,691,603,88
2,0,2,6,1,659,539,120
2,0,3,6,1,650,458,192
2,0,4,6,1,696,632,64
2,0,5,6,1,671,581,90
2,0,6,6,1,589,674,-85
2,0,7,6,1,561,738,-177
2,0,8,6,1,522,713,-191
2,0,9,6,1,510,647,-137
2,0,10,6,1,496,651,-155
2,0,11,6,1,485,638,-153
2,0,12,6,1,482,669,-187
2,0,13,6,1,488,673,-185
2,0,14,6,1,496,638,-142
2,0,15,6,1,504,673,-169
2,0,16,6,1,534,756,-222
2,0,17,6,1,550,732,-182
2,0,18,6,1,627,633,-6
2,0,19,6,1,668,635,33
2,0,20,6,1,640,647,-7
2,0,21,6,1,657,630,27
2,0,22,6,1,680,692,-12
2,0,23,6,1,639,714,-75
2,1,0,6,1,672,756,-84
2,1,1,6,1,708,626,82
2,1,2,6,1,672,534,138
2,1,3,6,1,641,495,146
2,1,4,6,1,672,782,-110
2,1,5,6,1,642,700,-58
2,1,6,6,1,552,820,-268
2,1,7,6,1,513,904,-391
2,1,8,6,1,487,876,-389
2,1,9,6,1,476,689,-213
2,1,10,6,1,463,696,-233
2,1,11,6,1,452,684,-232
2,1,12,6,1,449,731,-282
2,1,13,6,1,454,715,-261
2,1,14,6,1,460,673,-213
2,1,15,6,1,467,764,-297
2,1,16,6,1,513,930,-417
2,1,17,6,1,514,904,-390
2,1,18,6,1,588,762,-174
2,1,19,6,1,647,770,-123
2,1,20,6,1,639,768,-129
2,1,21,6,1,661,720,-59
2,1,22,6,1,687,775,-88
2,1,23,6,1,652,730,-78
2,2,0,6,1,696,772,-76
2,2,1,6,1,722,660,62
2,2,2,6,1,655,554,101
2,2,3,6,1,584,569,15
2,2,4,6,1,600,929,-329
2,2,5,6,1,591,896,-305
2,2,6,6,1,532,908,-376
2,2,7,6,1,511,1032,-521
2,2,8,6,1,474,1030,-556
2,2,9,6,1,466,693,-227
2,2,10,6,1,456,705,-249
2,2,11,6,1,448,678,-230
2,2,12,6,1,445,742,-297
2,2,13,6,1,448,713,-265
2,2,14,6,1,452,667,-215
2,2,15,6,1,456,825,-369
2,2,16,6,1,497,1080,-583
2,2,17,6,1,491,1037,-546
2,2,18,6,1,563,901,-338
2,2,19,6,1,622,906,-284
2,2,20,6,1,610,873,-263
2,2,21,6,1,634,824,-190
2,2,22,6,1,683,862,-179
2,2,23,6,1,675,739,-64
2,3,0,6,1,716,798,-82
2,3,1,6,1,748,688,60
2,3,2,6,1,664,548,116
2,3,3,6,1,555,613,-58
2,3,4,6,1,553,1042,-489
2,3,5,6,1,577,1056,-479
2,3,6,6,1,559,916,-357
2,3,7,6,1,514,1142,-628
2,3,8,6,1,486,1139,-653
2,3,9,6,1,488,658,-170
2,3,10,6,1,477,702,-225
2,3,11,6,1,478,634,-156
2,3,12,6,1,485,705,-220
2,3,13,6,1,486,679,-193
2,3,14,6,1,480,633,-153
2,3,15,6,1,483,842,-359
2,3,16,6,1,514,1187,-673
2,3,17,6,1,513,1086,-573
2,3,18,6,1,583,1002,-419
2,3,19,6,1,608,1026,-418
2,3,20,6,1,606,927,-321
2,3,21,6,1,652,891,-239
2,3,22,6,1,686,945,-259
2,3,23,6,1,700,762,-62
2,4,0,6,1,710,838,-128
2,4,1,6,1,700,788,-88
2,4,2,6,1,623,586,37
2,4,3,6,1,493,689,-196
2,4,4,6,1,482,1208,-726
2,4,5,6,1,517,1251,-734
2,4,6,6,1,491,1036,-545
2,4,7,6,1,466,1312,-846
2,4,8,6,1,478,1313,-835
2,4,9,6,1,460,700,-240
2,4,10,6,1,440,791,-351
2,4,11,6,1,451,692,-241
2,4,12,6,1,462,771,-309
2,4,13,6,1,451,743,-292
2,4,14,6,1,442,692,-250
2,4,15,6,1,469,949,-480
2,4,16,6,1,483,1383,-900
2,4,17,6,1,480,1191,-711
2,4,18,6,1,524,1191,-667
2,4,19,6,1,534,1202,-668
2,4,20,6,1,550,1025,-475
2,4,21,6,1,608,1029,-421
2,4,22,6,1,651,1055,-404
2,4,23,6,1,692,800,-108
2,5,0,6,1,700,842,-142
2,5,1,6,1,625,858,-233
2,5,2,6,1,569,601,-32
2,5,3,6,1,454,732,-278
2,5,4,6,1,504,1279,-775
2,5,5,6,1,515,1382,-867
2,5,6,6,1,520,1043,-523
2,5,7,6,1,547,1403,-856
2,5,8,6,1,566,1410,-844
2,5,9,6,1,537,679,-142
2,5,10,6,1,524,776,-252
2,5,11,6,1,525,667,-142
2,5,12,6,1,543,773,-230
2,5,13,6,1,538,723,-185
2,5,14,6,1,519,666,-147
2,5,15,6,1,550,994,-444
2,5,16,6,1,569,1492,-923
2,5,17,6,1,554,1212,-658
2,5,18,6,1,530,1268,-738
2,5,19,6,1,531,1299,-768
2,5,20,6,1,550,1066,-516
2,5,21,6,1,580,1115,-535
2,5,22,6,1,637,1073,-436
2,5,23,6,1,688,834,-146
2,6,0,6,1,725,811,-86
2,6,1,6,1,603,833,-230
2,6,2,6,1,539,574,-35
2,6,3,6,1,458,755,-297
2,6,4,6,1,632,1233,-601
2,6,5,6,1,581,1398,-817
2,6,6,6,1,674,932,-258
2,6,7,6,1,738,1404,-666
2,6,8,6,1,713,1390,-677
2,6,9,6,1,647,572,75
2,6,10,6,1,651,692,-41
2,6,11,6,1,638,556,82
2,6,12,6,1,669,665,4
2,6,13,6,1,673,606,67
2,6,14,6,1,638,543,95
2,6,15,6,1,673,945,-272
2,6,16,6,1,756,1492,-736
2,6,17,6,1,732,1137,-405
2,6,18,6,1,633,1159,-526
2,6,19,6,1,635,1248,-613
2,6,20,6,1,647,1027,-380
2,6,21,6,1,630,1112,-482
2,6,22,6,1,692,993,-301
2,6,23,6,1,714,855,-141
2,7,0,6,1,756,782,-26
2,7,1,6,1,626,778,-152
2,7,2,6,1,534,546,-12
2,7,3,6,1,495,813,-318
2,7,4,6,1,782,1234,-452
2,7,5,6,1,700,1376,-676
2,7,6,6,1,820,788,32
2,7,7,6,1,904,1308,-404
2,7,8,6,1,876,1270,-394
2,7,9,6,1,689,534,155
2,7,10,6,1,696,653,43
2,7,11,6,1,684,525,159
2,7,12,6,1,731,641,90
2,7,13,6,1,715,570,145
2,7,14,6,1,673,543,130
2,7,15,6,1,764,868,-104
2,7,16,6,1,930,1308,-378
2,7,17,6,1,904,1057,-153
2,7,18,6,1,762,1032,-270
2,7,19,6,1,770,1151,-381
2,7,20,6,1,768,1009,-241
2,7,21,6,1,720,1079,-359
2,7,22,6,1,775,875,-100
2,7,23,6,1,730,845,-115
2,8,0,6,1,772,826,-54
2,8,1,6,1,660,709,-49
2,8,2,6,1,554,540,14
2,8,3,6,1,569,924,-355
2,8,4,6,1,929,1177,-248
2,8,5,6,1,896,1203,-307
2,8,6,6,1,908,690,218
2,8,7,6,1,1032,1174,-142
2,8,8,6,1,1030,1208,-178
2,8,9,6,1,693,557,136
2,8,10,6,1,705,705,0
2,8,11,6,1,678,563,115
2,8,12,6,1,742,689,53
2,8,13,6,1,713,631,82
2,8,14,6,1,667,562,105
2,8,15,6,1,825,776,49
2,8,16,6,1,1080,1247,-167
2,8,17,6,1,1037,1048,-11
2,8,18,6,1,901,883,18
2,8,19,6,1,906,1001,-95
2,8,20,6,1,873,1009,-136
2,8,21,6,1,824,970,-146
2,8,22,6,1,862,752,110
2,8,23,6,1,739,912,-173
2,9,0,6,1,798,864,-66
2,9,1,6,1,688,616,72
2,9,2,6,1,548,493,55
2,9,3,6,1,613,1032,-419
2,9,4,6,1,1042,1098,-56
2,9,5,6,1,1056,992,64
2,9,6,6,1,916,620,296
2,9,7,6,1,1142,1122,20
2,9,8,6,1,1139,1216,-77
2,9,9,6,1,658,589,69
2,9,10,6,1,702,731,-29
2,9,11,6,1,634,590,44
2,9,12,6,1,705,732,-27
2,9,13,6,1,679,665,14
2,9,14,6,1,633,542,91
2,9,15,6,1,842,696,146
2,9,16,6,1,1187,1144,43
2,9,17,6,1,1086,988,98
2,9,18,6,1,1002,701,301
2,9,19,6,1,1026,865,161
2,9,20,6,1,927,1019,-92
2,9,21,6,1,891,820,71
2,9,22,6,1,945,606,339
2,9,23,6,1,762,969,-207
2,10,0,6,1,838,921,-83
2,10,1,6,1,788,519,269
2,10,2,6,1,586,475,111
2,10,3,6,1,689,1148,-459
2,10,4,6,1,1208,953,255
2,10,5,6,1,1251,774,477
2,10,6,6,1,1036,514,522
2,10,7,6,1,1312,969,343
2,10,8,6,1,1313,1123,190
2,10,9,6,1,700,547,153
2,10,10,6,1,791,639,152
2,10,11,6,1,692,540,152
2,10,12,6,1,771,715,56
2,10,13,6,1,743,609,134
2,10,14,6,1,692,480,212
2,10,15,6,1,949,591,358
2,10,16,6,1,1383,932,451
2,10,17,6,1,1191,887,304
2,10,18,6,1,1191,509,682
2,10,19,6,1,1202,726,476
2,10,20,6,1,1025,971,54
2,10,21,6,1,1029,711,318
2,10,22,6,1,1055,516,539
2,10,23,6,1,800,1001,-201
2,11,0,6,1,842,910,-68
2,11,1,6,1,858,479,379
2,11,2,6,1,601,476,125
2,11,3,6,1,732,1149,-417
2,11,4,6,1,1279,774,505
2,11,5,6,1,1382,562,820
2,11,6,6,1,1043,429,614
2,11,7,6,1,1403,816,587
2,11,8,6,1,1410,1035,375
2,11,9,6,1,679,489,190
2,11,10,6,1,776,592,184
2,11,11,6,1,667,507,160
2,11,12,6,1,773,704,69
2,11,13,6,1,723,580,143
2,11,14,6,1,666,415,251
2,11,15,6,1,994,515,479
2,11,16,6,1,1492,790,702
2,11,17,6,1,1212,787,425
2,11,18,6,1,1268,340,928
2,11,19,6,1,1299,567,732
2,11,20,6,1,1066,863,203
2,11,21,6,1,1115,597,518
2,11,22,6,1,1073,453,620
2,11,23,6,1,834,917,-83
2,12,0,6,1,811,913,-102
2,12,1,6,1,833,473,360
2,12,2,6,1,574,467,107
2,12,3,6,1,755,1072,-317
2,12,4,6,1,1233,636,597
2,12,5,6,1,1398,436,962
2,12,6,6,1,932,365,567
2,12,7,6,1,1404,665,739
2,12,8,6,1,1390,965,425
2,12,9,6,1,572,516,56
2,12,10,6,1,692,537,155
2,12,11,6,1,556,500,56
2,12,12,6,1,665,753,-88
2,12,13,6,1,606,587,19
2,12,14,6,1,543,446,97
2,12,15,6,1,945,469,476
2,12,16,6,1,1492,655,837
2,12,17,6,1,1137,693,444
2,12,18,6,1,1159,307,852
2,12,19,6,1,1248,477,771
2,12,20,6,1,1027,743,284
2,12,21,6,1,1112,464,648
2,12,22,6,1,993,434,559
2,12,23,6,1,855,809,46
2,0,0,7,1,782,902,-120
2,0,1,7,1,815,785,30
2,0,2,7,1,768,644,124
2,0,3,7,1,739,618,121
2,0,4,7,1,783,969,-186
2,0,5,7,1,753,953,-200
2,0,6,7,1,656,990,-334
2,0,7,7,1,619,1137,-518
2,0,8,7,1,591,1125,-534
2,0,9,7,1,579,789,-210
2,0,10,7,1,565,802,-237
2,0,11,7,1,554,777,-223
2,0,12,7,1,551,841,-290
2,0,13,7,1,557,811,-254
2,0,14,7,1,564,764,-200
2,0,15,7,1,572,921,-349
2,0,16,7,1,611,1179,-568
2,0,17,7,1,616,1121,-505
2,0,18,7,1,698,980,-282
2,0,19,7,1,755,983,-228
2,0,20,7,1,737,945,-208
2,0,21,7,1,764,908,-144
2,0,22,7,1,796,972,-176
2,0,23,7,1,754,864,-110
2,1,0,7,1,802,924,-122
2,1,1,7,1,833,829,4
2,1,2,7,1,762,669,93
2,1,3,7,1,690,691,-1
2,1,4,7,1,712,1105,-393
2,1,5,7,1,699,1150,-451
2,1,6,7,1,634,1051,-417
2,1,7,7,1,618,1263,-645
2,1,8,7,1,582,1266,-684
2,1,9,7,1,572,793,-221
2,1,10,7,1,560,832,-272
2,1,11,7,1,551,771,-220
2,1,12,7,1,548,851,-303
2,1,13,7,1,552,825,-273
2,1,14,7,1,557,771,-214
2,1,15,7,1,563,980,-417
2,1,16,7,1,612,1321,-709
2,1,17,7,1,598,1217,-619
2,1,18,7,1,667,1131,-464
2,1,19,7,1,724,1119,-395
2,1,20,7,1,711,1026,-315
2,1,21,7,1,745,1019,-274
2,1,22,7,1,797,1063,-266
2,1,23,7,1,777,893,-116
2,2,0,7,1,822,944,-122
2,2,1,7,1,863,857,6
2,2,2,7,1,776,655,121
2,2,3,7,1,662,732,-70
2,2,4,7,1,663,1249,-586
2,2,5,7,1,685,1306,-621
2,2,6,7,1,667,1080,-413
2,2,7,7,1,632,1379,-747
2,2,8,7,1,601,1377,-776
2,2,9,7,1,601,741,-140
2,2,10,7,1,586,820,-234
2,2,11,7,1,585,728,-143
2,2,12,7,1,591,810,-219
2,2,13,7,1,594,771,-177
2,2,14,7,1,590,719,-129
2,2,15,7,1,594,1002,-408
2,2,16,7,1,631,1442,-811
2,2,17,7,1,622,1257,-635
2,2,18,7,1,692,1249,-557
2,2,19,7,1,715,1249,-534
2,2,20,7,1,709,1076,-367
2,2,21,7,1,762,1089,-327
2,2,22,7,1,801,1131,-330
2,2,23,7,1,806,903,-97
2,3,0,7,1,822,946,-124
2,3,1,7,1,817,902,-85
2,3,2,7,1,733,661,72
2,3,3,7,1,598,808,-210
2,3,4,7,1,594,1427,-833
2,3,5,7,1,632,1500,-868
2,3,6,7,1,603,1166,-563
2,3,7,7,1,581,1560,-979
2,3,8,7,1,550,1552,-1002
2,3,9,7,1,529,807,-278
2,3,10,7,1,506,908,-402
2,3,11,7,1,514,786,-272
2,3,12,7,1,524,898,-374
2,3,13,7,1,514,855,-341
2,3,14,7,1,507,790,-283
2,3,15,7,1,536,1123,-587
2,3,16,7,1,573,1637,-1064
2,3,17,7,1,579,1361,-782
2,3,18,7,1,641,1380,-739
2,3,19,7,1,655,1419,-764
2,3,20,7,1,657,1181,-524
2,3,21,7,1,712,1197,-485
2,3,22,7,1,762,1172,-410
2,3,23,7,1,803,940,-137
2,4,0,7,1,814,950,-136
2,4,1,7,1,744,933,-189
2,4,2,7,1,683,664,19
2,4,3,7,1,569,878,-309
2,4,4,7,1,630,1486,-856
2,4,5,7,1,635,1573,-938
2,4,6,7,1,614,1155,-541
2,4,7,7,1,623,1634,-1011
2,4,8,7,1,620,1606,-986
2,4,9,7,1,588,750,-162
2,4,10,7,1,572,886,-314
2,4,11,7,1,570,734,-164
2,4,12,7,1,587,856,-269
2,4,13,7,1,583,806,-223
2,4,14,7,1,566,727,-161
2,4,15,7,1,598,1134,-536
2,4,16,7,1,628,1734,-1106
2,4,17,7,1,629,1373,-744
2,4,18,7,1,636,1343,-707
2,4,19,7,1,654,1459,-805
2,4,20,7,1,665,1240,-575
2,4,21,7,1,690,1281,-591
2,4,22,7,1,750,1166,-416
2,4,23,7,1,798,989,-191
2,5,0,7,1,839,933,-94
2,5,1,7,1,725,925,-200
2,5,2,7,1,659,650,9
2,5,3,7,1,577,939,-362
2,5,4,7,1,757,1471,-714
2,5,5,7,1,690,1577,-887
2,5,6,7,1,743,1001,-258
2,5,7,7,1,777,1532,-755
2,5,8,7,1,782,1502,-720
2,5,9,7,1,715,645,70
2,5,10,7,1,718,767,-49
2,5,11,7,1,703,640,63
2,5,12,7,1,734,772,-38
2,5,13,7,1,738,681,57
2,5,14,7,1,703,646,57
2,5,15,7,1,739,1027,-288
2,5,16,7,1,811,1559,-748
2,5,17,7,1,790,1295,-505
2,5,18,7,1,714,1232,-518
2,5,19,7,1,742,1373,-631
2,5,20,7,1,763,1227,-464
2,5,21,7,1,749,1276,-527
2,5,22,7,1,810,1074,-264
2,5,23,7,1,822,976,-154
2,6,0,7,1,876,972,-96
2,6,1,7,1,750,868,-118
2,6,2,7,1,643,650,-7
2,6,3,7,1,584,1047,-463
2,6,4,7,1,869,1364,-495
2,6,5,7,1,782,1456,-674
2,6,6,7,1,887,860,27
2,6,7,7,1,962,1407,-445
2,6,8,7,1,945,1457,-512
2,6,9,7,1,758,657,101
2,6,10,7,1,765,811,-46
2,6,11,7,1,753,656,97
2,6,12,7,1,800,799,1
2,6,13,7,1,784,727,57
2,6,14,7,1,741,653,88
2,6,15,7,1,832,933,-101
2,6,16,7,1,1007,1496,-489
2,6,17,7,1,970,1265,-295
2,6,18,7,1,833,1101,-268
2,6,19,7,1,857,1214,-357
2,6,20,7,1,865,1186,-321
2,6,21,7,1,827,1158,-331
2,6,22,7,1,891,949,-58
2,6,23,7,1,845,1046,-201
2,7,0,7,1,902,1016,-114
2,7,1,7,1,785,785,0
2,7,2,7,1,644,608,36
2,7,3,7,1,618,1154,-536
2,7,4,7,1,969,1274,-305
2,7,5,7,1,953,1246,-293
2,7,6,7,1,990,763,227
2,7,7,7,1,1137,1353,-216
2,7,8,7,1,1125,1452,-327
2,7,9,7,1,789,689,100
2,7,10,7,1,802,858,-56
2,7,11,7,1,777,683,94
2,7,12,7,1,841,841,0
2,7,13,7,1,811,777,34
2,7,14,7,1,764,646,118
2,7,15,7,1,921,851,70
2,7,16,7,1,1179,1385,-206
2,7,17,7,1,1121,1168,-47
2,7,18,7,1,980,931,49
2,7,19,7,1,983,1078,-95
2,7,20,7,1,945,1172,-227
2,7,21,7,1,908,1015,-107
2,7,22,7,1,972,807,165
2,7,23,7,1,864,1123,-259
2,8,0,7,1,924,1067,-143
2,8,1,7,1,829,688,141
2,8,2,7,1,669,582,87
2,8,3,7,1,691,1267,-576
2,8,4,7,1,1105,1160,-55
2,8,5,7,1,1150,1024,126
2,8,6,7,1,1051,678,373
2,8,7,7,1,1263,1206,57
2,8,8,7,1,1266,1361,-95
2,8,9,7,1,793,630,163
2,8,10,7,1,832,757,75
2,8,11,7,1,771,634,137
2,8,12,7,1,851,820,31
2,8,13,7,1,825,701,124
2,8,14,7,1,771,566,205
2,8,15,7,1,980,751,229
2,8,16,7,1,1321,1187,134
2,8,17,7,1,1217,1058,159
2,8,18,7,1,1131,756,375
2,8,19,7,1,1119,949,170
2,8,20,7,1,1026,1120,-94
2,8,21,7,1,1019,909,110
2,8,22,7,1,1063,702,361
2,8,23,7,1,893,1142,-249
2,9,0,7,1,944,1018,-74
2,9,1,7,1,857,593,264
2,9,2,7,1,655,551,104
2,9,3,7,1,732,1268,-536
2,9,4,7,1,1249,993,256
2,9,5,7,1,1306,811,495
2,9,6,7,1,1080,559,521
2,9,7,7,1,1379,1064,315
2,9,8,7,1,1377,1274,103
2,9,9,7,1,741,596,145
2,9,10,7,1,820,709,111
2,9,11,7,1,728,601,127
2,9,12,7,1,810,831,-21
2,9,13,7,1,771,692,79
2,9,14,7,1,719,513,206
2,9,15,7,1,1002,689,313
2,9,16,7,1,1442,1044,398
2,9,17,7,1,1257,957,300
2,9,18,7,1,1249,529,720
2,9,19,7,1,1249,784,465
2,9,20,7,1,1076,1019,57
2,9,21,7,1,1089,765,324
2,9,22,7,1,1131,570,561
2,9,23,7,1,903,1057,-154
2,10,0,7,1,946,1021,-75
2,10,1,7,1,902,548,354
2,10,2,7,1,661,530,131
2,10,3,7,1,808,1218,-410
2,10,4,7,1,1427,843,584
2,10,5,7,1,1500,627,873
2,10,6,7,1,1166,477,689
2,10,7,7,1,1560,896,664
2,10,8,7,1,1552,1161,391
2,10,9,7,1,807,587,220
2,10,10,7,1,908,647,261
2,10,11,7,1,786,567,219
2,10,12,7,1,898,836,62
2,10,13,7,1,855,670,185
2,10,14,7,1,790,507,283
2,10,15,7,1,1123,609,514
2,10,16,7,1,1637,897,740
2,10,17,7,1,1361,854,507
2,10,18,7,1,1380,382,998
2,10,19,7,1,1419,637,782
2,10,20,7,1,1181,917,264
2,10,21,7,1,1197,630,567
2,10,22,7,1,1172,527,645
2,10,23,7,1,940,964,-24
2,0,0,8,1,912,1070,-158
2,0,1,8,1,940,998,-58
2,0,2,8,1,858,776,82
2,0,3,8,1,788,810,-22
2,0,4,8,1,823,1312,-489
2,0,5,8,1,810,1400,-590
2,0,6,8,1,738,1215,-477
2,0,7,8,1,724,1500,-776
2,0,8,8,1,686,1504,-818
2,0,9,8,1,675,876,-201
2,0,10,8,1,662,950,-288
2,0,11,8,1,653,865,-212
2,0,12,8,1,650,956,-306
2,0,13,8,1,655,917,-262
2,0,14,8,1,661,857,-196
2,0,15,8,1,668,1140,-472
2,0,16,8,1,710,1576,-866
2,0,17,8,1,700,1388,-688
2,0,18,8,1,777,1378,-601
2,0,19,8,1,832,1342,-510
2,0,20,8,1,809,1175,-366
2,0,21,8,1,848,1217,-369
2,0,22,8,1,906,1249,-343
2,0,23,8,1,879,1034,-155
2,1,0,8,1,928,1052,-124
2,1,1,8,1,974,971,3
2,1,2,8,1,883,730,153
2,1,3,8,1,768,851,-83
2,1,4,8,1,775,1468,-693
2,1,5,8,1,793,1555,-762
2,1,6,8,1,769,1210,-441
2,1,7,8,1,739,1627,-888
2,1,8,8,1,709,1616,-907
2,1,9,8,1,707,848,-141
2,1,10,8,1,690,937,-247
2,1,11,8,1,688,822,-134
2,1,12,8,1,694,937,-243
2,1,13,8,1,698,883,-185
2,1,14,8,1,695,817,-122
2,1,15,8,1,701,1176,-475
2,1,16,8,1,746,1696,-950
2,1,17,8,1,729,1427,-698
2,1,18,8,1,796,1438,-642
2,1,19,8,1,817,1466,-649
2,1,20,8,1,810,1232,-422
2,1,21,8,1,873,1257,-384
2,1,22,8,1,915,1248,-333
2,1,23,8,1,908,1043,-135
2,2,0,8,1,928,1054,-126
2,2,1,8,1,932,977,-45
2,2,2,8,1,845,724,121
2,2,3,8,1,705,954,-249
2,2,4,8,1,704,1634,-930
2,2,5,8,1,740,1691,-951
2,2,6,8,1,711,1278,-567
2,2,7,8,1,699,1791,-1092
2,2,8,8,1,665,1748,-1083
2,2,9,8,1,642,878,-236
2,2,10,8,1,615,1018,-403
2,2,11,8,1,621,853,-232
2,2,12,8,1,630,981,-351
2,2,13,8,1,622,938,-316
2,2,14,8,1,617,851,-234
2,2,15,8,1,647,1263,-616
2,2,16,8,1,690,1879,-1189
2,2,17,8,1,688,1522,-834
2,2,18,8,1,750,1455,-705
2,2,19,8,1,762,1579,-817
2,2,20,8,1,760,1355,-595
2,2,21,8,1,822,1363,-541
2,2,22,8,1,877,1265,-388
2,2,23,8,1,909,1095,-186
2,3,0,8,1,926,1072,-146
2,3,1,8,1,861,1025,-164
2,3,2,8,1,793,740,53
2,3,3,8,1,674,1062,-388
2,3,4,8,1,742,1724,-982
2,3,5,8,1,750,1752,-1002
2,3,6,8,1,726,1224,-498
2,3,7,8,1,738,1762,-1024
2,3,8,8,1,692,1718,-1026
2,3,9,8,1,657,823,-166
2,3,10,8,1,638,961,-323
2,3,11,8,1,633,818,-185
2,3,12,8,1,649,963,-314
2,3,13,8,1,646,881,-235
2,3,14,8,1,631,830,-199
2,3,15,8,1,665,1216,-551
2,3,16,8,1,718,1801,-1083
2,3,17,8,1,728,1531,-803
2,3,18,8,1,753,1416,-663
2,3,19,8,1,775,1584,-809
2,3,20,8,1,772,1440,-668
2,3,21,8,1,794,1445,-651
2,3,22,8,1,861,1247,-386
2,3,23,8,1,909,1110,-201
2,4,0,8,1,953,1123,-170
2,4,1,8,1,844,1015,-171
2,4,2,8,1,773,754,19
2,4,3,8,1,692,1173,-481
2,4,4,8,1,883,1601,-718
2,4,5,8,1,810,1657,-847
2,4,6,8,1,837,1073,-236
2,4,7,8,1,853,1631,-778
2,4,8,8,1,836,1689,-853
2,4,9,8,1,766,768,-2
2,4,10,8,1,766,925,-159
2,4,11,8,1,748,771,-23
2,4,12,8,1,778,930,-152
2,4,13,8,1,783,838,-55
2,4,14,8,1,750,756,-6
2,4,15,8,1,787,1092,-305
2,4,16,8,1,870,1747,-877
2,4,17,8,1,865,1503,-638
2,4,18,8,1,820,1301,-481
2,4,19,8,1,865,1436,-571
2,4,20,8,1,878,1404,-526
2,4,21,8,1,859,1355,-496
2,4,22,8,1,923,1148,-225
2,4,23,8,1,932,1177,-245
2,5,0,8,1,990,1162,-172
2,5,1,8,1,872,944,-72
2,5,2,8,1,763,718,45
2,5,3,8,1,703,1277,-574
2,5,4,8,1,994,1461,-467
2,5,5,8,1,891,1499,-608
2,5,6,8,1,956,933,23
2,5,7,8,1,1001,1586,-585
2,5,8,8,1,1014,1701,-687
2,5,9,8,1,826,789,37
2,5,10,8,1,832,964,-132
2,5,11,8,1,818,776,42
2,5,12,8,1,865,951,-86
2,5,13,8,1,849,873,-24
2,5,14,8,1,806,737,69
2,5,15,8,1,898,1008,-110
2,5,16,8,1,1062,1634,-572
2,5,17,8,1,1028,1385,-357
2,5,18,8,1,914,1149,-235
2,5,19,8,1,964,1291,-327
2,5,20,8,1,981,1349,-368
2,5,21,8,1,946,1203,-257
2,5,22,8,1,1009,1004,5
2,5,23,8,1,953,1257,-304
2,6,0,8,1,1022,1219,-197
2,6,1,8,1,909,857,52
2,6,2,8,1,753,697,56
2,6,3,8,1,707,1389,-682
2,6,4,8,1,1056,1336,-280
2,6,5,8,1,1035,1278,-243
2,6,6,8,1,1057,821,236
2,6,7,8,1,1195,1437,-242
2,6,8,8,1,1194,1597,-403
2,6,9,8,1,858,730,128
2,6,10,8,1,871,884,-13
2,6,11,8,1,846,727,119
2,6,12,8,1,910,929,-19
2,6,13,8,1,880,813,67
2,6,14,8,1,832,670,162
2,6,15,8,1,989,906,83
2,6,16,8,1,1256,1428,-172
2,6,17,8,1,1187,1238,-51
2,6,18,8,1,1051,986,65
2,6,19,8,1,1070,1162,-92
2,6,20,8,1,1042,1273,-231
2,6,21,8,1,1015,1104,-89
2,6,22,8,1,1088,903,185
2,6,23,8,1,979,1296,-317
2,7,0,8,1,1054,1164,-110
2,7,1,8,1,954,762,192
2,7,2,8,1,759,658,101
2,7,3,8,1,740,1387,-647
2,7,4,8,1,1145,1200,-55
2,7,5,8,1,1207,1061,146
2,7,6,8,1,1133,723,410
2,7,7,8,1,1368,1301,67
2,7,8,8,1,1361,1512,-151
2,7,9,8,1,889,679,210
2,7,10,8,1,929,827,102
2,7,11,8,1,870,695,175
2,7,12,8,1,950,936,14
2,7,13,8,1,923,784,139
2,7,14,8,1,868,599,269
2,7,15,8,1,1076,849,227
2,7,16,8,1,1420,1299,121
2,7,17,8,1,1301,1128,173
2,7,18,8,1,1210,776,434
2,7,19,8,1,1196,1007,189
2,7,20,8,1,1098,1168,-70
2,7,21,8,1,1103,963,140
2,7,22,8,1,1173,756,417
2,7,23,8,1,1018,1198,-180
2,8,0,8,1,1070,1129,-59
2,8,1,8,1,998,662,336
2,8,2,8,1,776,605,171
2,8,3,8,1,810,1337,-527
2,8,4,8,1,1312,1062,250
2,8,5,8,1,1400,876,524
2,8,6,8,1,1215,607,608
2,8,7,8,1,1500,1144,356
2,8,8,8,1,1504,1400,104
2,8,9,8,1,876,694,182
2,8,10,8,1,950,764,186
2,8,11,8,1,865,661,204
2,8,12,8,1,956,963,-7
2,8,13,8,1,917,782,135
2,8,14,8,1,857,605,252
2,8,15,8,1,1140,783,357
2,8,16,8,1,1576,1151,425
2,8,17,8,1,1388,1024,364
2,8,18,8,1,1378,571,807
2,8,19,8,1,1342,854,488
2,8,20,8,1,1175,1073,102
2,8,21,8,1,1217,798,419
2,8,22,8,1,1249,644,605
2,8,23,8,1,1034,1104,-70
2,0,0,9,1,1038,1160,-122
2,0,1,9,1,1081,1046,35
2,0,2,9,1,979,793,186
2,0,3,9,1,866,997,-131
2,0,4,9,1,886,1675,-789
2,0,5,9,1,904,1746,-842
2,0,6,9,1,873,1322,-449
2,0,7,9,1,845,1858,-1013
2,0,8,9,1,813,1812,-999
2,0,9,9,1,810,919,-109
2,0,10,9,1,792,1047,-255
2,0,11,9,1,790,889,-99
2,0,12,9,1,796,1020,-224
2,0,13,9,1,801,966,-165
2,0,14,9,1,799,878,-79
2,0,15,9,1,806,1316,-510
2,0,16,9,1,844,1938,-1094
2,0,17,9,1,831,1588,-757
2,0,18,9,1,906,1513,-607
2,0,19,9,1,925,1626,-701
2,0,20,9,1,908,1406,-498
2,0,21,9,1,976,1423,-447
2,0,22,9,1,1024,1341,-317
2,0,23,9,1,1010,1198,-188
2,1,0,9,1,1034,1176,-142
2,1,1,9,1,1043,1069,-26
2,1,2,9,1,952,800,152
2,1,3,9,1,811,1138,-327
2,1,4,9,1,816,1872,-1056
2,1,5,9,1,848,1870,-1022
2,1,6,9,1,813,1347,-534
2,1,7,9,1,806,1919,-1113
2,1,8,9,1,773,1860,-1087
2,1,9,9,1,748,951,-203
2,1,10,9,1,719,1093,-374
2,1,11,9,1,724,937,-213
2,1,12,9,1,733,1088,-355
2,1,13,9,1,726,1013,-287
2,1,14,9,1,722,954,-232
2,1,15,9,1,754,1345,-591
2,1,16,9,1,805,1946,-1141
2,1,17,9,1,795,1680,-885
2,1,18,9,1,854,1528,-674
2,1,19,9,1,864,1704,-840
2,1,20,9,1,861,1555,-694
2,1,21,9,1,933,1527,-594
2,1,22,9,1,991,1346,-355
2,1,23,9,1,1011,1216,-205
2,2,0,9,1,1032,1262,-230
2,2,1,9,1,976,1115,-139
2,2,2,9,1,905,844,61
2,2,3,9,1,781,1296,-515
2,2,4,9,1,852,1854,-1002
2,2,5,9,1,858,1832,-974
2,2,6,9,1,834,1296,-462
2,2,7,9,1,856,1861,-1005
2,2,8,9,1,807,1905,-1098
2,2,9,9,1,770,946,-176
2,2,10,9,1,747,1119,-372
2,2,11,9,1,740,949,-209
2,2,12,9,1,755,1121,-366
2,2,13,9,1,754,1038,-284
2,2,14,9,1,741,940,-199
2,2,15,9,1,776,1281,-505
2,2,16,9,1,835,1989,-1154
2,2,17,9,1,837,1739,-902
2,2,18,9,1,862,1485,-623
2,2,19,9,1,882,1647,-765
2,2,20,9,1,875,1617,-742
2,2,21,9,1,904,1524,-620
2,2,22,9,1,976,1321,-345
2,2,23,9,1,1015,1311,-296
2,3,0,9,1,1065,1313,-248
2,3,1,9,1,961,1091,-130
2,3,2,9,1,883,822,61
2,3,3,9,1,797,1403,-606
2,3,4,9,1,995,1698,-703
2,3,5,9,1,925,1700,-775
2,3,6,9,1,949,1146,-197
2,3,7,9,1,968,1810,-842
2,3,8,9,1,908,1933,-1025
2,3,9,9,1,835,900,-65
2,3,10,9,1,832,1078,-246
2,3,11,9,1,811,891,-80
2,3,12,9,1,840,1082,-242
2,3,13,9,1,846,984,-138
2,3,14,9,1,815,840,-25
2,3,15,9,1,854,1167,-313
2,3,16,9,1,960,1885,-925
2,3,17,9,1,964,1623,-659
2,3,18,9,1,937,1349,-412
2,3,19,9,1,986,1513,-527
2,3,20,9,1,985,1567,-582
2,3,21,9,1,963,1400,-437
2,3,22,9,1,1034,1203,-169
2,3,23,9,1,1043,1388,-345
2,4,0,9,1,1104,1365,-261
2,4,1,9,1,991,1016,-25
2,4,2,9,1,877,807,70
2,4,3,9,1,818,1512,-694
2,4,4,9,1,1120,1523,-403
2,4,5,9,1,1011,1531,-520
2,4,6,9,1,1050,991,59
2,4,7,9,1,1077,1670,-593
2,4,8,9,1,1068,1846,-778
2,4,9,9,1,877,830,47
2,4,10,9,1,880,990,-110
2,4,11,9,1,863,820,43
2,4,12,9,1,909,1039,-130
2,4,13,9,1,894,909,-15
2,4,14,9,1,853,761,92
2,4,15,9,1,946,1063,-117
2,4,16,9,1,1121,1677,-556
2,4,17,9,1,1103,1455,-352
2,4,18,9,1,1020,1204,-184
2,4,19,9,1,1087,1375,-288
2,4,20,9,1,1096,1450,-354
2,4,21,9,1,1056,1292,-236
2,4,22,9,1,1122,1100,22
2,4,23,9,1,1063,1430,-367
2,5,0,9,1,1136,1316,-180
2,5,1,9,1,1031,931,100
2,5,2,9,1,873,773,100
2,5,3,9,1,826,1509,-683
2,5,4,9,1,1181,1376,-195
2,5,5,9,1,1144,1315,-171
2,5,6,9,1,1126,866,260
2,5,7,9,1,1234,1532,-298
2,5,8,9,1,1263,1748,-485
2,5,9,9,1,926,779,147
2,5,10,9,1,938,954,-16
2,5,11,9,1,911,788,123
2,5,12,9,1,975,1045,-70
2,5,13,9,1,945,896,49
2,5,14,9,1,897,703,194
2,5,15,9,1,1055,1004,51
2,5,16,9,1,1311,1540,-229
2,5,17,9,1,1245,1308,-63
2,5,18,9,1,1132,1006,126
2,5,19,9,1,1177,1220,-43
2,5,20,9,1,1158,1321,-163
2,5,21,9,1,1134,1158,-24
2,5,22,9,1,1206,957,249
2,5,23,9,1,1087,1352,-265
2,6,0,9,1,1174,1275,-101
2,6,1,9,1,1078,831,247
2,6,2,9,1,868,712,156
2,6,3,9,1,829,1456,-627
2,6,4,9,1,1232,1269,-37
2,6,5,9,1,1289,1126,163
2,6,6,9,1,1200,771,429
2,6,7,9,1,1426,1381,45
2,6,8,9,1,1430,1638,-208
2,6,9,9,1,958,777,181
2,6,10,9,1,998,882,116
2,6,11,9,1,939,755,184
2,6,12,9,1,1019,1068,-49
2,6,13,9,1,992,874,118
2,6,14,9,1,936,691,245
2,6,15,9,1,1144,943,201
2,6,16,9,1,1497,1406,91
2,6,17,9,1,1367,1195,172
2,6,18,9,1,1281,818,463
2,6,19,9,1,1283,1077,206
2,6,20,9,1,1195,1222,-27
2,6,21,9,1,1210,996,214
2,6,22,9,1,1289,830,459
2,6,23,9,1,1133,1245,-112
2,0,0,10,1,1144,1366,-222
2,0,1,10,1,1150,1159,-9
2,0,2,10,1,1048,904,144
2,0,3,10,1,909,1372,-463
2,0,4,10,1,927,2002,-1075
2,0,5,10,1,959,1950,-991
2,0,6,10,1,917,1419,-502
2,0,7,10,1,912,2018,-1106
2,0,8,10,1,877,2047,-1170
2,0,9,10,1,851,1074,-223
2,0,10,10,1,821,1251,-430
2,0,11,10,1,826,1068,-242
2,0,12,10,1,835,1246,-411
2,0,13,10,1,829,1170,-341
2,0,14,10,1,826,1064,-238
2,0,15,10,1,859,1410,-551
2,0,16,10,1,903,2134,-1231
2,0,17,10,1,897,1888,-991
2,0,18,10,1,964,1597,-633
2,0,19,10,1,972,1767,-795
2,0,20,10,1,959,1732,-773
2,0,21,10,1,1036,1606,-570
2,0,22,10,1,1100,1420,-320
2,0,23,10,1,1113,1417,-304
2,1,0,10,1,1138,1452,-314
2,1,1,10,1,1087,1191,-104
2,1,2,10,1,1012,912,100
2,1,3,10,1,887,1526,-639
2,1,4,10,1,964,1951,-987
2,1,5,10,1,966,1875,-909
2,1,6,10,1,936,1369,-433
2,1,7,10,1,963,2040,-1077
2,1,8,10,1,915,2149,-1234
2,1,9,10,1,876,1078,-202
2,1,10,10,1,851,1272,-421
2,1,11,10,1,843,1069,-226
2,1,12,10,1,858,1273,-415
2,1,13,10,1,858,1184,-326
2,1,14,10,1,846,1024,-178
2,1,15,10,1,883,1356,-473
2,1,16,10,1,950,2127,-1177
2,1,17,10,1,944,1859,-915
2,1,18,10,1,966,1533,-567
2,1,19,10,1,984,1724,-740
2,1,20,10,1,976,1780,-804
2,1,21,10,1,1015,1569,-554
2,1,22,10,1,1090,1376,-286
2,1,23,10,1,1117,1522,-405
2,2,0,10,1,1171,1516,-345
2,2,1,10,1,1076,1163,-87
2,2,2,10,1,995,911,84
2,2,3,10,1,904,1638,-734
2,2,4,10,1,1105,1760,-655
2,2,5,10,1,1033,1732,-699
2,2,6,10,1,1057,1204,-147
2,2,7,10,1,1086,1894,-808
2,2,8,10,1,1023,2078,-1055
2,2,9,10,1,948,941,7
2,2,10,10,1,941,1104,-163
2,2,11,10,1,918,935,-17
2,2,12,10,1,946,1170,-224
2,2,13,10,1,954,1020,-66
2,2,14,10,1,925,864,61
2,2,15,10,1,965,1222,-257
2,2,16,10,1,1077,1928,-851
2,2,17,10,1,1073,1693,-620
2,2,18,10,1,1046,1404,-358
2,2,19,10,1,1093,1597,-504
2,2,20,10,1,1088,1668,-580
2,2,21,10,1,1073,1489,-416
2,2,22,10,1,1149,1299,-150
2,2,23,10,1,1149,1561,-412
2,3,0,10,1,1216,1462,-246
2,3,1,10,1,1108,1090,18
2,3,2,10,1,987,883,104
2,3,3,10,1,923,1632,-709
2,3,4,10,1,1232,1563,-331
2,3,5,10,1,1126,1568,-442
2,3,6,10,1,1162,1036,126
2,3,7,10,1,1192,1765,-573
2,3,8,10,1,1140,1997,-857
2,3,9,10,1,946,879,67
2,3,10,10,1,946,1060,-114
2,3,11,10,1,926,881,45
2,3,12,10,1,971,1155,-184
2,3,13,10,1,957,992,-35
2,3,14,10,1,918,794,124
2,3,15,10,1,1013,1161,-148
2,3,16,10,1,1211,1789,-578
2,3,17,10,1,1202,1525,-323
2,3,18,10,1,1137,1224,-87
2,3,19,10,1,1208,1433,-225
2,3,20,10,1,1203,1498,-295
2,3,21,10,1,1160,1346,-186
2,3,22,10,1,1233,1154,79
2,3,23,10,1,1174,1486,-312
2,4,0,10,1,1250,1427,-177
2,4,1,10,1,1150,1000,150
2,4,2,10,1,987,827,160
2,4,3,10,1,941,1578,-637
2,4,4,10,1,1307,1445,-138
2,4,5,10,1,1264,1380,-116
2,4,6,10,1,1220,914,306
2,4,7,10,1,1310,1612,-302
2,4,8,10,1,1317,1874,-557
2,4,9,10,1,977,877,100
2,4,10,10,1,986,1009,-23
2,4,11,10,1,956,848,108
2,4,12,10,1,1019,1177,-158
2,4,13,10,1,990,986,4
2,4,14,10,1,944,795,149
2,4,15,10,1,1103,1098,5
2,4,16,10,1,1370,1647,-277
2,4,17,10,1,1320,1375,-55
2,4,18,10,1,1238,1048,190
2,4,19,10,1,1300,1290,10
2,4,20,10,1,1273,1375,-102
2,4,21,10,1,1244,1191,53
2,4,22,10,1,1319,1031,288
2,4,23,10,1,1197,1399,-202
2,0,0,11,1,1248,1655,-407
2,0,1,11,1,1194,1263,-69
2,0,2,11,1,1108,1001,107
2,0,3,11,1,985,1761,-776
2,0,4,11,1,1075,2013,-938
2,0,5,11,1,1077,1907,-830
2,0,6,11,1,1040,1427,-387
2,0,7,11,1,1069,2124,-1055
2,0,8,11,1,1019,2294,-1275
2,0,9,11,1,979,1119,-140
2,0,10,11,1,953,1298,-345
2,0,11,11,1,945,1113,-168
2,0,12,11,1,960,1361,-401
2,0,13,11,1,961,1220,-259
2,0,14,11,1,950,1048,-98
2,0,15,11,1,988,1411,-423
2,0,16,11,1,1048,2170,-1122
2,0,17,11,1,1046,1929,-883
2,0,18,11,1,1076,1588,-512
2,0,19,11,1,1092,1808,-716
2,0,20,11,1,1074,1881,-807
2,0,21,11,1,1118,1658,-540
2,0,22,11,1,1199,1472,-273
2,0,23,11,1,1219,1695,-476
2,1,0,11,1,1277,1613,-336
2,1,1,11,1,1187,1237,-50
2,1,2,11,1,1102,987,115
2,1,3,11,1,1010,1758,-748
2,1,4,11,1,1217,1800,-583
2,1,5,11,1,1141,1769,-628
2,1,6,11,1,1159,1249,-90
2,1,7,11,1,1193,1989,-796
2,1,8,11,1,1131,2229,-1098
2,1,9,11,1,1054,990,64
2,1,10,11,1,1045,1174,-129
2,1,11,11,1,1021,996,25
2,1,12,11,1,1049,1286,-237
2,1,13,11,1,1058,1103,-45
2,1,14,11,1,1030,897,133
2,1,15,11,1,1072,1320,-248
2,1,16,11,1,1192,2040,-848
2,1,17,11,1,1180,1763,-583
2,1,18,11,1,1150,1424,-274
2,1,19,11,1,1195,1655,-460
2,1,20,11,1,1189,1716,-527
2,1,21,11,1,1184,1543,-359
2,1,22,11,1,1263,1353,-90
2,1,23,11,1,1251,1617,-366
2,2,0,11,1,1322,1573,-251
2,2,1,11,1,1223,1159,64
2,2,2,11,1,1099,937,162
2,2,3,11,1,1030,1701,-671
2,2,4,11,1,1342,1632,-290
2,2,5,11,1,1234,1633,-399
2,2,6,11,1,1270,1084,186
2,2,7,11,1,1310,1845,-535
2,2,8,11,1,1255,2123,-868
2,2,9,11,1,1059,977,82
2,2,10,11,1,1055,1115,-60
2,2,11,11,1,1033,941,92
2,2,12,11,1,1077,1287,-210
2,2,13,11,1,1065,1082,-17
2,2,14,11,1,1028,886,142
2,2,15,11,1,1124,1255,-131
2,2,16,11,1,1328,1896,-568
2,2,17,11,1,1311,1592,-281
2,2,18,11,1,1246,1266,-20
2,2,19,11,1,1315,1503,-188
2,2,20,11,1,1306,1552,-246
2,2,21,11,1,1270,1379,-109
2,2,22,11,1,1348,1228,120
2,2,23,11,1,1280,1533,-253
2,0,0,12,1,1387,1724,-337
2,0,1,12,1,1294,1306,-12
2,0,2,12,1,1198,1041,157
2,0,3,12,1,1108,1827,-719
2,0,4,12,1,1328,1869,-541
2,0,5,12,1,1252,1834,-582
2,0,6,12,1,1263,1297,-34
2,0,7,12,1,1299,2069,-770
2,0,8,12,1,1235,2355,-1120
2,0,9,12,1,1157,1088,69
2,0,10,12,1,1147,1229,-82
2,0,11,12,1,1123,1056,67
2,0,12,12,1,1151,1418,-267
2,0,13,12,1,1161,1193,-32
2,0,14,12,1,1134,989,145
2,0,15,12,1,1177,1414,-237
2,0,16,12,1,1290,2147,-857
2,0,17,12,1,1282,1830,-548
2,0,18,12,1,1260,1466,-206
2,0,19,12,1,1303,1725,-422
2,0,20,12,1,1287,1770,-483
2,0,21,12,1,1287,1576,-289
2,0,22,12,1,1372,1427,-55
2,0,23,12,1,1353,1664,-311
2,0,0,1,2,217,217,0
2,0,1,1,2,203,218,-15
2,0,2,1,2,194,213,-19
2,0,3,1,2,209,218,-9
2,0,4,1,2,222,220,2
2,0,5,1,2,215,210,5
2,0,6,1,2,210,209,1
2,0,7,1,2,210,215,-5
2,0,8,1,2,207,214,-7
2,0,9,1,2,205,210,-5
2,0,10,1,2,204,207,-3
2,0,11,1,2,204,206,-2
2,0,12,1,2,205,207,-2
2,0,13,1,2,207,209,-2
2,0,14,1,2,209,212,-3
2,0,15,1,2,203,222,-19
2,0,16,1,2,200,222,-22
2,0,17,1,2,212,211,1
2,0,18,1,2,218,206,12
2,0,19,1,2,206,203,3
2,0,20,1,2,201,212,-11
2,0,21,1,2,212,225,-13
2,0,22,1,2,211,216,-5
2,1,0,1,2,217,221,-4
2,1,1,1,2,218,227,-9
2,1,2,1,2,213,219,-6
2,1,3,1,2,218,217,1
2,1,4,1,2,220,218,2
2,1,5,1,2,210,216,-6
2,1,6,1,2,209,226,-17
2,1,7,1,2,215,233,-18
2,1,8,1,2,214,228,-14
2,1,9,1,2,210,222,-12
2,1,10,1,2,207,216,-9
2,1,11,1,2,206,213,-7
2,1,12,1,2,207,214,-7
2,1,13,1,2,209,218,-9
2,1,14,1,2,212,221,-9
2,1,15,1,2,222,228,-6
2,1,16,1,2,222,226,-4
2,1,17,1,2,211,218,-7
2,1,18,1,2,206,216,-10
2,1,19,1,2,203,210,-7
2,1,20,1,2,212,213,-1
2,1,21,1,2,225,225,0
2,1,22,1,2,216,221,-5
2,2,0,1,2,221,229,-8
2,2,1,1,2,227,227,0
2,2,2,1,2,219,215,4
2,2,3,1,2,217,217,0
2,2,4,1,2,218,227,-9
2,2,5,1,2,216,227,-11
2,2,6,1,2,226,227,-1
2,2,7,1,2,233,187,46
2,2,8,1,2,228,141,87
2,2,9,1,2,222,135,87
2,2,10,1,2,216,129,87
2,2,11,1,2,213,125,88
2,2,12,1,2,214,125,89
2,2,13,1,2,218,128,90
2,2,14,1,2,221,132,89
2,2,15,1,2,228,157,71
2,2,16,1,2,226,189,37
2,2,17,1,2,218,216,2
2,2,18,1,2,216,238,-22
2,2,19,1,2,210,228,-18
2,2,20,1,2,213,211,2
2,2,21,1,2,225,215,10
2,2,22,1,2,221,222,-1
2,3,0,1,2,229,233,-4
2,3,1,1,2,227,233,-6
2,3,2,1,2,215,229,-14
2,3,3,1,2,217,241,-24
2,3,4,1,2,227,246,-19
2,3,5,1,2,227,214,13
2,3,6,1,2,227,170,57
2,3,7,1,2,187,130,57
2,3,8,1,2,141,105,36
2,3,9,1,2,135,99,36
2,3,10,1,2,129,93,36
2,3,11,1,2,125,89,36
2,3,12,1,2,125,89,36
2,3,13,1,2,128,92,36
2,3,14,1,2,132,95,37
2,3,15,1,2,157,107,50
2,3,16,1,2,189,134,55
2,3,17,1,2,216,181,35
2,3,18,1,2,238,229,9
2,3,19,1,2,228,238,-10
2,3,20,1,2,211,225,-14
2,3,21,1,2,215,223,-8
2,3,22,1,2,222,223,-1
2,4,0,1,2,233,236,-3
2,4,1,1,2,233,242,-9
2,4,2,1,2,229,239,-10
2,4,3,1,2,241,244,-3
2,4,4,1,2,246,234,12
2,4,5,1,2,214,178,36
2,4,6,1,2,170,108,62
2,4,7,1,2,130,108,22
2,4,8,1,2,105,137,-32
2,4,9,1,2,99,135,-36
2,4,10,1,2,93,132,-39
2,4,11,1,2,89,130,-41
2,4,12,1,2,89,130,-41
2,4,13,1,2,92,130,-38
2,4,14,1,2,95,131,-36
2,4,15,1,2,107,121,-14
2,4,16,1,2,134,113,21
2,4,17,1,2,181,139,42
2,4,18,1,2,229,188,41
2,4,19,1,2,238,223,15
2,4,20,1,2,225,235,-10
2,4,21,1,2,223,237,-14
2,4,22,1,2,223,226,-3
2,5,0,1,2,236,244,-8
2,5,1,1,2,242,233,9
2,5,2,1,2,239,198,41
2,5,3,1,2,244,176,68
2,5,4,1,2,234,169,65
2,5,5,1,2,178,149,29
2,5,6,1,2,108,125,-17
2,5,7,1,2,108,127,-19
2,5,8,1,2,137,138,-1
2,5,9,1,2,135,138,-3
2,5,10,1,2,132,138,-6
2,5,11,1,2,130,138,-8
2,5,12,1,2,130,138,-8
2,5,13,1,2,130,137,-7
2,5,14,1,2,131,136,-5
2,5,15,1,2,121,145,-24
2,5,16,1,2,113,143,-30
2,5,17,1,2,139,137,2
2,5,18,1,2,188,158,30
2,5,19,1,2,223,184,39
2,5,20,1,2,235,204,31
2,5,21,1,2,237,223,14
2,5,22,1,2,226,231,-5
2,6,0,1,2,244,255,-11
2,6,1,1,2,233,215,18
2,6,2,1,2,198,139,59
2,6,3,1,2,176,89,87
2,6,4,1,2,169,97,72
2,6,5,1,2,149,139,10
2,6,6,1,2,125,187,-62
2,6,7,1,2,127,200,-73
2,6,8,1,2,138,191,-53
2,6,9,1,2,138,193,-55
2,6,10,1,2,138,196,-58
2,6,11,1,2,138,198,-60
2,6,12,1,2,138,197,-59
2,6,13,1,2,137,195,-58
2,6,14,1,2,136,193,-57
2,6,15,1,2,145,195,-50
2,6,16,1,2,143,183,-40
2,6,17,1,2,137,163,-26
2,6,18,1,2,158,156,2
2,6,19,1,2,184,149,35
2,6,20,1,2,204,156,48
2,6,21,1,2,223,194,29
2,6,22,1,2,231,235,-4
2,7,0,1,2,255,267,-12
2,7,1,1,2,215,262,-47
2,7,2,1,2,139,199,-60
2,7,3,1,2,89,141,-52
2,7,4,1,2,97,157,-60
2,7,5,1,2,139,229,-90
2,7,6,1,2,187,256,-69
2,7,7,1,2,200,248,-48
2,7,8,1,2,191,262,-71
2,7,9,1,2,193,265,-72
2,7,10,1,2,196,267,-71
2,7,11,1,2,198,283,-85
2,7,12,1,2,197,292,-95
2,7,13,1,2,195,284,-89
2,7,14,1,2,193,276,-83
2,7,15,1,2,195,272,-77
2,7,16,1,2,183,265,-82
2,7,17,1,2,163,260,-97
2,7,18,1,2,156,222,-66
2,7,19,1,2,149,192,-43
2,7,20,1,2,156,227,-71
2,7,21,1,2,194,246,-52
2,7,22,1,2,235,249,-14
2,8,0,1,2,267,175,92
2,8,1,1,2,262,138,124
2,8,2,1,2,199,112,87
2,8,3,1,2,141,84,57
2,8,4,1,2,157,96,61
2,8,5,1,2,229,99,130
2,8,6,1,2,256,111,145
2,8,7,1,2,248,131,117
2,8,8,1,2,262,105,157
2,8,9,1,2,265,70,195
2,8,10,1,2,267,65,202
2,8,11,1,2,283,75,208
2,8,12,1,2,292,67,225
2,8,13,1,2,284,55,229
2,8,14,1,2,276,80,196
2,8,15,1,2,272,112,160
2,8,16,1,2,265,125,140
2,8,17,1,2,260,124,136
2,8,18,1,2,222,105,117
2,8,19,1,2,192,98,94
2,8,20,1,2,227,111,116
2,8,21,1,2,246,136,110
2,8,22,1,2,249,179,70
2,9,0,1,2,175,148,27
2,9,1,1,2,138,104,34
2,9,2,1,2,112,136,-24
2,9,3,1,2,84,224,-140
2,9,4,1,2,96,266,-170
2,9,5,1,2,99,241,-142
2,9,6,1,2,111,280,-169
2,9,7,1,2,131,299,-168
2,9,8,1,2,105,270,-165
2,9,9,1,2,70,260,-190
2,9,10,1,2,65,251,-186
2,9,11,1,2,75,244,-169
2,9,12,1,2,67,257,-190
2,9,13,1,2,55,256,-201
2,9,14,1,2,80,253,-173
2,9,15,1,2,112,274,-162
2,9,16,1,2,125,294,-169
2,9,17,1,2,124,261,-137
2,9,18,1,2,105,232,-127
2,9,19,1,2,98,235,-137
2,9,20,1,2,111,197,-86
2,9,21,1,2,136,181,-45
2,9,22,1,2,179,205,-26
2,10,0,1,2,148,239,-91
2,10,1,1,2,104,190,-86
2,10,2,1,2,136,213,-77
2,10,3,1,2,224,376,-152
2,10,4,1,2,266,428,-162
2,10,5,1,2,241,398,-157
2,10,6,1,2,280,453,-173
2,10,7,1,2,299,446,-147
2,10,8,1,2,270,394,-124
2,10,9,1,2,260,372,-112
2,10,10,1,2,251,372,-121
2,10,11,1,2,244,369,-125
2,10,12,1,2,257,391,-134
2,10,13,1,2,256,384,-128
2,10,14,1,2,253,373,-120
2,10,15,1,2,274,431,-157
2,10,16,1,2,294,478,-184
2,10,17,1,2,261,420,-159
2,10,18,1,2,232,395,-163
2,10,19,1,2,235,424,-189
2,10,20,1,2,197,382,-185
2,10,21,1,2,181,342,-161
2,10,22,1,2,205,307,-102
2,11,0,1,2,239,298,-59
2,11,1,1,2,190,251,-61
2,11,2,1,2,213,230,-17
2,11,3,1,2,376,363,13
2,11,4,1,2,428,438,-10
2,11,5,1,2,398,414,-16
2,11,6,1,2,453,437,16
2,11,7,1,2,446,456,-10
2,11,8,1,2,394,343,51
2,11,9,1,2,372,225,147
2,11,10,1,2,372,229,143
2,11,11,1,2,369,246,123
2,11,12,1,2,391,242,149
2,11,13,1,2,384,214,170
2,11,14,1,2,373,262,111
2,11,15,1,2,431,410,21
2,11,16,1,2,478,489,-11
2,11,17,1,2,420,438,-18
2,11,18,1,2,395,422,-27
2,11,19,1,2,424,440,-16
2,11,20,1,2,382,415,-33
2,11,21,1,2,342,396,-54
2,11,22,1,2,307,330,-23
2,12,0,1,2,298,305,-7
2,12,1,1,2,251,269,-18
2,12,2,1,2,230,233,-3
2,12,3,1,2,363,310,53
2,12,4,1,2,438,440,-2
2,12,5,1,2,414,423,-9
2,12,6,1,2,437,403,34
2,12,7,1,2,456,482,-26
2,12,8,1,2,343,349,-6
2,12,9,1,2,225,206,19
2,12,10,1,2,229,199,30
2,12,11,1,2,246,203,43
2,12,12,1,2,242,206,36
2,12,13,1,2,214,187,27
2,12,14,1,2,262,248,14
2,12,15,1,2,410,406,4
2,12,16,1,2,489,466,23
2,12,17,1,2,438,435,3
2,12,18,1,2,422,431,-9
2,12,19,1,2,440,390,50
2,12,20,1,2,415,365,50
2,12,21,1,2,396,385,11
2,12,22,1,2,330,331,-1
2,13,0,1,2,305,321,-16
2,13,1,1,2,269,284,-15
2,13,2,1,2,233,237,-4
2,13,3,1,2,310,298,12
2,13,4,1,2,440,430,10
2,13,5,1,2,423,397,26
2,13,6,1,2,403,374,29
2,13,7,1,2,482,467,15
2,13,8,1,2,349,336,13
2,13,9,1,2,206,227,-21
2,13,10,1,2,199,220,-21
2,13,11,1,2,203,202,1
2,13,12,1,2,206,221,-15
2,13,13,1,2,187,216,-29
2,13,14,1,2,248,259,-11
2,13,15,1,2,406,396,10
2,13,16,1,2,466,421,45
2,13,17,1,2,435,410,25
2,13,18,1,2,431,443,-12
2,13,19,1,2,390,366,24
2,13,20,1,2,365,348,17
2,13,21,1,2,385,396,-11
2,13,22,1,2,331,355,-24
2,14,0,1,2,321,315,6
2,14,1,1,2,284,276,8
2,14,2,1,2,237,226,11
2,14,3,1,2,298,326,-28
2,14,4,1,2,430,457,-27
2,14,5,1,2,397,414,-17
2,14,6,1,2,374,401,-27
2,14,7,1,2,467,475,-8
2,14,8,1,2,336,321,15
2,14,9,1,2,227,201,26
2,14,10,1,2,220,212,8
2,14,11,1,2,202,199,3
2,14,12,1,2,221,197,24
2,14,13,1,2,216,178,38
2,14,14,1,2,259,246,13
2,14,15,1,2,396,415,-19
2,14,16,1,2,421,426,-5
2,14,17,1,2,410,418,-8
2,14,18,1,2,443,470,-27
2,14,19,1,2,366,372,-6
2,14,20,1,2,348,347,1
2,14,21,1,2,396,384,12
2,14,22,1,2,355,327,28
2,15,0,1,2,315,222,93
2,15,1,1,2,276,189,87
2,15,2,1,2,226,194,32
2,15,3,1,2,326,338,-12
2,15,4,1,2,457,468,-11
2,15,5,1,2,414,379,35
2,15,6,1,2,401,378,23
2,15,7,1,2,475,487,-12
2,15,8,1,2,321,346,-25
2,15,9,1,2,201,224,-23
2,15,10,1,2,212,211,1
2,15,11,1,2,199,221,-22
2,15,12,1,2,197,239,-42
2,15,13,1,2,178,210,-32
2,15,14,1,2,246,272,-26
2,15,15,1,2,415,428,-13
2,15,16,1,2,426,424,2
2,15,17,1,2,418,359,59
2,15,18,1,2,470,406,64
2,15,19,1,2,372,373,-1
2,15,20,1,2,347,324,23
2,15,21,1,2,384,285,99
2,15,22,1,2,327,257,70
2,16,0,1,2,222,183,39
2,16,1,1,2,189,138,51
2,16,2,1,2,194,209,-15
2,16,3,1,2,338,353,-15
2,16,4,1,2,468,398,70
2,16,5,1,2,379,303,76
2,16,6,1,2,378,343,35
2,16,7,1,2,487,427,60
2,16,8,1,2,346,267,79
2,16,9,1,2,224,181,43
2,16,10,1,2,211,177,34
2,16,11,1,2,221,150,71
2,16,12,1,2,239,166,73
2,16,13,1,2,210,144,66
2,16,14,1,2,272,201,71
2,16,15,1,2,428,382,46
2,16,16,1,2,424,403,21
2,16,17,1,2,359,236,123
2,16,18,1,2,406,235,171
2,16,19,1,2,373,334,39
2,16,20,1,2,324,340,-16
2,16,21,1,2,285,259,26
2,16,22,1,2,257,248,9
2,17,0,1,2,183,214,-31
2,17,1,1,2,138,168,-30
2,17,2,1,2,209,260,-51
2,17,3,1,2,353,422,-69
2,17,4,1,2,398,417,-19
2,17,5,1,2,303,248,55
2,17,6,1,2,343,197,146
2,17,7,1,2,427,240,187
2,17,8,1,2,267,185,82
2,17,9,1,2,181,148,33
2,17,10,1,2,177,159,18
2,17,11,1,2,150,191,-41
2,17,12,1,2,166,182,-16
2,17,13,1,2,144,178,-34
2,17,14,1,2,201,185,16
2,17,15,1,2,382,149,233
2,17,16,1,2,403,225,178
2,17,17,1,2,236,231,5
2,17,18,1,2,235,198,37
2,17,19,1,2,334,325,9
2,17,20,1,2,340,364,-24
2,17,21,1,2,259,245,14
2,17,22,1,2,248,202,46
2,18,0,1,2,214,280,-66
2,18,1,1,2,168,194,-26
2,18,2,1,2,260,338,-78
2,18,3,1,2,422,364,58
2,18,4,1,2,417,210,207
2,18,5,1,2,248,152,96
2,18,6,1,2,197,171,26
2,18,7,1,2,240,286,-46
2,18,8,1,2,185,310,-125
2,18,9,1,2,148,281,-133
2,18,10,1,2,159,289,-130
2,18,11,1,2,191,289,-98
2,18,12,1,2,182,315,-133
2,18,13,1,2,178,267,-89
2,18,14,1,2,185,175,10
2,18,15,1,2,149,253,-104
2,18,16,1,2,225,396,-171
2,18,17,1,2,231,277,-46
2,18,18,1,2,198,132,66
2,18,19,1,2,325,240,85
2,18,20,1,2,364,256,108
2,18,21,1,2,245,153,92
2,18,22,1,2,202,275,-73
2,19,0,1,2,280,266,14
2,19,1,1,2,194,144,50
2,19,2,1,2,338,298,40
2,19,3,1,2,364,327,37
2,19,4,1,2,210,140,70
2,19,5,1,2,152,116,36
2,19,6,1,2,171,252,-81
2,19,7,1,2,286,423,-137
2,19,8,1,2,310,376,-66
2,19,9,1,2,281,285,-4
2,19,10,1,2,289,273,16
2,19,11,1,2,289,272,17
2,19,12,1,2,315,298,17
2,19,13,1,2,267,230,37
2,19,14,1,2,175,159,16
2,19,15,1,2,253,213,40
2,19,16,1,2,396,258,138
2,19,17,1,2,277,168,109
2,19,18,1,2,132,125,7
2,19,19,1,2,240,240,0
2,19,20,1,2,256,208,48
2,19,21,1,2,153,100,53
2,19,22,1,2,275,266,9
2,20,0,1,2,266,275,-9
2,20,1,1,2,144,161,-17
2,20,2,1,2,298,324,-26
2,20,3,1,2,327,297,30
2,20,4,1,2,140,94,46
2,20,5,1,2,116,90,26
2,20,6,1,2,252,142,110
2,20,7,1,2,423,229,194
2,20,8,1,2,376,186,190
2,20,9,1,2,285,67,218
2,20,10,1,2,273,70,203
2,20,11,1,2,272,132,140
2,20,12,1,2,298,124,174
2,20,13,1,2,230,60,170
2,20,14,1,2,159,79,80
2,20,15,1,2,213,98,115
2,20,16,1,2,258,113,145
2,20,17,1,2,168,125,43
2,20,18,1,2,125,139,-14
2,20,19,1,2,240,185,55
2,20,20,1,2,208,190,18
2,20,21,1,2,100,185,-85
2,20,22,1,2,266,269,-3
2,21,0,1,2,275,171,104
2,21,1,1,2,161,150,11
2,21,2,1,2,324,196,128
2,21,3,1,2,297,160,137
2,21,4,1,2,94,77,17
2,21,5,1,2,90,82,8
2,21,6,1,2,142,140,2
2,21,7,1,2,229,246,-17
2,21,8,1,2,186,200,-14
2,21,9,1,2,67,119,-52
2,21,10,1,2,70,131,-61
2,21,11,1,2,132,177,-45
2,21,12,1,2,124,199,-75
2,21,13,1,2,60,116,-56
2,21,14,1,2,79,131,-52
2,21,15,1,2,98,210,-112
2,21,16,1,2,113,182,-69
2,21,17,1,2,125,90,35
2,21,18,1,2,139,78,61
2,21,19,1,2,185,106,79
2,21,20,1,2,190,102,88
2,21,21,1,2,185,108,77
2,21,22,1,2,269,110,159
2,22,0,1,2,171,180,-9
2,22,1,1,2,150,123,27
2,22,2,1,2,196,123,73
2,22,3,1,2,160,138,22
2,22,4,1,2,77,134,-57
2,22,5,1,2,82,113,-31
2,22,6,1,2,140,128,12
2,22,7,1,2,246,206,40
2,22,8,1,2,200,224,-24
2,22,9,1,2,119,153,-34
2,22,10,1,2,131,115,16
2,22,11,1,2,177,192,-15
2,22,12,1,2,199,222,-23
2,22,13,1,2,116,182,-66
2,22,14,1,2,131,186,-55
2,22,15,1,2,210,201,9
2,22,16,1,2,182,174,8
2,22,17,1,2,90,109,-19
2,22,18,1,2,78,112,-34
2,22,19,1,2,106,124,-18
2,22,20,1,2,102,87,15
2,22,21,1,2,108,107,1
2,22,22,1,2,110,121,-11
2,0,0,2,2,434,450,-16
2,0,1,2,2,421,454,-33
2,0,2,2,2,407,434,-27
2,0,3,2,2,427,434,-7
2,0,4,2,2,442,445,-3
2,0,5,2,2,425,443,-18
2,0,6,2,2,419,453,-34
2,0,7,2,2,425,420,5
2,0,8,2,2,421,369,52
2,0,9,2,2,415,357,58
2,0,10,2,2,411,345,66
2,0,11,2,2,410,338,72
2,0,12,2,2,412,339,73
2,0,13,2,2,416,346,70
2,0,14,2,2,421,353,68
2,0,15,2,2,425,385,40
2,0,16,2,2,422,415,7
2,0,17,2,2,423,434,-11
2,0,18,2,2,424,454,-30
2,0,19,2,2,409,438,-29
2,0,20,2,2,413,424,-11
2,0,21,2,2,437,440,-3
2,0,22,2,2,427,443,-16
2,1,0,2,2,438,462,-24
2,1,1,2,2,445,460,-15
2,1,2,2,2,432,444,-12
2,1,3,2,2,435,458,-23
2,1,4,2,2,438,473,-35
2,1,5,2,2,426,441,-15
2,1,6,2,2,435,397,38
2,1,7,2,2,448,317,131
2,1,8,2,2,442,246,196
2,1,9,2,2,432,234,198
2,1,10,2,2,423,222,201
2,1,11,2,2,419,214,205
2,1,12,2,2,421,214,207
2,1,13,2,2,427,220,207
2,1,14,2,2,433,227,206
2,1,15,2,2,450,264,186
2,1,16,2,2,448,323,125
2,1,17,2,2,429,397,32
2,1,18,2,2,422,467,-45
2,1,19,2,2,413,466,-53
2,1,20,2,2,425,436,-11
2,1,21,2,2,450,438,12
2,1,22,2,2,437,445,-8
2,2,0,2,2,450,469,-19
2,2,1,2,2,454,475,-21
2,2,2,2,2,434,468,-34
2,2,3,2,2,434,485,-51
2,2,4,2,2,445,480,-35
2,2,5,2,2,443,392,51
2,2,6,2,2,453,278,175
2,2,7,2,2,420,238,182
2,2,8,2,2,369,242,127
2,2,9,2,2,357,234,123
2,2,10,2,2,345,225,120
2,2,11,2,2,338,219,119
2,2,12,2,2,339,219,120
2,2,13,2,2,346,222,124
2,2,14,2,2,353,226,127
2,2,15,2,2,385,228,157
2,2,16,2,2,415,247,168
2,2,17,2,2,434,320,114
2,2,18,2,2,454,417,37
2,2,19,2,2,438,461,-23
2,2,20,2,2,424,460,-36
2,2,21,2,2,440,460,-20
2,2,22,2,2,443,449,-6
2,3,0,2,2,462,480,-18
2,3,1,2,2,460,475,-15
2,3,2,2,2,444,437,7
2,3,3,2,2,458,420,38
2,3,4,2,2,473,403,70
2,3,5,2,2,441,327,114
2,3,6,2,2,397,233,164
2,3,7,2,2,317,235,82
2,3,8,2,2,246,275,-29
2,3,9,2,2,234,273,-39
2,3,10,2,2,222,270,-48
2,3,11,2,2,214,268,-54
2,3,12,2,2,214,268,-54
2,3,13,2,2,220,267,-47
2,3,14,2,2,227,267,-40
2,3,15,2,2,264,266,-2
2,3,16,2,2,323,256,67
2,3,17,2,2,397,276,121
2,3,18,2,2,467,346,121
2,3,19,2,2,466,407,59
2,3,20,2,2,436,439,-3
2,3,21,2,2,438,460,-22
2,3,22,2,2,445,457,-12
2,4,0,2,2,469,499,-30
2,4,1,2,2,475,448,27
2,4,2,2,2,468,337,131
2,4,3,2,2,485,265,220
2,4,4,2,2,480,266,214
2,4,5,2,2,392,288,104
2,4,6,2,2,278,312,-34
2,4,7,2,2,238,327,-89
2,4,8,2,2,242,329,-87
2,4,9,2,2,234,331,-97
2,4,10,2,2,225,334,-109
2,4,11,2,2,219,336,-117
2,4,12,2,2,219,335,-116
2,4,13,2,2,222,332,-110
2,4,14,2,2,226,329,-103
2,4,15,2,2,228,340,-112
2,4,16,2,2,247,326,-79
2,4,17,2,2,320,300,20
2,4,18,2,2,417,314,103
2,4,19,2,2,461,333,128
2,4,20,2,2,460,360,100
2,4,21,2,2,460,417,43
2,4,22,2,2,449,466,-17
2,5,0,2,2,480,522,-42
2,5,1,2,2,475,477,-2
2,5,2,2,2,437,338,99
2,5,3,2,2,420,230,190
2,5,4,2,2,403,254,149
2,5,5,2,2,327,368,-41
2,5,6,2,2,233,443,-210
2,5,7,2,2,235,448,-213
2,5,8,2,2,275,453,-178
2,5,9,2,2,273,458,-185
2,5,10,2,2,270,463,-193
2,5,11,2,2,268,481,-213
2,5,12,2,2,268,489,-221
2,5,13,2,2,267,479,-212
2,5,14,2,2,267,469,-202
2,5,15,2,2,266,467,-201
2,5,16,2,2,256,448,-192
2,5,17,2,2,276,423,-147
2,5,18,2,2,346,378,-32
2,5,19,2,2,407,341,66
2,5,20,2,2,439,383,56
2,5,21,2,2,460,440,20
2,5,22,2,2,457,484,-27
2,6,0,2,2,499,442,57
2,6,1,2,2,448,400,48
2,6,2,2,2,337,311,26
2,6,3,2,2,265,225,40
2,6,4,2,2,266,253,13
2,6,5,2,2,288,328,-40
2,6,6,2,2,312,367,-55
2,6,7,2,2,327,379,-52
2,6,8,2,2,329,367,-38
2,6,9,2,2,331,335,-4
2,6,10,2,2,334,332,2
2,6,11,2,2,336,358,-22
2,6,12,2,2,335,359,-24
2,6,13,2,2,332,339,-7
2,6,14,2,2,329,356,-27
2,6,15,2,2,340,384,-44
2,6,16,2,2,326,390,-64
2,6,17,2,2,300,384,-84
2,6,18,2,2,314,327,-13
2,6,19,2,2,333,290,43
2,6,20,2,2,360,338,22
2,6,21,2,2,417,382,35
2,6,22,2,2,466,428,38
2,7,0,2,2,522,323,199
2,7,1,2,2,477,242,235
2,7,2,2,2,338,248,90
2,7,3,2,2,230,308,-78
2,7,4,2,2,254,362,-108
2,7,5,2,2,368,340,28
2,7,6,2,2,443,391,52
2,7,7,2,2,448,430,18
2,7,8,2,2,453,375,78
2,7,9,2,2,458,330,128
2,7,10,2,2,463,316,147
2,7,11,2,2,481,319,162
2,7,12,2,2,489,324,165
2,7,13,2,2,479,311,168
2,7,14,2,2,469,333,136
2,7,15,2,2,467,386,81
2,7,16,2,2,448,419,29
2,7,17,2,2,423,385,38
2,7,18,2,2,378,337,41
2,7,19,2,2,341,333,8
2,7,20,2,2,383,308,75
2,7,21,2,2,440,317,123
2,7,22,2,2,484,384,100
2,8,0,2,2,442,387,55
2,8,1,2,2,400,294,106
2,8,2,2,2,311,349,-38
2,8,3,2,2,225,600,-375
2,8,4,2,2,253,694,-441
2,8,5,2,2,328,639,-311
2,8,6,2,2,367,733,-366
2,8,7,2,2,379,745,-366
2,8,8,2,2,367,664,-297
2,8,9,2,2,335,632,-297
2,8,10,2,2,332,623,-291
2,8,11,2,2,358,613,-255
2,8,12,2,2,359,648,-289
2,8,13,2,2,339,640,-301
2,8,14,2,2,356,626,-270
2,8,15,2,2,384,705,-321
2,8,16,2,2,390,772,-382
2,8,17,2,2,384,681,-297
2,8,18,2,2,327,627,-300
2,8,19,2,2,290,659,-369
2,8,20,2,2,338,579,-241
2,8,21,2,2,382,523,-141
2,8,22,2,2,428,512,-84
2,9,0,2,2,323,537,-214
2,9,1,2,2,242,441,-199
2,9,2,2,2,248,443,-195
2,9,3,2,2,308,739,-431
2,9,4,2,2,362,866,-504
2,9,5,2,2,340,812,-472
2,9,6,2,2,391,890,-499
2,9,7,2,2,430,902,-472
2,9,8,2,2,375,737,-362
2,9,9,2,2,330,597,-267
2,9,10,2,2,316,601,-285
2,9,11,2,2,319,615,-296
2,9,12,2,2,324,633,-309
2,9,13,2,2,311,598,-287
2,9,14,2,2,333,635,-302
2,9,15,2,2,386,841,-455
2,9,16,2,2,419,967,-548
2,9,17,2,2,385,858,-473
2,9,18,2,2,337,817,-480
2,9,19,2,2,333,864,-531
2,9,20,2,2,308,797,-489
2,9,21,2,2,317,738,-421
2,9,22,2,2,384,637,-253
2,10,0,2,2,387,603,-216
2,10,1,2,2,294,520,-226
2,10,2,2,2,349,463,-114
2,10,3,2,2,600,673,-73
2,10,4,2,2,694,878,-184
2,10,5,2,2,639,837,-198
2,10,6,2,2,733,840,-107
2,10,7,2,2,745,938,-193
2,10,8,2,2,664,692,-28
2,10,9,2,2,632,431,201
2,10,10,2,2,623,428,195
2,10,11,2,2,613,449,164
2,10,12,2,2,648,448,200
2,10,13,2,2,640,401,239
2,10,14,2,2,626,510,116
2,10,15,2,2,705,816,-111
2,10,16,2,2,772,955,-183
2,10,17,2,2,681,873,-192
2,10,18,2,2,627,853,-226
2,10,19,2,2,659,830,-171
2,10,20,2,2,579,780,-201
2,10,21,2,2,523,781,-258
2,10,22,2,2,512,661,-149
2,11,0,2,2,537,626,-89
2,11,1,2,2,441,553,-112
2,11,2,2,2,443,470,-27
2,11,3,2,2,739,608,131
2,11,4,2,2,866,870,-4
2,11,5,2,2,812,820,-8
2,11,6,2,2,890,777,113
2,11,7,2,2,902,949,-47
2,11,8,2,2,737,685,52
2,11,9,2,2,597,433,164
2,11,10,2,2,601,419,182
2,11,11,2,2,615,405,210
2,11,12,2,2,633,427,206
2,11,13,2,2,598,403,195
2,11,14,2,2,635,507,128
2,11,15,2,2,841,802,39
2,11,16,2,2,967,887,80
2,11,17,2,2,858,845,13
2,11,18,2,2,817,874,-57
2,11,19,2,2,864,756,108
2,11,20,2,2,797,713,84
2,11,21,2,2,738,781,-43
2,11,22,2,2,637,686,-49
2,12,0,2,2,603,636,-33
2,12,1,2,2,520,560,-40
2,12,2,2,2,463,463,0
2,12,3,2,2,673,624,49
2,12,4,2,2,878,887,-9
2,12,5,2,2,837,811,26
2,12,6,2,2,840,775,65
2,12,7,2,2,938,942,-4
2,12,8,2,2,692,657,35
2,12,9,2,2,431,428,3
2,12,10,2,2,428,432,-4
2,12,11,2,2,449,401,48
2,12,12,2,2,448,418,30
2,12,13,2,2,401,394,7
2,12,14,2,2,510,505,5
2,12,15,2,2,816,811,5
2,12,16,2,2,955,847,108
2,12,17,2,2,873,828,45
2,12,18,2,2,853,913,-60
2,12,19,2,2,830,738,92
2,12,20,2,2,780,695,85
2,12,21,2,2,781,780,1
2,12,22,2,2,661,682,-21
2,13,0,2,2,626,537,89
2,13,1,2,2,553,465,88
2,13,2,2,2,470,420,50
2,13,3,2,2,608,664,-56
2,13,4,2,2,870,925,-55
2,13,5,2,2,820,793,27
2,13,6,2,2,777,779,-2
2,13,7,2,2,949,962,-13
2,13,8,2,2,685,667,18
2,13,9,2,2,433,425,8
2,13,10,2,2,419,423,-4
2,13,11,2,2,405,420,-15
2,13,12,2,2,427,436,-9
2,13,13,2,2,403,388,15
2,13,14,2,2,507,518,-11
2,13,15,2,2,802,843,-41
2,13,16,2,2,887,850,37
2,13,17,2,2,845,777,68
2,13,18,2,2,874,876,-2
2,13,19,2,2,756,745,11
2,13,20,2,2,713,671,42
2,13,21,2,2,781,669,112
2,13,22,2,2,686,584,102
2,14,0,2,2,636,405,231
2,14,1,2,2,560,327,233
2,14,2,2,2,463,403,60
2,14,3,2,2,624,691,-67
2,14,4,2,2,887,866,21
2,14,5,2,2,811,682,129
2,14,6,2,2,775,721,54
2,14,7,2,2,942,914,28
2,14,8,2,2,657,613,44
2,14,9,2,2,428,405,23
2,14,10,2,2,432,388,44
2,14,11,2,2,401,371,30
2,14,12,2,2,418,405,13
2,14,13,2,2,394,354,40
2,14,14,2,2,505,473,32
2,14,15,2,2,811,810,1
2,14,16,2,2,847,827,20
2,14,17,2,2,828,595,233
2,14,18,2,2,913,641,272
2,14,19,2,2,738,707,31
2,14,20,2,2,695,664,31
2,14,21,2,2,780,544,236
2,14,22,2,2,682,505,177
2,15,0,2,2,537,397,140
2,15,1,2,2,465,306,159
2,15,2,2,2,420,469,-49
2,15,3,2,2,664,775,-111
2,15,4,2,2,925,815,110
2,15,5,2,2,793,551,242
2,15,6,2,2,779,540,239
2,15,7,2,2,962,667,295
2,15,8,2,2,667,452,215
2,15,9,2,2,425,329,96
2,15,10,2,2,423,336,87
2,15,11,2,2,420,341,79
2,15,12,2,2,436,348,88
2,15,13,2,2,388,322,66
2,15,14,2,2,518,386,132
2,15,15,2,2,843,531,312
2,15,16,2,2,850,628,222
2,15,17,2,2,777,467,310
2,15,18,2,2,876,433,443
2,15,19,2,2,745,659,86
2,15,20,2,2,671,704,-33
2,15,21,2,2,669,504,165
2,15,22,2,2,584,450,134
2,16,0,2,2,405,494,-89
2,16,1,2,2,327,362,-35
2,16,2,2,2,403,598,-195
2,16,3,2,2,691,786,-95
2,16,4,2,2,866,627,239
2,16,5,2,2,682,400,282
2,16,6,2,2,721,368,353
2,16,7,2,2,914,526,388
2,16,8,2,2,613,495,118
2,16,9,2,2,405,429,-24
2,16,10,2,2,388,448,-60
2,16,11,2,2,371,480,-109
2,16,12,2,2,405,497,-92
2,16,13,2,2,354,445,-91
2,16,14,2,2,473,360,113
2,16,15,2,2,810,402,408
2,16,16,2,2,827,621,206
2,16,17,2,2,595,508,87
2,16,18,2,2,641,330,311
2,16,19,2,2,707,565,142
2,16,20,2,2,664,620,44
2,16,21,2,2,544,398,146
2,16,22,2,2,505,477,28
2,17,0,2,2,397,546,-149
2,17,1,2,2,306,338,-32
2,17,2,2,2,469,636,-167
2,17,3,2,2,775,691,84
2,17,4,2,2,815,350,465
2,17,5,2,2,551,268,283
2,17,6,2,2,540,423,117
2,17,7,2,2,667,709,-42
2,17,8,2,2,452,686,-234
2,17,9,2,2,329,566,-237
2,17,10,2,2,336,562,-226
2,17,11,2,2,341,561,-220
2,17,12,2,2,348,613,-265
2,17,13,2,2,322,497,-175
2,17,14,2,2,386,334,52
2,17,15,2,2,531,466,65
2,17,16,2,2,628,654,-26
2,17,17,2,2,467,445,22
2,17,18,2,2,433,257,176
2,17,19,2,2,659,480,179
2,17,20,2,2,704,464,240
2,17,21,2,2,504,253,251
2,17,22,2,2,450,541,-91
2,18,0,2,2,494,541,-47
2,18,1,2,2,362,305,57
2,18,2,2,2,598,622,-24
2,18,3,2,2,786,624,162
2,18,4,2,2,627,234,393
2,18,5,2,2,400,206,194
2,18,6,2,2,368,394,-26
2,18,7,2,2,526,652,-126
2,18,8,2,2,495,562,-67
2,18,9,2,2,429,352,77
2,18,10,2,2,448,343,105
2,18,11,2,2,480,404,76
2,18,12,2,2,497,422,75
2,18,13,2,2,445,290,155
2,18,14,2,2,360,238,122
2,18,15,2,2,402,311,91
2,18,16,2,2,621,371,250
2,18,17,2,2,508,293,215
2,18,18,2,2,330,264,66
2,18,19,2,2,565,425,140
2,18,20,2,2,620,398,222
2,18,21,2,2,398,285,113
2,18,22,2,2,477,535,-58
2,19,0,2,2,546,446,100
2,19,1,2,2,338,311,27
2,19,2,2,2,636,520,116
2,19,3,2,2,691,457,234
2,19,4,2,2,350,171,179
2,19,5,2,2,268,172,96
2,19,6,2,2,423,282,141
2,19,7,2,2,709,475,234
2,19,8,2,2,686,386,300
2,19,9,2,2,566,186,380
2,19,10,2,2,562,201,361
2,19,11,2,2,561,309,252
2,19,12,2,2,613,323,290
2,19,13,2,2,497,176,321
2,19,14,2,2,334,210,124
2,19,15,2,2,466,308,158
2,19,16,2,2,654,295,359
2,19,17,2,2,445,215,230
2,19,18,2,2,257,217,40
2,19,19,2,2,480,291,189
2,19,20,2,2,464,292,172
2,19,21,2,2,253,293,-40
2,19,22,2,2,541,379,162
2,20,0,2,2,541,351,190
2,20,1,2,2,305,273,32
2,20,2,2,2,622,319,303
2,20,3,2,2,624,298,326
2,20,4,2,2,234,211,23
2,20,5,2,2,206,195,11
2,20,6,2,2,394,268,126
2,20,7,2,2,652,452,200
2,20,8,2,2,562,424,138
2,20,9,2,2,352,272,80
2,20,10,2,2,343,246,97
2,20,11,2,2,404,369,35
2,20,12,2,2,422,421,1
2,20,13,2,2,290,298,-8
2,20,14,2,2,238,317,-79
2,20,15,2,2,311,411,-100
2,20,16,2,2,371,356,15
2,20,17,2,2,293,199,94
2,20,18,2,2,264,190,74
2,20,19,2,2,425,230,195
2,20,20,2,2,398,189,209
2,20,21,2,2,285,215,70
2,20,22,2,2,535,231,304
2,0,0,3,2,655,698,-43
2,0,1,3,2,648,702,-54
2,0,2,3,2,626,683,-57
2,0,3,3,2,644,702,-58
2,0,4,3,2,660,707,-47
2,0,5,3,2,641,619,22
2,0,6,3,2,645,505,140
2,0,7,3,2,658,425,233
2,0,8,3,2,649,383,266
2,0,9,3,2,637,369,268
2,0,10,3,2,627,354,273
2,0,11,3,2,623,344,279
2,0,12,3,2,626,344,282
2,0,13,3,2,634,350,284
2,0,14,3,2,642,358,284
2,0,15,3,2,653,385,268
2,0,16,3,2,648,436,212
2,0,17,3,2,641,536,105
2,0,18,3,2,640,655,-15
2,0,19,3,2,619,689,-70
2,0,20,3,2,626,671,-45
2,0,21,3,2,662,675,-13
2,0,22,3,2,648,671,-23
2,1,0,3,2,667,713,-46
2,1,1,3,2,672,708,-36
2,1,2,3,2,647,666,-19
2,1,3,3,2,652,661,-9
2,1,4,3,2,665,649,16
2,1,5,3,2,653,541,112
2,1,6,3,2,662,403,259
2,1,7,3,2,635,365,270
2,1,8,3,2,583,380,203
2,1,9,3,2,567,372,195
2,1,10,3,2,552,363,189
2,1,11,3,2,544,357,187
2,1,12,3,2,546,357,189
2,1,13,3,2,555,359,196
2,1,14,3,2,565,362,203
2,1,15,3,2,607,373,234
2,1,16,3,2,637,390,247
2,1,17,3,2,645,457,188
2,1,18,3,2,660,575,85
2,1,19,3,2,641,645,-4
2,1,20,3,2,636,664,-28
2,1,21,3,2,665,683,-18
2,1,22,3,2,659,680,-21
2,2,0,3,2,683,735,-52
2,2,1,3,2,687,690,-3
2,2,2,3,2,663,576,87
2,2,3,3,2,675,509,166
2,2,4,3,2,691,500,191
2,2,5,3,2,657,466,191
2,2,6,3,2,623,420,203
2,2,7,3,2,550,435,115
2,2,8,3,2,474,466,8
2,2,9,3,2,456,466,-10
2,2,10,3,2,438,466,-28
2,2,11,3,2,427,466,-39
2,2,12,3,2,428,465,-37
2,2,13,3,2,438,462,-24
2,2,14,3,2,448,460,-12
2,2,15,3,2,492,461,31
2,2,16,3,2,549,439,110
2,2,17,3,2,615,439,176
2,2,18,3,2,683,502,181
2,2,19,3,2,676,556,120
2,2,20,3,2,649,595,54
2,2,21,3,2,663,654,9
2,2,22,3,2,666,692,-26
2,3,0,3,2,698,766,-68
2,3,1,3,2,702,710,-8
2,3,2,3,2,683,536,147
2,3,3,3,2,702,406,296
2,3,4,3,2,707,423,284
2,3,5,3,2,619,517,102
2,3,6,3,2,505,568,-63
2,3,7,3,2,425,575,-150
2,3,8,3,2,383,591,-208
2,3,9,3,2,369,596,-227
2,3,10,3,2,354,601,-247
2,3,11,3,2,344,619,-275
2,3,12,3,2,344,627,-283
2,3,13,3,2,350,616,-266
2,3,14,3,2,358,605,-247
2,3,15,3,2,385,612,-227
2,3,16,3,2,436,591,-155
2,3,17,3,2,536,560,-24
2,3,18,3,2,655,536,119
2,3,19,3,2,689,525,164
2,3,20,3,2,671,587,84
2,3,21,3,2,675,663,12
2,3,22,3,2,671,715,-44
2,4,0,3,2,713,697,16
2,4,1,3,2,708,615,93
2,4,2,3,2,666,450,216
2,4,3,3,2,661,314,347
2,4,4,3,2,649,350,299
2,4,5,3,2,541,467,74
2,4,6,3,2,403,554,-151
2,4,7,3,2,365,579,-214
2,4,8,3,2,380,558,-178
2,4,9,3,2,372,528,-156
2,4,10,3,2,363,528,-165
2,4,11,3,2,357,556,-199
2,4,12,3,2,357,556,-199
2,4,13,3,2,359,534,-175
2,4,14,3,2,362,549,-187
2,4,15,3,2,373,579,-206
2,4,16,3,2,390,573,-183
2,4,17,3,2,457,547,-90
2,4,18,3,2,575,483,92
2,4,19,3,2,645,439,206
2,4,20,3,2,664,494,170
2,4,21,3,2,683,576,107
2,4,22,3,2,680,663,17
2,5,0,3,2,735,590,145
2,5,1,3,2,690,504,186
2,5,2,3,2,576,447,129
2,5,3,3,2,509,449,60
2,5,4,3,2,500,519,-19
2,5,5,3,2,466,569,-103
2,5,6,3,2,420,647,-227
2,5,7,3,2,435,678,-243
2,5,8,3,2,466,637,-171
2,5,9,3,2,466,595,-129
2,5,10,3,2,466,583,-117
2,5,11,3,2,466,602,-136
2,5,12,3,2,465,616,-151
2,5,13,3,2,462,595,-133
2,5,14,3,2,460,609,-149
2,5,15,3,2,461,658,-197
2,5,16,3,2,439,684,-245
2,5,17,3,2,439,645,-206
2,5,18,3,2,502,559,-57
2,5,19,3,2,556,525,31
2,5,20,3,2,595,535,60
2,5,21,3,2,654,563,91
2,5,22,3,2,692,633,59
2,6,0,3,2,766,562,204
2,6,1,3,2,710,432,278
2,6,2,3,2,536,461,75
2,6,3,3,2,406,684,-278
2,6,4,3,2,423,790,-367
2,6,5,3,2,517,738,-221
2,6,6,3,2,568,844,-276
2,6,7,3,2,575,876,-301
2,6,8,3,2,591,769,-178
2,6,9,3,2,596,702,-106
2,6,10,3,2,601,688,-87
2,6,11,3,2,619,688,-69
2,6,12,3,2,627,715,-88
2,6,13,3,2,616,695,-79
2,6,14,3,2,605,706,-101
2,6,15,3,2,612,817,-205
2,6,16,3,2,591,897,-306
2,6,17,3,2,560,805,-245
2,6,18,3,2,536,732,-196
2,6,19,3,2,525,757,-232
2,6,20,3,2,587,690,-103
2,6,21,3,2,663,659,4
2,6,22,3,2,715,691,24
2,7,0,3,2,697,685,12
2,7,1,3,2,615,545,70
2,7,2,3,2,450,579,-129
2,7,3,3,2,314,963,-649
2,7,4,3,2,350,1132,-782
2,7,5,3,2,467,1053,-586
2,7,6,3,2,554,1170,-616
2,7,7,3,2,579,1201,-622
2,7,8,3,2,558,1007,-449
2,7,9,3,2,528,857,-329
2,7,10,3,2,528,852,-324
2,7,11,3,2,556,859,-303
2,7,12,3,2,556,890,-334
2,7,13,3,2,534,854,-320
2,7,14,3,2,549,888,-339
2,7,15,3,2,579,1115,-536
2,7,16,3,2,573,1261,-688
2,7,17,3,2,547,1119,-572
2,7,18,3,2,483,1049,-566
2,7,19,3,2,439,1099,-660
2,7,20,3,2,494,994,-500
2,7,21,3,2,576,919,-343
2,7,22,3,2,663,842,-179
2,8,0,3,2,590,842,-252
2,8,1,3,2,504,710,-206
2,8,2,3,2,447,676,-229
2,8,3,3,2,449,1049,-600
2,8,4,3,2,519,1306,-787
2,8,5,3,2,569,1235,-666
2,8,6,3,2,647,1293,-646
2,8,7,3,2,678,1384,-706
2,8,8,3,2,637,1086,-449
2,8,9,3,2,595,803,-208
2,8,10,3,2,583,800,-217
2,8,11,3,2,602,818,-216
2,8,12,3,2,616,839,-223
2,8,13,3,2,595,785,-190
2,8,14,3,2,609,883,-274
2,8,15,3,2,658,1247,-589
2,8,16,3,2,684,1433,-749
2,8,17,3,2,645,1293,-648
2,8,18,3,2,559,1248,-689
2,8,19,3,2,525,1254,-729
2,8,20,3,2,535,1162,-627
2,8,21,3,2,563,1123,-560
2,8,22,3,2,633,968,-335
2,9,0,3,2,562,924,-362
2,9,1,3,2,432,804,-372
2,9,2,3,2,461,700,-239
2,9,3,3,2,684,971,-287
2,9,4,3,2,790,1308,-518
2,9,5,3,2,738,1234,-496
2,9,6,3,2,844,1214,-370
2,9,7,3,2,876,1405,-529
2,9,8,3,2,769,1028,-259
2,9,9,3,2,702,658,44
2,9,10,3,2,688,648,40
2,9,11,3,2,688,651,37
2,9,12,3,2,715,669,46
2,9,13,3,2,695,617,78
2,9,14,3,2,706,769,-63
2,9,15,3,2,817,1212,-395
2,9,16,3,2,897,1376,-479
2,9,17,3,2,805,1283,-478
2,9,18,3,2,732,1296,-564
2,9,19,3,2,757,1196,-439
2,9,20,3,2,690,1128,-438
2,9,21,3,2,659,1177,-518
2,9,22,3,2,691,1016,-325
2,10,0,3,2,685,941,-256
2,10,1,3,2,545,829,-284
2,10,2,3,2,579,696,-117
2,10,3,3,2,963,934,29
2,10,4,3,2,1132,1327,-195
2,10,5,3,2,1053,1234,-181
2,10,6,3,2,1170,1178,-8
2,10,7,3,2,1201,1424,-223
2,10,8,3,2,1007,1006,1
2,10,9,3,2,857,634,223
2,10,10,3,2,852,631,221
2,10,11,3,2,859,604,255
2,10,12,3,2,890,624,266
2,10,13,3,2,854,581,273
2,10,14,3,2,888,753,135
2,10,15,3,2,1115,1217,-102
2,10,16,3,2,1261,1313,-52
2,10,17,3,2,1119,1263,-144
2,10,18,3,2,1049,1344,-295
2,10,19,3,2,1099,1128,-29
2,10,20,3,2,994,1060,-66
2,10,21,3,2,919,1165,-246
2,10,22,3,2,842,1013,-171
2,11,0,3,2,842,858,-16
2,11,1,3,2,710,749,-39
2,11,2,3,2,676,657,19
2,11,3,3,2,1049,962,87
2,11,4,3,2,1306,1355,-49
2,11,5,3,2,1235,1190,45
2,11,6,3,2,1293,1153,140
2,11,7,3,2,1384,1429,-45
2,11,8,3,2,1086,1003,83
2,11,9,3,2,803,652,151
2,11,10,3,2,800,643,157
2,11,11,3,2,818,622,196
2,11,12,3,2,839,657,182
2,11,13,3,2,785,604,181
2,11,14,3,2,883,777,106
2,11,15,3,2,1247,1239,8
2,11,16,3,2,1433,1271,162
2,11,17,3,2,1293,1187,106
2,11,18,3,2,1248,1319,-71
2,11,19,3,2,1254,1111,143
2,11,20,3,2,1162,1019,143
2,11,21,3,2,1123,1065,58
2,11,22,3,2,968,939,29
2,12,0,3,2,924,720,204
2,12,1,3,2,804,603,201
2,12,2,3,2,700,629,71
2,12,3,3,2,971,1017,-46
2,12,4,3,2,1308,1323,-15
2,12,5,3,2,1234,1096,138
2,12,6,3,2,1214,1122,92
2,12,7,3,2,1405,1389,16
2,12,8,3,2,1028,934,94
2,12,9,3,2,658,606,52
2,12,10,3,2,648,600,48
2,12,11,3,2,651,570,81
2,12,12,3,2,669,602,67
2,12,13,3,2,617,532,85
2,12,14,3,2,769,719,50
2,12,15,3,2,1212,1225,-13
2,12,16,3,2,1376,1253,123
2,12,17,3,2,1283,1013,270
2,12,18,3,2,1296,1111,185
2,12,19,3,2,1196,1079,117
2,12,20,3,2,1128,1011,117
2,12,21,3,2,1177,928,249
2,12,22,3,2,1016,832,184
2,13,0,3,2,941,619,322
2,13,1,3,2,829,495,334
2,13,2,3,2,696,663,33
2,13,3,3,2,934,1113,-179
2,13,4,3,2,1327,1283,44
2,13,5,3,2,1234,930,304
2,13,6,3,2,1178,918,260
2,13,7,3,2,1424,1154,270
2,13,8,3,2,1006,798,208
2,13,9,3,2,634,553,81
2,13,10,3,2,631,547,84
2,13,11,3,2,604,562,42
2,13,12,3,2,624,587,37
2,13,13,3,2,581,532,49
2,13,14,3,2,753,658,95
2,13,15,3,2,1217,959,258
2,13,16,3,2,1313,1052,261
2,13,17,3,2,1263,826,437
2,13,18,3,2,1344,839,505
2,13,19,3,2,1128,1032,96
2,13,20,3,2,1060,1028,32
2,13,21,3,2,1165,789,376
2,13,22,3,2,1013,707,306
2,14,0,3,2,858,677,181
2,14,1,3,2,749,500,249
2,14,2,3,2,657,807,-150
2,14,3,3,2,962,1139,-177
2,14,4,3,2,1355,1025,330
2,14,5,3,2,1190,703,487
2,14,6,3,2,1153,711,442
2,14,7,3,2,1429,953,476
2,14,8,3,2,1003,762,241
2,14,9,3,2,652,610,42
2,14,10,3,2,643,625,18
2,14,11,3,2,622,630,-8
2,14,12,3,2,657,663,-6
2,14,13,3,2,604,589,15
2,14,14,3,2,777,561,216
2,14,15,3,2,1239,784,455
2,14,16,3,2,1271,1024,247
2,14,17,3,2,1187,744,443
2,14,18,3,2,1319,565,754
2,14,19,3,2,1111,899,212
2,14,20,3,2,1019,960,59
2,14,21,3,2,1065,657,408
2,14,22,3,2,939,725,214
2,15,0,3,2,720,760,-40
2,15,1,3,2,603,506,97
2,15,2,3,2,629,896,-267
2,15,3,3,2,1017,1113,-96
2,15,4,3,2,1323,767,556
2,15,5,3,2,1096,516,580
2,15,6,3,2,1122,620,502
2,15,7,3,2,1389,949,440
2,15,8,3,2,934,871,63
2,15,9,3,2,606,714,-108
2,15,10,3,2,600,721,-121
2,15,11,3,2,570,752,-182
2,15,12,3,2,602,795,-193
2,15,13,3,2,532,675,-143
2,15,14,3,2,719,519,200
2,15,15,3,2,1225,615,610
2,15,16,3,2,1253,879,374
2,15,17,3,2,1013,676,337
2,15,18,3,2,1111,455,656
2,15,19,3,2,1079,805,274
2,15,20,3,2,1011,828,183
2,15,21,3,2,928,498,430
2,15,22,3,2,832,743,89
2,16,0,3,2,619,821,-202
2,16,1,3,2,495,499,-4
2,16,2,3,2,663,960,-297
2,16,3,3,2,1113,988,125
2,16,4,3,2,1283,444,839
2,16,5,3,2,930,358,572
2,16,6,3,2,918,565,353
2,16,7,3,2,1154,938,216
2,16,8,3,2,798,872,-74
2,16,9,3,2,553,633,-80
2,16,10,3,2,547,632,-85
2,16,11,3,2,562,693,-131
2,16,12,3,2,587,737,-150
2,16,13,3,2,532,557,-25
2,16,14,3,2,658,413,245
2,16,15,3,2,959,564,395
2,16,16,3,2,1052,767,285
2,16,17,3,2,826,570,256
2,16,18,3,2,839,396,443
2,16,19,3,2,1032,665,367
2,16,20,3,2,1028,654,374
2,16,21,3,2,789,438,351
2,16,22,3,2,707,810,-103
2,17,0,3,2,677,712,-35
2,17,1,3,2,500,455,45
2,17,2,3,2,807,818,-11
2,17,3,3,2,1139,784,355
2,17,4,3,2,1025,311,714
2,17,5,3,2,703,288,415
2,17,6,3,2,711,534,177
2,17,7,3,2,953,898,55
2,17,8,3,2,762,762,0
2,17,9,3,2,610,471,139
2,17,10,3,2,625,474,151
2,17,11,3,2,630,581,49
2,17,12,3,2,663,621,42
2,17,13,3,2,589,406,183
2,17,14,3,2,561,369,192
2,17,15,3,2,784,521,263
2,17,16,3,2,1024,553,471
2,17,17,3,2,744,383,361
2,17,18,3,2,565,342,223
2,17,19,3,2,899,531,368
2,17,20,3,2,960,500,460
2,17,21,3,2,657,393,264
2,17,22,3,2,725,645,80
2,18,0,3,2,760,626,134
2,18,1,3,2,506,434,72
2,18,2,3,2,896,643,253
2,18,3,3,2,1113,595,518
2,18,4,3,2,767,305,462
2,18,5,3,2,516,285,231
2,18,6,3,2,620,410,210
2,18,7,3,2,949,681,268
2,18,8,3,2,871,610,261
2,18,9,3,2,714,339,375
2,18,10,3,2,721,316,405
2,18,11,3,2,752,501,251
2,18,12,3,2,795,545,250
2,18,13,3,2,675,358,317
2,18,14,3,2,519,396,123
2,18,15,3,2,615,509,106
2,18,16,3,2,879,469,410
2,18,17,3,2,676,324,352
2,18,18,3,2,455,329,126
2,18,19,3,2,805,415,390
2,18,20,3,2,828,379,449
2,18,21,3,2,498,400,98
2,18,22,3,2,743,500,243
2,0,0,4,2,884,968,-84
2,0,1,4,2,875,923,-48
2,0,2,4,2,841,805,36
2,0,3,4,2,861,750,111
2,0,4,4,2,887,746,141
2,0,5,4,2,868,680,188
2,0,6,4,2,872,590,282
2,0,7,4,2,845,565,280
2,0,8,4,2,790,571,219
2,0,9,4,2,772,565,207
2,0,10,4,2,756,559,197
2,0,11,4,2,748,555,193
2,0,12,4,2,751,554,197
2,0,13,4,2,762,554,208
2,0,14,4,2,774,555,219
2,0,15,4,2,810,568,242
2,0,16,4,2,837,573,264
2,0,17,4,2,857,620,237
2,0,18,4,2,878,731,147
2,0,19,4,2,847,794,53
2,0,20,4,2,837,820,17
2,0,21,4,2,877,877,0
2,0,22,4,2,870,915,-45
2,1,0,4,2,900,1002,-102
2,1,1,4,2,905,952,-47
2,1,2,4,2,876,775,101
2,1,3,4,2,893,650,243
2,1,4,4,2,911,657,254
2,1,5,4,2,867,695,172
2,1,6,4,2,832,676,156
2,1,7,4,2,765,683,82
2,1,8,4,2,688,728,-40
2,1,9,4,2,666,731,-65
2,1,10,4,2,645,733,-88
2,1,11,4,2,633,749,-116
2,1,12,4,2,635,757,-122
2,1,13,4,2,647,746,-99
2,1,14,4,2,660,736,-76
2,1,15,4,2,714,733,-19
2,1,16,4,2,771,704,67
2,1,17,4,2,826,699,127
2,1,18,4,2,889,724,165
2,1,19,4,2,879,748,131
2,1,20,4,2,861,822,39
2,1,21,4,2,888,900,-12
2,1,22,4,2,882,941,-59
2,2,0,4,2,919,941,-22
2,2,1,4,2,929,848,81
2,2,2,4,2,902,648,254
2,2,3,4,2,919,490,429
2,2,4,4,2,925,519,406
2,2,5,4,2,835,616,219
2,2,6,4,2,731,679,52
2,2,7,4,2,658,706,-48
2,2,8,4,2,611,696,-85
2,2,9,4,2,591,666,-75
2,2,10,4,2,570,666,-96
2,2,11,4,2,557,694,-137
2,2,12,4,2,558,694,-136
2,2,13,4,2,568,671,-103
2,2,14,4,2,579,685,-106
2,2,15,4,2,613,724,-111
2,2,16,4,2,662,716,-54
2,2,17,4,2,754,684,70
2,2,18,4,2,871,641,230
2,2,19,4,2,899,623,276
2,2,20,4,2,884,698,186
2,2,21,4,2,900,799,101
2,2,22,4,2,892,894,-2
2,3,0,4,2,942,845,97
2,3,1,4,2,935,719,216
2,3,2,4,2,881,586,295
2,3,3,4,2,878,538,340
2,3,4,4,2,876,616,260
2,3,5,4,2,768,708,60
2,3,6,4,2,630,834,-204
2,3,7,4,2,552,878,-326
2,3,8,4,2,521,828,-307
2,3,9,4,2,507,788,-281
2,3,10,4,2,492,779,-287
2,3,11,4,2,482,800,-318
2,3,12,4,2,482,813,-331
2,3,13,4,2,487,790,-303
2,3,14,4,2,494,802,-308
2,3,15,4,2,530,853,-323
2,3,16,4,2,579,867,-288
2,3,17,4,2,673,808,-135
2,3,18,4,2,813,715,98
2,3,19,4,2,873,674,199
2,3,20,4,2,875,691,184
2,3,21,4,2,898,757,141
2,3,22,4,2,902,868,34
2,4,0,4,2,968,829,139
2,4,1,4,2,923,694,229
2,4,2,4,2,805,660,145
2,4,3,4,2,750,825,-75
2,4,4,4,2,746,947,-201
2,4,5,4,2,680,967,-287
2,4,6,4,2,590,1100,-510
2,4,7,4,2,565,1124,-559
2,4,8,4,2,571,1031,-460
2,4,9,4,2,565,967,-402
2,4,10,4,2,559,955,-396
2,4,11,4,2,555,971,-416
2,4,12,4,2,554,1007,-453
2,4,13,4,2,554,979,-425
2,4,14,4,2,555,982,-427
2,4,15,4,2,568,1089,-521
2,4,16,4,2,573,1162,-589
2,4,17,4,2,620,1065,-445
2,4,18,4,2,731,954,-223
2,4,19,4,2,794,949,-155
2,4,20,4,2,820,917,-97
2,4,21,4,2,877,905,-28
2,4,22,4,2,915,940,-25
2,5,0,4,2,1002,860,142
2,5,1,4,2,952,683,269
2,5,2,4,2,775,691,84
2,5,3,4,2,650,1047,-397
2,5,4,4,2,657,1228,-571
2,5,5,4,2,695,1152,-457
2,5,6,4,2,676,1281,-605
2,5,7,4,2,683,1332,-649
2,5,8,4,2,728,1112,-384
2,5,9,4,2,731,927,-196
2,5,10,4,2,733,917,-184
2,5,11,4,2,749,934,-185
2,5,12,4,2,757,957,-200
2,5,13,4,2,746,909,-163
2,5,14,4,2,736,968,-232
2,5,15,4,2,733,1227,-494
2,5,16,4,2,704,1386,-682
2,5,17,4,2,699,1243,-544
2,5,18,4,2,724,1154,-430
2,5,19,4,2,748,1197,-449
2,5,20,4,2,822,1105,-283
2,5,21,4,2,900,1055,-155
2,5,22,4,2,941,1021,-80
2,6,0,4,2,941,990,-49
2,6,1,4,2,848,814,34
2,6,2,4,2,648,812,-164
2,6,3,4,2,490,1273,-783
2,6,4,4,2,519,1572,-1053
2,6,5,4,2,616,1476,-860
2,6,6,4,2,679,1573,-894
2,6,7,4,2,706,1683,-977
2,6,8,4,2,696,1356,-660
2,6,9,4,2,666,1063,-397
2,6,10,4,2,666,1051,-385
2,6,11,4,2,694,1062,-368
2,6,12,4,2,694,1096,-402
2,6,13,4,2,671,1041,-370
2,6,14,4,2,685,1136,-451
2,6,15,4,2,724,1521,-797
2,6,16,4,2,716,1727,-1011
2,6,17,4,2,684,1554,-870
2,6,18,4,2,641,1480,-839
2,6,19,4,2,623,1489,-866
2,6,20,4,2,698,1359,-661
2,6,21,4,2,799,1304,-505
2,6,22,4,2,894,1173,-279
2,7,0,4,2,845,1163,-318
2,7,1,4,2,719,994,-275
2,7,2,4,2,586,913,-327
2,7,3,4,2,538,1347,-809
2,7,4,4,2,616,1736,-1120
2,7,5,4,2,708,1632,-924
2,7,6,4,2,834,1667,-833
2,7,7,4,2,878,1851,-973
2,7,8,4,2,828,1422,-594
2,7,9,4,2,788,1030,-242
2,7,10,4,2,779,1020,-241
2,7,11,4,2,800,1020,-220
2,7,12,4,2,813,1060,-247
2,7,13,4,2,790,1001,-211
2,7,14,4,2,802,1142,-340
2,7,15,4,2,853,1643,-790
2,7,16,4,2,867,1854,-987
2,7,17,4,2,808,1703,-895
2,7,18,4,2,715,1691,-976
2,7,19,4,2,674,1620,-946
2,7,20,4,2,691,1510,-819
2,7,21,4,2,757,1519,-762
2,7,22,4,2,868,1323,-455
2,8,0,4,2,829,1239,-410
2,8,1,4,2,694,1080,-386
2,8,2,4,2,660,926,-266
2,8,3,4,2,825,1297,-472
2,8,4,4,2,947,1765,-818
2,8,5,4,2,967,1648,-681
2,8,6,4,2,1100,1615,-515
2,8,7,4,2,1124,1880,-756
2,8,8,4,2,1031,1349,-318
2,8,9,4,2,967,859,108
2,8,10,4,2,955,860,95
2,8,11,4,2,971,850,121
2,8,12,4,2,1007,866,141
2,8,13,4,2,979,795,184
2,8,14,4,2,982,1015,-33
2,8,15,4,2,1089,1627,-538
2,8,16,4,2,1162,1802,-640
2,8,17,4,2,1065,1701,-636
2,8,18,4,2,954,1766,-812
2,8,19,4,2,949,1568,-619
2,8,20,4,2,917,1475,-558
2,8,21,4,2,905,1561,-656
2,8,22,4,2,940,1343,-403
2,9,0,4,2,860,1163,-303
2,9,1,4,2,683,1018,-335
2,9,2,4,2,691,890,-199
2,9,3,4,2,1047,1272,-225
2,9,4,4,2,1228,1795,-567
2,9,5,4,2,1152,1613,-461
2,9,6,4,2,1281,1556,-275
2,9,7,4,2,1332,1911,-579
2,9,8,4,2,1112,1352,-240
2,9,9,4,2,927,858,69
2,9,10,4,2,917,842,75
2,9,11,4,2,934,825,109
2,9,12,4,2,957,863,94
2,9,13,4,2,909,791,118
2,9,14,4,2,968,1025,-57
2,9,15,4,2,1227,1645,-418
2,9,16,4,2,1386,1737,-351
2,9,17,4,2,1243,1622,-379
2,9,18,4,2,1154,1750,-596
2,9,19,4,2,1197,1501,-304
2,9,20,4,2,1105,1384,-279
2,9,21,4,2,1055,1450,-395
2,9,22,4,2,1021,1270,-249
2,10,0,4,2,990,1041,-51
2,10,1,4,2,814,887,-73
2,10,2,4,2,812,866,-54
2,10,3,4,2,1273,1315,-42
2,10,4,4,2,1572,1753,-181
2,10,5,4,2,1476,1493,-17
2,10,6,4,2,1573,1496,77
2,10,7,4,2,1683,1856,-173
2,10,8,4,2,1356,1270,86
2,10,9,4,2,1063,833,230
2,10,10,4,2,1051,820,231
2,10,11,4,2,1062,772,290
2,10,12,4,2,1096,823,273
2,10,13,4,2,1041,748,293
2,10,14,4,2,1136,978,158
2,10,15,4,2,1521,1621,-100
2,10,16,4,2,1727,1674,53
2,10,17,4,2,1554,1423,131
2,10,18,4,2,1480,1554,-74
2,10,19,4,2,1489,1445,44
2,10,20,4,2,1359,1359,0
2,10,21,4,2,1304,1324,-20
2,10,22,4,2,1173,1187,-14
2,11,0,4,2,1163,934,229
2,11,1,4,2,994,771,223
2,11,2,4,2,913,889,24
2,11,3,4,2,1347,1439,-92
2,11,4,4,2,1736,1740,-4
2,11,5,4,2,1632,1344,288
2,11,6,4,2,1667,1319,348
2,11,7,4,2,1851,1629,222
2,11,8,4,2,1422,1119,303
2,11,9,4,2,1030,754,276
2,11,10,4,2,1020,759,261
2,11,11,4,2,1020,761,259
2,11,12,4,2,1060,784,276
2,11,13,4,2,1001,710,291
2,11,14,4,2,1142,904,238
2,11,15,4,2,1643,1374,269
2,11,16,4,2,1854,1478,376
2,11,17,4,2,1703,1244,459
2,11,18,4,2,1691,1309,382
2,11,19,4,2,1620,1404,216
2,11,20,4,2,1510,1375,135
2,11,21,4,2,1519,1173,346
2,11,22,4,2,1323,1034,289
2,12,0,4,2,1239,899,340
2,12,1,4,2,1080,689,391
2,12,2,4,2,926,1001,-75
2,12,3,4,2,1297,1477,-180
2,12,4,4,2,1765,1493,272
2,12,5,4,2,1648,1082,566
2,12,6,4,2,1615,1089,526
2,12,7,4,2,1880,1440,440
2,12,8,4,2,1349,1108,241
2,12,9,4,2,859,834,25
2,12,10,4,2,860,836,24
2,12,11,4,2,850,851,-1
2,12,12,4,2,866,902,-36
2,12,13,4,2,795,799,-4
2,12,14,4,2,1015,833,182
2,12,15,4,2,1627,1212,415
2,12,16,4,2,1802,1448,354
2,12,17,4,2,1701,1103,598
2,12,18,4,2,1766,971,795
2,12,19,4,2,1568,1272,296
2,12,20,4,2,1475,1284,191
2,12,21,4,2,1561,942,619
2,12,22,4,2,1343,982,361
2,13,0,4,2,1163,943,220
2,13,1,4,2,1018,644,374
2,13,2,4,2,890,1105,-215
2,13,3,4,2,1272,1466,-194
2,13,4,4,2,1795,1165,630
2,13,5,4,2,1613,819,794
2,13,6,4,2,1556,963,593
2,13,7,4,2,1911,1376,535
2,13,8,4,2,1352,1138,214
2,13,9,4,2,858,895,-37
2,13,10,4,2,842,898,-56
2,13,11,4,2,825,902,-77
2,13,12,4,2,863,961,-98
2,13,13,4,2,791,819,-28
2,13,14,4,2,1025,720,305
2,13,15,4,2,1645,997,648
2,13,16,4,2,1737,1282,455
2,13,17,4,2,1622,912,710
2,13,18,4,2,1750,690,1060
2,13,19,4,2,1501,1139,362
2,13,20,4,2,1384,1168,216
2,13,21,4,2,1450,757,693
2,13,22,4,2,1270,991,279
2,14,0,4,2,1041,1035,6
2,14,1,4,2,887,667,220
2,14,2,4,2,866,1220,-354
2,14,3,4,2,1315,1410,-95
2,14,4,4,2,1753,861,892
2,14,5,4,2,1493,606,887
2,14,6,4,2,1496,762,734
2,14,7,4,2,1856,1178,678
2,14,8,4,2,1270,1057,213
2,14,9,4,2,833,781,52
2,14,10,4,2,820,791,29
2,14,11,4,2,772,884,-112
2,14,12,4,2,823,919,-96
2,14,13,4,2,748,735,13
2,14,14,4,2,978,598,380
2,14,15,4,2,1621,713,908
2,14,16,4,2,1674,992,682
2,14,17,4,2,1423,801,622
2,14,18,4,2,1554,594,960
2,14,19,4,2,1445,990,455
2,14,20,4,2,1359,1018,341
2,14,21,4,2,1324,683,641
2,14,22,4,2,1187,1012,175
2,15,0,4,2,934,992,-58
2,15,1,4,2,771,649,122
2,15,2,4,2,889,1156,-267
2,15,3,4,2,1439,1148,291
2,15,4,4,2,1740,521,1219
2,15,5,4,2,1344,440,904
2,15,6,4,2,1319,705,614
2,15,7,4,2,1629,1184,445
2,15,8,4,2,1119,1072,47
2,15,9,4,2,754,752,2
2,15,10,4,2,759,763,-4
2,15,11,4,2,761,870,-109
2,15,12,4,2,784,936,-152
2,15,13,4,2,710,673,37
2,15,14,4,2,904,544,360
2,15,15,4,2,1374,774,600
2,15,16,4,2,1478,949,529
2,15,17,4,2,1244,660,584
2,15,18,4,2,1309,474,835
2,15,19,4,2,1404,771,633
2,15,20,4,2,1375,756,619
2,15,21,4,2,1173,546,627
2,15,22,4,2,1034,920,114
2,16,0,4,2,899,892,7
2,16,1,4,2,689,578,111
2,16,2,4,2,1001,941,60
2,16,3,4,2,1477,922,555
2,16,4,4,2,1493,445,1048
2,16,5,4,2,1082,401,681
2,16,6,4,2,1089,662,427
2,16,7,4,2,1440,1104,336
2,16,8,4,2,1108,986,122
2,16,9,4,2,834,624,210
2,16,10,4,2,836,589,247
2,16,11,4,2,851,773,78
2,16,12,4,2,902,843,59
2,16,13,4,2,799,588,211
2,16,14,4,2,833,555,278
2,16,15,4,2,1212,722,490
2,16,16,4,2,1448,727,721
2,16,17,4,2,1103,492,611
2,16,18,4,2,971,454,517
2,16,19,4,2,1272,655,617
2,16,20,4,2,1284,587,697
2,16,21,4,2,942,500,442
2,16,22,4,2,982,766,216
2,0,0,5,2,1117,1177,-60
2,0,1,5,2,1108,1090,18
2,0,2,5,2,1070,887,183
2,0,3,5,2,1102,734,368
2,0,4,5,2,1133,753,380
2,0,5,5,2,1082,794,288
2,0,6,5,2,1042,787,255
2,0,7,5,2,975,814,161
2,0,8,5,2,895,833,62
2,0,9,5,2,871,801,70
2,0,10,5,2,849,798,51
2,0,11,5,2,837,824,13
2,0,12,5,2,840,824,16
2,0,13,5,2,854,801,53
2,0,14,5,2,869,816,53
2,0,15,5,2,917,845,72
2,0,16,5,2,971,829,142
2,0,17,5,2,1038,823,215
2,0,18,5,2,1107,829,278
2,0,19,5,2,1085,846,239
2,0,20,5,2,1062,933,129
2,0,21,5,2,1100,1036,64
2,0,22,5,2,1093,1120,-27
2,1,0,5,2,1136,1089,47
2,1,1,5,2,1147,952,195
2,1,2,5,2,1115,784,331
2,1,3,5,2,1137,714,423
2,1,4,5,2,1145,785,360
2,1,5,5,2,1045,857,188
2,1,6,5,2,940,959,-19
2,1,7,5,2,873,1005,-132
2,1,8,5,2,825,966,-141
2,1,9,5,2,801,926,-125
2,1,10,5,2,777,917,-140
2,1,11,5,2,763,938,-175
2,1,12,5,2,765,951,-186
2,1,13,5,2,777,927,-150
2,1,14,5,2,791,938,-147
2,1,15,5,2,835,998,-163
2,1,16,5,2,884,1010,-126
2,1,17,5,2,965,945,20
2,1,18,5,2,1077,873,204
2,1,19,5,2,1102,858,244
2,1,20,5,2,1096,895,201
2,1,21,5,2,1125,980,145
2,1,22,5,2,1108,1099,9
2,2,0,5,2,1163,1084,79
2,2,1,5,2,1162,909,253
2,2,2,5,2,1100,799,301
2,2,3,5,2,1095,914,181
2,2,4,5,2,1094,1044,50
2,2,5,5,2,984,1106,-122
2,2,6,5,2,856,1287,-431
2,2,7,5,2,785,1324,-539
2,2,8,5,2,749,1222,-473
2,2,9,5,2,729,1160,-431
2,2,10,5,2,708,1151,-443
2,2,11,5,2,695,1169,-474
2,2,12,5,2,696,1204,-508
2,2,13,5,2,705,1174,-469
2,2,14,5,2,715,1175,-460
2,2,15,5,2,758,1284,-526
2,2,16,5,2,805,1345,-540
2,2,17,5,2,891,1228,-337
2,2,18,5,2,1029,1110,-81
2,2,19,5,2,1083,1098,-15
2,2,20,5,2,1088,1073,15
2,2,21,5,2,1123,1099,24
2,2,22,5,2,1123,1175,-52
2,3,0,5,2,1197,1127,70
2,3,1,5,2,1150,945,205
2,3,2,5,2,1020,890,130
2,3,3,5,2,967,1188,-221
2,3,4,5,2,973,1385,-412
2,3,5,5,2,907,1381,-474
2,3,6,5,2,817,1537,-720
2,3,7,5,2,752,1580,-828
2,3,8,5,2,712,1374,-662
2,3,9,5,2,700,1192,-492
2,3,10,5,2,688,1184,-496
2,3,11,5,2,680,1217,-537
2,3,12,5,2,679,1249,-570
2,3,13,5,2,682,1193,-511
2,3,14,5,2,687,1244,-557
2,3,15,5,2,725,1499,-774
2,3,16,5,2,762,1651,-889
2,3,17,5,2,836,1503,-667
2,3,18,5,2,969,1376,-407
2,3,19,5,2,1022,1389,-367
2,3,20,5,2,1031,1332,-301
2,3,21,5,2,1092,1301,-209
2,3,22,5,2,1137,1270,-133
2,4,0,5,2,1235,1165,70
2,4,1,5,2,1185,952,233
2,4,2,5,2,1004,924,80
2,4,3,5,2,891,1357,-466
2,4,4,5,2,903,1668,-765
2,4,5,5,2,909,1575,-666
2,4,6,5,2,846,1684,-838
2,4,7,5,2,813,1814,-1001
2,4,8,5,2,833,1461,-628
2,4,9,5,2,830,1133,-303
2,4,10,5,2,826,1116,-290
2,4,11,5,2,838,1137,-299
2,4,12,5,2,846,1163,-317
2,4,13,5,2,838,1096,-258
2,4,14,5,2,831,1216,-385
2,4,15,5,2,840,1633,-793
2,4,16,5,2,838,1852,-1014
2,4,17,5,2,880,1678,-798
2,4,18,5,2,953,1585,-632
2,4,19,5,2,986,1587,-601
2,4,20,5,2,1047,1470,-423
2,4,21,5,2,1123,1440,-317
2,4,22,5,2,1164,1352,-188
2,5,0,5,2,1177,1311,-134
2,5,1,5,2,1090,1098,-8
2,5,2,5,2,887,1049,-162
2,5,3,5,2,734,1571,-837
2,5,4,5,2,753,2002,-1249
2,5,5,5,2,794,1873,-1079
2,5,6,5,2,787,1947,-1160
2,5,7,5,2,814,2150,-1336
2,5,8,5,2,833,1692,-859
2,5,9,5,2,801,1290,-489
2,5,10,5,2,798,1271,-473
2,5,11,5,2,824,1264,-440
2,5,12,5,2,824,1317,-493
2,5,13,5,2,801,1257,-456
2,5,14,5,2,816,1395,-579
2,5,15,5,2,845,1917,-1072
2,5,16,5,2,829,2148,-1319
2,5,17,5,2,823,1964,-1141
2,5,18,5,2,829,1923,-1094
2,5,19,5,2,846,1855,-1009
2,5,20,5,2,933,1707,-774
2,5,21,5,2,1036,1700,-664
2,5,22,5,2,1120,1528,-408
2,6,0,5,2,1089,1478,-389
2,6,1,5,2,952,1270,-318
2,6,2,5,2,784,1139,-355
2,6,3,5,2,714,1673,-959
2,6,4,5,2,785,2193,-1408
2,6,5,5,2,857,2046,-1189
2,6,6,5,2,959,2068,-1109
2,6,7,5,2,1005,2326,-1321
2,6,8,5,2,966,1743,-777
2,6,9,5,2,926,1231,-305
2,6,10,5,2,917,1232,-315
2,6,11,5,2,938,1219,-281
2,6,12,5,2,951,1257,-306
2,6,13,5,2,927,1179,-252
2,6,14,5,2,938,1388,-450
2,6,15,5,2,998,2058,-1060
2,6,16,5,2,1010,2280,-1270
2,6,17,5,2,945,2121,-1176
2,6,18,5,2,873,2161,-1288
2,6,19,5,2,858,1992,-1134
2,6,20,5,2,895,1857,-962
2,6,21,5,2,980,1903,-923
2,6,22,5,2,1099,1650,-551
2,7,0,5,2,1084,1461,-377
2,7,1,5,2,909,1269,-360
2,7,2,5,2,799,1120,-321
2,7,3,5,2,914,1635,-721
2,7,4,5,2,1044,2233,-1189
2,7,5,5,2,1106,2027,-921
2,7,6,5,2,1287,1993,-706
2,7,7,5,2,1324,2367,-1043
2,7,8,5,2,1222,1695,-473
2,7,9,5,2,1160,1083,77
2,7,10,5,2,1151,1071,80
2,7,11,5,2,1169,1071,98
2,7,12,5,2,1204,1105,99
2,7,13,5,2,1174,1005,169
2,7,14,5,2,1175,1287,-112
2,7,15,5,2,1284,2055,-771
2,7,16,5,2,1345,2226,-881
2,7,17,5,2,1228,2060,-832
2,7,18,5,2,1110,2172,-1062
2,7,19,5,2,1098,1941,-843
2,7,20,5,2,1073,1799,-726
2,7,21,5,2,1099,1846,-747
2,7,22,5,2,1175,1600,-425
2,8,0,5,2,1127,1346,-219
2,8,1,5,2,945,1156,-211
2,8,2,5,2,890,1099,-209
2,8,3,5,2,1188,1625,-437
2,8,4,5,2,1385,2193,-808
2,8,5,5,2,1381,1916,-535
2,8,6,5,2,1537,1899,-362
2,8,7,5,2,1580,2338,-758
2,8,8,5,2,1374,1619,-245
2,8,9,5,2,1192,1039,153
2,8,10,5,2,1184,1019,165
2,8,11,5,2,1217,975,242
2,8,12,5,2,1249,1029,220
2,8,13,5,2,1193,935,258
2,8,14,5,2,1244,1226,18
2,8,15,5,2,1499,2027,-528
2,8,16,5,2,1651,2140,-489
2,8,17,5,2,1503,1858,-355
2,8,18,5,2,1376,1985,-609
2,8,19,5,2,1389,1835,-446
2,8,20,5,2,1332,1724,-392
2,8,21,5,2,1301,1709,-408
2,8,22,5,2,1270,1518,-248
2,9,0,5,2,1165,1255,-90
2,9,1,5,2,952,1055,-103
2,9,2,5,2,924,1126,-202
2,9,3,5,2,1357,1737,-380
2,9,4,5,2,1668,2170,-502
2,9,5,5,2,1575,1741,-166
2,9,6,5,2,1684,1693,-9
2,9,7,5,2,1814,2096,-282
2,9,8,5,2,1461,1455,6
2,9,9,5,2,1133,981,152
2,9,10,5,2,1116,979,137
2,9,11,5,2,1137,963,174
2,9,12,5,2,1163,1005,158
2,9,13,5,2,1096,926,170
2,9,14,5,2,1216,1163,53
2,9,15,5,2,1633,1770,-137
2,9,16,5,2,1852,1899,-47
2,9,17,5,2,1678,1654,24
2,9,18,5,2,1585,1752,-167
2,9,19,5,2,1587,1770,-183
2,9,20,5,2,1470,1723,-253
2,9,21,5,2,1440,1569,-129
2,9,22,5,2,1352,1389,-37
2,10,0,5,2,1311,1214,97
2,10,1,5,2,1098,965,133
2,10,2,5,2,1049,1227,-178
2,10,3,5,2,1571,1803,-232
2,10,4,5,2,2002,1950,52
2,10,5,5,2,1873,1496,377
2,10,6,5,2,1947,1490,457
2,10,7,5,2,2150,1915,235
2,10,8,5,2,1692,1429,263
2,10,9,5,2,1290,1035,255
2,10,10,5,2,1271,1048,223
2,10,11,5,2,1264,1050,214
2,10,12,5,2,1317,1099,218
2,10,13,5,2,1257,977,280
2,10,14,5,2,1395,1079,316
2,10,15,5,2,1917,1627,290
2,10,16,5,2,2148,1874,274
2,10,17,5,2,1964,1521,443
2,10,18,5,2,1923,1441,482
2,10,19,5,2,1855,1644,211
2,10,20,5,2,1707,1631,76
2,10,21,5,2,1700,1326,374
2,10,22,5,2,1528,1309,219
2,11,0,5,2,1478,1165,313
2,11,1,5,2,1270,833,437
2,11,2,5,2,1139,1299,-160
2,11,3,5,2,1673,1804,-131
2,11,4,5,2,2193,1633,560
2,11,5,5,2,2046,1198,848
2,11,6,5,2,2068,1341,727
2,11,7,5,2,2326,1863,463
2,11,8,5,2,1743,1484,259
2,11,9,5,2,1231,1119,112
2,11,10,5,2,1232,1109,123
2,11,11,5,2,1219,1123,96
2,11,12,5,2,1257,1200,57
2,11,13,5,2,1179,1029,150
2,11,14,5,2,1388,992,396
2,11,15,5,2,2058,1425,633
2,11,16,5,2,2280,1706,574
2,11,17,5,2,2121,1271,850
2,11,18,5,2,2161,1096,1065
2,11,19,5,2,1992,1512,480
2,11,20,5,2,1857,1492,365
2,11,21,5,2,1903,1042,861
2,11,22,5,2,1650,1248,402
2,12,0,5,2,1461,1218,243
2,12,1,5,2,1269,805,464
2,12,2,5,2,1120,1429,-309
2,12,3,5,2,1635,1763,-128
2,12,4,5,2,2233,1259,974
2,12,5,5,2,2027,909,1118
2,12,6,5,2,1993,1105,888
2,12,7,5,2,2367,1605,762
2,12,8,5,2,1695,1324,371
2,12,9,5,2,1083,962,121
2,12,10,5,2,1071,968,103
2,12,11,5,2,1071,1034,37
2,12,12,5,2,1105,1085,20
2,12,13,5,2,1005,879,126
2,12,14,5,2,1287,799,488
2,12,15,5,2,2055,1095,960
2,12,16,5,2,2226,1395,831
2,12,17,5,2,2060,1037,1023
2,12,18,5,2,2172,829,1343
2,12,19,5,2,1941,1324,617
2,12,20,5,2,1799,1358,441
2,12,21,5,2,1846,942,904
2,12,22,5,2,1600,1260,340
2,13,0,5,2,1346,1206,140
2,13,1,5,2,1156,817,339
2,13,2,5,2,1099,1416,-317
2,13,3,5,2,1625,1570,55
2,13,4,5,2,2193,938,1255
2,13,5,5,2,1916,688,1228
2,13,6,5,2,1899,902,997
2,13,7,5,2,2338,1424,914
2,13,8,5,2,1619,1257,362
2,13,9,5,2,1039,900,139
2,13,10,5,2,1019,922,97
2,13,11,5,2,975,1061,-86
2,13,12,5,2,1029,1118,-89
2,13,13,5,2,935,851,84
2,13,14,5,2,1226,729,497
2,13,15,5,2,2027,923,1104
2,13,16,5,2,2140,1174,966
2,13,17,5,2,1858,891,967
2,13,18,5,2,1985,672,1313
2,13,19,5,2,1835,1096,739
2,13,20,5,2,1724,1120,604
2,13,21,5,2,1709,791,918
2,13,22,5,2,1518,1122,396
2,14,0,5,2,1255,1172,83
2,14,1,5,2,1055,772,283
2,14,2,5,2,1126,1279,-153
2,14,3,5,2,1737,1286,451
2,14,4,5,2,2170,655,1515
2,14,5,5,2,1741,553,1188
2,14,6,5,2,1693,833,860
2,14,7,5,2,2096,1390,706
2,14,8,5,2,1455,1296,159
2,14,9,5,2,981,905,76
2,14,10,5,2,979,878,101
2,14,11,5,2,963,1062,-99
2,14,12,5,2,1005,1158,-153
2,14,13,5,2,926,855,71
2,14,14,5,2,1163,730,433
2,14,15,5,2,1770,975,795
2,14,16,5,2,1899,1123,776
2,14,17,5,2,1654,769,885
2,14,18,5,2,1752,586,1166
2,14,19,5,2,1770,895,875
2,14,20,5,2,1723,843,880
2,14,21,5,2,1569,653,916
2,14,22,5,2,1389,1041,348
2,0,0,6,2,1353,1328,25
2,0,1,6,2,1350,1142,208
2,0,2,6,2,1309,997,312
2,0,3,6,2,1346,1090,256
2,0,4,6,2,1367,1213,154
2,0,5,6,2,1260,1255,5
2,0,6,6,2,1150,1412,-262
2,0,7,6,2,1083,1451,-368
2,0,8,6,2,1032,1360,-328
2,0,9,6,2,1006,1298,-292
2,0,10,6,2,981,1289,-308
2,0,11,6,2,967,1307,-340
2,0,12,6,2,970,1342,-372
2,0,13,6,2,984,1311,-327
2,0,14,6,2,1000,1311,-311
2,0,15,6,2,1038,1429,-391
2,0,16,6,2,1084,1488,-404
2,0,17,6,2,1177,1365,-188
2,0,18,6,2,1295,1268,27
2,0,19,6,2,1308,1282,26
2,0,20,6,2,1297,1277,20
2,0,21,6,2,1337,1322,15
2,0,22,6,2,1319,1406,-87
2,1,0,6,2,1380,1382,-2
2,1,1,6,2,1380,1160,220
2,1,2,6,2,1313,1029,284
2,1,3,6,2,1313,1277,36
2,1,4,6,2,1314,1482,-168
2,1,5,6,2,1194,1520,-326
2,1,6,6,2,1065,1724,-659
2,1,7,6,2,1000,1780,-780
2,1,8,6,2,963,1565,-602
2,1,9,6,2,939,1385,-446
2,1,10,6,2,915,1380,-465
2,1,11,6,2,901,1415,-514
2,1,12,6,2,903,1446,-543
2,1,13,6,2,914,1388,-474
2,1,14,6,2,927,1437,-510
2,1,15,6,2,980,1694,-714
2,1,16,6,2,1027,1834,-807
2,1,17,6,2,1102,1666,-564
2,1,18,6,2,1235,1532,-297
2,1,19,6,2,1286,1538,-252
2,1,20,6,2,1300,1488,-188
2,1,21,6,2,1348,1495,-147
2,1,22,6,2,1339,1505,-166
2,2,0,6,2,1418,1432,-14
2,2,1,6,2,1377,1214,163
2,2,2,6,2,1239,1123,116
2,2,3,6,2,1184,1498,-314
2,2,4,6,2,1191,1825,-634
2,2,5,6,2,1123,1804,-681
2,2,6,6,2,1043,1940,-897
2,2,7,6,2,985,2062,-1077
2,2,8,6,2,940,1723,-783
2,2,9,6,2,922,1398,-476
2,2,10,6,2,904,1383,-479
2,2,11,6,2,893,1420,-527
2,2,12,6,2,893,1455,-562
2,2,13,6,2,900,1380,-480
2,2,14,6,2,908,1492,-584
2,2,15,6,2,953,1905,-952
2,2,16,6,2,988,2117,-1129
2,2,17,6,2,1054,1938,-884
2,2,18,6,2,1185,1807,-622
2,2,19,6,2,1232,1779,-547
2,2,20,6,2,1244,1697,-453
2,2,21,6,2,1317,1686,-369
2,2,22,6,2,1358,1601,-243
2,3,0,6,2,1464,1486,-22
2,3,1,6,2,1412,1236,176
2,3,2,6,2,1219,1161,58
2,3,3,6,2,1108,1655,-547
2,3,4,6,2,1130,2098,-968
2,3,5,6,2,1136,1972,-836
2,3,6,6,2,1073,2058,-985
2,3,7,6,2,1000,2281,-1281
2,3,8,6,2,974,1797,-823
2,3,9,6,2,965,1360,-395
2,3,10,6,2,955,1336,-381
2,3,11,6,2,963,1339,-376
2,3,12,6,2,971,1384,-413
2,3,13,6,2,966,1312,-346
2,3,14,6,2,963,1475,-512
2,3,15,6,2,997,2029,-1032
2,3,16,6,2,1027,2273,-1246
2,3,17,6,2,1096,2088,-992
2,3,18,6,2,1191,2028,-837
2,3,19,6,2,1214,1953,-739
2,3,20,6,2,1258,1818,-560
2,3,21,6,2,1338,1836,-498
2,3,22,6,2,1386,1707,-321
2,4,0,6,2,1410,1626,-216
2,4,1,6,2,1323,1374,-51
2,4,2,6,2,1116,1275,-159
2,4,3,6,2,975,1897,-922
2,4,4,6,2,999,2459,-1460
2,4,5,6,2,1008,2287,-1279
2,4,6,6,2,957,2348,-1391
2,4,7,6,2,944,2625,-1681
2,4,8,6,2,938,2013,-1075
2,4,9,6,2,900,1491,-591
2,4,10,6,2,891,1483,-592
2,4,11,6,2,913,1463,-550
2,4,12,6,2,913,1514,-601
2,4,13,6,2,893,1435,-542
2,4,14,6,2,911,1641,-730
2,4,15,6,2,952,2332,-1380
2,4,16,6,2,963,2574,-1611
2,4,17,6,2,1004,2382,-1378
2,4,18,6,2,1058,2393,-1335
2,4,19,6,2,1084,2227,-1143
2,4,20,6,2,1158,2054,-896
2,4,21,6,2,1259,2084,-825
2,4,22,6,2,1343,1855,-512
2,5,0,6,2,1325,1700,-375
2,5,1,6,2,1194,1459,-265
2,5,2,6,2,1023,1333,-310
2,5,3,6,2,958,2011,-1053
2,5,4,6,2,1019,2661,-1642
2,5,5,6,2,1035,2425,-1390
2,5,6,6,2,1067,2446,-1379
2,5,7,6,2,1113,2813,-1700
2,5,8,6,2,1103,2089,-986
2,5,9,6,2,1061,1455,-394
2,5,10,6,2,1049,1443,-394
2,5,11,6,2,1068,1440,-372
2,5,12,6,2,1081,1496,-415
2,5,13,6,2,1057,1389,-332
2,5,14,6,2,1069,1660,-591
2,5,15,6,2,1119,2486,-1367
2,5,16,6,2,1123,2704,-1581
2,5,17,6,2,1084,2480,-1396
2,5,18,6,2,1061,2567,-1506
2,5,19,6,2,1081,2365,-1284
2,5,20,6,2,1130,2181,-1051
2,5,21,6,2,1217,2188,-971
2,5,22,6,2,1325,1907,-582
2,6,0,6,2,1328,1644,-316
2,6,1,6,2,1142,1407,-265
2,6,2,6,2,997,1329,-332
2,6,3,6,2,1090,1988,-898
2,6,4,6,2,1213,2631,-1418
2,6,5,6,2,1255,2330,-1075
2,6,6,6,2,1412,2336,-924
2,6,7,6,2,1451,2794,-1343
2,6,8,6,2,1360,1962,-602
2,6,9,6,2,1298,1264,34
2,6,10,6,2,1289,1248,41
2,6,11,6,2,1307,1221,86
2,6,12,6,2,1342,1271,71
2,6,13,6,2,1311,1149,162
2,6,14,6,2,1311,1488,-177
2,6,15,6,2,1429,2437,-1008
2,6,16,6,2,1488,2629,-1141
2,6,17,6,2,1365,2296,-931
2,6,18,6,2,1268,2407,-1139
2,6,19,6,2,1282,2275,-993
2,6,20,6,2,1277,2139,-862
2,6,21,6,2,1322,2105,-783
2,6,22,6,2,1406,1848,-442
2,7,0,6,2,1382,1560,-178
2,7,1,6,2,1160,1324,-164
2,7,2,6,2,1029,1359,-330
2,7,3,6,2,1277,2047,-770
2,7,4,6,2,1482,2610,-1128
2,7,5,6,2,1520,2164,-644
2,7,6,6,2,1724,2096,-372
2,7,7,6,2,1780,2578,-798
2,7,8,6,2,1565,1804,-239
2,7,9,6,2,1385,1187,198
2,7,10,6,2,1380,1178,202
2,7,11,6,2,1415,1166,249
2,7,12,6,2,1446,1211,235
2,7,13,6,2,1388,1113,275
2,7,14,6,2,1437,1411,26
2,7,15,6,2,1694,2176,-482
2,7,16,6,2,1834,2365,-531
2,7,17,6,2,1666,2089,-423
2,7,18,6,2,1532,2183,-651
2,7,19,6,2,1538,2160,-622
2,7,20,6,2,1488,2088,-600
2,7,21,6,2,1495,1954,-459
2,7,22,6,2,1505,1720,-215
2,8,0,6,2,1432,1535,-103
2,8,1,6,2,1214,1249,-35
2,8,2,6,2,1123,1464,-341
2,8,3,6,2,1498,2101,-603
2,8,4,6,2,1825,2380,-555
2,8,5,6,2,1804,1893,-89
2,8,6,6,2,1940,1864,76
2,8,7,6,2,2062,2382,-320
2,8,8,6,2,1723,1765,-42
2,8,9,6,2,1398,1262,136
2,8,10,6,2,1383,1268,115
2,8,11,6,2,1420,1252,168
2,8,12,6,2,1455,1320,135
2,8,13,6,2,1380,1193,187
2,8,14,6,2,1492,1338,154
2,8,15,6,2,1905,2023,-118
2,8,16,6,2,2117,2295,-178
2,8,17,6,2,1938,1931,7
2,8,18,6,2,1807,1884,-77
2,8,19,6,2,1779,2010,-231
2,8,20,6,2,1697,1979,-282
2,8,21,6,2,1686,1722,-36
2,8,22,6,2,1601,1664,-63
2,9,0,6,2,1486,1480,6
2,9,1,6,2,1236,1109,127
2,9,2,6,2,1161,1525,-364
2,9,3,6,2,1655,2130,-475
2,9,4,6,2,2098,2090,8
2,9,5,6,2,1972,1612,360
2,9,6,6,2,2058,1742,316
2,9,7,6,2,2281,2338,-57
2,9,8,6,2,1797,1805,-8
2,9,9,6,2,1360,1320,40
2,9,10,6,2,1336,1321,15
2,9,11,6,2,1339,1322,17
2,9,12,6,2,1384,1397,-13
2,9,13,6,2,1312,1207,105
2,9,14,6,2,1475,1238,237
2,9,15,6,2,2029,1840,189
2,9,16,6,2,2273,2132,141
2,9,17,6,2,2088,1689,399
2,9,18,6,2,2028,1566,462
2,9,19,6,2,1953,1884,69
2,9,20,6,2,1818,1839,-21
2,9,21,6,2,1836,1426,410
2,9,22,6,2,1707,1575,132
2,10,0,6,2,1626,1440,186
2,10,1,6,2,1374,994,380
2,10,2,6,2,1275,1623,-348
2,10,3,6,2,1897,2101,-204
2,10,4,6,2,2459,1727,732
2,10,5,6,2,2287,1288,999
2,10,6,6,2,2348,1483,865
2,10,7,6,2,2625,2092,533
2,10,8,6,2,2013,1670,343
2,10,9,6,2,1491,1186,305
2,10,10,6,2,1483,1179,304
2,10,11,6,2,1463,1255,208
2,10,12,6,2,1514,1324,190
2,10,13,6,2,1435,1089,346
2,10,14,6,2,1641,1071,570
2,10,15,6,2,2332,1523,809
2,10,16,6,2,2574,1819,755
2,10,17,6,2,2382,1396,986
2,10,18,6,2,2393,1235,1158
2,10,19,6,2,2227,1697,530
2,10,20,6,2,2054,1682,372
2,10,21,6,2,2084,1227,857
2,10,22,6,2,1855,1517,338
2,11,0,6,2,1700,1389,311
2,11,1,6,2,1459,955,504
2,11,2,6,2,1333,1625,-292
2,11,3,6,2,2011,1923,88
2,11,4,6,2,2661,1336,1325
2,11,5,6,2,2425,991,1434
2,11,6,6,2,2446,1245,1201
2,11,7,6,2,2813,1851,962
2,11,8,6,2,2089,1524,565
2,11,9,6,2,1455,1081,374
2,11,10,6,2,1443,1099,344
2,11,11,6,2,1440,1211,229
2,11,12,6,2,1496,1284,212
2,11,13,6,2,1389,995,394
2,11,14,6,2,1660,930,730
2,11,15,6,2,2486,1305,1181
2,11,16,6,2,2704,1577,1127
2,11,17,6,2,2480,1127,1353
2,11,18,6,2,2567,907,1660
2,11,19,6,2,2365,1430,935
2,11,20,6,2,2181,1460,721
2,11,21,6,2,2188,1050,1138
2,11,22,6,2,1907,1370,537
2,12,0,6,2,1644,1386,258
2,12,1,6,2,1407,940,467
2,12,2,6,2,1329,1539,-210
2,12,3,6,2,1988,1708,280
2,12,4,6,2,2631,1072,1559
2,12,5,6,2,2330,801,1529
2,12,6,6,2,2336,1030,1306
2,12,7,6,2,2794,1630,1164
2,12,8,6,2,1962,1481,481
2,12,9,6,2,1264,1053,211
2,12,10,6,2,1248,1037,211
2,12,11,6,2,1221,1253,-32
2,12,12,6,2,1271,1340,-69
2,12,13,6,2,1149,1033,116
2,12,14,6,2,1488,915,573
2,12,15,6,2,2437,1124,1313
2,12,16,6,2,2629,1348,1281
2,12,17,6,2,2296,1000,1296
2,12,18,6,2,2407,784,1623
2,12,19,6,2,2275,1220,1055
2,12,20,6,2,2139,1207,932
2,12,21,6,2,2105,898,1207
2,12,22,6,2,1848,1243,605
2,0,0,7,2,1597,1687,-90
2,0,1,7,2,1583,1429,154
2,0,2,7,2,1507,1262,245
2,0,3,7,2,1522,1587,-65
2,0,4,7,2,1536,1922,-386
2,0,5,7,2,1409,1943,-534
2,0,6,7,2,1275,2127,-852
2,0,7,7,2,1210,2262,-1052
2,0,8,7,2,1170,1914,-744
2,0,9,7,2,1144,1591,-447
2,0,10,7,2,1119,1579,-460
2,0,11,7,2,1105,1618,-513
2,0,12,7,2,1108,1652,-544
2,0,13,7,2,1121,1575,-454
2,0,14,7,2,1136,1685,-549
2,0,15,7,2,1183,2100,-917
2,0,16,7,2,1227,2300,-1073
2,0,17,7,2,1314,2101,-787
2,0,18,7,2,1453,1963,-510
2,0,19,7,2,1492,1928,-436
2,0,20,7,2,1501,1853,-352
2,0,21,7,2,1560,1880,-320
2,0,22,7,2,1550,1836,-286
2,1,0,7,2,1635,1753,-118
2,1,1,7,2,1595,1498,97
2,1,2,7,2,1452,1360,92
2,1,3,7,2,1402,1796,-394
2,1,4,7,2,1411,2255,-844
2,1,5,7,2,1333,2201,-868
2,1,6,7,2,1252,2314,-1062
2,1,7,7,2,1200,2529,-1329
2,1,8,7,2,1154,2059,-905
2,1,9,7,2,1132,1625,-493
2,1,10,7,2,1111,1603,-492
2,1,11,7,2,1099,1622,-523
2,1,12,7,2,1100,1676,-576
2,1,13,7,2,1109,1596,-487
2,1,14,7,2,1120,1751,-631
2,1,15,7,2,1175,2301,-1126
2,1,16,7,2,1210,2538,-1328
2,1,17,7,2,1265,2348,-1083
2,1,18,7,2,1391,2250,-859
2,1,19,7,2,1435,2145,-710
2,1,20,7,2,1456,2045,-589
2,1,21,7,2,1542,2082,-540
2,1,22,7,2,1574,1956,-382
2,2,0,7,2,1685,1801,-116
2,2,1,7,2,1639,1512,127
2,2,2,7,2,1438,1387,51
2,2,3,7,2,1325,1981,-656
2,2,4,7,2,1348,2555,-1207
2,2,5,7,2,1352,2386,-1034
2,2,6,7,2,1299,2459,-1160
2,2,7,7,2,1233,2756,-1523
2,2,8,7,2,1202,2118,-916
2,2,9,7,2,1187,1561,-374
2,2,10,7,2,1171,1548,-377
2,2,11,7,2,1176,1538,-362
2,2,12,7,2,1185,1581,-396
2,2,13,7,2,1184,1490,-306
2,2,14,7,2,1184,1721,-537
2,2,15,7,2,1225,2444,-1219
2,2,16,7,2,1253,2699,-1446
2,2,17,7,2,1314,2506,-1192
2,2,18,7,2,1407,2498,-1091
2,2,19,7,2,1424,2325,-901
2,2,20,7,2,1471,2165,-694
2,2,21,7,2,1563,2220,-657
2,2,22,7,2,1607,2034,-427
2,3,0,7,2,1639,1848,-209
2,3,1,7,2,1550,1563,-13
2,3,2,7,2,1331,1469,-138
2,3,3,7,2,1192,2235,-1043
2,3,4,7,2,1226,2927,-1701
2,3,5,7,2,1235,2666,-1431
2,3,6,7,2,1184,2726,-1542
2,3,7,7,2,1131,3112,-1981
2,3,8,7,2,1079,2359,-1280
2,3,9,7,2,1035,1715,-680
2,3,10,7,2,1020,1694,-674
2,3,11,7,2,1038,1684,-646
2,3,12,7,2,1038,1753,-715
2,3,13,7,2,1021,1645,-624
2,3,14,7,2,1043,1913,-870
2,3,15,7,2,1109,2760,-1651
2,3,16,7,2,1152,2998,-1846
2,3,17,7,2,1220,2741,-1521
2,3,18,7,2,1296,2799,-1503
2,3,19,7,2,1312,2600,-1288
2,3,20,7,2,1369,2378,-1009
2,3,21,7,2,1474,2369,-895
2,3,22,7,2,1565,2112,-547
2,4,0,7,2,1558,1883,-325
2,4,1,7,2,1427,1597,-170
2,4,2,7,2,1252,1542,-290
2,4,3,7,2,1199,2364,-1165
2,4,4,7,2,1265,3059,-1794
2,4,5,7,2,1249,2728,-1479
2,4,6,7,2,1237,2789,-1552
2,4,7,7,2,1243,3240,-1997
2,4,8,7,2,1208,2356,-1148
2,4,9,7,2,1160,1636,-476
2,4,10,7,2,1142,1620,-478
2,4,11,7,2,1157,1590,-433
2,4,12,7,2,1170,1662,-492
2,4,13,7,2,1149,1533,-384
2,4,14,7,2,1164,1861,-697
2,4,15,7,2,1226,2868,-1642
2,4,16,7,2,1257,3107,-1850
2,4,17,7,2,1265,2716,-1451
2,4,18,7,2,1290,2802,-1512
2,4,19,7,2,1319,2699,-1380
2,4,20,7,2,1355,2521,-1166
2,4,21,7,2,1440,2447,-1007
2,4,22,7,2,1548,2155,-607
2,5,0,7,2,1564,1858,-294
2,5,1,7,2,1384,1575,-191
2,5,2,7,2,1236,1589,-353
2,5,3,7,2,1334,2410,-1076
2,5,4,7,2,1447,3048,-1601
2,5,5,7,2,1433,2578,-1145
2,5,6,7,2,1520,2533,-1013
2,5,7,7,2,1559,3034,-1475
2,5,8,7,2,1497,2147,-650
2,5,9,7,2,1433,1412,21
2,5,10,7,2,1421,1407,14
2,5,11,7,2,1437,1412,25
2,5,12,7,2,1472,1453,19
2,5,13,7,2,1441,1327,114
2,5,14,7,2,1442,1673,-231
2,5,15,7,2,1550,2586,-1036
2,5,16,7,2,1601,2854,-1253
2,5,17,7,2,1504,2527,-1023
2,5,18,7,2,1456,2605,-1149
2,5,19,7,2,1505,2600,-1095
2,5,20,7,2,1512,2503,-991
2,5,21,7,2,1559,2350,-791
2,5,22,7,2,1632,2050,-418
2,6,0,7,2,1626,1840,-214
2,6,1,7,2,1393,1518,-125
2,6,2,7,2,1227,1697,-470
2,6,3,7,2,1453,2411,-958
2,6,4,7,2,1651,2820,-1169
2,6,5,7,2,1669,2316,-647
2,6,6,7,2,1849,2267,-418
2,6,7,7,2,1907,2864,-957
2,6,8,7,2,1703,2114,-411
2,6,9,7,2,1523,1468,55
2,6,10,7,2,1518,1467,51
2,6,11,7,2,1553,1455,98
2,6,12,7,2,1584,1526,58
2,6,13,7,2,1525,1380,145
2,6,14,7,2,1573,1586,-13
2,6,15,7,2,1839,2429,-590
2,6,16,7,2,1977,2761,-784
2,6,17,7,2,1803,2366,-563
2,6,18,7,2,1690,2315,-625
2,6,19,7,2,1722,2400,-678
2,6,20,7,2,1692,2344,-652
2,6,21,7,2,1718,2107,-389
2,6,22,7,2,1736,1995,-259
2,7,0,7,2,1687,1801,-114
2,7,1,7,2,1429,1393,36
2,7,2,7,2,1262,1762,-500
2,7,3,7,2,1587,2428,-841
2,7,4,7,2,1922,2520,-598
2,7,5,7,2,1943,2009,-66
2,7,6,7,2,2127,2116,11
2,7,7,7,2,2262,2805,-543
2,7,8,7,2,1914,2141,-227
2,7,9,7,2,1591,1547,44
2,7,10,7,2,1579,1541,38
2,7,11,7,2,1618,1524,94
2,7,12,7,2,1652,1618,34
2,7,13,7,2,1575,1423,152
2,7,14,7,2,1685,1497,188
2,7,15,7,2,2100,2236,-136
2,7,16,7,2,2300,2553,-253
2,7,17,7,2,2101,2099,2
2,7,18,7,2,1963,2009,-46
2,7,19,7,2,1928,2250,-322
2,7,20,7,2,1853,2187,-334
2,7,21,7,2,1880,1822,58
2,7,22,7,2,1836,1930,-94
2,8,0,7,2,1753,1755,-2
2,8,1,7,2,1498,1270,228
2,8,2,7,2,1360,1849,-489
2,8,3,7,2,1796,2427,-631
2,8,4,7,2,2255,2184,71
2,8,5,7,2,2201,1702,499
2,8,6,7,2,2314,1884,430
2,8,7,7,2,2529,2567,-38
2,8,8,7,2,2059,1991,68
2,8,9,7,2,1625,1387,238
2,8,10,7,2,1603,1391,212
2,8,11,7,2,1622,1454,168
2,8,12,7,2,1676,1521,155
2,8,13,7,2,1596,1267,329
2,8,14,7,2,1751,1317,434
2,8,15,7,2,2301,1938,363
2,8,16,7,2,2538,2245,293
2,8,17,7,2,2348,1814,534
2,8,18,7,2,2250,1705,545
2,8,19,7,2,2145,2069,76
2,8,20,7,2,2045,2029,16
2,8,21,7,2,2082,1611,471
2,8,22,7,2,1956,1844,112
2,9,0,7,2,1801,1611,190
2,9,1,7,2,1512,1144,368
2,9,2,7,2,1387,1819,-432
2,9,3,7,2,1981,2261,-280
2,9,4,7,2,2555,1804,751
2,9,5,7,2,2386,1370,1016
2,9,6,7,2,2459,1623,836
2,9,7,7,2,2756,2338,418
2,9,8,7,2,2118,1870,248
2,9,9,7,2,1561,1305,256
2,9,10,7,2,1548,1310,238
2,9,11,7,2,1538,1432,106
2,9,12,7,2,1581,1523,58
2,9,13,7,2,1490,1205,285
2,9,14,7,2,1721,1202,519
2,9,15,7,2,2444,1733,711
2,9,16,7,2,2699,2001,698
2,9,17,7,2,2506,1486,1020
2,9,18,7,2,2498,1313,1185
2,9,19,7,2,2325,1803,522
2,9,20,7,2,2165,1784,381
2,9,21,7,2,2220,1335,885
2,9,22,7,2,2034,1627,407
2,10,0,7,2,1848,1569,279
2,10,1,7,2,1563,1078,485
2,10,2,7,2,1469,1748,-279
2,10,3,7,2,2235,2061,174
2,10,4,7,2,2927,1470,1457
2,10,5,7,2,2666,1104,1562
2,10,6,7,2,2726,1373,1353
2,10,7,7,2,3112,2057,1055
2,10,8,7,2,2359,1748,611
2,10,9,7,2,1715,1234,481
2,10,10,7,2,1694,1214,480
2,10,11,7,2,1684,1403,281
2,10,12,7,2,1753,1506,247
2,10,13,7,2,1645,1177,468
2,10,14,7,2,1913,1116,797
2,10,15,7,2,2760,1506,1254
2,10,16,7,2,2998,1751,1247
2,10,17,7,2,2741,1236,1505
2,10,18,7,2,2799,1019,1780
2,10,19,7,2,2600,1554,1046
2,10,20,7,2,2378,1547,831
2,10,21,7,2,2369,1157,1212
2,10,22,7,2,2112,1491,621
2,0,0,8,2,1852,2068,-216
2,0,1,8,2,1798,1774,24
2,0,2,8,2,1646,1586,60
2,0,3,8,2,1611,2122,-511
2,0,4,8,2,1633,2712,-1079
2,0,5,8,2,1548,2615,-1067
2,0,6,8,2,1462,2715,-1253
2,0,7,8,2,1410,3004,-1594
2,0,8,8,2,1361,2380,-1019
2,0,9,8,2,1337,1826,-489
2,0,10,8,2,1315,1815,-500
2,0,11,8,2,1303,1821,-518
2,0,12,8,2,1305,1873,-568
2,0,13,8,2,1316,1774,-458
2,0,14,8,2,1329,1997,-668
2,0,15,8,2,1378,2716,-1338
2,0,16,8,2,1410,2964,-1554
2,0,17,8,2,1477,2766,-1289
2,0,18,8,2,1609,2720,-1111
2,0,19,8,2,1641,2517,-876
2,0,20,8,2,1657,2392,-735
2,0,21,8,2,1754,2466,-712
2,0,22,8,2,1785,2283,-498
2,1,0,8,2,1902,2023,-121
2,1,1,8,2,1857,1701,156
2,1,2,8,2,1651,1581,70
2,1,3,8,2,1543,2319,-776
2,1,4,8,2,1568,3023,-1455
2,1,5,8,2,1562,2765,-1203
2,1,6,8,2,1508,2837,-1329
2,1,7,8,2,1448,3243,-1795
2,1,8,8,2,1416,2464,-1048
2,1,9,8,2,1397,1785,-388
2,1,10,8,2,1378,1759,-381
2,1,11,8,2,1382,1759,-377
2,1,12,8,2,1392,1820,-428
2,1,13,8,2,1393,1700,-307
2,1,14,8,2,1396,1993,-597
2,1,15,8,2,1447,2872,-1425
2,1,16,8,2,1475,3123,-1648
2,1,17,8,2,1525,2865,-1340
2,1,18,8,2,1613,2904,-1291
2,1,19,8,2,1627,2698,-1071
2,1,20,8,2,1683,2489,-806
2,1,21,8,2,1788,2505,-717
2,1,22,8,2,1823,2291,-468
2,2,0,8,2,1860,2031,-171
2,2,1,8,2,1777,1701,76
2,2,2,8,2,1550,1678,-128
2,2,3,8,2,1409,2588,-1179
2,2,4,8,2,1444,3325,-1881
2,2,5,8,2,1451,2969,-1518
2,2,6,8,2,1410,3069,-1659
2,2,7,8,2,1364,3539,-2175
2,2,8,8,2,1307,2626,-1319
2,2,9,8,2,1257,1896,-639
2,2,10,8,2,1236,1871,-635
2,2,11,8,2,1251,1834,-583
2,2,12,8,2,1252,1919,-667
2,2,13,8,2,1239,1789,-550
2,2,14,8,2,1264,2114,-850
2,2,15,8,2,1337,3142,-1805
2,2,16,8,2,1378,3401,-2023
2,2,17,8,2,1438,2977,-1539
2,2,18,8,2,1512,3034,-1522
2,2,19,8,2,1522,2934,-1412
2,2,20,8,2,1582,2718,-1136
2,2,21,8,2,1699,2628,-929
2,2,22,8,2,1786,2360,-574
2,3,0,8,2,1787,2097,-310
2,3,1,8,2,1654,1765,-111
2,3,2,8,2,1467,1802,-335
2,3,3,8,2,1416,2786,-1370
2,3,4,8,2,1492,3476,-1984
2,3,5,8,2,1476,2976,-1500
2,3,6,8,2,1464,2986,-1522
2,3,7,8,2,1430,3480,-2050
2,3,8,8,2,1349,2541,-1192
2,3,9,8,2,1295,1784,-489
2,3,10,8,2,1271,1779,-508
2,3,11,8,2,1282,1781,-499
2,3,12,8,2,1295,1844,-549
2,3,13,8,2,1277,1711,-434
2,3,14,8,2,1296,2046,-750
2,3,15,8,2,1383,3017,-1634
2,3,16,8,2,1446,3332,-1886
2,3,17,8,2,1481,2947,-1466
2,3,18,8,2,1528,3000,-1472
2,3,19,8,2,1547,3024,-1477
2,3,20,8,2,1566,2885,-1319
2,3,21,8,2,1655,2692,-1037
2,3,22,8,2,1770,2357,-587
2,4,0,8,2,1797,2138,-341
2,4,1,8,2,1617,1769,-152
2,4,2,8,2,1465,1927,-462
2,4,3,8,2,1575,2774,-1199
2,4,4,8,2,1693,3258,-1565
2,4,5,8,2,1647,2730,-1083
2,4,6,8,2,1690,2704,-1014
2,4,7,8,2,1689,3320,-1631
2,4,8,8,2,1602,2457,-855
2,4,9,8,2,1532,1693,-161
2,4,10,8,2,1514,1696,-182
2,4,11,8,2,1526,1701,-175
2,4,12,8,2,1561,1768,-207
2,4,13,8,2,1533,1594,-61
2,4,14,8,2,1537,1848,-311
2,4,15,8,2,1657,2839,-1182
2,4,16,8,2,1735,3250,-1515
2,4,17,8,2,1685,2804,-1119
2,4,18,8,2,1685,2737,-1052
2,4,19,8,2,1743,2840,-1097
2,4,20,8,2,1737,2759,-1022
2,4,21,8,2,1782,2503,-721
2,4,22,8,2,1855,2325,-470
2,5,0,8,2,1862,2106,-244
2,5,1,8,2,1635,1662,-27
2,5,2,8,2,1466,1995,-529
2,5,3,8,2,1697,2738,-1041
2,5,4,8,2,1885,2960,-1075
2,5,5,8,2,1847,2432,-585
2,5,6,8,2,1957,2519,-562
2,5,7,8,2,2015,3287,-1272
2,5,8,8,2,1840,2490,-650
2,5,9,8,2,1658,1753,-95
2,5,10,8,2,1650,1740,-90
2,5,11,8,2,1683,1727,-44
2,5,12,8,2,1714,1824,-110
2,5,13,8,2,1655,1610,45
2,5,14,8,2,1704,1745,-41
2,5,15,8,2,1960,2642,-682
2,5,16,8,2,2090,3019,-929
2,5,17,8,2,1942,2534,-592
2,5,18,8,2,1878,2440,-562
2,5,19,8,2,1945,2640,-695
2,5,20,8,2,1927,2552,-625
2,5,21,8,2,1955,2207,-252
2,5,22,8,2,1962,2261,-299
2,6,0,8,2,1931,2076,-145
2,6,1,8,2,1662,1554,108
2,6,2,8,2,1460,2086,-626
2,6,3,8,2,1763,2725,-962
2,6,4,8,2,2091,2614,-523
2,6,5,8,2,2092,2099,-7
2,6,6,8,2,2252,2258,-6
2,6,7,8,2,2389,3034,-645
2,6,8,8,2,2052,2327,-275
2,6,9,8,2,1729,1614,115
2,6,10,8,2,1717,1611,106
2,6,11,8,2,1756,1656,100
2,6,12,8,2,1790,1742,48
2,6,13,8,2,1712,1483,229
2,6,14,8,2,1821,1576,245
2,6,15,8,2,2245,2334,-89
2,6,16,8,2,2443,2666,-223
2,6,17,8,2,2238,2224,14
2,6,18,8,2,2121,2148,-27
2,6,19,8,2,2112,2435,-323
2,6,20,8,2,2057,2377,-320
2,6,21,8,2,2103,2007,96
2,6,22,8,2,2067,2199,-132
2,7,0,8,2,2008,1926,82
2,7,1,8,2,1713,1420,293
2,7,2,8,2,1499,2045,-546
2,7,3,8,2,1885,2587,-702
2,7,4,8,2,2352,2261,91
2,7,5,8,2,2340,1784,556
2,7,6,8,2,2501,2024,477
2,7,7,8,2,2729,2813,-84
2,7,8,8,2,2250,2191,59
2,7,9,8,2,1818,1506,312
2,7,10,8,2,1799,1522,277
2,7,11,8,2,1820,1631,189
2,7,12,8,2,1873,1720,153
2,7,13,8,2,1791,1383,408
2,7,14,8,2,1944,1448,496
2,7,15,8,2,2496,2148,348
2,7,16,8,2,2721,2427,294
2,7,17,8,2,2511,1904,607
2,7,18,8,2,2406,1783,623
2,7,19,8,2,2294,2175,119
2,7,20,8,2,2201,2131,70
2,7,21,8,2,2276,1719,557
2,7,22,8,2,2191,1954,237
2,8,0,8,2,2068,1791,277
2,8,1,8,2,1774,1267,507
2,8,2,8,2,1586,1942,-356
2,8,3,8,2,2122,2399,-277
2,8,4,8,2,2712,1938,774
2,8,5,8,2,2615,1483,1132
2,8,6,8,2,2715,1751,964
2,8,7,8,2,3004,2544,460
2,8,8,8,2,2380,2094,286
2,8,9,8,2,1826,1458,368
2,8,10,8,2,1815,1425,390
2,8,11,8,2,1821,1624,197
2,8,12,8,2,1873,1745,128
2,8,13,8,2,1774,1387,387
2,8,14,8,2,1997,1388,609
2,8,15,8,2,2716,1934,782
2,8,16,8,2,2964,2175,789
2,8,17,8,2,2766,1595,1171
2,8,18,8,2,2720,1425,1295
2,8,19,8,2,2517,1927,590
2,8,20,8,2,2392,1871,521
2,8,21,8,2,2466,1442,1024
2,8,22,8,2,2283,1748,535
2,0,0,9,2,2119,2206,-87
2,0,1,9,2,2060,1839,221
2,0,2,9,2,1845,1790,55
2,0,3,9,2,1752,2672,-920
2,0,4,9,2,1790,3421,-1631
2,0,5,9,2,1777,3068,-1291
2,0,6,9,2,1718,3180,-1462
2,0,7,9,2,1658,3670,-2012
2,0,8,9,2,1623,2731,-1108
2,0,9,9,2,1602,1966,-364
2,0,10,9,2,1582,1936,-354
2,0,11,9,2,1586,1909,-323
2,0,12,9,2,1597,1986,-389
2,0,13,9,2,1600,1844,-244
2,0,14,9,2,1605,2194,-589
2,0,15,9,2,1650,3254,-1604
2,0,16,9,2,1675,3526,-1851
2,0,17,9,2,1737,3101,-1364
2,0,18,9,2,1831,3139,-1308
2,0,19,9,2,1833,3032,-1199
2,0,20,9,2,1884,2829,-945
2,0,21,9,2,2000,2764,-764
2,0,22,9,2,2034,2539,-505
2,1,0,9,2,2077,2245,-168
2,1,1,9,2,1995,1869,126
2,1,2,9,2,1763,1938,-175
2,1,3,9,2,1627,3010,-1383
2,1,4,9,2,1664,3742,-2078
2,1,5,9,2,1661,3217,-1556
2,1,6,9,2,1619,3266,-1647
2,1,7,9,2,1579,3779,-2200
2,1,8,9,2,1521,2811,-1290
2,1,9,9,2,1467,2044,-577
2,1,10,9,2,1443,2030,-587
2,1,11,9,2,1457,2025,-568
2,1,12,9,2,1459,2101,-642
2,1,13,9,2,1448,1967,-519
2,1,14,9,2,1476,2299,-823
2,1,15,9,2,1559,3291,-1732
2,1,16,9,2,1600,3626,-2026
2,1,17,9,2,1649,3208,-1559
2,1,18,9,2,1718,3232,-1514
2,1,19,9,2,1725,3259,-1534
2,1,20,9,2,1794,3082,-1288
2,1,21,9,2,1924,2873,-949
2,1,22,9,2,2002,2562,-560
2,2,0,9,2,2008,2377,-369
2,2,1,9,2,1881,1959,-78
2,2,2,9,2,1686,2140,-454
2,2,3,9,2,1633,3150,-1517
2,2,4,9,2,1710,3686,-1976
2,2,5,9,2,1692,3128,-1436
2,2,6,9,2,1690,3157,-1467
2,2,7,9,2,1663,3766,-2103
2,2,8,9,2,1577,2851,-1274
2,2,9,9,2,1517,2065,-548
2,2,10,9,2,1487,2068,-581
2,2,11,9,2,1495,2070,-575
2,2,12,9,2,1509,2159,-650
2,2,13,9,2,1495,1978,-483
2,2,14,9,2,1517,2221,-704
2,2,15,9,2,1611,3270,-1659
2,2,16,9,2,1672,3728,-2056
2,2,17,9,2,1699,3224,-1525
2,2,18,9,2,1744,3132,-1388
2,2,19,9,2,1757,3264,-1507
2,2,20,9,2,1779,3141,-1362
2,2,21,9,2,1880,2845,-965
2,2,22,9,2,1991,2632,-641
2,3,0,9,2,2026,2404,-378
2,3,1,9,2,1844,1913,-69
2,3,2,9,2,1680,2225,-545
2,3,3,9,2,1792,3101,-1309
2,3,4,9,2,1920,3398,-1478
2,3,5,9,2,1874,2846,-972
2,3,6,9,2,1917,2956,-1039
2,3,7,9,2,1876,3743,-1867
2,3,8,9,2,1743,2833,-1090
2,3,9,9,2,1667,1978,-311
2,3,10,9,2,1643,1969,-326
2,3,11,9,2,1651,1973,-322
2,3,12,9,2,1686,2066,-380
2,3,13,9,2,1661,1824,-163
2,3,14,9,2,1669,2007,-338
2,3,15,9,2,1814,3052,-1238
2,3,16,9,2,1924,3508,-1584
2,3,17,9,2,1901,2972,-1071
2,3,18,9,2,1923,2862,-939
2,3,19,9,2,1971,3080,-1109
2,3,20,9,2,1948,2967,-1019
2,3,21,9,2,1997,2603,-606
2,3,22,9,2,2077,2591,-514
2,4,0,9,2,2095,2381,-286
2,4,1,9,2,1868,1823,45
2,4,2,9,2,1695,2319,-624
2,4,3,9,2,1938,3035,-1097
2,4,4,9,2,2131,3054,-923
2,4,5,9,2,2061,2522,-461
2,4,6,9,2,2127,2661,-534
2,4,7,9,2,2145,3516,-1371
2,4,8,9,2,1945,2676,-731
2,4,9,9,2,1757,1820,-63
2,4,10,9,2,1743,1810,-67
2,4,11,9,2,1772,1859,-87
2,4,12,9,2,1803,1948,-145
2,4,13,9,2,1747,1670,77
2,4,14,9,2,1799,1824,-25
2,4,15,9,2,2067,2740,-673
2,4,16,9,2,2224,3132,-908
2,4,17,9,2,2123,2659,-536
2,4,18,9,2,2107,2579,-472
2,4,19,9,2,2183,2825,-642
2,4,20,9,2,2152,2742,-590
2,4,21,9,2,2178,2392,-214
2,4,22,9,2,2185,2530,-345
2,5,0,9,2,2167,2247,-80
2,5,1,9,2,1904,1704,200
2,5,2,9,2,1699,2282,-583
2,5,3,9,2,2007,2885,-878
2,5,4,9,2,2325,2691,-366
2,5,5,9,2,2270,2181,89
2,5,6,9,2,2360,2398,-38
2,5,7,9,2,2497,3280,-783
2,5,8,9,2,2189,2527,-338
2,5,9,9,2,1864,1733,131
2,5,10,9,2,1849,1742,107
2,5,11,9,2,1886,1833,53
2,5,12,9,2,1920,1941,-21
2,5,13,9,2,1842,1599,243
2,5,14,9,2,1952,1707,245
2,5,15,9,2,2366,2544,-178
2,5,16,9,2,2556,2848,-292
2,5,17,9,2,2377,2314,63
2,5,18,9,2,2309,2226,83
2,5,19,9,2,2335,2541,-206
2,5,20,9,2,2292,2479,-187
2,5,21,9,2,2340,2115,225
2,5,22,9,2,2293,2309,-16
2,6,0,9,2,2252,2106,146
2,6,1,9,2,1946,1543,403
2,6,2,9,2,1697,2168,-471
2,6,3,9,2,2061,2725,-664
2,6,4,9,2,2521,2395,126
2,6,5,9,2,2489,1897,592
2,6,6,9,2,2626,2152,474
2,6,7,9,2,2856,3019,-163
2,6,8,9,2,2388,2415,-27
2,6,9,9,2,1956,1659,297
2,6,10,9,2,1937,1637,300
2,6,11,9,2,1958,1823,135
2,6,12,9,2,2011,1942,69
2,6,13,9,2,1928,1565,363
2,6,14,9,2,2080,1634,446
2,6,15,9,2,2641,2349,292
2,6,16,9,2,2864,2601,263
2,6,17,9,2,2648,2013,635
2,6,18,9,2,2564,1895,669
2,6,19,9,2,2478,2299,179
2,6,20,9,2,2405,2218,187
2,6,21,9,2,2499,1826,673
2,6,22,9,2,2422,2075,347
2,0,0,10,2,2294,2525,-231
2,0,1,10,2,2198,2063,135
2,0,2,10,2,1957,2276,-319
2,0,3,10,2,1836,3374,-1538
2,0,4,10,2,1886,3952,-2066
2,0,5,10,2,1876,3369,-1493
2,0,6,10,2,1829,3437,-1608
2,0,7,10,2,1789,4065,-2276
2,0,8,10,2,1728,3121,-1393
2,0,9,10,2,1672,2325,-653
2,0,10,10,2,1647,2319,-672
2,0,11,10,2,1661,2314,-653
2,0,12,10,2,1664,2416,-752
2,0,13,10,2,1655,2234,-579
2,0,14,10,2,1685,2474,-789
2,0,15,10,2,1762,3544,-1782
2,0,16,10,2,1800,4022,-2222
2,0,17,10,2,1861,3485,-1624
2,0,18,10,2,1936,3364,-1428
2,0,19,10,2,1931,3499,-1568
2,0,20,10,2,1995,3338,-1343
2,0,21,10,2,2136,3026,-890
2,0,22,10,2,2213,2837,-624
2,1,0,10,2,2225,2643,-418
2,1,1,10,2,2099,2103,-4
2,1,2,10,2,1899,2438,-539
2,1,3,10,2,1851,3477,-1626
2,1,4,10,2,1930,3826,-1896
2,1,5,10,2,1902,3244,-1342
2,1,6,10,2,1899,3409,-1510
2,1,7,10,2,1878,4189,-2311
2,1,8,10,2,1791,3227,-1436
2,1,9,10,2,1727,2350,-623
2,1,10,10,2,1694,2341,-647
2,1,11,10,2,1701,2342,-641
2,1,12,10,2,1716,2457,-741
2,1,13,10,2,1704,2208,-504
2,1,14,10,2,1729,2380,-651
2,1,15,10,2,1833,3483,-1650
2,1,16,10,2,1894,3986,-2092
2,1,17,10,2,1910,3392,-1482
2,1,18,10,2,1950,3257,-1307
2,1,19,10,2,1960,3504,-1544
2,1,20,10,2,1991,3349,-1358
2,1,21,10,2,2105,2945,-840
2,1,22,10,2,2207,2898,-691
2,2,0,10,2,2247,2679,-432
2,2,1,10,2,2071,2074,-3
2,2,2,10,2,1899,2549,-650
2,2,3,10,2,2009,3398,-1389
2,2,4,10,2,2138,3492,-1354
2,2,5,10,2,2090,2936,-846
2,2,6,10,2,2143,3098,-955
2,2,7,10,2,2109,3972,-1863
2,2,8,10,2,1971,3019,-1048
2,2,9,10,2,1889,2045,-156
2,2,10,10,2,1859,2039,-180
2,2,11,10,2,1864,2105,-241
2,2,12,10,2,1900,2190,-290
2,2,13,10,2,1879,1884,-5
2,2,14,10,2,1890,2086,-196
2,2,15,10,2,2042,3150,-1108
2,2,16,10,2,2150,3621,-1471
2,2,17,10,2,2119,3097,-978
2,2,18,10,2,2139,3001,-862
2,2,19,10,2,2181,3265,-1084
2,2,20,10,2,2161,3157,-996
2,2,21,10,2,2222,2788,-566
2,2,22,10,2,2298,2860,-562
2,3,0,10,2,2324,2552,-228
2,3,1,10,2,2095,1973,122
2,3,2,10,2,1910,2515,-605
2,3,3,10,2,2155,3195,-1040
2,3,4,10,2,2358,3131,-773
2,3,5,10,2,2288,2604,-316
2,3,6,10,2,2354,2801,-447
2,3,7,10,2,2332,3762,-1430
2,3,8,10,2,2086,2876,-790
2,3,9,10,2,1892,1939,-47
2,3,10,10,2,1872,1941,-69
2,3,11,10,2,1897,2036,-139
2,3,12,10,2,1928,2147,-219
2,3,13,10,2,1875,1786,89
2,3,14,10,2,1931,1955,-24
2,3,15,10,2,2224,2950,-726
2,3,16,10,2,2413,3314,-901
2,3,17,10,2,2339,2749,-410
2,3,18,10,2,2345,2657,-312
2,3,19,10,2,2411,2931,-520
2,3,20,10,2,2363,2844,-481
2,3,21,10,2,2393,2500,-107
2,3,22,10,2,2407,2640,-233
2,4,0,10,2,2400,2427,-27
2,4,1,10,2,2137,1827,310
2,4,2,10,2,1928,2405,-477
2,4,3,10,2,2248,3023,-775
2,4,4,10,2,2571,2825,-254
2,4,5,10,2,2484,2294,190
2,4,6,10,2,2530,2526,4
2,4,7,10,2,2627,3486,-859
2,4,8,10,2,2294,2751,-457
2,4,9,10,2,1963,1886,77
2,4,10,10,2,1942,1857,85
2,4,11,10,2,1975,2025,-50
2,4,12,10,2,2009,2163,-154
2,4,13,10,2,1934,1781,153
2,4,14,10,2,2047,1893,154
2,4,15,10,2,2473,2745,-272
2,4,16,10,2,2690,3022,-332
2,4,17,10,2,2558,2423,135
2,4,18,10,2,2538,2338,200
2,4,19,10,2,2573,2665,-92
2,4,20,10,2,2517,2566,-49
2,4,21,10,2,2563,2222,341
2,4,22,10,2,2516,2430,86
2,0,0,11,2,2442,2918,-476
2,0,1,11,2,2302,2264,38
2,0,2,11,2,2093,2762,-669
2,0,3,11,2,2060,3774,-1714
2,0,4,11,2,2152,3920,-1768
2,0,5,11,2,2117,3334,-1217
2,0,6,11,2,2109,3551,-1442
2,0,7,11,2,2088,4418,-2330
2,0,8,11,2,1998,3413,-1415
2,0,9,11,2,1932,2417,-485
2,0,10,11,2,1898,2411,-513
2,0,11,11,2,1905,2474,-569
2,0,12,11,2,1921,2581,-660
2,0,13,11,2,1911,2268,-357
2,0,14,11,2,1938,2459,-521
2,0,15,11,2,2036,3581,-1545
2,0,16,11,2,2094,4099,-2005
2,0,17,11,2,2122,3517,-1395
2,0,18,11,2,2168,3396,-1228
2,0,19,11,2,2166,3689,-1523
2,0,20,11,2,2192,3539,-1347
2,0,21,11,2,2317,3130,-813
2,0,22,11,2,2418,3167,-749
2,1,0,11,2,2464,2850,-386
2,1,1,11,2,2289,2224,65
2,1,2,11,2,2112,2745,-633
2,1,3,11,2,2227,3558,-1331
2,1,4,11,2,2358,3569,-1211
2,1,5,11,2,2300,3018,-718
2,1,6,11,2,2352,3238,-886
2,1,7,11,2,2324,4218,-1894
2,1,8,11,2,2185,3219,-1034
2,1,9,11,2,2099,2164,-65
2,1,10,11,2,2066,2170,-104
2,1,11,11,2,2070,2282,-212
2,1,12,11,2,2107,2389,-282
2,1,13,11,2,2088,2000,88
2,1,14,11,2,2102,2217,-115
2,1,15,11,2,2264,3360,-1096
2,1,16,11,2,2372,3803,-1431
2,1,17,11,2,2330,3187,-857
2,1,18,11,2,2345,3079,-734
2,1,19,11,2,2384,3371,-987
2,1,20,11,2,2373,3259,-886
2,1,21,11,2,2447,2896,-449
2,1,22,11,2,2514,2970,-456
2,2,0,11,2,2545,2732,-187
2,2,1,11,2,2322,2096,226
2,2,2,11,2,2129,2638,-509
2,2,3,11,2,2372,3333,-961
2,2,4,11,2,2576,3265,-689
2,2,5,11,2,2504,2717,-213
2,2,6,11,2,2580,2929,-349
2,2,7,11,2,2565,3968,-1403
2,2,8,11,2,2314,3100,-786
2,2,9,11,2,2114,2092,22
2,2,10,11,2,2088,2056,32
2,2,11,11,2,2110,2228,-118
2,2,12,11,2,2142,2369,-227
2,2,13,11,2,2093,1968,125
2,2,14,11,2,2152,2141,11
2,2,15,11,2,2452,3151,-699
2,2,16,11,2,2639,3488,-849
2,2,17,11,2,2557,2858,-301
2,2,18,11,2,2561,2769,-208
2,2,19,11,2,2621,3055,-434
2,2,20,11,2,2576,2931,-355
2,2,21,11,2,2618,2607,11
2,2,22,11,2,2628,2761,-133
2,0,0,12,2,2681,3030,-349
2,0,1,12,2,2492,2347,145
2,0,2,12,2,2306,2868,-562
2,0,3,12,2,2436,3696,-1260
2,0,4,12,2,2580,3703,-1123
2,0,5,12,2,2515,3131,-616
2,0,6,12,2,2562,3366,-804
2,0,7,12,2,2534,4424,-1890
2,0,8,12,2,2392,3443,-1051
2,0,9,12,2,2304,2317,-13
2,0,10,12,2,2270,2285,-15
2,0,11,12,2,2274,2474,-200
2,0,12,12,2,2312,2611,-299
2,0,13,12,2,2295,2182,113
2,0,14,12,2,2311,2403,-92
2,0,15,12,2,2467,3561,-1094
2,0,16,12,2,2572,3977,-1405
2,0,17,12,2,2542,3296,-754
2,0,18,12,2,2563,3191,-628
2,0,19,12,2,2590,3495,-905
2,0,20,12,2,2574,3346,-772
2,0,21,12,2,2659,3003,-344
2,0,22,12,2,2725,3091,-366
2,0,0,1,3,313,324,-11
2,0,1,1,3,301,324,-23
2,0,2,1,3,305,325,-20
2,0,3,1,3,320,326,-6
2,0,4,1,3,326,322,4
2,0,5,1,3,321,317,4
2,0,6,1,3,314,317,-3
2,0,7,1,3,313,321,-8
2,0,8,1,3,309,318,-9
2,0,9,1,3,307,313,-6
2,0,10,1,3,306,310,-4
2,0,11,1,3,307,310,-3
2,0,12,1,3,309,312,-3
2,0,13,1,3,312,316,-4
2,0,14,1,3,307,327,-20
2,0,15,1,3,305,329,-24
2,0,16,1,3,310,326,-16
2,0,17,1,3,320,313,7
2,0,18,1,3,316,307,9
2,0,19,1,3,309,314,-5
2,0,20,1,3,310,326,-16
2,0,21,1,3,314,327,-13
2,1,0,1,3,324,333,-9
2,1,1,1,3,324,334,-10
2,1,2,1,3,325,329,-4
2,1,3,1,3,326,325,1
2,1,4,1,3,322,326,-4
2,1,5,1,3,317,334,-17
2,1,6,1,3,317,341,-24
2,1,7,1,3,321,346,-25
2,1,8,1,3,318,337,-19
2,1,9,1,3,313,329,-16
2,1,10,1,3,310,322,-12
2,1,11,1,3,310,321,-11
2,1,12,1,3,312,324,-12
2,1,13,1,3,316,329,-13
2,1,14,1,3,327,338,-11
2,1,15,1,3,329,337,-8
2,1,16,1,3,326,335,-9
2,1,17,1,3,313,325,-12
2,1,18,1,3,307,319,-12
2,1,19,1,3,314,320,-6
2,1,20,1,3,326,328,-2
2,1,21,1,3,327,331,-4
2,2,0,1,3,333,339,-6
2,2,1,1,3,334,332,2
2,2,2,1,3,329,327,2
2,2,3,1,3,325,332,-7
2,2,4,1,3,326,339,-13
2,2,5,1,3,334,342,-8
2,2,6,1,3,341,299,42
2,2,7,1,3,346,256,90
2,2,8,1,3,337,207,130
2,2,9,1,3,329,198,131
2,2,10,1,3,322,191,131
2,2,11,1,3,321,188,133
2,2,12,1,3,324,190,134
2,2,13,1,3,329,195,134
2,2,14,1,3,338,222,116
2,2,15,1,3,337,256,81
2,2,16,1,3,335,306,29
2,2,17,1,3,325,337,-12
2,2,18,1,3,319,345,-26
2,2,19,1,3,320,332,-12
2,2,20,1,3,328,322,6
2,2,21,1,3,331,326,5
2,3,0,1,3,339,347,-8
2,3,1,1,3,332,348,-16
2,3,2,1,3,327,355,-28
2,3,3,1,3,332,361,-29
2,3,4,1,3,339,340,-1
2,3,5,1,3,342,290,52
2,3,6,1,3,299,224,75
2,3,7,1,3,256,181,75
2,3,8,1,3,207,153,54
2,3,9,1,3,198,144,54
2,3,10,1,3,191,137,54
2,3,11,1,3,188,134,54
2,3,12,1,3,190,136,54
2,3,13,1,3,195,140,55
2,3,14,1,3,222,154,68
2,3,15,1,3,256,182,74
2,3,16,1,3,306,240,66
2,3,17,1,3,337,304,33
2,3,18,1,3,345,344,1
2,3,19,1,3,332,348,-16
2,3,20,1,3,322,338,-16
2,3,21,1,3,326,333,-7
2,4,0,1,3,347,356,-9
2,4,1,1,3,348,361,-13
2,4,2,1,3,355,364,-9
2,4,3,1,3,361,353,8
2,4,4,1,3,340,303,37
2,4,5,1,3,290,217,73
2,4,6,1,3,224,177,47
2,4,7,1,3,181,176,5
2,4,8,1,3,153,204,-51
2,4,9,1,3,144,200,-56
2,4,10,1,3,137,197,-60
2,4,11,1,3,134,195,-61
2,4,12,1,3,136,195,-59
2,4,13,1,3,140,196,-56
2,4,14,1,3,154,186,-32
2,4,15,1,3,182,179,3
2,4,16,1,3,240,194,46
2,4,17,1,3,304,246,58
2,4,18,1,3,344,304,40
2,4,19,1,3,348,342,6
2,4,20,1,3,338,353,-15
2,4,21,1,3,333,345,-12
2,5,0,1,3,356,353,3
2,5,1,1,3,361,322,39
2,5,2,1,3,364,285,79
2,5,3,1,3,353,258,95
2,5,4,1,3,303,236,67
2,5,5,1,3,217,207,10
2,5,6,1,3,177,194,-17
2,5,7,1,3,176,196,-20
2,5,8,1,3,204,207,-3
2,5,9,1,3,200,207,-7
2,5,10,1,3,197,207,-10
2,5,11,1,3,195,207,-12
2,5,12,1,3,195,206,-11
2,5,13,1,3,196,205,-9
2,5,14,1,3,186,213,-27
2,5,15,1,3,179,211,-32
2,5,16,1,3,194,214,-20
2,5,17,1,3,246,224,22
2,5,18,1,3,304,255,49
2,5,19,1,3,342,291,51
2,5,20,1,3,353,320,33
2,5,21,1,3,345,338,7
2,6,0,1,3,353,345,8
2,6,1,1,3,322,264,58
2,6,2,1,3,285,179,106
2,6,3,1,3,258,146,112
2,6,4,1,3,236,179,57
2,6,5,1,3,207,244,-37
2,6,6,1,3,194,282,-88
2,6,7,1,3,196,296,-100
2,6,8,1,3,207,288,-81
2,6,9,1,3,207,292,-85
2,6,10,1,3,207,295,-88
2,6,11,1,3,207,296,-89
2,6,12,1,3,206,294,-88
2,6,13,1,3,205,291,-86
2,6,14,1,3,213,292,-79
2,6,15,1,3,211,279,-68
2,6,16,1,3,214,262,-48
2,6,17,1,3,224,240,-16
2,6,18,1,3,255,228,27
2,6,19,1,3,291,233,58
2,6,20,1,3,320,266,54
2,6,21,1,3,338,319,19
2,7,0,1,3,345,388,-43
2,7,1,1,3,264,340,-76
2,7,2,1,3,179,262,-83
2,7,3,1,3,146,235,-89
2,7,4,1,3,179,292,-113
2,7,5,1,3,244,350,-106
2,7,6,1,3,282,383,-101
2,7,7,1,3,296,383,-87
2,7,8,1,3,288,392,-104
2,7,9,1,3,292,402,-110
2,7,10,1,3,295,413,-118
2,7,11,1,3,296,429,-133
2,7,12,1,3,294,430,-136
2,7,13,1,3,291,422,-131
2,7,14,1,3,292,410,-118
2,7,15,1,3,279,403,-124
2,7,16,1,3,262,394,-132
2,7,17,1,3,240,353,-113
2,7,18,1,3,228,321,-93
2,7,19,1,3,233,320,-87
2,7,20,1,3,266,345,-79
2,7,21,1,3,319,377,-58
2,8,0,1,3,388,244,144
2,8,1,1,3,340,181,159
2,8,2,1,3,262,153,109
2,8,3,1,3,235,139,96
2,8,4,1,3,292,140,152
2,8,5,1,3,350,166,184
2,8,6,1,3,383,175,208
2,8,7,1,3,383,172,211
2,8,8,1,3,392,134,258
2,8,9,1,3,402,106,296
2,8,10,1,3,413,104,309
2,8,11,1,3,429,103,326
2,8,12,1,3,430,94,336
2,8,13,1,3,422,108,314
2,8,14,1,3,410,139,271
2,8,15,1,3,403,178,225
2,8,16,1,3,394,183,211
2,8,17,1,3,353,171,182
2,8,18,1,3,321,156,165
2,8,19,1,3,320,158,162
2,8,20,1,3,345,187,158
2,8,21,1,3,377,239,138
2,9,0,1,3,244,208,36
2,9,1,1,3,181,180,1
2,9,2,1,3,153,284,-131
2,9,3,1,3,139,342,-203
2,9,4,1,3,140,389,-249
2,9,5,1,3,166,398,-232
2,9,6,1,3,175,422,-247
2,9,7,1,3,172,427,-255
2,9,8,1,3,134,402,-268
2,9,9,1,3,106,379,-273
2,9,10,1,3,104,376,-272
2,9,11,1,3,103,376,-273
2,9,12,1,3,94,381,-287
2,9,13,1,3,108,385,-277
2,9,14,1,3,139,398,-259
2,9,15,1,3,178,423,-245
2,9,16,1,3,183,406,-223
2,9,17,1,3,171,381,-210
2,9,18,1,3,156,347,-191
2,9,19,1,3,158,317,-159
2,9,20,1,3,187,296,-109
2,9,21,1,3,239,287,-48
2,10,0,1,3,208,329,-121
2,10,1,1,3,180,313,-133
2,10,2,1,3,284,466,-182
2,10,3,1,3,342,551,-209
2,10,4,1,3,389,651,-262
2,10,5,1,3,398,628,-230
2,10,6,1,3,422,669,-247
2,10,7,1,3,427,624,-197
2,10,8,1,3,402,588,-186
2,10,9,1,3,379,550,-171
2,10,10,1,3,376,563,-187
2,10,11,1,3,376,569,-193
2,10,12,1,3,381,575,-194
2,10,13,1,3,385,573,-188
2,10,14,1,3,398,615,-217
2,10,15,1,3,423,667,-244
2,10,16,1,3,406,662,-256
2,10,17,1,3,381,631,-250
2,10,18,1,3,347,608,-261
2,10,19,1,3,317,593,-276
2,10,20,1,3,296,555,-259
2,10,21,1,3,287,476,-189
2,11,0,1,3,329,402,-73
2,11,1,1,3,313,377,-64
2,11,2,1,3,466,467,-1
2,11,3,1,3,551,564,-13
2,11,4,1,3,651,651,0
2,11,5,1,3,628,638,-10
2,11,6,1,3,669,669,0
2,11,7,1,3,624,567,57
2,11,8,1,3,588,457,131
2,11,9,1,3,550,340,210
2,11,10,1,3,563,360,203
2,11,11,1,3,569,357,212
2,11,12,1,3,575,345,230
2,11,13,1,3,573,373,200
2,11,14,1,3,615,513,102
2,11,15,1,3,667,648,19
2,11,16,1,3,662,689,-27
2,11,17,1,3,631,660,-29
2,11,18,1,3,608,640,-32
2,11,19,1,3,593,637,-44
2,11,20,1,3,555,614,-59
2,11,21,1,3,476,527,-51
2,12,0,1,3,402,415,-13
2,12,1,1,3,377,392,-15
2,12,2,1,3,467,420,47
2,12,3,1,3,564,563,1
2,12,4,1,3,651,610,41
2,12,5,1,3,638,656,-18
2,12,6,1,3,669,652,17
2,12,7,1,3,567,582,-15
2,12,8,1,3,457,455,2
2,12,9,1,3,340,299,41
2,12,10,1,3,360,309,51
2,12,11,1,3,357,299,58
2,12,12,1,3,345,297,48
2,12,13,1,3,373,344,29
2,12,14,1,3,513,497,16
2,12,15,1,3,648,623,25
2,12,16,1,3,689,684,5
2,12,17,1,3,660,648,12
2,12,18,1,3,640,608,32
2,12,19,1,3,637,578,59
2,12,20,1,3,614,562,52
2,12,21,1,3,527,519,8
2,13,0,1,3,415,436,-21
2,13,1,1,3,392,406,-14
2,13,2,1,3,420,413,7
2,13,3,1,3,563,552,11
2,13,4,1,3,610,573,37
2,13,5,1,3,656,628,28
2,13,6,1,3,652,610,42
2,13,7,1,3,582,567,15
2,13,8,1,3,455,463,-8
2,13,9,1,3,299,320,-21
2,13,10,1,3,309,329,-20
2,13,11,1,3,299,314,-15
2,13,12,1,3,297,325,-28
2,13,13,1,3,344,371,-27
2,13,14,1,3,497,500,-3
2,13,15,1,3,623,576,47
2,13,16,1,3,684,651,33
2,13,17,1,3,648,623,25
2,13,18,1,3,608,596,12
2,13,19,1,3,578,561,17
2,13,20,1,3,562,549,13
2,13,21,1,3,519,550,-31
2,14,0,1,3,436,422,14
2,14,1,1,3,406,395,11
2,14,2,1,3,413,433,-20
2,14,3,1,3,552,576,-24
2,14,4,1,3,573,621,-48
2,14,5,1,3,628,651,-23
2,14,6,1,3,610,639,-29
2,14,7,1,3,567,558,9
2,14,8,1,3,463,439,24
2,14,9,1,3,320,295,25
2,14,10,1,3,329,317,12
2,14,11,1,3,314,291,23
2,14,12,1,3,325,283,42
2,14,13,1,3,371,338,33
2,14,14,1,3,500,501,-1
2,14,15,1,3,576,586,-10
2,14,16,1,3,651,673,-22
2,14,17,1,3,623,641,-18
2,14,18,1,3,596,619,-23
2,14,19,1,3,561,570,-9
2,14,20,1,3,549,533,16
2,14,21,1,3,550,525,25
2,15,0,1,3,422,297,125
2,15,1,1,3,395,308,87
2,15,2,1,3,433,413,20
2,15,3,1,3,576,587,-11
2,15,4,1,3,621,598,23
2,15,5,1,3,651,627,24
2,15,6,1,3,639,617,22
2,15,7,1,3,558,594,-36
2,15,8,1,3,439,463,-24
2,15,9,1,3,295,318,-23
2,15,10,1,3,317,338,-21
2,15,11,1,3,291,333,-42
2,15,12,1,3,283,337,-54
2,15,13,1,3,338,384,-46
2,15,14,1,3,501,526,-25
2,15,15,1,3,586,598,-12
2,15,16,1,3,673,613,60
2,15,17,1,3,641,576,65
2,15,18,1,3,619,562,57
2,15,19,1,3,570,541,29
2,15,20,1,3,533,441,92
2,15,21,1,3,525,425,100
2,16,0,1,3,297,246,51
2,16,1,1,3,308,284,24
2,16,2,1,3,413,416,-3
2,16,3,1,3,587,544,43
2,16,4,1,3,598,510,88
2,16,5,1,3,627,534,93
2,16,6,1,3,617,539,78
2,16,7,1,3,594,498,96
2,16,8,1,3,463,377,86
2,16,9,1,3,318,248,70
2,16,10,1,3,338,260,78
2,16,11,1,3,333,233,100
2,16,12,1,3,337,227,110
2,16,13,1,3,384,284,100
2,16,14,1,3,526,443,83
2,16,15,1,3,598,543,55
2,16,16,1,3,613,478,135
2,16,17,1,3,576,396,180
2,16,18,1,3,562,409,153
2,16,19,1,3,541,500,41
2,16,20,1,3,441,433,8
2,16,21,1,3,425,414,11
2,17,0,1,3,246,290,-44
2,17,1,1,3,284,352,-68
2,17,2,1,3,416,498,-82
2,17,3,1,3,544,601,-57
2,17,4,1,3,510,486,24
2,17,5,1,3,534,376,158
2,17,6,1,3,539,309,230
2,17,7,1,3,498,313,185
2,17,8,1,3,377,260,117
2,17,9,1,3,248,232,16
2,17,10,1,3,260,266,-6
2,17,11,1,3,233,266,-33
2,17,12,1,3,227,285,-58
2,17,13,1,3,284,260,24
2,17,14,1,3,443,252,191
2,17,15,1,3,543,307,236
2,17,16,1,3,478,298,180
2,17,17,1,3,396,356,40
2,17,18,1,3,409,398,11
2,17,19,1,3,500,489,11
2,17,20,1,3,433,445,-12
2,17,21,1,3,414,366,48
2,18,0,1,3,290,384,-94
2,18,1,1,3,352,428,-76
2,18,2,1,3,498,468,30
2,18,3,1,3,601,444,157
2,18,4,1,3,486,282,204
2,18,5,1,3,376,251,125
2,18,6,1,3,309,358,-49
2,18,7,1,3,313,409,-96
2,18,8,1,3,260,468,-208
2,18,9,1,3,232,412,-180
2,18,10,1,3,266,447,-181
2,18,11,1,3,266,446,-180
2,18,12,1,3,285,425,-140
2,18,13,1,3,260,332,-72
2,18,14,1,3,252,363,-111
2,18,15,1,3,307,461,-154
2,18,16,1,3,298,465,-167
2,18,17,1,3,356,340,16
2,18,18,1,3,398,309,89
2,18,19,1,3,489,319,170
2,18,20,1,3,445,330,115
2,18,21,1,3,366,354,12
2,19,0,1,3,384,334,50
2,19,1,1,3,428,374,54
2,19,2,1,3,468,395,73
2,19,3,1,3,444,370,74
2,19,4,1,3,282,213,69
2,19,5,1,3,251,295,-44
2,19,6,1,3,358,496,-138
2,19,7,1,3,409,555,-146
2,19,8,1,3,468,529,-61
2,19,9,1,3,412,405,7
2,19,10,1,3,447,425,22
2,19,11,1,3,446,418,28
2,19,12,1,3,425,382,43
2,19,13,1,3,332,305,27
2,19,14,1,3,363,297,66
2,19,15,1,3,461,333,128
2,19,16,1,3,465,306,159
2,19,17,1,3,340,245,95
2,19,18,1,3,309,288,21
2,19,19,1,3,319,285,34
2,19,20,1,3,330,263,67
2,19,21,1,3,354,311,43
2,20,0,1,3,334,364,-30
2,20,1,1,3,374,396,-22
2,20,2,1,3,395,386,9
2,20,3,1,3,370,329,41
2,20,4,1,3,213,152,61
2,20,5,1,3,295,174,121
2,20,6,1,3,496,287,209
2,20,7,1,3,555,270,285
2,20,8,1,3,529,212,317
2,20,9,1,3,405,111,294
2,20,10,1,3,425,158,267
2,20,11,1,3,418,168,250
2,20,12,1,3,382,148,234
2,20,13,1,3,305,115,190
2,20,14,1,3,297,122,175
2,20,15,1,3,333,168,165
2,20,16,1,3,306,168,138
2,20,17,1,3,245,209,36
2,20,18,1,3,288,240,48
2,20,19,1,3,285,274,11
2,20,20,1,3,263,286,-23
2,20,21,1,3,311,358,-47
2,21,0,1,3,364,247,117
2,21,1,1,3,396,270,126
2,21,2,1,3,386,236,150
2,21,3,1,3,329,197,132
2,21,4,1,3,152,122,30
2,21,5,1,3,174,177,-3
2,21,6,1,3,287,291,-4
2,21,7,1,3,270,295,-25
2,21,8,1,3,212,270,-58
2,21,9,1,3,111,180,-69
2,21,10,1,3,158,247,-89
2,21,11,1,3,168,260,-92
2,21,12,1,3,148,232,-84
2,21,13,1,3,115,214,-99
2,21,14,1,3,122,243,-121
2,21,15,1,3,168,280,-112
2,21,16,1,3,168,202,-34
2,21,17,1,3,209,148,61
2,21,18,1,3,240,126,114
2,21,19,1,3,274,160,114
2,21,20,1,3,286,156,130
2,21,21,1,3,358,164,194
2,22,0,1,3,247,234,13
2,22,1,1,3,270,192,78
2,22,2,1,3,236,192,44
2,22,3,1,3,197,203,-6
2,22,4,1,3,122,182,-60
2,22,5,1,3,177,193,-16
2,22,6,1,3,291,254,37
2,22,7,1,3,295,304,-9
2,22,8,1,3,270,279,-9
2,22,9,1,3,180,213,-33
2,22,10,1,3,247,247,0
2,22,11,1,3,260,282,-22
2,22,12,1,3,232,314,-82
2,22,13,1,3,214,276,-62
2,22,14,1,3,243,293,-50
2,22,15,1,3,280,268,12
2,22,16,1,3,202,216,-14
2,22,17,1,3,148,179,-31
2,22,18,1,3,126,166,-40
2,22,19,1,3,160,157,3
2,22,20,1,3,156,161,-5
2,22,21,1,3,164,154,10
2,0,0,2,3,637,672,-35
2,0,1,2,3,625,666,-41
2,0,2,2,3,630,656,-26
2,0,3,2,3,646,657,-11
2,0,4,2,3,648,665,-17
2,0,5,2,3,638,676,-38
2,0,6,2,3,631,640,-9
2,0,7,2,3,634,602,32
2,0,8,2,3,627,544,83
2,0,9,2,3,620,527,93
2,0,10,2,3,616,513,103
2,0,11,2,3,617,509,108
2,0,12,2,3,621,514,107
2,0,13,2,3,628,524,104
2,0,14,2,3,634,560,74
2,0,15,2,3,634,593,41
2,0,16,2,3,636,641,-5
2,0,17,2,3,633,662,-29
2,0,18,2,3,623,664,-41
2,0,19,2,3,623,652,-29
2,0,20,2,3,636,650,-14
2,0,21,2,3,641,657,-16
2,1,0,2,3,657,686,-29
2,1,1,2,3,658,680,-22
2,1,2,2,3,654,682,-28
2,1,3,2,3,651,693,-42
2,1,4,2,3,648,679,-31
2,1,5,2,3,651,632,19
2,1,6,2,3,658,523,135
2,1,7,2,3,667,437,230
2,1,8,2,3,655,360,295
2,1,9,2,3,642,342,300
2,1,10,2,3,632,328,304
2,1,11,2,3,631,322,309
2,1,12,2,3,636,326,310
2,1,13,2,3,645,335,310
2,1,14,2,3,665,376,289
2,1,15,2,3,666,438,228
2,1,16,2,3,661,546,115
2,1,17,2,3,638,641,-3
2,1,18,2,3,626,689,-63
2,1,19,2,3,634,680,-46
2,1,20,2,3,654,660,-6
2,1,21,2,3,658,659,-1
2,2,0,2,3,672,703,-31
2,2,1,2,3,666,709,-43
2,2,2,2,3,656,719,-63
2,2,3,2,3,657,714,-57
2,2,4,2,3,665,643,22
2,2,5,2,3,676,507,169
2,2,6,2,3,640,401,239
2,2,7,2,3,602,357,245
2,2,8,2,3,544,357,187
2,2,9,2,3,527,344,183
2,2,10,2,3,513,334,179
2,2,11,2,3,509,329,180
2,2,12,2,3,514,331,183
2,2,13,2,3,524,336,188
2,2,14,2,3,560,340,220
2,2,15,2,3,593,361,232
2,2,16,2,3,641,434,207
2,2,17,2,3,662,550,112
2,2,18,2,3,664,648,16
2,2,19,2,3,652,690,-38
2,2,20,2,3,650,691,-41
2,2,21,2,3,657,678,-21
2,3,0,2,3,686,709,-23
2,3,1,2,3,680,683,-3
2,3,2,2,3,682,649,33
2,3,3,2,3,693,611,82
2,3,4,2,3,679,539,140
2,3,5,2,3,632,424,208
2,3,6,2,3,523,371,152
2,3,7,2,3,437,372,65
2,3,8,2,3,360,411,-51
2,3,9,2,3,342,407,-65
2,3,10,2,3,328,404,-76
2,3,11,2,3,322,402,-80
2,3,12,2,3,326,401,-75
2,3,13,2,3,335,401,-66
2,3,14,2,3,376,399,-23
2,3,15,2,3,438,390,48
2,3,16,2,3,546,408,138
2,3,17,2,3,641,470,171
2,3,18,2,3,689,559,130
2,3,19,2,3,680,633,47
2,3,20,2,3,660,673,-13
2,3,21,2,3,659,683,-24
2,4,0,2,3,703,698,5
2,4,1,2,3,709,586,123
2,4,2,2,3,719,464,255
2,4,3,2,3,714,404,310
2,4,4,2,3,643,415,228
2,4,5,2,3,507,451,56
2,4,6,2,3,401,476,-75
2,4,7,2,3,357,492,-135
2,4,8,2,3,357,495,-138
2,4,9,2,3,344,499,-155
2,4,10,2,3,334,502,-168
2,4,11,2,3,329,503,-174
2,4,12,2,3,331,500,-169
2,4,13,2,3,336,496,-160
2,4,14,2,3,340,505,-165
2,4,15,2,3,361,490,-129
2,4,16,2,3,434,476,-42
2,4,17,2,3,550,464,86
2,4,18,2,3,648,483,165
2,4,19,2,3,690,524,166
2,4,20,2,3,691,586,105
2,4,21,2,3,678,657,21
2,5,0,2,3,709,733,-24
2,5,1,2,3,683,604,79
2,5,2,2,3,649,441,208
2,5,3,2,3,611,381,230
2,5,4,2,3,539,471,68
2,5,5,2,3,424,594,-170
2,5,6,2,3,371,665,-294
2,5,7,2,3,372,679,-307
2,5,8,2,3,411,680,-269
2,5,9,2,3,407,694,-287
2,5,10,2,3,404,708,-304
2,5,11,2,3,402,725,-323
2,5,12,2,3,401,724,-323
2,5,13,2,3,401,713,-312
2,5,14,2,3,399,702,-303
2,5,15,2,3,390,682,-292
2,5,16,2,3,408,656,-248
2,5,17,2,3,470,593,-123
2,5,18,2,3,559,549,10
2,5,19,2,3,633,553,80
2,5,20,2,3,673,611,62
2,5,21,2,3,683,696,-13
2,6,0,2,3,698,632,66
2,6,1,2,3,586,521,65
2,6,2,2,3,464,415,49
2,6,3,2,3,404,374,30
2,6,4,2,3,415,432,-17
2,6,5,2,3,451,516,-65
2,6,6,2,3,476,558,-82
2,6,7,2,3,492,555,-63
2,6,8,2,3,495,526,-31
2,6,9,2,3,499,508,-9
2,6,10,2,3,502,517,-15
2,6,11,2,3,503,532,-29
2,6,12,2,3,500,524,-24
2,6,13,2,3,496,530,-34
2,6,14,2,3,505,549,-44
2,6,15,2,3,490,581,-91
2,6,16,2,3,476,577,-101
2,6,17,2,3,464,524,-60
2,6,18,2,3,483,477,6
2,6,19,2,3,524,478,46
2,6,20,2,3,586,532,54
2,6,21,2,3,657,616,41
2,7,0,2,3,733,452,281
2,7,1,2,3,604,361,243
2,7,2,2,3,441,437,4
2,7,3,2,3,381,481,-100
2,7,4,2,3,471,529,-58
2,7,5,2,3,594,564,30
2,7,6,2,3,665,597,68
2,7,7,2,3,679,599,80
2,7,8,2,3,680,536,144
2,7,9,2,3,694,485,209
2,7,10,2,3,708,480,228
2,7,11,2,3,725,479,246
2,7,12,2,3,724,475,249
2,7,13,2,3,713,493,220
2,7,14,2,3,702,537,165
2,7,15,2,3,682,601,81
2,7,16,2,3,656,589,67
2,7,17,2,3,593,552,41
2,7,18,2,3,549,503,46
2,7,19,2,3,553,475,78
2,7,20,2,3,611,483,128
2,7,21,2,3,696,526,170
2,8,0,2,3,632,537,95
2,8,1,2,3,521,493,28
2,8,2,2,3,415,750,-335
2,8,3,2,3,374,893,-519
2,8,4,2,3,432,1040,-608
2,8,5,2,3,516,1026,-510
2,8,6,2,3,558,1091,-533
2,8,7,2,3,555,1051,-496
2,8,8,2,3,526,990,-464
2,8,9,2,3,508,929,-421
2,8,10,2,3,517,939,-422
2,8,11,2,3,532,945,-413
2,8,12,2,3,524,956,-432
2,8,13,2,3,530,958,-428
2,8,14,2,3,549,1013,-464
2,8,15,2,3,581,1090,-509
2,8,16,2,3,577,1068,-491
2,8,17,2,3,524,1012,-488
2,8,18,2,3,477,955,-478
2,8,19,2,3,478,910,-432
2,8,20,2,3,532,851,-319
2,8,21,2,3,616,763,-147
2,9,0,2,3,452,731,-279
2,9,1,2,3,361,690,-329
2,9,2,2,3,437,933,-496
2,9,3,2,3,481,1115,-634
2,9,4,2,3,529,1302,-773
2,9,5,2,3,564,1266,-702
2,9,6,2,3,597,1338,-741
2,9,7,2,3,599,1191,-592
2,9,8,2,3,536,1045,-509
2,9,9,2,3,485,890,-405
2,9,10,2,3,480,923,-443
2,9,11,2,3,479,926,-447
2,9,12,2,3,475,920,-445
2,9,13,2,3,493,946,-453
2,9,14,2,3,537,1128,-591
2,9,15,2,3,601,1315,-714
2,9,16,2,3,589,1351,-762
2,9,17,2,3,552,1291,-739
2,9,18,2,3,503,1248,-745
2,9,19,2,3,475,1230,-755
2,9,20,2,3,483,1169,-686
2,9,21,2,3,526,1003,-477
2,10,0,2,3,537,817,-280
2,10,1,2,3,493,769,-276
2,10,2,2,3,750,887,-137
2,10,3,2,3,893,1127,-234
2,10,4,2,3,1040,1261,-221
2,10,5,2,3,1026,1294,-268
2,10,6,2,3,1091,1321,-230
2,10,7,2,3,1051,1149,-98
2,10,8,2,3,990,912,78
2,10,9,2,3,929,639,290
2,10,10,2,3,939,669,270
2,10,11,2,3,945,656,289
2,10,12,2,3,956,642,314
2,10,13,2,3,958,717,241
2,10,14,2,3,1013,1010,3
2,10,15,2,3,1090,1271,-181
2,10,16,2,3,1068,1373,-305
2,10,17,2,3,1012,1308,-296
2,10,18,2,3,955,1248,-293
2,10,19,2,3,910,1215,-305
2,10,20,2,3,851,1176,-325
2,10,21,2,3,763,1046,-283
2,11,0,2,3,731,851,-120
2,11,1,2,3,690,798,-108
2,11,2,2,3,933,833,100
2,11,3,2,3,1115,1115,0
2,11,4,2,3,1302,1183,119
2,11,5,2,3,1266,1284,-18
2,11,6,2,3,1338,1262,76
2,11,7,2,3,1191,1149,42
2,11,8,2,3,1045,918,127
2,11,9,2,3,890,619,271
2,11,10,2,3,923,638,285
2,11,11,2,3,926,613,313
2,11,12,2,3,920,622,298
2,11,13,2,3,946,715,231
2,11,14,2,3,1128,997,131
2,11,15,2,3,1315,1199,116
2,11,16,2,3,1351,1335,16
2,11,17,2,3,1291,1271,20
2,11,18,2,3,1248,1204,44
2,11,19,2,3,1230,1139,91
2,11,20,2,3,1169,1111,58
2,11,21,2,3,1003,1069,-66
2,12,0,2,3,817,858,-41
2,12,1,2,3,769,801,-32
2,12,2,2,3,887,846,41
2,12,3,2,3,1127,1128,-1
2,12,4,2,3,1261,1194,67
2,12,5,2,3,1294,1279,15
2,12,6,2,3,1321,1249,72
2,12,7,2,3,1149,1125,24
2,12,8,2,3,912,902,10
2,12,9,2,3,639,615,24
2,12,10,2,3,669,646,23
2,12,11,2,3,656,605,51
2,12,12,2,3,642,608,34
2,12,13,2,3,717,709,8
2,12,14,2,3,1010,1001,9
2,12,15,2,3,1271,1162,109
2,12,16,2,3,1373,1324,49
2,12,17,2,3,1308,1264,44
2,12,18,2,3,1248,1215,33
2,12,19,2,3,1215,1131,84
2,12,20,2,3,1176,1082,94
2,12,21,2,3,1046,1075,-29
2,13,0,2,3,851,719,132
2,13,1,2,3,798,703,95
2,13,2,2,3,833,846,-13
2,13,3,2,3,1115,1163,-48
2,13,4,2,3,1183,1219,-36
2,13,5,2,3,1284,1278,6
2,13,6,2,3,1262,1256,6
2,13,7,2,3,1149,1152,-3
2,13,8,2,3,918,902,16
2,13,9,2,3,619,613,6
2,13,10,2,3,638,655,-17
2,13,11,2,3,613,624,-11
2,13,12,2,3,622,620,2
2,13,13,2,3,715,722,-7
2,13,14,2,3,997,1027,-30
2,13,15,2,3,1199,1184,15
2,13,16,2,3,1335,1286,49
2,13,17,2,3,1271,1217,54
2,13,18,2,3,1204,1181,23
2,13,19,2,3,1139,1111,28
2,13,20,2,3,1111,974,137
2,13,21,2,3,1069,950,119
2,14,0,2,3,858,543,315
2,14,1,2,3,801,592,209
2,14,2,2,3,846,829,17
2,14,3,2,3,1128,1131,-3
2,14,4,2,3,1194,1108,86
2,14,5,2,3,1279,1161,118
2,14,6,2,3,1249,1156,93
2,14,7,2,3,1125,1092,33
2,14,8,2,3,902,840,62
2,14,9,2,3,615,566,49
2,14,10,2,3,646,598,48
2,14,11,2,3,605,566,39
2,14,12,2,3,608,564,44
2,14,13,2,3,709,668,41
2,14,14,2,3,1001,969,32
2,14,15,2,3,1162,1141,21
2,14,16,2,3,1324,1091,233
2,14,17,2,3,1264,972,292
2,14,18,2,3,1215,971,244
2,14,19,2,3,1131,1041,90
2,14,20,2,3,1082,874,208
2,14,21,2,3,1075,839,236
2,15,0,2,3,719,536,183
2,15,1,2,3,703,636,67
2,15,2,2,3,846,914,-68
2,15,3,2,3,1163,1145,18
2,15,4,2,3,1219,996,223
2,15,5,2,3,1278,910,368
2,15,6,2,3,1256,848,408
2,15,7,2,3,1152,811,341
2,15,8,2,3,902,637,265
2,15,9,2,3,613,480,133
2,15,10,2,3,655,526,129
2,15,11,2,3,624,499,125
2,15,12,2,3,620,512,108
2,15,13,2,3,722,544,178
2,15,14,2,3,1027,695,332
2,15,15,2,3,1184,850,334
2,15,16,2,3,1286,776,510
2,15,17,2,3,1217,752,465
2,15,18,2,3,1181,807,374
2,15,19,2,3,1111,989,122
2,15,20,2,3,974,878,96
2,15,21,2,3,950,780,170
2,16,0,2,3,543,674,-131
2,16,1,2,3,592,780,-188
2,16,2,2,3,829,966,-137
2,16,3,2,3,1131,1045,86
2,16,4,2,3,1108,768,340
2,16,5,2,3,1161,627,534
2,16,6,2,3,1156,667,489
2,16,7,2,3,1092,722,370
2,16,8,2,3,840,728,112
2,16,9,2,3,566,644,-78
2,16,10,2,3,598,713,-115
2,16,11,2,3,566,712,-146
2,16,12,2,3,564,710,-146
2,16,13,2,3,668,592,76
2,16,14,2,3,969,615,354
2,16,15,2,3,1141,768,373
2,16,16,2,3,1091,763,328
2,16,17,2,3,972,696,276
2,16,18,2,3,971,707,264
2,16,19,2,3,1041,808,233
2,16,20,2,3,874,775,99
2,16,21,2,3,839,720,119
2,17,0,2,3,536,718,-182
2,17,1,2,3,636,802,-166
2,17,2,2,3,914,863,51
2,17,3,2,3,1145,814,331
2,17,4,2,3,996,495,501
2,17,5,2,3,910,546,364
2,17,6,2,3,848,854,-6
2,17,7,2,3,811,964,-153
2,17,8,2,3,637,997,-360
2,17,9,2,3,480,817,-337
2,17,10,2,3,526,872,-346
2,17,11,2,3,499,864,-365
2,17,12,2,3,512,807,-295
2,17,13,2,3,544,637,-93
2,17,14,2,3,695,660,35
2,17,15,2,3,850,794,56
2,17,16,2,3,776,771,5
2,17,17,2,3,752,585,167
2,17,18,2,3,807,597,210
2,17,19,2,3,989,604,385
2,17,20,2,3,878,593,285
2,17,21,2,3,780,665,115
2,18,0,2,3,674,698,-24
2,18,1,2,3,780,770,10
2,18,2,2,3,966,781,185
2,18,3,2,3,1045,699,346
2,18,4,2,3,768,365,403
2,18,5,2,3,627,469,158
2,18,6,2,3,667,783,-116
2,18,7,2,3,722,825,-103
2,18,8,2,3,728,741,-13
2,18,9,2,3,644,516,128
2,18,10,2,3,713,583,130
2,18,11,2,3,712,586,126
2,18,12,2,3,710,530,180
2,18,13,2,3,592,420,172
2,18,14,2,3,615,419,196
2,18,15,2,3,768,501,267
2,18,16,2,3,763,474,289
2,18,17,2,3,696,454,242
2,18,18,2,3,707,528,179
2,18,19,2,3,808,559,249
2,18,20,2,3,775,549,226
2,18,21,2,3,720,669,51
2,19,0,2,3,718,611,107
2,19,1,2,3,802,666,136
2,19,2,2,3,863,622,241
2,19,3,2,3,814,526,288
2,19,4,2,3,495,274,221
2,19,5,2,3,546,351,195
2,19,6,2,3,854,578,276
2,19,7,2,3,964,565,399
2,19,8,2,3,997,482,515
2,19,9,2,3,817,291,526
2,19,10,2,3,872,405,467
2,19,11,2,3,864,428,436
2,19,12,2,3,807,380,427
2,19,13,2,3,637,329,308
2,19,14,2,3,660,365,295
2,19,15,2,3,794,448,346
2,19,16,2,3,771,370,401
2,19,17,2,3,585,357,228
2,19,18,2,3,597,366,231
2,19,19,2,3,604,434,170
2,19,20,2,3,593,442,151
2,19,21,2,3,665,522,143
2,20,0,2,3,698,481,217
2,20,1,2,3,770,462,308
2,20,2,2,3,781,428,353
2,20,3,2,3,699,400,299
2,20,4,2,3,365,304,61
2,20,5,2,3,469,370,99
2,20,6,2,3,783,545,238
2,20,7,2,3,825,599,226
2,20,8,2,3,741,549,192
2,20,9,2,3,516,393,123
2,20,10,2,3,583,494,89
2,20,11,2,3,586,542,44
2,20,12,2,3,530,546,-16
2,20,13,2,3,420,490,-70
2,20,14,2,3,419,536,-117
2,20,15,2,3,501,548,-47
2,20,16,2,3,474,418,56
2,20,17,2,3,454,327,127
2,20,18,2,3,528,292,236
2,20,19,2,3,559,317,242
2,20,20,2,3,549,317,232
2,20,21,2,3,669,318,351
2,0,0,3,3,970,1042,-72
2,0,1,3,3,959,1041,-82
2,0,2,3,3,959,1046,-87
2,0,3,3,3,971,1046,-75
2,0,4,3,3,974,982,-8
2,0,5,3,3,972,849,123
2,0,6,3,3,972,700,272
2,0,7,3,3,980,613,367
2,0,8,3,3,964,564,400
2,0,9,3,3,949,542,407
2,0,10,3,3,938,525,413
2,0,11,3,3,938,517,421
2,0,12,3,3,945,521,424
2,0,13,3,3,957,531,426
2,0,14,3,3,972,562,410
2,0,15,3,3,971,617,354
2,0,16,3,3,971,740,231
2,0,17,3,3,958,887,71
2,0,18,3,3,942,993,-51
2,0,19,3,3,943,1022,-79
2,0,20,3,3,964,1013,-49
2,0,21,3,3,972,1004,-32
2,1,0,3,3,996,1056,-60
2,1,1,3,3,990,1031,-41
2,1,2,3,3,981,1004,-23
2,1,3,3,3,983,972,11
2,1,4,3,3,987,879,108
2,1,5,3,3,993,714,279
2,1,6,3,3,957,595,362
2,1,7,3,3,923,553,370
2,1,8,3,3,862,564,298
2,1,9,3,3,840,551,289
2,1,10,3,3,823,541,282
2,1,11,3,3,819,536,283
2,1,12,3,3,826,537,289
2,1,13,3,3,840,541,299
2,1,14,3,3,887,553,334
2,1,15,3,3,922,572,350
2,1,16,3,3,967,648,319
2,1,17,3,3,975,774,201
2,1,18,3,3,971,903,68
2,1,19,3,3,966,981,-15
2,1,20,3,3,976,1011,-35
2,1,21,3,3,984,1016,-32
2,2,0,3,3,1019,1054,-35
2,2,1,3,3,1014,947,67
2,2,2,3,3,1011,828,183
2,2,3,3,3,1018,757,261
2,2,4,3,3,1005,718,287
2,2,5,3,3,966,668,298
2,2,6,3,3,864,653,211
2,2,7,3,3,783,668,115
2,2,8,3,3,697,699,-2
2,2,9,3,3,671,699,-28
2,2,10,3,3,650,699,-49
2,2,11,3,3,643,698,-55
2,2,12,3,3,650,695,-45
2,2,13,3,3,664,692,-28
2,2,14,3,3,714,691,23
2,2,15,3,3,775,669,106
2,2,16,3,3,881,670,211
2,2,17,3,3,966,710,256
2,2,18,3,3,1008,787,221
2,2,19,3,3,1000,866,134
2,2,20,3,3,988,939,49
2,2,21,3,3,990,1002,-12
2,3,0,3,3,1042,1086,-44
2,3,1,3,3,1041,926,115
2,3,2,3,3,1046,726,320
2,3,3,3,3,1046,639,407
2,3,4,3,3,982,707,275
2,3,5,3,3,849,801,48
2,3,6,3,3,700,859,-159
2,3,7,3,3,613,875,-262
2,3,8,3,3,564,887,-323
2,3,9,3,3,542,901,-359
2,3,10,3,3,525,915,-390
2,3,11,3,3,517,932,-415
2,3,12,3,3,521,930,-409
2,3,13,3,3,531,918,-387
2,3,14,3,3,562,915,-353
2,3,15,3,3,617,893,-276
2,3,16,3,3,740,870,-130
2,3,17,3,3,887,817,70
2,3,18,3,3,993,804,189
2,3,19,3,3,1022,844,178
2,3,20,3,3,1013,931,82
2,3,21,3,3,1004,1034,-30
2,4,0,3,3,1056,977,79
2,4,1,3,3,1031,785,246
2,4,2,3,3,1004,594,410
2,4,3,3,3,972,520,452
2,4,4,3,3,879,611,268
2,4,5,3,3,714,760,-46
2,4,6,3,3,595,840,-245
2,4,7,3,3,553,851,-298
2,4,8,3,3,564,814,-250
2,4,9,3,3,551,800,-249
2,4,10,3,3,541,812,-271
2,4,11,3,3,536,828,-292
2,4,12,3,3,537,818,-281
2,4,13,3,3,541,821,-280
2,4,14,3,3,553,841,-288
2,4,15,3,3,572,860,-288
2,4,16,3,3,648,839,-191
2,4,17,3,3,774,764,10
2,4,18,3,3,903,705,198
2,4,19,3,3,981,711,270
2,4,20,3,3,1011,798,213
2,4,21,3,3,1016,935,81
2,5,0,3,3,1054,840,214
2,5,1,3,3,947,701,246
2,5,2,3,3,828,699,129
2,5,3,3,3,757,716,41
2,5,4,3,3,718,821,-103
2,5,5,3,3,668,914,-246
2,5,6,3,3,653,980,-327
2,5,7,3,3,668,982,-314
2,5,8,3,3,699,928,-229
2,5,9,3,3,699,887,-188
2,5,10,3,3,699,893,-194
2,5,11,3,3,698,908,-210
2,5,12,3,3,695,905,-210
2,5,13,3,3,692,915,-223
2,5,14,3,3,691,947,-256
2,5,15,3,3,669,1004,-335
2,5,16,3,3,670,983,-313
2,5,17,3,3,710,905,-195
2,5,18,3,3,787,824,-37
2,5,19,3,3,866,795,71
2,5,20,3,3,939,828,111
2,5,21,3,3,1002,903,99
2,6,0,3,3,1086,781,305
2,6,1,3,3,926,674,252
2,6,2,3,3,726,903,-177
2,6,3,3,3,639,1032,-393
2,6,4,3,3,707,1180,-473
2,6,5,3,3,801,1192,-391
2,6,6,3,3,859,1266,-407
2,6,7,3,3,875,1223,-348
2,6,8,3,3,887,1124,-237
2,6,9,3,3,901,1035,-134
2,6,10,3,3,915,1043,-128
2,6,11,3,3,932,1048,-116
2,6,12,3,3,930,1050,-120
2,6,13,3,3,918,1066,-148
2,6,14,3,3,915,1152,-237
2,6,15,3,3,893,1268,-375
2,6,16,3,3,870,1251,-381
2,6,17,3,3,817,1183,-366
2,6,18,3,3,804,1111,-307
2,6,19,3,3,844,1068,-224
2,6,20,3,3,931,1038,-107
2,6,21,3,3,1034,1002,32
2,7,0,3,3,977,939,38
2,7,1,3,3,785,870,-85
2,7,2,3,3,594,1217,-623
2,7,3,3,3,520,1457,-937
2,7,4,3,3,611,1691,-1080
2,7,5,3,3,760,1664,-904
2,7,6,3,3,840,1760,-920
2,7,7,3,3,851,1618,-767
2,7,8,3,3,814,1447,-633
2,7,9,3,3,800,1269,-469
2,7,10,3,3,812,1299,-487
2,7,11,3,3,828,1302,-474
2,7,12,3,3,818,1301,-483
2,7,13,3,3,821,1331,-510
2,7,14,3,3,841,1526,-685
2,7,15,3,3,860,1738,-878
2,7,16,3,3,839,1757,-918
2,7,17,3,3,764,1672,-908
2,7,18,3,3,705,1595,-890
2,7,19,3,3,711,1547,-836
2,7,20,3,3,798,1465,-667
2,7,21,3,3,935,1290,-355
2,8,0,3,3,840,1146,-306
2,8,1,3,3,701,1082,-381
2,8,2,3,3,699,1353,-654
2,8,3,3,3,716,1678,-962
2,8,4,3,3,821,1912,-1091
2,8,5,3,3,914,1922,-1008
2,8,6,3,3,980,1990,-1010
2,8,7,3,3,982,1773,-791
2,8,8,3,3,928,1500,-572
2,8,9,3,3,887,1189,-302
2,8,10,3,3,893,1232,-339
2,8,11,3,3,908,1225,-317
2,8,12,3,3,905,1217,-312
2,8,13,3,3,915,1290,-375
2,8,14,3,3,947,1625,-678
2,8,15,3,3,1004,1938,-934
2,8,16,3,3,983,2035,-1052
2,8,17,3,3,905,1939,-1034
2,8,18,3,3,824,1856,-1032
2,8,19,3,3,795,1808,-1013
2,8,20,3,3,828,1731,-903
2,8,21,3,3,903,1522,-619
2,9,0,3,3,781,1253,-472
2,9,1,3,3,674,1175,-501
2,9,2,3,3,903,1300,-397
2,9,3,3,3,1032,1679,-647
2,9,4,3,3,1180,1834,-654
2,9,5,3,3,1192,1922,-730
2,9,6,3,3,1266,1931,-665
2,9,7,3,3,1223,1716,-493
2,9,8,3,3,1124,1375,-251
2,9,9,3,3,1035,959,76
2,9,10,3,3,1043,998,45
2,9,11,3,3,1048,970,78
2,9,12,3,3,1050,967,83
2,9,13,3,3,1066,1088,-22
2,9,14,3,3,1152,1510,-358
2,9,15,3,3,1268,1847,-579
2,9,16,3,3,1251,2024,-773
2,9,17,3,3,1183,1931,-748
2,9,18,3,3,1111,1844,-733
2,9,19,3,3,1068,1776,-708
2,9,20,3,3,1038,1725,-687
2,9,21,3,3,1002,1596,-594
2,10,0,3,3,939,1273,-334
2,10,1,3,3,870,1193,-323
2,10,2,3,3,1217,1266,-49
2,10,3,3,3,1457,1691,-234
2,10,4,3,3,1691,1804,-113
2,10,5,3,3,1664,1935,-271
2,10,6,3,3,1760,1901,-141
2,10,7,3,3,1618,1707,-89
2,10,8,3,3,1447,1357,90
2,10,9,3,3,1269,914,355
2,10,10,3,3,1299,955,344
2,10,11,3,3,1302,904,398
2,10,12,3,3,1301,905,396
2,10,13,3,3,1331,1053,278
2,10,14,3,3,1526,1498,28
2,10,15,3,3,1738,1785,-47
2,10,16,3,3,1757,2008,-251
2,10,17,3,3,1672,1912,-240
2,10,18,3,3,1595,1823,-228
2,10,19,3,3,1547,1709,-162
2,10,20,3,3,1465,1644,-179
2,10,21,3,3,1290,1594,-304
2,11,0,3,3,1146,1155,-9
2,11,1,3,3,1082,1109,-27
2,11,2,3,3,1353,1259,94
2,11,3,3,3,1678,1715,-37
2,11,4,3,3,1912,1792,120
2,11,5,3,3,1922,1906,16
2,11,6,3,3,1990,1866,124
2,11,7,3,3,1773,1719,54
2,11,8,3,3,1500,1365,135
2,11,9,3,3,1189,933,256
2,11,10,3,3,1232,984,248
2,11,11,3,3,1225,938,287
2,11,12,3,3,1217,945,272
2,11,13,3,3,1290,1093,197
2,11,14,3,3,1625,1527,98
2,11,15,3,3,1938,1760,178
2,11,16,3,3,2035,1937,98
2,11,17,3,3,1939,1840,99
2,11,18,3,3,1856,1777,79
2,11,19,3,3,1808,1672,136
2,11,20,3,3,1731,1523,208
2,11,21,3,3,1522,1500,22
2,12,0,3,3,1253,965,288
2,12,1,3,3,1175,987,188
2,12,2,3,3,1300,1262,38
2,12,3,3,3,1679,1707,-28
2,12,4,3,3,1834,1729,105
2,12,5,3,3,1922,1812,110
2,12,6,3,3,1931,1795,136
2,12,7,3,3,1716,1650,66
2,12,8,3,3,1375,1279,96
2,12,9,3,3,959,861,98
2,12,10,3,3,998,915,83
2,12,11,3,3,970,857,113
2,12,12,3,3,967,847,120
2,12,13,3,3,1088,1006,82
2,12,14,3,3,1510,1470,40
2,12,15,3,3,1847,1727,120
2,12,16,3,3,2024,1764,260
2,12,17,3,3,1931,1613,318
2,12,18,3,3,1844,1590,254
2,12,19,3,3,1776,1611,165
2,12,20,3,3,1725,1407,318
2,12,21,3,3,1596,1364,232
2,13,0,3,3,1273,833,440
2,13,1,3,3,1193,944,249
2,13,2,3,3,1266,1327,-61
2,13,3,3,3,1691,1732,-41
2,13,4,3,3,1804,1594,210
2,13,5,3,3,1935,1537,398
2,13,6,3,3,1901,1465,436
2,13,7,3,3,1707,1405,302
2,13,8,3,3,1357,1100,257
2,13,9,3,3,914,798,116
2,13,10,3,3,955,864,91
2,13,11,3,3,904,832,72
2,13,12,3,3,905,849,56
2,13,13,3,3,1053,928,125
2,13,14,3,3,1498,1221,277
2,13,15,3,3,1785,1448,337
2,13,16,3,3,2008,1389,619
2,13,17,3,3,1912,1328,584
2,13,18,3,3,1823,1369,454
2,13,19,3,3,1709,1530,179
2,13,20,3,3,1644,1319,325
2,13,21,3,3,1594,1205,389
2,14,0,3,3,1155,920,235
2,14,1,3,3,1109,1064,45
2,14,2,3,3,1259,1382,-123
2,14,3,3,3,1715,1589,126
2,14,4,3,3,1792,1278,514
2,14,5,3,3,1906,1161,745
2,14,6,3,3,1866,1206,660
2,14,7,3,3,1719,1220,499
2,14,8,3,3,1365,1105,260
2,14,9,3,3,933,892,41
2,14,10,3,3,984,973,11
2,14,11,3,3,938,945,-7
2,14,12,3,3,945,937,8
2,14,13,3,3,1093,876,217
2,14,14,3,3,1527,1058,469
2,14,15,3,3,1760,1311,449
2,14,16,3,3,1937,1241,696
2,14,17,3,3,1840,1092,748
2,14,18,3,3,1777,1116,661
2,14,19,3,3,1672,1308,364
2,14,20,3,3,1523,1208,315
2,14,21,3,3,1500,1134,366
2,15,0,3,3,965,1008,-43
2,15,1,3,3,987,1154,-167
2,15,2,3,3,1262,1361,-99
2,15,3,3,3,1707,1415,292
2,15,4,3,3,1729,981,748
2,15,5,3,3,1812,922,890
2,15,6,3,3,1795,1163,632
2,15,7,3,3,1650,1277,373
2,15,8,3,3,1279,1257,22
2,15,9,3,3,861,1049,-188
2,15,10,3,3,915,1138,-223
2,15,11,3,3,857,1130,-273
2,15,12,3,3,847,1092,-245
2,15,13,3,3,1006,897,109
2,15,14,3,3,1470,912,558
2,15,15,3,3,1727,1101,626
2,15,16,3,3,1764,1069,695
2,15,17,3,3,1613,941,672
2,15,18,3,3,1590,995,595
2,15,19,3,3,1611,1093,518
2,15,20,3,3,1407,1038,369
2,15,21,3,3,1364,1031,333
2,16,0,3,3,833,1082,-249
2,16,1,3,3,944,1198,-254
2,16,2,3,3,1327,1249,78
2,16,3,3,3,1732,1143,589
2,16,4,3,3,1594,647,947
2,16,5,3,3,1537,720,817
2,16,6,3,3,1465,1141,324
2,16,7,3,3,1405,1234,171
2,16,8,3,3,1100,1209,-109
2,16,9,3,3,798,928,-130
2,16,10,3,3,864,1030,-166
2,16,11,3,3,832,1032,-200
2,16,12,3,3,849,955,-106
2,16,13,3,3,928,752,176
2,16,14,3,3,1221,782,439
2,16,15,3,3,1448,962,486
2,16,16,3,3,1389,939,450
2,16,17,3,3,1328,794,534
2,16,18,3,3,1369,837,532
2,16,19,3,3,1530,878,652
2,16,20,3,3,1319,879,440
2,16,21,3,3,1205,1023,182
2,17,0,3,3,920,945,-25
2,17,1,3,3,1064,1040,24
2,17,2,3,3,1382,1017,365
2,17,3,3,3,1589,896,693
2,17,4,3,3,1278,487,791
2,17,5,3,3,1161,646,515
2,17,6,3,3,1206,1074,132
2,17,7,3,3,1220,1120,100
2,17,8,3,3,1105,1011,94
2,17,9,3,3,892,696,196
2,17,10,3,3,973,830,143
2,17,11,3,3,945,846,99
2,17,12,3,3,937,762,175
2,17,13,3,3,876,634,242
2,17,14,3,3,1058,662,396
2,17,15,3,3,1311,781,530
2,17,16,3,3,1241,676,565
2,17,17,3,3,1092,602,490
2,17,18,3,3,1116,654,462
2,17,19,3,3,1308,719,589
2,17,20,3,3,1208,705,503
2,17,21,3,3,1134,833,301
2,18,0,3,3,1008,845,163
2,18,1,3,3,1154,858,296
2,18,2,3,3,1361,814,547
2,18,3,3,3,1415,729,686
2,18,4,3,3,981,456,525
2,18,5,3,3,922,544,378
2,18,6,3,3,1163,832,331
2,18,7,3,3,1277,869,408
2,18,8,3,3,1257,761,496
2,18,9,3,3,1049,504,545
2,18,10,3,3,1138,652,486
2,18,11,3,3,1130,710,420
2,18,12,3,3,1092,694,398
2,18,13,3,3,897,605,292
2,18,14,3,3,912,658,254
2,18,15,3,3,1101,716,385
2,18,16,3,3,1069,586,483
2,18,17,3,3,941,536,405
2,18,18,3,3,995,532,463
2,18,19,3,3,1093,591,502
2,18,20,3,3,1038,603,435
2,18,21,3,3,1031,676,355
2,0,0,4,3,1309,1401,-92
2,0,1,4,3,1291,1295,-4
2,0,2,4,3,1286,1183,103
2,0,3,4,3,1303,1118,185
2,0,4,4,3,1313,1058,255
2,0,5,4,3,1314,958,356
2,0,6,4,3,1271,877,394
2,0,7,4,3,1236,849,387
2,0,8,4,3,1171,852,319
2,0,9,4,3,1147,843,304
2,0,10,4,3,1129,836,293
2,0,11,4,3,1126,832,294
2,0,12,4,3,1135,831,304
2,0,13,4,3,1152,832,320
2,0,14,4,3,1194,845,349
2,0,15,4,3,1227,851,376
2,0,16,4,3,1277,910,367
2,0,17,4,3,1295,1014,281
2,0,18,4,3,1287,1131,156
2,0,19,4,3,1275,1214,61
2,0,20,4,3,1286,1277,9
2,0,21,4,3,1298,1335,-37
2,1,0,4,3,1343,1442,-99
2,1,1,4,3,1338,1287,51
2,1,2,4,3,1336,1090,246
2,1,3,4,3,1344,992,352
2,1,4,4,3,1327,1010,317
2,1,5,4,3,1283,1018,265
2,1,6,4,3,1181,1036,145
2,1,7,4,3,1104,1051,53
2,1,8,4,3,1015,1091,-76
2,1,9,4,3,984,1101,-117
2,1,10,4,3,960,1112,-152
2,1,11,4,3,953,1127,-174
2,1,12,4,3,962,1125,-163
2,1,13,4,3,980,1114,-134
2,1,14,4,3,1041,1101,-60
2,1,15,4,3,1104,1072,32
2,1,16,4,3,1207,1064,143
2,1,17,4,3,1279,1063,216
2,1,18,4,3,1315,1108,207
2,1,19,4,3,1314,1186,128
2,1,20,4,3,1314,1284,30
2,1,21,4,3,1317,1379,-62
2,2,0,4,3,1375,1330,45
2,2,1,4,3,1375,1107,268
2,2,2,4,3,1375,879,496
2,2,3,4,3,1371,778,593
2,2,4,4,3,1308,847,461
2,2,5,4,3,1183,967,216
2,2,6,4,3,1041,1034,7
2,2,7,4,3,959,1047,-88
2,2,8,4,3,901,1021,-120
2,2,9,4,3,871,1007,-136
2,2,10,4,3,847,1019,-172
2,2,11,4,3,838,1035,-197
2,2,12,4,3,845,1024,-179
2,2,13,4,3,860,1026,-166
2,2,14,4,3,900,1054,-154
2,2,15,4,3,954,1071,-117
2,2,16,4,3,1075,1053,22
2,2,17,4,3,1212,988,224
2,2,18,4,3,1312,960,352
2,2,19,4,3,1342,1002,340
2,2,20,4,3,1341,1118,223
2,2,21,4,3,1335,1273,62
2,3,0,4,3,1395,1185,210
2,3,1,4,3,1363,965,398
2,3,2,4,3,1331,878,453
2,3,3,4,3,1304,862,442
2,3,4,4,3,1218,1000,218
2,3,5,4,3,1056,1158,-102
2,3,6,4,3,894,1262,-368
2,3,7,4,3,809,1278,-469
2,3,8,4,3,771,1216,-445
2,3,9,4,3,749,1179,-430
2,3,10,4,3,732,1188,-456
2,3,11,4,3,724,1204,-480
2,3,12,4,3,727,1199,-472
2,3,13,4,3,736,1206,-470
2,3,14,4,3,775,1239,-464
2,3,15,4,3,828,1283,-455
2,3,16,4,3,954,1245,-291
2,3,17,4,3,1111,1145,-34
2,3,18,4,3,1248,1052,196
2,3,19,4,3,1313,1028,285
2,3,20,4,3,1333,1094,239
2,3,21,4,3,1342,1222,120
2,4,0,4,3,1401,1169,232
2,4,1,4,3,1295,1014,281
2,4,2,4,3,1183,1165,18
2,4,3,4,3,1118,1267,-149
2,4,4,4,3,1058,1472,-414
2,4,5,4,3,958,1542,-584
2,4,6,4,3,877,1649,-772
2,4,7,4,3,849,1606,-757
2,4,8,4,3,852,1516,-664
2,4,9,4,3,843,1437,-594
2,4,10,4,3,836,1456,-620
2,4,11,4,3,832,1477,-645
2,4,12,4,3,831,1480,-649
2,4,13,4,3,832,1488,-656
2,4,14,4,3,845,1562,-717
2,4,15,4,3,851,1671,-820
2,4,16,4,3,910,1645,-735
2,4,17,4,3,1014,1536,-522
2,4,18,4,3,1131,1432,-301
2,4,19,4,3,1214,1388,-174
2,4,20,4,3,1277,1383,-106
2,4,21,4,3,1335,1379,-44
2,5,0,4,3,1442,1183,259
2,5,1,4,3,1287,1051,236
2,5,2,4,3,1090,1370,-280
2,5,3,4,3,992,1596,-604
2,5,4,4,3,1010,1831,-821
2,5,5,4,3,1018,1830,-812
2,5,6,4,3,1036,1935,-899
2,5,7,4,3,1051,1790,-739
2,5,8,4,3,1091,1581,-490
2,5,9,4,3,1101,1375,-274
2,5,10,4,3,1112,1403,-291
2,5,11,4,3,1127,1405,-278
2,5,12,4,3,1125,1395,-270
2,5,13,4,3,1114,1439,-325
2,5,14,4,3,1101,1665,-564
2,5,15,4,3,1072,1916,-844
2,5,16,4,3,1064,1940,-876
2,5,17,4,3,1063,1843,-780
2,5,18,4,3,1108,1751,-643
2,5,19,4,3,1186,1705,-519
2,5,20,4,3,1284,1652,-368
2,5,21,4,3,1379,1529,-150
2,6,0,4,3,1330,1354,-24
2,6,1,4,3,1107,1262,-155
2,6,2,4,3,879,1637,-758
2,6,3,4,3,778,2020,-1242
2,6,4,4,3,847,2301,-1454
2,6,5,4,3,967,2320,-1353
2,6,6,4,3,1034,2412,-1378
2,6,7,4,3,1047,2200,-1153
2,6,8,4,3,1021,1902,-881
2,6,9,4,3,1007,1568,-561
2,6,10,4,3,1019,1608,-589
2,6,11,4,3,1035,1601,-566
2,6,12,4,3,1024,1598,-574
2,6,13,4,3,1026,1675,-649
2,6,14,4,3,1054,2023,-969
2,6,15,4,3,1071,2361,-1290
2,6,16,4,3,1053,2441,-1388
2,6,17,4,3,988,2320,-1332
2,6,18,4,3,960,2203,-1243
2,6,19,4,3,1002,2125,-1123
2,6,20,4,3,1118,2027,-909
2,6,21,4,3,1273,1809,-536
2,7,0,4,3,1185,1582,-397
2,7,1,4,3,965,1488,-523
2,7,2,4,3,878,1766,-888
2,7,3,4,3,862,2230,-1368
2,7,4,4,3,1000,2485,-1485
2,7,5,4,3,1158,2550,-1392
2,7,6,4,3,1262,2600,-1338
2,7,7,4,3,1278,2340,-1062
2,7,8,4,3,1216,1963,-747
2,7,9,4,3,1179,1509,-330
2,7,10,4,3,1188,1561,-373
2,7,11,4,3,1204,1539,-335
2,7,12,4,3,1199,1542,-343
2,7,13,4,3,1206,1661,-455
2,7,14,4,3,1239,2125,-886
2,7,15,4,3,1283,2514,-1231
2,7,16,4,3,1245,2686,-1441
2,7,17,4,3,1145,2562,-1417
2,7,18,4,3,1052,2452,-1400
2,7,19,4,3,1028,2369,-1341
2,7,20,4,3,1094,2280,-1186
2,7,21,4,3,1222,2072,-850
2,8,0,4,3,1169,1675,-506
2,8,1,4,3,1014,1570,-556
2,8,2,4,3,1165,1733,-568
2,8,3,4,3,1267,2255,-988
2,8,4,4,3,1472,2455,-983
2,8,5,4,3,1542,2573,-1031
2,8,6,4,3,1649,2570,-921
2,8,7,4,3,1606,2274,-668
2,8,8,4,3,1516,1814,-298
2,8,9,4,3,1437,1254,183
2,8,10,4,3,1456,1315,141
2,8,11,4,3,1477,1261,216
2,8,12,4,3,1480,1250,230
2,8,13,4,3,1488,1426,62
2,8,14,4,3,1562,2011,-449
2,8,15,4,3,1671,2433,-762
2,8,16,4,3,1645,2697,-1052
2,8,17,4,3,1536,2572,-1036
2,8,18,4,3,1432,2463,-1031
2,8,19,4,3,1388,2346,-958
2,8,20,4,3,1383,2258,-875
2,8,21,4,3,1379,2121,-742
2,9,0,4,3,1183,1570,-387
2,9,1,4,3,1051,1501,-450
2,9,2,4,3,1370,1679,-309
2,9,3,4,3,1596,2278,-682
2,9,4,4,3,1831,2402,-571
2,9,5,4,3,1830,2562,-732
2,9,6,4,3,1935,2518,-583
2,9,7,4,3,1790,2301,-511
2,9,8,4,3,1581,1820,-239
2,9,9,4,3,1375,1232,143
2,9,10,4,3,1403,1293,110
2,9,11,4,3,1405,1237,168
2,9,12,4,3,1395,1242,153
2,9,13,4,3,1439,1437,2
2,9,14,4,3,1665,2024,-359
2,9,15,4,3,1916,2383,-467
2,9,16,4,3,1940,2621,-681
2,9,17,4,3,1843,2488,-645
2,9,18,4,3,1751,2385,-634
2,9,19,4,3,1705,2250,-545
2,9,20,4,3,1652,2085,-433
2,9,21,4,3,1529,2019,-490
2,10,0,4,3,1354,1401,-47
2,10,1,4,3,1262,1393,-131
2,10,2,4,3,1637,1675,-38
2,10,3,4,3,2020,2259,-239
2,10,4,4,3,2301,2302,-1
2,10,5,4,3,2320,2440,-120
2,10,6,4,3,2412,2405,7
2,10,7,4,3,2200,2217,-17
2,10,8,4,3,1902,1742,160
2,10,9,4,3,1568,1181,387
2,10,10,4,3,1608,1244,364
2,10,11,4,3,1601,1171,430
2,10,12,4,3,1598,1172,426
2,10,13,4,3,1675,1377,298
2,10,14,4,3,2023,1970,53
2,10,15,4,3,2361,2303,58
2,10,16,4,3,2441,2415,26
2,10,17,4,3,2320,2236,84
2,10,18,4,3,2203,2186,17
2,10,19,4,3,2125,2172,-47
2,10,20,4,3,2027,1956,71
2,10,21,4,3,1809,1914,-105
2,11,0,4,3,1582,1255,327
2,11,1,4,3,1488,1339,149
2,11,2,4,3,1766,1760,6
2,11,3,4,3,2230,2308,-78
2,11,4,4,3,2485,2215,270
2,11,5,4,3,2550,2188,362
2,11,6,4,3,2600,2104,496
2,11,7,4,3,2340,1963,377
2,11,8,4,3,1963,1539,424
2,11,9,4,3,1509,1093,416
2,11,10,4,3,1561,1181,380
2,11,11,4,3,1539,1123,416
2,11,12,4,3,1542,1132,410
2,11,13,4,3,1661,1266,395
2,11,14,4,3,2125,1722,403
2,11,15,4,3,2514,2034,480
2,11,16,4,3,2686,2062,624
2,11,17,4,3,2562,1969,593
2,11,18,4,3,2452,1988,464
2,11,19,4,3,2369,2100,269
2,11,20,4,3,2280,1852,428
2,11,21,4,3,2072,1730,342
2,12,0,4,3,1675,1217,458
2,12,1,4,3,1570,1372,198
2,12,2,4,3,1733,1795,-62
2,12,3,4,3,2255,2176,79
2,12,4,4,3,2455,1876,579
2,12,5,4,3,2573,1788,785
2,12,6,4,3,2570,1823,747
2,12,7,4,3,2274,1814,460
2,12,8,4,3,1814,1568,246
2,12,9,4,3,1254,1210,44
2,12,10,4,3,1315,1311,4
2,12,11,4,3,1261,1278,-17
2,12,12,4,3,1250,1274,-24
2,12,13,4,3,1426,1260,166
2,12,14,4,3,2011,1584,427
2,12,15,4,3,2433,1909,524
2,12,16,4,3,2697,1854,843
2,12,17,4,3,2572,1668,904
2,12,18,4,3,2463,1678,785
2,12,19,4,3,2346,1849,497
2,12,20,4,3,2258,1649,609
2,12,21,4,3,2121,1559,562
2,13,0,4,3,1570,1254,316
2,13,1,4,3,1501,1438,63
2,13,2,4,3,1679,1777,-98
2,13,3,4,3,2278,1959,319
2,13,4,4,3,2402,1491,911
2,13,5,4,3,2562,1456,1106
2,13,6,4,3,2518,1702,816
2,13,7,4,3,2301,1775,526
2,13,8,4,3,1820,1634,186
2,13,9,4,3,1232,1297,-65
2,13,10,4,3,1293,1398,-105
2,13,11,4,3,1237,1363,-126
2,13,12,4,3,1242,1319,-77
2,13,13,4,3,1437,1181,256
2,13,14,4,3,2024,1355,669
2,13,15,4,3,2383,1644,739
2,13,16,4,3,2621,1547,1074
2,13,17,4,3,2488,1337,1151
2,13,18,4,3,2385,1404,981
2,13,19,4,3,2250,1593,657
2,13,20,4,3,2085,1471,614
2,13,21,4,3,2019,1445,574
2,14,0,4,3,1401,1372,29
2,14,1,4,3,1393,1550,-157
2,14,2,4,3,1675,1747,-72
2,14,3,4,3,2259,1744,515
2,14,4,4,3,2302,1133,1169
2,14,5,4,3,2440,1096,1344
2,14,6,4,3,2405,1450,955
2,14,7,4,3,2217,1547,670
2,14,8,4,3,1742,1469,273
2,14,9,4,3,1181,1160,21
2,14,10,4,3,1244,1296,-52
2,14,11,4,3,1171,1298,-127
2,14,12,4,3,1172,1240,-68
2,14,13,4,3,1377,1012,365
2,14,14,4,3,1970,1034,936
2,14,15,4,3,2303,1269,1034
2,14,16,4,3,2415,1237,1178
2,14,17,4,3,2236,1150,1086
2,14,18,4,3,2186,1235,951
2,14,19,4,3,2172,1367,805
2,14,20,4,3,1956,1324,632
2,14,21,4,3,1914,1389,525
2,15,0,4,3,1255,1329,-74
2,15,1,4,3,1339,1468,-129
2,15,2,4,3,1760,1485,275
2,15,3,4,3,2308,1340,968
2,15,4,4,3,2215,769,1446
2,15,5,4,3,2188,897,1291
2,15,6,4,3,2104,1432,672
2,15,7,4,3,1963,1529,434
2,15,8,4,3,1539,1479,60
2,15,9,4,3,1093,1108,-15
2,15,10,4,3,1181,1277,-96
2,15,11,4,3,1123,1292,-169
2,15,12,4,3,1132,1187,-55
2,15,13,4,3,1266,966,300
2,15,14,4,3,1722,1025,697
2,15,15,4,3,2034,1242,792
2,15,16,4,3,2062,1141,921
2,15,17,4,3,1969,942,1027
2,15,18,4,3,1988,963,1025
2,15,19,4,3,2100,1038,1062
2,15,20,4,3,1852,1035,817
2,15,21,4,3,1730,1187,543
2,16,0,4,3,1217,1179,38
2,16,1,4,3,1372,1232,140
2,16,2,4,3,1795,1209,586
2,16,3,4,3,2176,1099,1077
2,16,4,4,3,1876,669,1207
2,16,5,4,3,1788,839,949
2,16,6,4,3,1823,1328,495
2,16,7,4,3,1814,1424,390
2,16,8,4,3,1568,1290,278
2,16,9,4,3,1210,909,301
2,16,10,4,3,1311,1077,234
2,16,11,4,3,1278,1128,150
2,16,12,4,3,1274,1076,198
2,16,13,4,3,1260,910,350
2,16,14,4,3,1584,955,629
2,16,15,4,3,1909,1049,860
2,16,16,4,3,1854,892,962
2,16,17,4,3,1668,781,887
2,16,18,4,3,1678,820,858
2,16,19,4,3,1849,876,973
2,16,20,4,3,1649,866,783
2,16,21,4,3,1559,987,572
2,0,0,5,3,1656,1686,-30
2,0,1,5,3,1639,1468,171
2,0,2,5,3,1641,1243,398
2,0,3,5,3,1664,1131,533
2,0,4,5,3,1653,1150,503
2,0,5,5,3,1604,1184,420
2,0,6,5,3,1495,1211,284
2,0,7,5,3,1417,1223,194
2,0,8,5,3,1324,1225,99
2,0,9,5,3,1291,1207,84
2,0,10,5,3,1266,1216,50
2,0,11,5,3,1260,1230,30
2,0,12,5,3,1271,1219,52
2,0,13,5,3,1292,1222,70
2,0,14,5,3,1348,1240,108
2,0,15,5,3,1409,1250,159
2,0,16,5,3,1517,1247,270
2,0,17,5,3,1599,1234,365
2,0,18,5,3,1631,1264,367
2,0,19,5,3,1623,1344,279
2,0,20,5,3,1624,1471,153
2,0,21,5,3,1631,1618,13
2,1,0,5,3,1699,1538,161
2,1,1,5,3,1699,1287,412
2,1,2,5,3,1700,1163,537
2,1,3,5,3,1697,1120,577
2,1,4,5,3,1630,1236,394
2,1,5,5,3,1500,1365,135
2,1,6,5,3,1358,1456,-98
2,1,7,5,3,1280,1474,-194
2,1,8,5,3,1219,1423,-204
2,1,9,5,3,1184,1386,-202
2,1,10,5,3,1157,1395,-238
2,1,11,5,3,1148,1411,-263
2,1,12,5,3,1157,1405,-248
2,1,13,5,3,1176,1411,-235
2,1,14,5,3,1227,1452,-225
2,1,15,5,3,1283,1494,-211
2,1,16,5,3,1401,1459,-58
2,1,17,5,3,1525,1369,156
2,1,18,5,3,1619,1307,312
2,1,19,5,3,1656,1319,337
2,1,20,5,3,1667,1414,253
2,1,21,5,3,1662,1560,102
2,2,0,5,3,1728,1514,214
2,2,1,5,3,1697,1278,419
2,2,2,5,3,1660,1344,316
2,2,3,5,3,1629,1413,216
2,2,4,5,3,1544,1651,-107
2,2,5,5,3,1390,1786,-396
2,2,6,5,3,1235,1931,-696
2,2,7,5,3,1155,1902,-747
2,2,8,5,3,1108,1804,-696
2,2,9,5,3,1078,1729,-651
2,2,10,5,3,1054,1751,-697
2,2,11,5,3,1045,1773,-728
2,2,12,5,3,1051,1774,-723
2,2,13,5,3,1065,1779,-714
2,2,14,5,3,1113,1854,-741
2,2,15,5,3,1165,1950,-785
2,2,16,5,3,1289,1907,-618
2,2,17,5,3,1436,1776,-340
2,2,18,5,3,1567,1660,-93
2,2,19,5,3,1633,1621,12
2,2,20,5,3,1661,1649,12
2,2,21,5,3,1673,1698,-25
2,3,0,5,3,1740,1571,169
2,3,1,5,3,1627,1391,236
2,3,2,5,3,1510,1632,-122
2,3,3,5,3,1450,1831,-381
2,3,4,5,3,1397,2123,-726
2,3,5,5,3,1300,2180,-880
2,3,6,5,3,1176,2318,-1142
2,3,7,5,3,1105,2173,-1068
2,3,8,5,3,1059,1973,-914
2,3,9,5,3,1041,1777,-736
2,3,10,5,3,1027,1816,-789
2,3,11,5,3,1020,1834,-814
2,3,12,5,3,1021,1825,-804
2,3,13,5,3,1027,1861,-834
2,3,14,5,3,1067,2075,-1008
2,3,15,5,3,1107,2319,-1212
2,3,16,5,3,1216,2334,-1118
2,3,17,5,3,1351,2196,-845
2,3,18,5,3,1476,2072,-596
2,3,19,5,3,1546,2025,-479
2,3,20,5,3,1599,1997,-398
2,3,21,5,3,1661,1906,-245
2,4,0,5,3,1789,1598,191
2,4,1,5,3,1635,1443,192
2,4,2,5,3,1445,1790,-345
2,4,3,5,3,1353,2159,-806
2,4,4,5,3,1350,2441,-1091
2,4,5,5,3,1308,2486,-1178
2,4,6,5,3,1260,2587,-1327
2,4,7,5,3,1232,2372,-1140
2,4,8,5,3,1244,2036,-792
2,4,9,5,3,1245,1674,-429
2,4,10,5,3,1249,1712,-463
2,4,11,5,3,1261,1704,-443
2,4,12,5,3,1261,1692,-431
2,4,13,5,3,1254,1783,-529
2,4,14,5,3,1255,2162,-907
2,4,15,5,3,1254,2539,-1285
2,4,16,5,3,1304,2624,-1320
2,4,17,5,3,1367,2491,-1124
2,4,18,5,3,1452,2359,-907
2,4,19,5,3,1534,2283,-749
2,4,20,5,3,1622,2214,-592
2,4,21,5,3,1712,2048,-336
2,5,0,5,3,1686,1790,-104
2,5,1,5,3,1468,1668,-200
2,5,2,5,3,1243,2050,-807
2,5,3,5,3,1131,2572,-1441
2,5,4,5,3,1150,2874,-1724
2,5,5,5,3,1184,2948,-1764
2,5,6,5,3,1211,3022,-1811
2,5,7,5,3,1223,2767,-1544
2,5,8,5,3,1225,2365,-1140
2,5,9,5,3,1207,1888,-681
2,5,10,5,3,1216,1937,-721
2,5,11,5,3,1230,1915,-685
2,5,12,5,3,1219,1923,-704
2,5,13,5,3,1222,2046,-824
2,5,14,5,3,1240,2523,-1283
2,5,15,5,3,1250,2937,-1687
2,5,16,5,3,1247,3092,-1845
2,5,17,5,3,1234,2943,-1709
2,5,18,5,3,1264,2799,-1535
2,5,19,5,3,1344,2686,-1342
2,5,20,5,3,1471,2576,-1105
2,5,21,5,3,1618,2359,-741
2,6,0,5,3,1538,2004,-466
2,6,1,5,3,1287,1883,-596
2,6,2,5,3,1163,2199,-1036
2,6,3,5,3,1120,2806,-1686
2,6,4,5,3,1236,3106,-1870
2,6,5,5,3,1365,3201,-1836
2,6,6,5,3,1456,3239,-1783
2,6,7,5,3,1474,2898,-1424
2,6,8,5,3,1423,2402,-979
2,6,9,5,3,1386,1804,-418
2,6,10,5,3,1395,1878,-483
2,6,11,5,3,1411,1830,-419
2,6,12,5,3,1405,1825,-420
2,6,13,5,3,1411,1999,-588
2,6,14,5,3,1452,2626,-1174
2,6,15,5,3,1494,3100,-1606
2,6,16,5,3,1459,3359,-1900
2,6,17,5,3,1369,3203,-1834
2,6,18,5,3,1307,3071,-1764
2,6,19,5,3,1319,2939,-1620
2,6,20,5,3,1414,2813,-1399
2,6,21,5,3,1560,2597,-1037
2,7,0,5,3,1514,1972,-458
2,7,1,5,3,1278,1878,-600
2,7,2,5,3,1344,2146,-802
2,7,3,5,3,1413,2842,-1429
2,7,4,5,3,1651,3053,-1402
2,7,5,5,3,1786,3200,-1414
2,7,6,5,3,1931,3187,-1256
2,7,7,5,3,1902,2868,-966
2,7,8,5,3,1804,2277,-473
2,7,9,5,3,1729,1572,157
2,7,10,5,3,1751,1653,98
2,7,11,5,3,1773,1594,179
2,7,12,5,3,1774,1587,187
2,7,13,5,3,1779,1810,-31
2,7,14,5,3,1854,2537,-683
2,7,15,5,3,1950,3031,-1081
2,7,16,5,3,1907,3310,-1403
2,7,17,5,3,1776,3148,-1372
2,7,18,5,3,1660,3025,-1365
2,7,19,5,3,1621,2887,-1266
2,7,20,5,3,1649,2699,-1050
2,7,21,5,3,1698,2546,-848
2,8,0,5,3,1571,1816,-245
2,8,1,5,3,1391,1785,-394
2,8,2,5,3,1632,2095,-463
2,8,3,5,3,1831,2822,-991
2,8,4,5,3,2123,2912,-789
2,8,5,5,3,2180,3096,-916
2,8,6,5,3,2318,3057,-739
2,8,7,5,3,2173,2799,-626
2,8,8,5,3,1973,2197,-224
2,8,9,5,3,1777,1480,297
2,8,10,5,3,1816,1553,263
2,8,11,5,3,1834,1470,364
2,8,12,5,3,1825,1469,356
2,8,13,5,3,1861,1721,140
2,8,14,5,3,2075,2467,-392
2,8,15,5,3,2319,2926,-607
2,8,16,5,3,2334,3099,-765
2,8,17,5,3,2196,2884,-688
2,8,18,5,3,2072,2794,-722
2,8,19,5,3,2025,2750,-725
2,8,20,5,3,1997,2518,-521
2,8,21,5,3,1906,2433,-527
2,9,0,5,3,1598,1691,-93
2,9,1,5,3,1443,1745,-302
2,9,2,5,3,1790,2173,-383
2,9,3,5,3,2159,2860,-701
2,9,4,5,3,2441,2788,-347
2,9,5,5,3,2486,2816,-330
2,9,6,5,3,2587,2714,-127
2,9,7,5,3,2372,2530,-158
2,9,8,5,3,2036,2002,34
2,9,9,5,3,1674,1413,261
2,9,10,5,3,1712,1510,202
2,9,11,5,3,1704,1437,267
2,9,12,5,3,1692,1457,235
2,9,13,5,3,1783,1637,146
2,9,14,5,3,2162,2222,-60
2,9,15,5,3,2539,2610,-71
2,9,16,5,3,2624,2713,-89
2,9,17,5,3,2491,2592,-101
2,9,18,5,3,2359,2584,-225
2,9,19,5,3,2283,2661,-378
2,9,20,5,3,2214,2401,-187
2,9,21,5,3,2048,2280,-232
2,10,0,5,3,1790,1639,151
2,10,1,5,3,1668,1767,-99
2,10,2,5,3,2050,2228,-178
2,10,3,5,3,2572,2752,-180
2,10,4,5,3,2874,2497,377
2,10,5,5,3,2948,2439,509
2,10,6,5,3,3022,2462,560
2,10,7,5,3,2767,2372,395
2,10,8,5,3,2365,2007,358
2,10,9,5,3,1888,1505,383
2,10,10,5,3,1937,1628,309
2,10,11,5,3,1915,1569,346
2,10,12,5,3,1923,1557,366
2,10,13,5,3,2046,1598,448
2,10,14,5,3,2523,2085,438
2,10,15,5,3,2937,2495,442
2,10,16,5,3,3092,2527,565
2,10,17,5,3,2943,2309,634
2,10,18,5,3,2799,2297,502
2,10,19,5,3,2686,2419,267
2,10,20,5,3,2576,2182,394
2,10,21,5,3,2359,2084,275
2,11,0,5,3,2004,1551,453
2,11,1,5,3,1883,1746,137
2,11,2,5,3,2199,2190,9
2,11,3,5,3,2806,2546,260
2,11,4,5,3,3106,2089,1017
2,11,5,5,3,3201,2083,1118
2,11,6,5,3,3239,2319,920
2,11,7,5,3,2898,2369,529
2,11,8,5,3,2402,2097,305
2,11,9,5,3,1804,1615,189
2,11,10,5,3,1878,1736,142
2,11,11,5,3,1830,1696,134
2,11,12,5,3,1825,1656,169
2,11,13,5,3,1999,1565,434
2,11,14,5,3,2626,1881,745
2,11,15,5,3,3100,2242,858
2,11,16,5,3,3359,2160,1199
2,11,17,5,3,3203,1913,1290
2,11,18,5,3,3071,1966,1105
2,11,19,5,3,2939,2134,805
2,11,20,5,3,2813,1912,901
2,11,21,5,3,2597,1870,727
2,12,0,5,3,1972,1618,354
2,12,1,5,3,1878,1834,44
2,12,2,5,3,2146,2163,-17
2,12,3,5,3,2842,2288,554
2,12,4,5,3,3053,1643,1410
2,12,5,5,3,3200,1630,1570
2,12,6,5,3,3187,1989,1198
2,12,7,5,3,2868,2045,823
2,12,8,5,3,2277,1846,431
2,12,9,5,3,1572,1408,164
2,12,10,5,3,1653,1556,97
2,12,11,5,3,1594,1531,63
2,12,12,5,3,1587,1467,120
2,12,13,5,3,1810,1296,514
2,12,14,5,3,2537,1477,1060
2,12,15,5,3,3031,1812,1219
2,12,16,5,3,3310,1715,1595
2,12,17,5,3,3148,1546,1602
2,12,18,5,3,3025,1644,1381
2,12,19,5,3,2887,1867,1020
2,12,20,5,3,2699,1757,942
2,12,21,5,3,2546,1803,743
2,13,0,5,3,1816,1619,197
2,13,1,5,3,1785,1820,-35
2,13,2,5,3,2095,1983,112
2,13,3,5,3,2822,1941,881
2,13,4,5,3,2912,1255,1657
2,13,5,5,3,3096,1273,1823
2,13,6,5,3,3057,1741,1316
2,13,7,5,3,2799,1842,957
2,13,8,5,3,2197,1739,458
2,13,9,5,3,1480,1340,140
2,13,10,5,3,1553,1543,10
2,13,11,5,3,1470,1558,-88
2,13,12,5,3,1469,1472,-3
2,13,13,5,3,1721,1226,495
2,13,14,5,3,2467,1277,1190
2,13,15,5,3,2926,1549,1377
2,13,16,5,3,3099,1439,1660
2,13,17,5,3,2884,1298,1586
2,13,18,5,3,2794,1361,1433
2,13,19,5,3,2750,1527,1223
2,13,20,5,3,2518,1480,1038
2,13,21,5,3,2433,1553,880
2,14,0,5,3,1691,1563,128
2,14,1,5,3,1745,1660,85
2,14,2,5,3,2173,1677,496
2,14,3,5,3,2860,1543,1317
2,14,4,5,3,2788,951,1837
2,14,5,5,3,2816,1090,1726
2,14,6,5,3,2714,1686,1028
2,14,7,5,3,2530,1833,697
2,14,8,5,3,2002,1758,244
2,14,9,5,3,1413,1321,92
2,14,10,5,3,1510,1524,-14
2,14,11,5,3,1437,1574,-137
2,14,12,5,3,1457,1501,-44
2,14,13,5,3,1637,1242,395
2,14,14,5,3,2222,1318,904
2,14,15,5,3,2610,1510,1100
2,14,16,5,3,2713,1357,1356
2,14,17,5,3,2592,1121,1471
2,14,18,5,3,2584,1129,1455
2,14,19,5,3,2661,1195,1466
2,14,20,5,3,2401,1196,1205
2,14,21,5,3,2280,1341,939
2,0,0,6,3,2012,1867,145
2,0,1,6,3,2000,1600,400
2,0,2,6,3,2005,1629,376
2,0,3,6,3,2017,1671,346
2,0,4,6,3,1956,1887,69
2,0,5,6,3,1821,1993,-172
2,0,6,6,3,1672,2125,-453
2,0,7,6,3,1593,2098,-505
2,0,8,6,3,1528,2011,-483
2,0,9,6,3,1491,1936,-445
2,0,10,6,3,1463,1958,-495
2,0,11,6,3,1455,1980,-525
2,0,12,6,3,1466,1980,-514
2,0,13,6,3,1488,1984,-496
2,0,14,6,3,1534,2067,-533
2,0,15,6,3,1588,2161,-573
2,0,16,6,3,1711,2121,-410
2,0,17,6,3,1845,2000,-155
2,0,18,6,3,1935,1915,20
2,0,19,6,3,1965,1912,53
2,0,20,6,3,1977,1969,8
2,0,21,6,3,1976,2036,-60
2,1,0,6,3,2052,1916,136
2,1,1,6,3,2021,1655,366
2,1,2,6,3,1985,1811,174
2,1,3,6,3,1955,1977,-22
2,1,4,6,3,1866,2302,-436
2,1,5,6,3,1707,2424,-717
2,1,6,6,3,1552,2600,-1048
2,1,7,6,3,1476,2469,-993
2,1,8,6,3,1426,2261,-835
2,1,9,6,3,1391,2069,-678
2,1,10,6,3,1364,2111,-747
2,1,11,6,3,1355,2130,-775
2,1,12,6,3,1363,2119,-756
2,1,13,6,3,1381,2152,-771
2,1,14,6,3,1440,2367,-927
2,1,15,6,3,1494,2598,-1104
2,1,16,6,3,1615,2596,-981
2,1,17,6,3,1749,2436,-687
2,1,18,6,3,1874,2300,-426
2,1,19,6,3,1947,2258,-311
2,1,20,6,3,1987,2263,-276
2,1,21,6,3,2000,2225,-225
2,2,0,6,3,2073,1986,87
2,2,1,6,3,1961,1783,178
2,2,2,6,3,1839,2052,-213
2,2,3,6,3,1775,2394,-619
2,2,4,6,3,1723,2733,-1010
2,2,5,6,3,1634,2836,-1202
2,2,6,6,3,1517,2970,-1453
2,2,7,6,3,1451,2755,-1304
2,2,8,6,3,1396,2428,-1032
2,2,9,6,3,1370,2076,-706
2,2,10,6,3,1349,2125,-776
2,2,11,6,3,1341,2133,-792
2,2,12,6,3,1345,2122,-777
2,2,13,6,3,1356,2205,-849
2,2,14,6,3,1405,2572,-1167
2,2,15,6,3,1444,2942,-1498
2,2,16,6,3,1551,3018,-1467
2,2,17,6,3,1676,2844,-1168
2,2,18,6,3,1795,2680,-885
2,2,19,6,3,1866,2603,-737
2,2,20,6,3,1927,2559,-632
2,2,21,6,3,1992,2425,-433
2,3,0,6,3,2128,2034,94
2,3,1,6,3,1967,1849,118
2,3,2,6,3,1772,2203,-431
2,3,3,6,3,1685,2711,-1026
2,3,4,6,3,1689,3014,-1325
2,3,5,6,3,1650,3114,-1464
2,3,6,6,3,1559,3197,-1638
2,3,7,6,3,1488,2939,-1451
2,3,8,6,3,1451,2499,-1048
2,3,9,6,3,1443,1994,-551
2,3,10,6,3,1440,2041,-601
2,3,11,6,3,1449,2018,-569
2,3,12,6,3,1451,2017,-566
2,3,13,6,3,1449,2154,-705
2,3,14,6,3,1477,2662,-1185
2,3,15,6,3,1510,3115,-1605
2,3,16,6,3,1610,3275,-1665
2,3,17,6,3,1704,3114,-1410
2,3,18,6,3,1797,2955,-1158
2,3,19,6,3,1866,2844,-978
2,3,20,6,3,1944,2763,-819
2,3,21,6,3,2038,2598,-560
2,4,0,6,3,2033,2212,-179
2,4,1,6,3,1816,2063,-247
2,4,2,6,3,1598,2483,-885
2,4,3,6,3,1492,3148,-1656
2,4,4,6,3,1490,3495,-2005
2,4,5,6,3,1474,3599,-2125
2,4,6,6,3,1435,3661,-2226
2,4,7,6,3,1404,3325,-1921
2,4,8,6,3,1378,2804,-1426
2,4,9,6,3,1351,2183,-832
2,4,10,6,3,1353,2254,-901
2,4,11,6,3,1364,2206,-842
2,4,12,6,3,1355,2206,-851
2,4,13,6,3,1362,2384,-1022
2,4,14,6,3,1394,3024,-1630
2,4,15,6,3,1432,3523,-2091
2,4,16,6,3,1487,3765,-2278
2,4,17,6,3,1538,3584,-2046
2,4,18,6,3,1608,3418,-1810
2,4,19,6,3,1692,3256,-1564
2,4,20,6,3,1809,3109,-1300
2,4,21,6,3,1951,2884,-933
2,5,0,6,3,1894,2301,-407
2,5,1,6,3,1648,2191,-543
2,5,2,6,3,1527,2612,-1085
2,5,3,6,3,1473,3393,-1920
2,5,4,6,3,1539,3704,-2165
2,5,5,6,3,1582,3828,-2246
2,5,6,6,3,1633,3856,-2223
2,5,7,6,3,1650,3492,-1842
2,5,8,6,3,1627,2865,-1238
2,5,9,6,3,1586,2122,-536
2,5,10,6,3,1592,2216,-624
2,5,11,6,3,1606,2163,-557
2,5,12,6,3,1600,2162,-562
2,5,13,6,3,1607,2383,-776
2,5,14,6,3,1638,3152,-1514
2,5,15,6,3,1673,3698,-2025
2,5,16,6,3,1653,3972,-2319
2,5,17,6,3,1615,3779,-2164
2,5,18,6,3,1611,3633,-2022
2,5,19,6,3,1661,3480,-1819
2,5,20,6,3,1767,3254,-1487
2,5,21,6,3,1905,3022,-1117
2,6,0,6,3,1867,2218,-351
2,6,1,6,3,1600,2162,-562
2,6,2,6,3,1629,2562,-933
2,6,3,6,3,1671,3386,-1715
2,6,4,6,3,1887,3563,-1676
2,6,5,6,3,1993,3734,-1741
2,6,6,6,3,2125,3726,-1601
2,6,7,6,3,2098,3366,-1268
2,6,8,6,3,2011,2654,-643
2,6,9,6,3,1936,1820,116
2,6,10,6,3,1958,1913,45
2,6,11,6,3,1980,1827,153
2,6,12,6,3,1980,1814,166
2,6,13,6,3,1984,2094,-110
2,6,14,6,3,2067,2980,-913
2,6,15,6,3,2161,3574,-1413
2,6,16,6,3,2121,3788,-1667
2,6,17,6,3,2000,3544,-1544
2,6,18,6,3,1915,3434,-1519
2,6,19,6,3,1912,3387,-1475
2,6,20,6,3,1969,3132,-1163
2,6,21,6,3,2036,2960,-924
2,7,0,6,3,1916,2106,-190
2,7,1,6,3,1655,2137,-482
2,7,2,6,3,1811,2593,-782
2,7,3,6,3,1977,3423,-1446
2,7,4,6,3,2302,3398,-1096
2,7,5,6,3,2424,3472,-1048
2,7,6,6,3,2600,3366,-766
2,7,7,6,3,2469,3112,-643
2,7,8,6,3,2261,2457,-196
2,7,9,6,3,2069,1712,357
2,7,10,6,3,2111,1819,292
2,7,11,6,3,2130,1736,394
2,7,12,6,3,2119,1754,365
2,7,13,6,3,2152,1981,171
2,7,14,6,3,2367,2719,-352
2,7,15,6,3,2598,3233,-635
2,7,16,6,3,2596,3397,-801
2,7,17,6,3,2436,3240,-804
2,7,18,6,3,2300,3192,-892
2,7,19,6,3,2258,3239,-981
2,7,20,6,3,2263,2963,-700
2,7,21,6,3,2225,2799,-574
2,8,0,6,3,1986,2075,-89
2,8,1,6,3,1783,2173,-390
2,8,2,6,3,2052,2641,-589
2,8,3,6,3,2394,3304,-910
2,8,4,6,3,2733,3070,-337
2,8,5,6,3,2836,3067,-231
2,8,6,6,3,2970,3072,-102
2,8,7,6,3,2755,2939,-184
2,8,8,6,3,2428,2470,-42
2,8,9,6,3,2076,1825,251
2,8,10,6,3,2125,1957,168
2,8,11,6,3,2133,1883,250
2,8,12,6,3,2122,1882,240
2,8,13,6,3,2205,1969,236
2,8,14,6,3,2572,2585,-13
2,8,15,6,3,2942,3071,-129
2,8,16,6,3,3018,3178,-160
2,8,17,6,3,2844,2932,-88
2,8,18,6,3,2680,2893,-213
2,8,19,6,3,2603,2980,-377
2,8,20,6,3,2559,2731,-172
2,8,21,6,3,2425,2634,-209
2,9,0,6,3,2034,1973,61
2,9,1,6,3,1849,2141,-292
2,9,2,6,3,2203,2623,-420
2,9,3,6,3,2711,3122,-411
2,9,4,6,3,3014,2710,304
2,9,5,6,3,3114,2734,380
2,9,6,6,3,3197,2958,239
2,9,7,6,3,2939,2927,12
2,9,8,6,3,2499,2536,-37
2,9,9,6,3,1994,1910,84
2,9,10,6,3,2041,2053,-12
2,9,11,6,3,2018,1987,31
2,9,12,6,3,2017,1939,78
2,9,13,6,3,2154,1903,251
2,9,14,6,3,2662,2382,280
2,9,15,6,3,3115,2828,287
2,9,16,6,3,3275,2833,442
2,9,17,6,3,3114,2554,560
2,9,18,6,3,2955,2585,370
2,9,19,6,3,2844,2704,140
2,9,20,6,3,2763,2445,318
2,9,21,6,3,2598,2395,203
2,10,0,6,3,2212,1915,297
2,10,1,6,3,2063,2142,-79
2,10,2,6,3,2483,2576,-93
2,10,3,6,3,3148,2875,273
2,10,4,6,3,3495,2241,1254
2,10,5,6,3,3599,2257,1342
2,10,6,6,3,3661,2606,1055
2,10,7,6,3,3325,2639,686
2,10,8,6,3,2804,2309,495
2,10,9,6,3,2183,1726,457
2,10,10,6,3,2254,1894,360
2,10,11,6,3,2206,1864,342
2,10,12,6,3,2206,1804,402
2,10,13,6,3,2384,1680,704
2,10,14,6,3,3024,2003,1021
2,10,15,6,3,3523,2410,1113
2,10,16,6,3,3765,2328,1437
2,10,17,6,3,3584,2122,1462
2,10,18,6,3,3418,2206,1212
2,10,19,6,3,3256,2408,848
2,10,20,6,3,3109,2198,911
2,10,21,6,3,2884,2228,656
2,11,0,6,3,2301,1865,436
2,11,1,6,3,2191,2104,87
2,11,2,6,3,2612,2399,213
2,11,3,6,3,3393,2485,908
2,11,4,6,3,3704,1765,1939
2,11,5,6,3,3828,1807,2021
2,11,6,6,3,3856,2280,1576
2,11,7,6,3,3492,2340,1152
2,11,8,6,3,2865,2116,749
2,11,9,6,3,2122,1588,534
2,11,10,6,3,2216,1803,413
2,11,11,6,3,2163,1791,372
2,11,12,6,3,2162,1699,463
2,11,13,6,3,2383,1510,873
2,11,14,6,3,3152,1720,1432
2,11,15,6,3,3698,2092,1606
2,11,16,6,3,3972,1917,2055
2,11,17,6,3,3779,1694,2085
2,11,18,6,3,3633,1770,1863
2,11,19,6,3,3480,2027,1453
2,11,20,6,3,3254,1913,1341
2,11,21,6,3,3022,1967,1055
2,12,0,6,3,2218,1853,365
2,12,1,6,3,2162,2012,150
2,12,2,6,3,2562,2175,387
2,12,3,6,3,3386,2144,1242
2,12,4,6,3,3563,1437,2126
2,12,5,6,3,3734,1466,2268
2,12,6,6,3,3726,1995,1731
2,12,7,6,3,3366,2146,1220
2,12,8,6,3,2654,2018,636
2,12,9,6,3,1820,1553,267
2,12,10,6,3,1913,1790,123
2,12,11,6,3,1827,1840,-13
2,12,12,6,3,1814,1786,28
2,12,13,6,3,2094,1502,592
2,12,14,6,3,2980,1570,1410
2,12,15,6,3,3574,1817,1757
2,12,16,6,3,3788,1655,2133
2,12,17,6,3,3544,1477,2067
2,12,18,6,3,3434,1527,1907
2,12,19,6,3,3387,1684,1703
2,12,20,6,3,3132,1641,1491
2,12,21,6,3,2960,1707,1253
2,0,0,7,3,2365,2331,34
2,0,1,7,3,2322,2047,275
2,0,2,7,3,2290,2231,59
2,0,3,7,3,2275,2540,-265
2,0,4,7,3,2192,2912,-720
2,0,5,7,3,2028,3080,-1052
2,0,6,7,3,1866,3252,-1386
2,0,7,7,3,1789,3051,-1262
2,0,8,7,3,1735,2716,-981
2,0,9,7,3,1698,2368,-670
2,0,10,7,3,1670,2420,-750
2,0,11,7,3,1662,2429,-767
2,0,12,7,3,1672,2416,-744
2,0,13,7,3,1693,2496,-803
2,0,14,7,3,1747,2864,-1117
2,0,15,7,3,1799,3221,-1422
2,0,16,7,3,1925,3280,-1355
2,0,17,7,3,2069,3084,-1015
2,0,18,7,3,2190,2908,-718
2,0,19,7,3,2256,2836,-580
2,0,20,7,3,2297,2825,-528
2,0,21,7,3,2314,2744,-430
2,1,0,7,3,2397,2422,-25
2,1,1,7,3,2285,2189,96
2,1,2,7,3,2164,2465,-301
2,1,3,7,3,2101,2946,-845
2,1,4,7,3,2045,3306,-1261
2,1,5,7,3,1951,3464,-1513
2,1,6,7,3,1834,3580,-1746
2,1,7,7,3,1772,3322,-1550
2,1,8,7,3,1714,2891,-1177
2,1,9,7,3,1683,2396,-713
2,1,10,7,3,1659,2454,-795
2,1,11,7,3,1651,2447,-796
2,1,12,7,3,1657,2447,-790
2,1,13,7,3,1672,2576,-904
2,1,14,7,3,1732,3072,-1340
2,1,15,7,3,1773,3518,-1745
2,1,16,7,3,1877,3669,-1792
2,1,17,7,3,1989,3467,-1478
2,1,18,7,3,2102,3276,-1174
2,1,19,7,3,2180,3164,-984
2,1,20,7,3,2253,3108,-855
2,1,21,7,3,2319,2975,-656
2,2,0,7,3,2461,2456,5
2,2,1,7,3,2301,2244,57
2,2,2,7,3,2101,2636,-535
2,2,3,7,3,2010,3287,-1277
2,2,4,7,3,2015,3635,-1620
2,2,5,7,3,1984,3765,-1781
2,2,6,7,3,1900,3836,-1936
2,2,7,7,3,1834,3497,-1663
2,2,8,7,3,1788,2938,-1150
2,2,9,7,3,1772,2289,-517
2,2,10,7,3,1762,2358,-596
2,2,11,7,3,1770,2309,-539
2,2,12,7,3,1775,2300,-525
2,2,13,7,3,1778,2492,-714
2,2,14,7,3,1815,3163,-1348
2,2,15,7,3,1847,3701,-1854
2,2,16,7,3,1945,3948,-2003
2,2,17,7,3,2029,3755,-1726
2,2,18,7,3,2116,3574,-1458
2,2,19,7,3,2186,3414,-1228
2,2,20,7,3,2272,3296,-1024
2,2,21,7,3,2369,3123,-754
2,3,0,7,3,2372,2509,-137
2,3,1,7,3,2148,2371,-223
2,3,2,7,3,1925,2896,-971
2,3,3,7,3,1824,3735,-1911
2,3,4,7,3,1829,4093,-2264
2,3,5,7,3,1816,4226,-2410
2,3,6,7,3,1734,4278,-2544
2,3,7,7,3,1660,3919,-2259
2,3,8,7,3,1585,3267,-1682
2,3,9,7,3,1549,2501,-952
2,3,10,7,3,1544,2592,-1048
2,3,11,7,3,1552,2539,-987
2,3,12,7,3,1545,2543,-998
2,3,13,7,3,1557,2768,-1211
2,3,14,7,3,1616,3550,-1934
2,3,15,7,3,1688,4121,-2433
2,3,16,7,3,1793,4378,-2585
2,3,17,7,3,1875,4160,-2285
2,3,18,7,3,1953,3980,-2027
2,3,19,7,3,2024,3797,-1773
2,3,20,7,3,2131,3550,-1419
2,3,21,7,3,2277,3309,-1032
2,4,0,7,3,2241,2547,-306
2,4,1,7,3,1996,2475,-479
2,4,2,7,3,1882,3028,-1146
2,4,3,7,3,1834,3937,-2103
2,4,4,7,3,1879,4214,-2335
2,4,5,7,3,1872,4362,-2490
2,4,6,7,3,1857,4395,-2538
2,4,7,7,3,1831,3990,-2159
2,4,8,7,3,1780,3242,-1462
2,4,9,7,3,1730,2370,-640
2,4,10,7,3,1729,2476,-747
2,4,11,7,3,1740,2396,-656
2,4,12,7,3,1736,2389,-653
2,4,13,7,3,1747,2667,-920
2,4,14,7,3,1792,3595,-1803
2,4,15,7,3,1855,4241,-2386
2,4,16,7,3,1893,4450,-2557
2,4,17,7,3,1919,4175,-2256
2,4,18,7,3,1955,4042,-2087
2,4,19,7,3,2009,3980,-1971
2,4,20,7,3,2105,3687,-1582
2,4,21,7,3,2238,3436,-1198
2,5,0,7,3,2223,2508,-285
2,5,1,7,3,1961,2514,-553
2,5,2,7,3,1993,3060,-1067
2,5,3,7,3,2024,3987,-1963
2,5,4,7,3,2190,4049,-1859
2,5,5,7,3,2210,4110,-1900
2,5,6,7,3,2302,4035,-1733
2,5,7,7,3,2274,3679,-1405
2,5,8,7,3,2215,2914,-699
2,5,9,7,3,2136,2052,84
2,5,10,7,3,2155,2179,-24
2,5,11,7,3,2175,2093,82
2,5,12,7,3,2175,2099,76
2,5,13,7,3,2180,2354,-174
2,5,14,7,3,2253,3232,-979
2,5,15,7,3,2340,3881,-1541
2,5,16,7,3,2315,4086,-1771
2,5,17,7,3,2246,3900,-1654
2,5,18,7,3,2219,3832,-1613
2,5,19,7,3,2254,3876,-1622
2,5,20,7,3,2322,3577,-1255
2,5,21,7,3,2381,3326,-945
2,6,0,7,3,2269,2490,-221
2,6,1,7,3,1977,2565,-588
2,6,2,7,3,2096,3061,-965
2,6,3,7,3,2235,3867,-1632
2,6,4,7,3,2538,3680,-1142
2,6,5,7,3,2631,3723,-1092
2,6,6,7,3,2794,3724,-930
2,6,7,7,3,2665,3521,-856
2,6,8,7,3,2468,2925,-457
2,6,9,7,3,2276,2124,152
2,6,10,7,3,2318,2266,52
2,6,11,7,3,2337,2182,155
2,6,12,7,3,2325,2179,146
2,6,13,7,3,2357,2313,44
2,6,14,7,3,2580,3082,-502
2,6,15,7,3,2809,3694,-885
2,6,16,7,3,2810,3862,-1052
2,6,17,7,3,2660,3580,-920
2,6,18,7,3,2555,3501,-946
2,6,19,7,3,2549,3558,-1009
2,6,20,7,3,2583,3293,-710
2,6,21,7,3,2563,3153,-590
2,7,0,7,3,2331,2409,-78
2,7,1,7,3,2047,2547,-500
2,7,2,7,3,2231,3036,-805
2,7,3,7,3,2540,3674,-1134
2,7,4,7,3,2912,3283,-371
2,7,5,7,3,3080,3362,-282
2,7,6,7,3,3252,3568,-316
2,7,7,7,3,3051,3494,-443
2,7,8,7,3,2716,2999,-283
2,7,9,7,3,2368,2230,138
2,7,10,7,3,2420,2382,38
2,7,11,7,3,2429,2301,128
2,7,12,7,3,2416,2264,152
2,7,13,7,3,2496,2274,222
2,7,14,7,3,2864,2882,-18
2,7,15,7,3,3221,3404,-183
2,7,16,7,3,3280,3484,-204
2,7,17,7,3,3084,3177,-93
2,7,18,7,3,2908,3181,-273
2,7,19,7,3,2836,3265,-429
2,7,20,7,3,2825,2994,-169
2,7,21,7,3,2744,2945,-201
2,8,0,7,3,2422,2337,85
2,8,1,7,3,2189,2537,-348
2,8,2,7,3,2465,3009,-544
2,8,3,7,3,2946,3451,-505
2,8,4,7,3,3306,2862,444
2,8,5,7,3,3464,2908,556
2,8,6,7,3,3580,3245,335
2,8,7,7,3,3322,3197,125
2,8,8,7,3,2891,2748,143
2,8,9,7,3,2396,2021,375
2,8,10,7,3,2454,2211,243
2,8,11,7,3,2447,2155,292
2,8,12,7,3,2447,2087,360
2,8,13,7,3,2576,2018,558
2,8,14,7,3,3072,2504,568
2,8,15,7,3,3518,2996,522
2,8,16,7,3,3669,3001,668
2,8,17,7,3,3467,2763,704
2,8,18,7,3,3276,2825,451
2,8,19,7,3,3164,2978,186
2,8,20,7,3,3108,2731,377
2,8,21,7,3,2975,2753,222
2,9,0,7,3,2456,2162,294
2,9,1,7,3,2244,2412,-168
2,9,2,7,3,2636,2812,-176
2,9,3,7,3,3287,3072,215
2,9,4,7,3,3635,2363,1272
2,9,5,7,3,3765,2434,1331
2,9,6,7,3,3836,2897,939
2,9,7,7,3,3497,2934,563
2,9,8,7,3,2938,2579,359
2,9,9,7,3,2289,1906,383
2,9,10,7,3,2358,2141,217
2,9,11,7,3,2309,2124,185
2,9,12,7,3,2300,2036,264
2,9,13,7,3,2492,1894,598
2,9,14,7,3,3163,2246,917
2,9,15,7,3,3701,2690,1011
2,9,16,7,3,3948,2530,1418
2,9,17,7,3,3755,2270,1485
2,9,18,7,3,3574,2332,1242
2,9,19,7,3,3414,2568,846
2,9,20,7,3,3296,2354,942
2,9,21,7,3,3123,2392,731
2,10,0,7,3,2509,2099,410
2,10,1,7,3,2371,2296,75
2,10,2,7,3,2896,2591,305
2,10,3,7,3,3735,2688,1047
2,10,4,7,3,4093,1947,2146
2,10,5,7,3,4226,2000,2226
2,10,6,7,3,4278,2534,1744
2,10,7,7,3,3919,2644,1275
2,10,8,7,3,3267,2395,872
2,10,9,7,3,2501,1801,700
2,10,10,7,3,2592,2050,542
2,10,11,7,3,2539,2073,466
2,10,12,7,3,2543,2013,530
2,10,13,7,3,2768,1786,982
2,10,14,7,3,3550,2013,1537
2,10,15,7,3,4121,2360,1761
2,10,16,7,3,4378,2133,2245
2,10,17,7,3,4160,1873,2287
2,10,18,7,3,3980,1936,2044
2,10,19,7,3,3797,2184,1613
2,10,20,7,3,3550,2074,1476
2,10,21,7,3,3309,2121,1188
2,0,0,8,3,2710,2844,-134
2,0,1,8,3,2586,2584,2
2,0,2,8,3,2469,2898,-429
2,0,3,8,3,2421,3522,-1101
2,0,4,8,3,2371,3927,-1556
2,0,5,8,3,2272,4115,-1843
2,0,6,8,3,2148,4219,-2071
2,0,7,8,3,2085,3880,-1795
2,0,8,8,3,2023,3330,-1307
2,0,9,8,3,1990,2691,-701
2,0,10,8,3,1965,2771,-806
2,0,11,8,3,1958,2738,-780
2,0,12,8,3,1966,2730,-764
2,0,13,8,3,1984,2914,-930
2,0,14,8,3,2039,3573,-1534
2,0,15,8,3,2078,4104,-2026
2,0,16,8,3,2187,4342,-2155
2,0,17,8,3,2309,4108,-1799
2,0,18,8,3,2418,3895,-1477
2,0,19,8,3,2489,3734,-1245
2,0,20,8,3,2563,3641,-1078
2,0,21,8,3,2633,3500,-867
2,1,0,8,3,2785,2753,32
2,1,1,8,3,2625,2552,73
2,1,2,8,3,2426,3049,-623
2,1,3,8,3,2336,3874,-1538
2,1,4,8,3,2337,4233,-1896
2,1,5,8,3,2301,4392,-2091
2,1,6,8,3,2217,4453,-2236
2,1,7,8,3,2155,4091,-1936
2,1,8,8,3,2106,3401,-1295
2,1,9,8,3,2085,2607,-522
2,1,10,8,3,2072,2696,-624
2,1,11,8,3,2080,2642,-562
2,1,12,8,3,2087,2637,-550
2,1,13,8,3,2094,2876,-782
2,1,14,8,3,2142,3689,-1547
2,1,15,8,3,2176,4299,-2123
2,1,16,8,3,2271,4561,-2290
2,1,17,8,3,2342,4331,-1989
2,1,18,8,3,2423,4136,-1713
2,1,19,8,3,2500,3955,-1455
2,1,20,8,3,2598,3737,-1139
2,1,21,8,3,2696,3548,-852
2,2,0,8,3,2705,2755,-50
2,2,1,8,3,2482,2655,-173
2,2,2,8,3,2254,3312,-1058
2,2,3,8,3,2149,4279,-2130
2,2,4,8,3,2155,4603,-2448
2,2,5,8,3,2150,4760,-2610
2,2,6,8,3,2075,4817,-2742
2,2,7,8,3,2006,4417,-2411
2,2,8,8,3,1922,3644,-1722
2,2,9,8,3,1878,2749,-871
2,2,10,8,3,1866,2852,-986
2,2,11,8,3,1873,2772,-899
2,2,12,8,3,1869,2770,-901
2,2,13,8,3,1886,3052,-1166
2,2,14,8,3,1954,3993,-2039
2,2,15,8,3,2025,4664,-2639
2,2,16,8,3,2128,4856,-2728
2,2,17,8,3,2200,4556,-2356
2,2,18,8,3,2272,4389,-2117
2,2,19,8,3,2344,4297,-1953
2,2,20,8,3,2459,3983,-1524
2,2,21,8,3,2608,3723,-1115
2,3,0,8,3,2580,2837,-257
2,3,1,8,3,2328,2827,-499
2,3,2,8,3,2209,3526,-1317
2,3,3,8,3,2166,4538,-2372
2,3,4,8,3,2218,4700,-2482
2,3,5,8,3,2214,4738,-2524
2,3,6,8,3,2156,4704,-2548
2,3,7,8,3,2087,4303,-2216
2,3,8,8,3,1987,3502,-1515
2,3,9,8,3,1928,2602,-674
2,3,10,8,3,1920,2742,-822
2,3,11,8,3,1928,2662,-734
2,3,12,8,3,1926,2674,-748
2,3,13,8,3,1942,2927,-985
2,3,14,8,3,2014,3847,-1833
2,3,15,8,3,2111,4548,-2437
2,3,16,8,3,2199,4748,-2549
2,3,17,8,3,2256,4531,-2275
2,3,18,8,3,2300,4440,-2140
2,3,19,8,3,2341,4469,-2128
2,3,20,8,3,2427,4132,-1705
2,3,21,8,3,2564,3802,-1238
2,4,0,8,3,2570,2892,-322
2,4,1,8,3,2309,2942,-633
2,4,2,8,3,2348,3528,-1180
2,4,3,8,3,2385,4431,-2046
2,4,4,8,3,2530,4331,-1801
2,4,5,8,3,2500,4361,-1861
2,4,6,8,3,2526,4393,-1867
2,4,7,8,3,2455,4088,-1633
2,4,8,8,3,2368,3382,-1014
2,4,9,8,3,2280,2464,-184
2,4,10,8,3,2292,2626,-334
2,4,11,8,3,2309,2539,-230
2,4,12,8,3,2311,2524,-213
2,4,13,8,3,2320,2686,-366
2,4,14,8,3,2407,3595,-1188
2,4,15,8,3,2522,4342,-1820
2,4,16,8,3,2555,4551,-1996
2,4,17,8,3,2550,4240,-1690
2,4,18,8,3,2563,4141,-1578
2,4,19,8,3,2602,4195,-1593
2,4,20,8,3,2660,3907,-1247
2,4,21,8,3,2714,3680,-966
2,5,0,8,3,2625,2824,-199
2,5,1,8,3,2338,2939,-601
2,5,2,8,3,2460,3456,-996
2,5,3,8,3,2588,4237,-1649
2,5,4,8,3,2841,3893,-1052
2,5,5,8,3,2848,4018,-1170
2,5,6,8,3,2971,4220,-1249
2,5,7,8,3,2841,4076,-1235
2,5,8,8,3,2672,3454,-782
2,5,9,8,3,2476,2529,-53
2,5,10,8,3,2515,2691,-176
2,5,11,8,3,2532,2600,-68
2,5,12,8,3,2520,2561,-41
2,5,13,8,3,2553,2618,-65
2,5,14,8,3,2766,3379,-613
2,5,15,8,3,2988,4027,-1039
2,5,16,8,3,3004,4168,-1164
2,5,17,8,3,2906,3825,-919
2,5,18,8,3,2859,3789,-930
2,5,19,8,3,2891,3843,-952
2,5,20,8,3,2936,3556,-620
2,5,21,8,3,2908,3464,-556
2,6,0,8,3,2684,2773,-89
2,6,1,8,3,2369,2943,-574
2,6,2,8,3,2516,3422,-906
2,6,3,8,3,2798,4003,-1205
2,6,4,8,3,3148,3435,-287
2,6,5,8,3,3287,3536,-249
2,6,6,8,3,3446,3855,-409
2,6,7,8,3,3247,3764,-517
2,6,8,8,3,2923,3211,-288
2,6,9,8,3,2575,2341,234
2,6,10,8,3,2627,2540,87
2,6,11,8,3,2636,2469,167
2,6,12,8,3,2622,2412,210
2,6,13,8,3,2701,2389,312
2,6,14,8,3,3077,3004,73
2,6,15,8,3,3432,3572,-140
2,6,16,8,3,3494,3652,-158
2,6,17,8,3,3308,3386,-78
2,6,18,8,3,3163,3421,-258
2,6,19,8,3,3127,3539,-412
2,6,20,8,3,3145,3280,-135
2,6,21,8,3,3082,3303,-221
2,7,0,8,3,2767,2584,183
2,7,1,8,3,2453,2807,-354
2,7,2,8,3,2644,3245,-601
2,7,3,8,3,3092,3648,-556
2,7,4,8,3,3485,2984,501
2,7,5,8,3,3708,3085,623
2,7,6,8,3,3862,3536,326
2,7,7,8,3,3618,3492,126
2,7,8,8,3,3179,3018,161
2,7,9,8,3,2688,2201,487
2,7,10,8,3,2749,2458,291
2,7,11,8,3,2743,2415,328
2,7,12,8,3,2741,2319,422
2,7,13,8,3,2867,2232,635
2,7,14,8,3,3364,2747,617
2,7,15,8,3,3797,3276,521
2,7,16,8,3,3931,3203,728
2,7,17,8,3,3707,2911,796
2,7,18,8,3,3504,2951,553
2,7,19,8,3,3397,3138,259
2,7,20,8,3,3374,2887,487
2,7,21,8,3,3294,2917,377
2,8,0,8,3,2844,2396,448
2,8,1,8,3,2584,2604,-20
2,8,2,8,3,2898,3004,-106
2,8,3,8,3,3522,3275,247
2,8,4,8,3,3927,2545,1382
2,8,5,8,3,4115,2627,1488
2,8,6,8,3,4219,3151,1068
2,8,7,8,3,3880,3238,642
2,8,8,8,3,3330,2858,472
2,8,9,8,3,2691,2119,572
2,8,10,8,3,2771,2388,383
2,8,11,8,3,2738,2406,332
2,8,12,8,3,2730,2350,380
2,8,13,8,3,2914,2170,744
2,8,14,8,3,3573,2539,1034
2,8,15,8,3,4104,2958,1146
2,8,16,8,3,4342,2746,1596
2,8,17,8,3,4108,2449,1659
2,8,18,8,3,3895,2498,1397
2,8,19,8,3,3734,2725,1009
2,8,20,8,3,3641,2515,1126
2,8,21,8,3,3500,2546,954
2,0,0,9,3,3098,2999,99
2,0,1,9,3,2926,2836,90
2,0,2,9,3,2731,3465,-734
2,0,3,9,3,2656,4418,-1762
2,0,4,9,3,2663,4743,-2080
2,0,5,9,3,2622,4926,-2304
2,0,6,9,3,2531,4992,-2461
2,0,7,9,3,2468,4589,-2121
2,0,8,9,3,2415,3778,-1363
2,0,9,9,3,2392,2855,-463
2,0,10,9,3,2378,2956,-578
2,0,11,9,3,2387,2875,-488
2,0,12,9,3,2396,2864,-468
2,0,13,9,3,2406,3160,-754
2,0,14,9,3,2449,4132,-1683
2,0,15,9,3,2481,4842,-2361
2,0,16,9,3,2581,5039,-2458
2,0,17,9,3,2662,4727,-2065
2,0,18,9,3,2739,4545,-1806
2,0,19,9,3,2809,4455,-1646
2,0,20,9,3,2908,4170,-1262
2,0,21,9,3,3010,3962,-952
2,1,0,9,3,3029,3045,-16
2,1,1,9,3,2806,3007,-201
2,1,2,9,3,2579,3810,-1231
2,1,3,9,3,2475,4880,-2405
2,1,4,9,3,2477,5089,-2612
2,1,5,9,3,2467,5136,-2669
2,1,6,9,3,2392,5126,-2734
2,1,7,9,3,2327,4730,-2403
2,1,8,9,3,2240,3904,-1664
2,1,9,9,3,2191,2981,-790
2,1,10,9,3,2176,3118,-942
2,1,11,9,3,2183,3038,-855
2,1,12,9,3,2181,3055,-874
2,1,13,9,3,2202,3312,-1110
2,1,14,9,3,2281,4245,-1964
2,1,15,9,3,2354,4971,-2617
2,1,16,9,3,2454,5154,-2700
2,1,17,9,3,2513,4912,-2399
2,1,18,9,3,2579,4787,-2208
2,1,19,9,3,2658,4786,-2128
2,1,20,9,3,2785,4428,-1643
2,1,21,9,3,2935,4089,-1154
2,2,0,9,3,2913,3221,-308
2,2,1,9,3,2662,3255,-593
2,2,2,9,3,2538,3994,-1456
2,2,3,9,3,2491,4982,-2491
2,2,4,9,3,2544,4982,-2438
2,2,5,9,3,2548,4989,-2441
2,2,6,9,3,2497,5062,-2565
2,2,7,9,3,2433,4712,-2279
2,2,8,9,3,2324,3970,-1646
2,2,9,9,3,2257,3014,-757
2,2,10,9,3,2242,3189,-947
2,2,11,9,3,2249,3108,-859
2,2,12,9,3,2250,3099,-849
2,2,13,9,3,2271,3259,-988
2,2,14,9,3,2352,4210,-1858
2,2,15,9,3,2448,5009,-2561
2,2,16,9,3,2534,5213,-2679
2,2,17,9,3,2581,4871,-2290
2,2,18,9,3,2619,4749,-2130
2,2,19,9,3,2661,4788,-2127
2,2,20,9,3,2755,4462,-1707
2,2,21,9,3,2895,4156,-1261
2,3,0,9,3,2909,3226,-317
2,3,1,9,3,2641,3316,-675
2,3,2,9,3,2675,3923,-1248
2,3,3,9,3,2717,4801,-2084
2,3,4,9,3,2869,4544,-1675
2,3,5,9,3,2842,4656,-1814
2,3,6,9,3,2825,4889,-2064
2,3,7,9,3,2711,4643,-1932
2,3,8,9,3,2575,3911,-1336
2,3,9,9,3,2478,2869,-391
2,3,10,9,3,2483,3051,-568
2,3,11,9,3,2497,2957,-460
2,3,12,9,3,2501,2906,-405
2,3,13,9,3,2515,2991,-476
2,3,14,9,3,2629,3892,-1263
2,3,15,9,3,2778,4675,-1897
2,3,16,9,3,2861,4857,-1996
2,3,17,9,3,2887,4485,-1598
2,3,18,9,3,2908,4429,-1521
2,3,19,9,3,2934,4480,-1546
2,3,20,9,3,2982,4170,-1188
2,3,21,9,3,3040,3991,-951
2,4,0,9,3,2972,3188,-216
2,4,1,9,3,2686,3335,-649
2,4,2,9,3,2815,3842,-1027
2,4,3,9,3,2949,4566,-1617
2,4,4,9,3,3181,4045,-864
2,4,5,9,3,3138,4192,-1054
2,4,6,9,3,3195,4507,-1312
2,4,7,9,3,3022,4346,-1324
2,4,8,9,3,2825,3666,-841
2,4,9,9,3,2620,2640,-20
2,4,10,9,3,2652,2849,-197
2,4,11,9,3,2666,2768,-102
2,4,12,9,3,2656,2709,-53
2,4,13,9,3,2693,2733,-40
2,4,14,9,3,2920,3501,-581
2,4,15,9,3,3170,4195,-1025
2,4,16,9,3,3244,4336,-1092
2,4,17,9,3,3210,4034,-824
2,4,18,9,3,3203,4029,-826
2,4,19,9,3,3239,4117,-878
2,4,20,9,3,3274,3842,-568
2,4,21,9,3,3241,3822,-581
2,5,0,9,3,3040,3020,20
2,5,1,9,3,2730,3213,-483
2,5,2,9,3,2880,3658,-778
2,5,3,9,3,3151,4200,-1049
2,5,4,9,3,3451,3557,-106
2,5,5,9,3,3504,3713,-209
2,5,6,9,3,3623,4146,-523
2,5,7,9,3,3423,4059,-636
2,5,8,9,3,3127,3481,-354
2,5,9,9,3,2775,2521,254
2,5,10,9,3,2824,2787,37
2,5,11,9,3,2831,2729,102
2,5,12,9,3,2817,2644,173
2,5,13,9,3,2897,2603,294
2,5,14,9,3,3263,3247,16
2,5,15,9,3,3611,3852,-241
2,5,16,9,3,3688,3854,-166
2,5,17,9,3,3554,3534,20
2,5,18,9,3,3467,3547,-80
2,5,19,9,3,3469,3699,-230
2,5,20,9,3,3498,3436,62
2,5,21,9,3,3427,3467,-40
2,6,0,9,3,3120,2818,302
2,6,1,9,3,2775,2999,-224
2,6,2,9,3,2929,3437,-508
2,6,3,9,3,3350,3851,-501
2,6,4,9,3,3721,3166,555
2,6,5,9,3,3915,3278,637
2,6,6,9,3,4056,3790,266
2,6,7,9,3,3814,3796,18
2,6,8,9,3,3386,3297,89
2,6,9,9,3,2895,2414,481
2,6,10,9,3,2956,2705,251
2,6,11,9,3,2950,2697,253
2,6,12,9,3,2947,2633,314
2,6,13,9,3,3072,2508,564
2,6,14,9,3,3577,3040,537
2,6,15,9,3,4008,3544,464
2,6,16,9,3,4145,3419,726
2,6,17,9,3,3931,3090,841
2,6,18,9,3,3759,3117,642
2,6,19,9,3,3688,3295,393
2,6,20,9,3,3694,3048,646
2,6,21,9,3,3632,3071,561
2,0,0,10,3,3342,3429,-87
2,0,1,10,3,3107,3435,-328
2,0,2,10,3,2884,4278,-1394
2,0,3,10,3,2795,5324,-2529
2,0,4,10,3,2803,5371,-2568
2,0,5,10,3,2788,5387,-2599
2,0,6,10,3,2706,5484,-2778
2,0,7,10,3,2640,5139,-2499
2,0,8,10,3,2549,4372,-1823
2,0,9,10,3,2498,3393,-895
2,0,10,10,3,2482,3565,-1083
2,0,11,10,3,2490,3484,-994
2,0,12,10,3,2490,3480,-990
2,0,13,10,3,2514,3644,-1130
2,0,14,10,3,2588,4608,-2020
2,0,15,10,3,2659,5432,-2773
2,0,16,10,3,2764,5619,-2855
2,0,17,10,3,2833,5252,-2419
2,0,18,10,3,2895,5096,-2201
2,0,19,10,3,2967,5105,-2138
2,0,20,10,3,3095,4758,-1663
2,0,21,10,3,3249,4443,-1194
2,1,0,10,3,3237,3555,-318
2,1,1,10,3,2986,3629,-643
2,1,2,10,3,2863,4389,-1526
2,1,3,10,3,2817,5352,-2535
2,1,4,10,3,2866,5195,-2329
2,1,5,10,3,2865,5284,-2419
2,1,6,10,3,2814,5558,-2744
2,1,7,10,3,2754,5267,-2513
2,1,8,10,3,2642,4499,-1857
2,1,9,10,3,2570,3419,-849
2,1,10,10,3,2552,3614,-1062
2,1,11,10,3,2559,3526,-967
2,1,12,10,3,2562,3481,-919
2,1,13,10,3,2587,3564,-977
2,1,14,10,3,2679,4507,-1828
2,1,15,10,3,2777,5342,-2565
2,1,16,10,3,2860,5519,-2659
2,1,17,10,3,2894,5116,-2222
2,1,18,10,3,2926,5037,-2111
2,1,19,10,3,2975,5073,-2098
2,1,20,10,3,3081,4725,-1644
2,1,21,10,3,3222,4467,-1245
2,2,0,10,3,3242,3590,-348
2,2,1,10,3,2975,3712,-737
2,2,2,10,3,3004,4309,-1305
2,2,3,10,3,3042,5130,-2088
2,2,4,10,3,3195,4696,-1501
2,2,5,10,3,3176,4830,-1654
2,2,6,10,3,3166,5176,-2010
2,2,7,10,3,3057,4913,-1856
2,2,8,10,3,2912,4123,-1211
2,2,9,10,3,2807,2980,-173
2,2,10,10,3,2805,3209,-404
2,2,11,10,3,2818,3125,-307
2,2,12,10,3,2825,3054,-229
2,2,13,10,3,2844,3106,-262
2,2,14,10,3,2967,4014,-1047
2,2,15,10,3,3115,4843,-1728
2,2,16,10,3,3196,5025,-1829
2,2,17,10,3,3212,4694,-1482
2,2,18,10,3,3227,4669,-1442
2,2,19,10,3,3254,4754,-1500
2,2,20,10,3,3310,4456,-1146
2,2,21,10,3,3371,4349,-978
2,3,0,10,3,3311,3435,-124
2,3,1,10,3,3018,3605,-587
2,3,2,10,3,3142,4078,-936
2,3,3,10,3,3281,4763,-1482
2,3,4,10,3,3520,4167,-647
2,3,5,10,3,3480,4369,-889
2,3,6,10,3,3494,4798,-1304
2,3,7,10,3,3278,4641,-1363
2,3,8,10,3,3032,3936,-904
2,3,9,10,3,2818,2820,-2
2,3,10,10,3,2843,3096,-253
2,3,11,10,3,2854,3028,-174
2,3,12,10,3,2846,2941,-95
2,3,13,10,3,2888,2947,-59
2,3,14,10,3,3142,3744,-602
2,3,15,10,3,3426,4475,-1049
2,3,16,10,3,3550,4538,-988
2,3,17,10,3,3547,4182,-635
2,3,18,10,3,3548,4155,-607
2,3,19,10,3,3571,4277,-706
2,3,20,10,3,3596,3998,-402
2,3,21,10,3,3567,3986,-419
2,4,0,10,3,3387,3254,133
2,4,1,10,3,3078,3405,-327
2,4,2,10,3,3235,3850,-615
2,4,3,10,3,3512,4403,-891
2,4,4,10,3,3791,3739,52
2,4,5,10,3,3794,3906,-112
2,4,6,10,3,3847,4400,-553
2,4,7,10,3,3604,4363,-759
2,4,8,10,3,3280,3760,-480
2,4,9,10,3,2919,2734,185
2,4,10,10,3,2961,3034,-73
2,4,11,10,3,2965,3011,-46
2,4,12,10,3,2953,2958,-5
2,4,13,10,3,3037,2879,158
2,4,14,10,3,3417,3540,-123
2,4,15,10,3,3793,4120,-327
2,4,16,10,3,3928,4070,-142
2,4,17,10,3,3858,3713,145
2,4,18,10,3,3811,3713,98
2,4,19,10,3,3817,3856,-39
2,4,20,10,3,3836,3597,239
2,4,21,10,3,3760,3621,139
2,0,0,11,3,3550,3919,-369
2,0,1,11,3,3287,4025,-738
2,0,2,11,3,3168,4775,-1607
2,0,3,11,3,3137,5681,-2544
2,0,4,11,3,3192,5347,-2155
2,0,5,11,3,3186,5458,-2272
2,0,6,11,3,3128,5845,-2717
2,0,7,11,3,3067,5537,-2470
2,0,8,11,3,2951,4711,-1760
2,0,9,11,3,2877,3530,-653
2,0,10,11,3,2858,3772,-914
2,0,11,11,3,2866,3694,-828
2,0,12,11,3,2871,3629,-758
2,0,13,11,3,2899,3679,-780
2,0,14,11,3,2986,4629,-1643
2,0,15,11,3,3082,5510,-2428
2,0,16,11,3,3170,5687,-2517
2,0,17,11,3,3214,5325,-2111
2,0,18,11,3,3242,5277,-2035
2,0,19,11,3,3284,5347,-2063
2,0,20,11,3,3391,5011,-1620
2,0,21,11,3,3536,4825,-1289
2,1,0,11,3,3566,3837,-271
2,1,1,11,3,3299,3982,-683
2,1,2,11,3,3329,4545,-1216
2,1,3,11,3,3368,5327,-1959
2,1,4,11,3,3517,4818,-1301
2,1,5,11,3,3493,5007,-1514
2,1,6,11,3,3483,5467,-1984
2,1,7,11,3,3378,5208,-1830
2,1,8,11,3,3230,4393,-1163
2,1,9,11,3,3120,3160,-40
2,1,10,11,3,3115,3456,-341
2,1,11,11,3,3128,3385,-257
2,1,12,11,3,3137,3286,-149
2,1,13,11,3,3160,3320,-160
2,1,14,11,3,3294,4257,-963
2,1,15,11,3,3444,5123,-1679
2,1,16,11,3,3522,5227,-1705
2,1,17,11,3,3525,4842,-1317
2,1,18,11,3,3534,4795,-1261
2,1,19,11,3,3568,4914,-1346
2,1,20,11,3,3636,4612,-976
2,1,21,11,3,3698,4513,-815
2,2,0,11,3,3644,3669,-25
2,2,1,11,3,3352,3797,-445
2,2,2,11,3,3471,4270,-799
2,2,3,11,3,3606,4966,-1360
2,2,4,11,3,3846,4349,-503
2,2,5,11,3,3814,4562,-748
2,2,6,11,3,3835,5052,-1217
2,2,7,11,3,3624,4945,-1321
2,2,8,11,3,3369,4215,-846
2,2,9,11,3,3147,3033,114
2,2,10,11,3,3165,3343,-178
2,2,11,11,3,3175,3310,-135
2,2,12,11,3,3170,3255,-85
2,2,13,11,3,3217,3223,-6
2,2,14,11,3,3480,4037,-557
2,2,15,11,3,3763,4743,-980
2,2,16,11,3,3885,4754,-869
2,2,17,11,3,3872,4361,-489
2,2,18,11,3,3867,4321,-454
2,2,19,11,3,3891,4434,-543
2,2,20,11,3,3924,4159,-235
2,2,21,11,3,3898,4140,-242
2,0,0,12,3,3879,4071,-192
2,0,1,12,3,3600,4174,-574
2,0,2,12,3,3634,4737,-1103
2,0,3,12,3,3688,5530,-1842
2,0,4,12,3,3843,5000,-1157
2,0,5,12,3,3814,5200,-1386
2,0,6,12,3,3797,5721,-1924
2,0,7,12,3,3691,5512,-1821
2,0,8,12,3,3539,4672,-1133
2,0,9,12,3,3427,3373,54
2,0,10,12,3,3421,3703,-282
2,0,11,12,3,3435,3667,-232
2,0,12,12,3,3446,3600,-154
2,0,13,12,3,3472,3596,-124
2,0,14,12,3,3601,4550,-949
2,0,15,12,3,3749,5391,-1642
2,0,16,12,3,3832,5443,-1611
2,0,17,12,3,3845,5021,-1176
2,0,18,12,3,3850,4961,-1111
2,0,19,12,3,3877,5071,-1194
2,0,20,12,3,3946,4773,-827
2,0,21,12,3,4012,4667,-655
2,0,0,1,4,411,430,-19
2,0,1,1,4,412,436,-24
2,0,2,1,4,416,433,-17
2,0,3,1,4,424,428,-4
2,0,4,1,4,432,429,3
2,0,5,1,4,425,425,0
2,0,6,1,4,417,423,-6
2,0,7,1,4,415,425,-10
2,0,8,1,4,411,421,-10
2,0,9,1,4,409,416,-7
2,0,10,1,4,409,414,-5
2,0,11,1,4,411,415,-4
2,0,12,1,4,414,419,-5
2,0,13,1,4,410,431,-21
2,0,14,1,4,409,434,-25
2,0,15,1,4,415,433,-18
2,0,16,1,4,418,428,-10
2,0,17,1,4,418,414,4
2,0,18,1,4,419,418,1
2,0,19,1,4,418,428,-10
2,0,20,1,4,412,428,-16
2,1,0,1,4,430,440,-10
2,1,1,1,4,436,444,-8
2,1,2,1,4,433,437,-4
2,1,3,1,4,428,433,-5
2,1,4,1,4,429,444,-15
2,1,5,1,4,425,449,-24
2,1,6,1,4,423,454,-31
2,1,7,1,4,425,455,-30
2,1,8,1,4,421,444,-23
2,1,9,1,4,416,435,-19
2,1,10,1,4,414,430,-16
2,1,11,1,4,415,431,-16
2,1,12,1,4,419,435,-16
2,1,13,1,4,431,446,-15
2,1,14,1,4,434,447,-13
2,1,15,1,4,433,446,-13
2,1,16,1,4,428,442,-14
2,1,17,1,4,414,428,-14
2,1,18,1,4,418,429,-11
2,1,19,1,4,428,435,-7
2,1,20,1,4,428,434,-6
2,2,0,1,4,440,444,-4
2,2,1,1,4,444,444,0
2,2,2,1,4,437,442,-5
2,2,3,1,4,433,444,-11
2,2,4,1,4,444,454,-10
2,2,5,1,4,449,414,35
2,2,6,1,4,454,368,86
2,2,7,1,4,455,322,133
2,2,8,1,4,444,270,174
2,2,9,1,4,435,260,175
2,2,10,1,4,430,254,176
2,2,11,1,4,431,253,178
2,2,12,1,4,435,257,178
2,2,13,1,4,446,285,161
2,2,14,1,4,447,321,126
2,2,15,1,4,446,373,73
2,2,16,1,4,442,427,15
2,2,17,1,4,428,444,-16
2,2,18,1,4,429,449,-20
2,2,19,1,4,435,443,-8
2,2,20,1,4,434,433,1
2,3,0,1,4,444,462,-18
2,3,1,1,4,444,474,-30
2,3,2,1,4,442,475,-33
2,3,3,1,4,444,455,-11
2,3,4,1,4,454,416,38
2,3,5,1,4,414,344,70
2,3,6,1,4,368,275,93
2,3,7,1,4,322,229,93
2,3,8,1,4,270,198,72
2,3,9,1,4,260,188,72
2,3,10,1,4,254,182,72
2,3,11,1,4,253,181,72
2,3,12,1,4,257,184,73
2,3,13,1,4,285,199,86
2,3,14,1,4,321,229,92
2,3,15,1,4,373,288,85
2,3,16,1,4,427,363,64
2,3,17,1,4,444,419,25
2,3,18,1,4,449,454,-5
2,3,19,1,4,443,461,-18
2,3,20,1,4,433,448,-15
2,4,0,1,4,462,475,-13
2,4,1,1,4,474,486,-12
2,4,2,1,4,475,473,2
2,4,3,1,4,455,422,33
2,4,4,1,4,416,342,74
2,4,5,1,4,344,286,58
2,4,6,1,4,275,245,30
2,4,7,1,4,229,243,-14
2,4,8,1,4,198,269,-71
2,4,9,1,4,188,265,-77
2,4,10,1,4,182,262,-80
2,4,11,1,4,181,260,-79
2,4,12,1,4,184,261,-77
2,4,13,1,4,199,251,-52
2,4,14,1,4,229,244,-15
2,4,15,1,4,288,260,28
2,4,16,1,4,363,301,62
2,4,17,1,4,419,362,57
2,4,18,1,4,454,423,31
2,4,19,1,4,461,460,1
2,4,20,1,4,448,461,-13
2,5,0,1,4,475,442,33
2,5,1,1,4,486,409,77
2,5,2,1,4,473,367,106
2,5,3,1,4,422,325,97
2,5,4,1,4,342,294,48
2,5,5,1,4,286,276,10
2,5,6,1,4,245,263,-18
2,5,7,1,4,243,265,-22
2,5,8,1,4,269,276,-7
2,5,9,1,4,265,276,-11
2,5,10,1,4,262,276,-14
2,5,11,1,4,260,275,-15
2,5,12,1,4,261,274,-13
2,5,13,1,4,251,282,-31
2,5,14,1,4,244,279,-35
2,5,15,1,4,260,282,-22
2,5,16,1,4,301,301,0
2,5,17,1,4,362,321,41
2,5,18,1,4,423,362,61
2,5,19,1,4,460,407,53
2,5,20,1,4,461,435,26
2,6,0,1,4,442,394,48
2,6,1,1,4,409,304,105
2,6,2,1,4,367,236,131
2,6,3,1,4,325,228,97
2,6,4,1,4,294,284,10
2,6,5,1,4,276,339,-63
2,6,6,1,4,263,378,-115
2,6,7,1,4,265,393,-128
2,6,8,1,4,276,387,-111
2,6,9,1,4,276,391,-115
2,6,10,1,4,276,393,-117
2,6,11,1,4,275,393,-118
2,6,12,1,4,274,390,-116
2,6,13,1,4,282,390,-108
2,6,14,1,4,279,376,-97
2,6,15,1,4,282,358,-76
2,6,16,1,4,301,339,-38
2,6,17,1,4,321,312,9
2,6,18,1,4,362,312,50
2,6,19,1,4,407,343,64
2,6,20,1,4,435,391,44
2,7,0,1,4,394,466,-72
2,7,1,1,4,304,403,-99
2,7,2,1,4,236,356,-120
2,7,3,1,4,228,370,-142
2,7,4,1,4,284,413,-129
2,7,5,1,4,339,477,-138
2,7,6,1,4,378,518,-140
2,7,7,1,4,393,513,-120
2,7,8,1,4,387,529,-142
2,7,9,1,4,391,548,-157
2,7,10,1,4,393,559,-166
2,7,11,1,4,393,567,-174
2,7,12,1,4,390,568,-178
2,7,13,1,4,390,556,-166
2,7,14,1,4,376,541,-165
2,7,15,1,4,358,532,-174
2,7,16,1,4,339,487,-148
2,7,17,1,4,312,452,-140
2,7,18,1,4,312,449,-137
2,7,19,1,4,343,438,-95
2,7,20,1,4,391,476,-85
2,8,0,1,4,466,287,179
2,8,1,1,4,403,222,181
2,8,2,1,4,356,208,148
2,8,3,1,4,370,183,187
2,8,4,1,4,413,207,206
2,8,5,1,4,477,230,247
2,8,6,1,4,518,216,302
2,8,7,1,4,513,201,312
2,8,8,1,4,529,170,359
2,8,9,1,4,548,145,403
2,8,10,1,4,559,132,427
2,8,11,1,4,567,130,437
2,8,12,1,4,568,147,421
2,8,13,1,4,556,167,389
2,8,14,1,4,541,205,336
2,8,15,1,4,532,236,296
2,8,16,1,4,487,230,257
2,8,17,1,4,452,222,230
2,8,18,1,4,449,216,233
2,8,19,1,4,438,234,204
2,8,20,1,4,476,290,186
2,9,0,1,4,287,284,3
2,9,1,1,4,222,328,-106
2,9,2,1,4,208,402,-194
2,9,3,1,4,183,465,-282
2,9,4,1,4,207,546,-339
2,9,5,1,4,230,540,-310
2,9,6,1,4,216,550,-334
2,9,7,1,4,201,559,-358
2,9,8,1,4,170,521,-351
2,9,9,1,4,145,504,-359
2,9,10,1,4,132,508,-376
2,9,11,1,4,130,500,-370
2,9,12,1,4,147,510,-363
2,9,13,1,4,167,530,-363
2,9,14,1,4,205,547,-342
2,9,15,1,4,236,535,-299
2,9,16,1,4,230,526,-296
2,9,17,1,4,222,496,-274
2,9,18,1,4,216,429,-213
2,9,19,1,4,234,416,-182
2,9,20,1,4,290,402,-112
2,10,0,1,4,284,452,-168
2,10,1,1,4,328,566,-238
2,10,2,1,4,402,641,-239
2,10,3,1,4,465,774,-309
2,10,4,1,4,546,881,-335
2,10,5,1,4,540,844,-304
2,10,6,1,4,550,847,-297
2,10,7,1,4,559,818,-259
2,10,8,1,4,521,766,-245
2,10,9,1,4,504,741,-237
2,10,10,1,4,508,763,-255
2,10,11,1,4,500,753,-253
2,10,12,1,4,510,764,-254
2,10,13,1,4,530,815,-285
2,10,14,1,4,547,851,-304
2,10,15,1,4,535,851,-316
2,10,16,1,4,526,873,-347
2,10,17,1,4,496,844,-348
2,10,18,1,4,429,777,-348
2,10,19,1,4,416,766,-350
2,10,20,1,4,402,689,-287
2,11,0,1,4,452,528,-76
2,11,1,1,4,566,614,-48
2,11,2,1,4,641,668,-27
2,11,3,1,4,774,777,-3
2,11,4,1,4,881,875,6
2,11,5,1,4,844,870,-26
2,11,6,1,4,847,780,67
2,11,7,1,4,818,681,137
2,11,8,1,4,766,572,194
2,11,9,1,4,741,471,270
2,11,10,1,4,763,471,292
2,11,11,1,4,753,460,293
2,11,12,1,4,764,504,260
2,11,13,1,4,815,624,191
2,11,14,1,4,851,751,100
2,11,15,1,4,851,848,3
2,11,16,1,4,873,911,-38
2,11,17,1,4,844,878,-34
2,11,18,1,4,777,837,-60
2,11,19,1,4,766,836,-70
2,11,20,1,4,689,745,-56
2,12,0,1,4,528,538,-10
2,12,1,1,4,614,579,35
2,12,2,1,4,668,673,-5
2,12,3,1,4,777,733,44
2,12,4,1,4,875,843,32
2,12,5,1,4,870,905,-35
2,12,6,1,4,780,752,28
2,12,7,1,4,681,688,-7
2,12,8,1,4,572,548,24
2,12,9,1,4,471,409,62
2,12,10,1,4,471,405,66
2,12,11,1,4,460,390,70
2,12,12,1,4,504,454,50
2,12,13,1,4,624,593,31
2,12,14,1,4,751,714,37
2,12,15,1,4,848,841,7
2,12,16,1,4,911,897,14
2,12,17,1,4,878,825,53
2,12,18,1,4,837,796,41
2,12,19,1,4,836,775,61
2,12,20,1,4,745,696,49
2,13,0,1,4,538,558,-20
2,13,1,1,4,579,582,-3
2,13,2,1,4,673,667,6
2,13,3,1,4,733,695,38
2,13,4,1,4,843,804,39
2,13,5,1,4,905,864,41
2,13,6,1,4,752,710,42
2,13,7,1,4,688,694,-6
2,13,8,1,4,548,556,-8
2,13,9,1,4,409,429,-20
2,13,10,1,4,405,441,-36
2,13,11,1,4,390,418,-28
2,13,12,1,4,454,480,-26
2,13,13,1,4,593,612,-19
2,13,14,1,4,714,680,34
2,13,15,1,4,841,806,35
2,13,16,1,4,897,864,33
2,13,17,1,4,825,776,49
2,13,18,1,4,796,791,5
2,13,19,1,4,775,762,13
2,13,20,1,4,696,703,-7
2,14,0,1,4,558,541,17
2,14,1,1,4,582,602,-20
2,14,2,1,4,667,683,-16
2,14,3,1,4,695,740,-45
2,14,4,1,4,804,858,-54
2,14,5,1,4,864,889,-25
2,14,6,1,4,710,722,-12
2,14,7,1,4,694,676,18
2,14,8,1,4,556,533,23
2,14,9,1,4,429,400,29
2,14,10,1,4,441,409,32
2,14,11,1,4,418,377,41
2,14,12,1,4,480,443,37
2,14,13,1,4,612,593,19
2,14,14,1,4,680,672,8
2,14,15,1,4,806,833,-27
2,14,16,1,4,864,896,-32
2,14,17,1,4,776,790,-14
2,14,18,1,4,791,817,-26
2,14,19,1,4,762,756,6
2,14,20,1,4,703,674,29
2,15,0,1,4,541,416,125
2,15,1,1,4,602,527,75
2,15,2,1,4,683,662,21
2,15,3,1,4,740,717,23
2,15,4,1,4,858,846,12
2,15,5,1,4,889,866,23
2,15,6,1,4,722,724,-2
2,15,7,1,4,676,711,-35
2,15,8,1,4,533,557,-24
2,15,9,1,4,400,445,-45
2,15,10,1,4,409,450,-41
2,15,11,1,4,377,431,-54
2,15,12,1,4,443,511,-68
2,15,13,1,4,593,638,-45
2,15,14,1,4,672,696,-24
2,15,15,1,4,833,787,46
2,15,16,1,4,896,830,66
2,15,17,1,4,790,732,58
2,15,18,1,4,817,730,87
2,15,19,1,4,756,658,98
2,15,20,1,4,674,581,93
2,16,0,1,4,416,392,24
2,16,1,1,4,527,491,36
2,16,2,1,4,662,607,55
2,16,3,1,4,717,656,61
2,16,4,1,4,846,741,105
2,16,5,1,4,866,730,136
2,16,6,1,4,724,610,114
2,16,7,1,4,711,608,103
2,16,8,1,4,557,444,113
2,16,9,1,4,445,331,114
2,16,10,1,4,450,343,107
2,16,11,1,4,431,294,137
2,16,12,1,4,511,367,144
2,16,13,1,4,638,526,112
2,16,14,1,4,696,604,92
2,16,15,1,4,787,618,169
2,16,16,1,4,830,638,192
2,16,17,1,4,732,570,162
2,16,18,1,4,730,575,155
2,16,19,1,4,658,593,65
2,16,20,1,4,581,588,-7
2,17,0,1,4,392,474,-82
2,17,1,1,4,491,590,-99
2,17,2,1,4,607,677,-70
2,17,3,1,4,656,670,-14
2,17,4,1,4,741,614,127
2,17,5,1,4,730,488,242
2,17,6,1,4,610,382,228
2,17,7,1,4,608,388,220
2,17,8,1,4,444,344,100
2,17,9,1,4,331,339,-8
2,17,10,1,4,343,341,2
2,17,11,1,4,294,369,-75
2,17,12,1,4,367,367,0
2,17,13,1,4,526,327,199
2,17,14,1,4,604,410,194
2,17,15,1,4,618,380,238
2,17,16,1,4,638,423,215
2,17,17,1,4,570,556,14
2,17,18,1,4,575,562,13
2,17,19,1,4,593,570,23
2,17,20,1,4,588,566,22
2,18,0,1,4,474,618,-144
2,18,1,1,4,590,558,32
2,18,2,1,4,677,548,129
2,18,3,1,4,670,516,154
2,18,4,1,4,614,381,233
2,18,5,1,4,488,438,50
2,18,6,1,4,382,481,-99
2,18,7,1,4,388,567,-179
2,18,8,1,4,344,599,-255
2,18,9,1,4,339,570,-231
2,18,10,1,4,341,604,-263
2,18,11,1,4,369,556,-187
2,18,12,1,4,367,490,-123
2,18,13,1,4,327,520,-193
2,18,14,1,4,410,571,-161
2,18,15,1,4,380,530,-150
2,18,16,1,4,423,528,-105
2,18,17,1,4,556,517,39
2,18,18,1,4,562,388,174
2,18,19,1,4,570,393,177
2,18,20,1,4,566,531,35
2,19,0,1,4,618,564,54
2,19,1,1,4,558,471,87
2,19,2,1,4,548,438,110
2,19,3,1,4,516,443,73
2,19,4,1,4,381,392,-11
2,19,5,1,4,438,539,-101
2,19,6,1,4,481,628,-147
2,19,7,1,4,567,708,-141
2,19,8,1,4,599,649,-50
2,19,9,1,4,570,557,13
2,19,10,1,4,604,571,33
2,19,11,1,4,556,502,54
2,19,12,1,4,490,457,33
2,19,13,1,4,520,443,77
2,19,14,1,4,571,417,154
2,19,15,1,4,530,381,149
2,19,16,1,4,528,383,145
2,19,17,1,4,517,408,109
2,19,18,1,4,388,333,55
2,19,19,1,4,393,340,53
2,19,20,1,4,531,474,57
2,20,0,1,4,564,599,-35
2,20,1,1,4,471,458,13
2,20,2,1,4,438,418,20
2,20,3,1,4,443,387,56
2,20,4,1,4,392,236,156
2,20,5,1,4,539,319,220
2,20,6,1,4,628,328,300
2,20,7,1,4,708,296,412
2,20,8,1,4,649,256,393
2,20,9,1,4,557,199,358
2,20,10,1,4,571,194,377
2,20,11,1,4,502,192,310
2,20,12,1,4,457,203,254
2,20,13,1,4,443,158,285
2,20,14,1,4,417,192,225
2,20,15,1,4,381,223,158
2,20,16,1,4,383,252,131
2,20,17,1,4,408,310,98
2,20,18,1,4,333,329,4
2,20,19,1,4,340,370,-30
2,20,20,1,4,474,459,15
2,21,0,1,4,599,367,232
2,21,1,1,4,458,310,148
2,21,2,1,4,418,273,145
2,21,3,1,4,387,242,145
2,21,4,1,4,236,217,19
2,21,5,1,4,319,328,-9
2,21,6,1,4,328,340,-12
2,21,7,1,4,296,365,-69
2,21,8,1,4,256,331,-75
2,21,9,1,4,199,296,-97
2,21,10,1,4,194,330,-136
2,21,11,1,4,192,293,-101
2,21,12,1,4,203,330,-127
2,21,13,1,4,158,326,-168
2,21,14,1,4,192,313,-121
2,21,15,1,4,223,300,-77
2,21,16,1,4,252,260,-8
2,21,17,1,4,310,196,114
2,21,18,1,4,329,180,149
2,21,19,1,4,370,214,156
2,21,20,1,4,459,212,247
2,22,0,1,4,367,303,64
2,22,1,1,4,310,261,49
2,22,2,1,4,273,257,16
2,22,3,1,4,242,251,-9
2,22,4,1,4,217,262,-45
2,22,5,1,4,328,319,9
2,22,6,1,4,340,352,-12
2,22,7,1,4,365,359,6
2,22,8,1,4,331,339,-8
2,22,9,1,4,296,345,-49
2,22,10,1,4,330,337,-7
2,22,11,1,4,293,374,-81
2,22,12,1,4,330,408,-78
2,22,13,1,4,326,383,-57
2,22,14,1,4,313,360,-47
2,22,15,1,4,300,310,-10
2,22,16,1,4,260,286,-26
2,22,17,1,4,196,233,-37
2,22,18,1,4,180,199,-19
2,22,19,1,4,214,231,-17
2,22,20,1,4,212,208,4
2,0,0,2,4,841,884,-43
2,0,1,2,4,848,888,-40
2,0,2,2,4,849,879,-30
2,0,3,2,4,852,877,-25
2,0,4,2,4,861,898,-37
2,0,5,2,4,850,863,-13
2,0,6,2,4,840,822,18
2,0,7,2,4,840,777,63
2,0,8,2,4,832,714,118
2,0,9,2,4,825,695,130
2,0,10,2,4,823,684,139
2,0,11,2,4,826,684,142
2,0,12,2,4,833,692,141
2,0,13,2,4,841,731,110
2,0,14,2,4,843,768,75
2,0,15,2,4,848,819,29
2,0,16,2,4,846,869,-23
2,0,17,2,4,832,872,-40
2,0,18,2,4,837,878,-41
2,0,19,2,4,846,878,-32
2,0,20,2,4,840,867,-27
2,1,0,2,4,870,906,-36
2,1,1,2,4,880,918,-38
2,1,2,2,4,870,917,-47
2,1,3,2,4,861,899,-38
2,1,4,2,4,873,870,3
2,1,5,2,4,874,758,116
2,1,6,2,4,877,643,234
2,1,7,2,4,880,551,329
2,1,8,2,4,865,468,397
2,1,9,2,4,851,448,403
2,1,10,2,4,844,436,408
2,1,11,2,4,846,434,412
2,1,12,2,4,854,441,413
2,1,13,2,4,877,484,393
2,1,14,2,4,881,550,331
2,1,15,2,4,879,661,218
2,1,16,2,4,870,790,80
2,1,17,2,4,842,863,-21
2,1,18,2,4,847,903,-56
2,1,19,2,4,863,904,-41
2,1,20,2,4,862,881,-19
2,2,0,2,4,884,937,-53
2,2,1,2,4,888,960,-72
2,2,2,2,4,879,948,-69
2,2,3,2,4,877,877,0
2,2,4,2,4,898,758,140
2,2,5,2,4,863,630,233
2,2,6,2,4,822,520,302
2,2,7,2,4,777,472,305
2,2,8,2,4,714,467,247
2,2,9,2,4,695,453,242
2,2,10,2,4,684,444,240
2,2,11,2,4,684,441,243
2,2,12,2,4,692,445,247
2,2,13,2,4,731,450,281
2,2,14,2,4,768,473,295
2,2,15,2,4,819,548,271
2,2,16,2,4,869,664,205
2,2,17,2,4,872,781,91
2,2,18,2,4,878,877,1
2,2,19,2,4,878,921,-43
2,2,20,2,4,867,909,-42
2,3,0,2,4,906,917,-11
2,3,1,2,4,918,895,23
2,3,2,2,4,917,840,77
2,3,3,2,4,899,747,152
2,3,4,2,4,870,636,234
2,3,5,2,4,758,562,196
2,3,6,2,4,643,508,135
2,3,7,2,4,551,508,43
2,3,8,2,4,468,545,-77
2,3,9,2,4,448,541,-93
2,3,10,2,4,436,538,-102
2,3,11,2,4,434,535,-101
2,3,12,2,4,441,535,-94
2,3,13,2,4,484,533,-49
2,3,14,2,4,550,523,27
2,3,15,2,4,661,542,119
2,3,16,2,4,790,602,188
2,3,17,2,4,863,683,180
2,3,18,2,4,903,785,118
2,3,19,2,4,904,867,37
2,3,20,2,4,881,896,-15
2,4,0,2,4,937,836,101
2,4,1,2,4,960,713,247
2,4,2,2,4,948,603,345
2,4,3,2,4,877,553,324
2,4,4,2,4,758,578,180
2,4,5,2,4,630,615,15
2,4,6,2,4,520,641,-121
2,4,7,2,4,472,658,-186
2,4,8,2,4,467,663,-196
2,4,9,2,4,453,667,-214
2,4,10,2,4,444,669,-225
2,4,11,2,4,441,668,-227
2,4,12,2,4,445,664,-219
2,4,13,2,4,450,672,-222
2,4,14,2,4,473,655,-182
2,4,15,2,4,548,640,-92
2,4,16,2,4,664,640,24
2,4,17,2,4,781,633,148
2,4,18,2,4,877,674,203
2,4,19,2,4,921,750,171
2,4,20,2,4,909,826,83
2,5,0,2,4,917,860,57
2,5,1,2,4,895,707,188
2,5,2,2,4,840,592,248
2,5,3,2,4,747,598,149
2,5,4,2,4,636,697,-61
2,5,5,2,4,562,816,-254
2,5,6,2,4,508,896,-388
2,5,7,2,4,508,906,-398
2,5,8,2,4,545,916,-371
2,5,9,2,4,541,939,-398
2,5,10,2,4,538,952,-414
2,5,11,2,4,535,960,-425
2,5,12,2,4,535,958,-423
2,5,13,2,4,533,946,-413
2,5,14,2,4,523,917,-394
2,5,15,2,4,542,890,-348
2,5,16,2,4,602,826,-224
2,5,17,2,4,683,764,-81
2,5,18,2,4,785,761,24
2,5,19,2,4,867,781,86
2,5,20,2,4,896,867,29
2,6,0,2,4,836,753,83
2,6,1,2,4,713,625,88
2,6,2,2,4,603,564,39
2,6,3,2,4,553,553,0
2,6,4,2,4,578,620,-42
2,6,5,2,4,615,707,-92
2,6,6,2,4,641,734,-93
2,6,7,2,4,658,714,-56
2,6,8,2,4,663,699,-36
2,6,9,2,4,667,693,-26
2,6,10,2,4,669,691,-22
2,6,11,2,4,668,697,-29
2,6,12,2,4,664,715,-51
2,6,13,2,4,672,723,-51
2,6,14,2,4,655,746,-91
2,6,15,2,4,640,768,-128
2,6,16,2,4,640,717,-77
2,6,17,2,4,633,674,-41
2,6,18,2,4,674,665,9
2,6,19,2,4,750,672,78
2,6,20,2,4,826,766,60
2,7,0,2,4,860,571,289
2,7,1,2,4,707,550,157
2,7,2,2,4,592,610,-18
2,7,3,2,4,598,648,-50
2,7,4,2,4,697,753,-56
2,7,5,2,4,816,770,46
2,7,6,2,4,896,766,130
2,7,7,2,4,906,760,146
2,7,8,2,4,916,691,225
2,7,9,2,4,939,649,290
2,7,10,2,4,952,640,312
2,7,11,2,4,960,630,330
2,7,12,2,4,958,657,301
2,7,13,2,4,946,697,249
2,7,14,2,4,917,752,165
2,7,15,2,4,890,771,119
2,7,16,2,4,826,756,70
2,7,17,2,4,764,718,46
2,7,18,2,4,761,645,116
2,7,19,2,4,781,650,131
2,7,20,2,4,867,692,175
2,8,0,2,4,753,736,17
2,8,1,2,4,625,894,-269
2,8,2,2,4,564,1043,-479
2,8,3,2,4,553,1239,-686
2,8,4,2,4,620,1427,-807
2,8,5,2,4,707,1384,-677
2,8,6,2,4,734,1397,-663
2,8,7,2,4,714,1377,-663
2,8,8,2,4,699,1287,-588
2,8,9,2,4,693,1245,-552
2,8,10,2,4,691,1271,-580
2,8,11,2,4,697,1253,-556
2,8,12,2,4,715,1274,-559
2,8,13,2,4,723,1345,-622
2,8,14,2,4,746,1398,-652
2,8,15,2,4,768,1386,-618
2,8,16,2,4,717,1399,-682
2,8,17,2,4,674,1340,-666
2,8,18,2,4,665,1206,-541
2,8,19,2,4,672,1182,-510
2,8,20,2,4,766,1091,-325
2,9,0,2,4,571,980,-409
2,9,1,2,4,550,1180,-630
2,9,2,2,4,610,1309,-699
2,9,3,2,4,648,1551,-903
2,9,4,2,4,753,1756,-1003
2,9,5,2,4,770,1714,-944
2,9,6,2,4,766,1627,-861
2,9,7,2,4,760,1499,-739
2,9,8,2,4,691,1338,-647
2,9,9,2,4,649,1212,-563
2,9,10,2,4,640,1234,-594
2,9,11,2,4,630,1213,-583
2,9,12,2,4,657,1268,-611
2,9,13,2,4,697,1439,-742
2,9,14,2,4,752,1602,-850
2,9,15,2,4,771,1699,-928
2,9,16,2,4,756,1784,-1028
2,9,17,2,4,718,1722,-1004
2,9,18,2,4,645,1614,-969
2,9,19,2,4,650,1602,-952
2,9,20,2,4,692,1434,-742
2,10,0,2,4,736,1066,-330
2,10,1,2,4,894,1193,-299
2,10,2,2,4,1043,1341,-298
2,10,3,2,4,1239,1510,-271
2,10,4,2,4,1427,1718,-291
2,10,5,2,4,1384,1775,-391
2,10,6,2,4,1397,1532,-135
2,10,7,2,4,1377,1369,8
2,10,8,2,4,1287,1120,167
2,10,9,2,4,1245,880,365
2,10,10,2,4,1271,876,395
2,10,11,2,4,1253,850,403
2,10,12,2,4,1274,958,316
2,10,13,2,4,1345,1217,128
2,10,14,2,4,1398,1465,-67
2,10,15,2,4,1386,1689,-303
2,10,16,2,4,1399,1808,-409
2,10,17,2,4,1340,1703,-363
2,10,18,2,4,1206,1633,-427
2,10,19,2,4,1182,1611,-429
2,10,20,2,4,1091,1441,-350
2,11,0,2,4,980,1096,-116
2,11,1,2,4,1180,1161,19
2,11,2,2,4,1309,1340,-31
2,11,3,2,4,1551,1428,123
2,11,4,2,4,1756,1647,109
2,11,5,2,4,1714,1769,-55
2,11,6,2,4,1627,1462,165
2,11,7,2,4,1499,1382,117
2,11,8,2,4,1338,1104,234
2,11,9,2,4,1212,838,374
2,11,10,2,4,1234,846,388
2,11,11,2,4,1213,808,405
2,11,12,2,4,1268,934,334
2,11,13,2,4,1439,1205,234
2,11,14,2,4,1602,1394,208
2,11,15,2,4,1699,1647,52
2,11,16,2,4,1784,1761,23
2,11,17,2,4,1722,1601,121
2,11,18,2,4,1614,1587,27
2,11,19,2,4,1602,1537,65
2,11,20,2,4,1434,1399,35
2,12,0,2,4,1066,1099,-33
2,12,1,2,4,1193,1184,9
2,12,2,2,4,1341,1350,-9
2,12,3,2,4,1510,1435,75
2,12,4,2,4,1718,1662,56
2,12,5,2,4,1775,1753,22
2,12,6,2,4,1532,1432,100
2,12,7,2,4,1369,1370,-1
2,12,8,2,4,1120,1089,31
2,12,9,2,4,880,829,51
2,12,10,2,4,876,850,26
2,12,11,2,4,850,795,55
2,12,12,2,4,958,923,35
2,12,13,2,4,1217,1205,12
2,12,14,2,4,1465,1352,113
2,12,15,2,4,1689,1639,50
2,12,16,2,4,1808,1760,48
2,12,17,2,4,1703,1566,137
2,12,18,2,4,1633,1608,25
2,12,19,2,4,1611,1518,93
2,12,20,2,4,1441,1377,64
2,13,0,2,4,1096,957,139
2,13,1,2,4,1161,1129,32
2,13,2,2,4,1340,1345,-5
2,13,3,2,4,1428,1457,-29
2,13,4,2,4,1647,1704,-57
2,13,5,2,4,1769,1755,14
2,13,6,2,4,1462,1446,16
2,13,7,2,4,1382,1387,-5
2,13,8,2,4,1104,1090,14
2,13,9,2,4,838,845,-7
2,13,10,2,4,846,859,-13
2,13,11,2,4,808,808,0
2,13,12,2,4,934,954,-20
2,13,13,2,4,1205,1231,-26
2,13,14,2,4,1394,1368,26
2,13,15,2,4,1647,1620,27
2,13,16,2,4,1761,1726,35
2,13,17,2,4,1601,1522,79
2,13,18,2,4,1587,1547,40
2,13,19,2,4,1537,1414,123
2,13,20,2,4,1399,1255,144
2,14,0,2,4,1099,808,291
2,14,1,2,4,1184,1018,166
2,14,2,2,4,1350,1269,81
2,14,3,2,4,1435,1373,62
2,14,4,2,4,1662,1587,75
2,14,5,2,4,1753,1596,157
2,14,6,2,4,1432,1334,98
2,14,7,2,4,1370,1319,51
2,14,8,2,4,1089,1001,88
2,14,9,2,4,829,776,53
2,14,10,2,4,850,793,57
2,14,11,2,4,795,725,70
2,14,12,2,4,923,878,45
2,14,13,2,4,1205,1164,41
2,14,14,2,4,1352,1300,52
2,14,15,2,4,1639,1405,234
2,14,16,2,4,1760,1468,292
2,14,17,2,4,1566,1302,264
2,14,18,2,4,1608,1305,303
2,14,19,2,4,1518,1251,267
2,14,20,2,4,1377,1169,208
2,15,0,2,4,957,866,91
2,15,1,2,4,1129,1081,48
2,15,2,2,4,1345,1284,61
2,15,3,2,4,1457,1326,131
2,15,4,2,4,1704,1355,349
2,15,5,2,4,1755,1218,537
2,15,6,2,4,1446,992,454
2,15,7,2,4,1387,996,391
2,15,8,2,4,1090,788,302
2,15,9,2,4,845,670,175
2,15,10,2,4,859,684,175
2,15,11,2,4,808,663,145
2,15,12,2,4,954,734,220
2,15,13,2,4,1231,853,378
2,15,14,2,4,1368,1014,354
2,15,15,2,4,1620,998,622
2,15,16,2,4,1726,1061,665
2,15,17,2,4,1522,1126,396
2,15,18,2,4,1547,1137,410
2,15,19,2,4,1414,1163,251
2,15,20,2,4,1255,1154,101
2,16,0,2,4,808,1092,-284
2,16,1,2,4,1018,1148,-130
2,16,2,2,4,1269,1225,44
2,16,3,2,4,1373,1186,187
2,16,4,2,4,1587,995,592
2,16,5,2,4,1596,926,670
2,16,6,2,4,1334,863,471
2,16,7,2,4,1319,955,364
2,16,8,2,4,1001,943,58
2,16,9,2,4,776,909,-133
2,16,10,2,4,793,945,-152
2,16,11,2,4,725,925,-200
2,16,12,2,4,878,857,21
2,16,13,2,4,1164,847,317
2,16,14,2,4,1300,981,319
2,16,15,2,4,1405,910,495
2,16,16,2,4,1468,951,517
2,16,17,2,4,1302,1073,229
2,16,18,2,4,1305,950,355
2,16,19,2,4,1251,963,288
2,16,20,2,4,1169,1097,72
2,17,0,2,4,866,1182,-316
2,17,1,2,4,1081,1029,52
2,17,2,2,4,1284,986,298
2,17,3,2,4,1326,959,367
2,17,4,2,4,1355,773,582
2,17,5,2,4,1218,977,241
2,17,6,2,4,992,1109,-117
2,17,7,2,4,996,1275,-279
2,17,8,2,4,788,1248,-460
2,17,9,2,4,670,1127,-457
2,17,10,2,4,684,1175,-491
2,17,11,2,4,663,1058,-395
2,17,12,2,4,734,947,-213
2,17,13,2,4,853,963,-110
2,17,14,2,4,1014,988,26
2,17,15,2,4,998,911,87
2,17,16,2,4,1061,911,150
2,17,17,2,4,1126,925,201
2,17,18,2,4,1137,721,416
2,17,19,2,4,1163,733,430
2,17,20,2,4,1154,1005,149
2,18,0,2,4,1092,1163,-71
2,18,1,2,4,1148,929,219
2,18,2,2,4,1225,856,369
2,18,3,2,4,1186,830,356
2,18,4,2,4,995,628,367
2,18,5,2,4,926,858,68
2,18,6,2,4,863,956,-93
2,18,7,2,4,955,1004,-49
2,18,8,2,4,943,905,38
2,18,9,2,4,909,756,153
2,18,10,2,4,945,765,180
2,18,11,2,4,925,694,231
2,18,12,2,4,857,660,197
2,18,13,2,4,847,601,246
2,18,14,2,4,981,609,372
2,18,15,2,4,910,604,306
2,18,16,2,4,951,635,316
2,18,17,2,4,1073,718,355
2,18,18,2,4,950,662,288
2,18,19,2,4,963,710,253
2,18,20,2,4,1097,933,164
2,19,0,2,4,1182,966,216
2,19,1,2,4,1029,768,261
2,19,2,2,4,986,691,295
2,19,3,2,4,959,629,330
2,19,4,2,4,773,453,320
2,19,5,2,4,977,647,330
2,19,6,2,4,1109,668,441
2,19,7,2,4,1275,661,614
2,19,8,2,4,1248,587,661
2,19,9,2,4,1127,495,632
2,19,10,2,4,1175,524,651
2,19,11,2,4,1058,485,573
2,19,12,2,4,947,533,414
2,19,13,2,4,963,484,479
2,19,14,2,4,988,505,483
2,19,15,2,4,911,523,388
2,19,16,2,4,911,512,399
2,19,17,2,4,925,506,419
2,19,18,2,4,721,509,212
2,19,19,2,4,733,584,149
2,19,20,2,4,1005,671,334
2,20,0,2,4,1163,670,493
2,20,1,2,4,929,571,358
2,20,2,2,4,856,530,326
2,20,3,2,4,830,493,337
2,20,4,2,4,628,479,149
2,20,5,2,4,858,647,211
2,20,6,2,4,956,692,264
2,20,7,2,4,1004,724,280
2,20,8,2,4,905,670,235
2,20,9,2,4,756,641,115
2,20,10,2,4,765,667,98
2,20,11,2,4,694,667,27
2,20,12,2,4,660,738,-78
2,20,13,2,4,601,709,-108
2,20,14,2,4,609,673,-64
2,20,15,2,4,604,610,-6
2,20,16,2,4,635,546,89
2,20,17,2,4,718,429,289
2,20,18,2,4,662,379,283
2,20,19,2,4,710,445,265
2,20,20,2,4,933,420,513
2,0,0,3,4,1281,1381,-100
2,0,1,3,4,1292,1404,-112
2,0,2,3,4,1286,1390,-104
2,0,3,3,4,1285,1321,-36
2,0,4,3,4,1305,1212,93
2,0,5,3,4,1299,1044,255
2,0,6,3,4,1294,888,406
2,0,7,3,4,1295,794,501
2,0,8,3,4,1276,737,539
2,0,9,3,4,1260,713,547
2,0,10,3,4,1253,698,555
2,0,11,3,4,1257,694,563
2,0,12,3,4,1268,702,566
2,0,13,3,4,1287,735,552
2,0,14,3,4,1290,794,496
2,0,15,3,4,1294,921,373
2,0,16,3,4,1288,1091,197
2,0,17,3,4,1260,1225,35
2,0,18,3,4,1266,1326,-60
2,0,19,3,4,1281,1364,-83
2,0,20,3,4,1274,1342,-68
2,1,0,3,4,1314,1379,-65
2,1,1,3,4,1324,1369,-45
2,1,2,3,4,1312,1315,-3
2,1,3,3,4,1305,1202,103
2,1,4,3,4,1327,1052,275
2,1,5,3,4,1288,906,382
2,1,6,3,4,1245,783,462
2,1,7,3,4,1202,737,465
2,1,8,3,4,1135,743,392
2,1,9,3,4,1111,729,382
2,1,10,3,4,1098,720,378
2,1,11,3,4,1099,716,383
2,1,12,3,4,1111,719,392
2,1,13,3,4,1162,732,430
2,1,14,3,4,1202,752,450
2,1,15,3,4,1252,830,422
2,1,16,3,4,1297,965,332
2,1,17,3,4,1286,1102,184
2,1,18,3,4,1296,1239,57
2,1,19,3,4,1306,1328,-22
2,1,20,3,4,1295,1344,-49
2,2,0,3,4,1346,1311,35
2,2,1,3,4,1362,1199,163
2,2,2,3,4,1354,1076,278
2,2,3,3,4,1332,975,357
2,2,4,3,4,1314,920,394
2,2,5,3,4,1207,901,306
2,2,6,3,4,1097,886,211
2,2,7,3,4,1006,901,105
2,2,8,3,4,912,932,-20
2,2,9,3,4,883,932,-49
2,2,10,3,4,866,931,-65
2,2,11,3,4,865,928,-63
2,2,12,3,4,876,925,-49
2,2,13,3,4,930,923,7
2,2,14,3,4,997,899,98
2,2,15,3,4,1107,900,207
2,2,16,3,4,1232,941,291
2,2,17,3,4,1291,995,296
2,2,18,3,4,1332,1097,235
2,2,19,3,4,1339,1210,129
2,2,20,3,4,1315,1287,28
2,3,0,3,4,1381,1302,79
2,3,1,3,4,1404,1116,288
2,3,2,3,4,1390,959,431
2,3,3,3,4,1321,923,398
2,3,4,3,4,1212,991,221
2,3,5,3,4,1044,1092,-48
2,3,6,3,4,888,1159,-271
2,3,7,3,4,794,1171,-377
2,3,8,3,4,737,1192,-455
2,3,9,3,4,713,1215,-502
2,3,10,3,4,698,1228,-530
2,3,11,3,4,694,1235,-541
2,3,12,3,4,702,1232,-530
2,3,13,3,4,735,1228,-493
2,3,14,3,4,794,1196,-402
2,3,15,3,4,921,1172,-251
2,3,16,3,4,1091,1127,-36
2,3,17,3,4,1225,1085,140
2,3,18,3,4,1326,1123,203
2,3,19,3,4,1364,1188,176
2,3,20,3,4,1342,1302,40
2,4,0,3,4,1379,1147,232
2,4,1,3,4,1369,929,440
2,4,2,3,4,1315,800,515
2,4,3,3,4,1202,781,421
2,4,4,3,4,1052,904,148
2,4,5,3,4,906,1046,-140
2,4,6,3,4,783,1112,-329
2,4,7,3,4,737,1107,-370
2,4,8,3,4,743,1086,-343
2,4,9,3,4,729,1084,-355
2,4,10,3,4,720,1084,-364
2,4,11,3,4,716,1090,-374
2,4,12,3,4,719,1105,-386
2,4,13,3,4,732,1113,-381
2,4,14,3,4,752,1122,-370
2,4,15,3,4,830,1126,-296
2,4,16,3,4,965,1056,-91
2,4,17,3,4,1102,986,116
2,4,18,3,4,1239,977,262
2,4,19,3,4,1328,1015,313
2,4,20,3,4,1344,1157,187
2,5,0,3,4,1311,1037,274
2,5,1,3,4,1199,953,246
2,5,2,3,4,1076,966,110
2,5,3,3,4,975,1018,-43
2,5,4,3,4,920,1166,-246
2,5,5,3,4,901,1247,-346
2,5,6,3,4,886,1284,-398
2,5,7,3,4,901,1273,-372
2,5,8,3,4,932,1220,-288
2,5,9,3,4,932,1197,-265
2,5,10,3,4,931,1199,-268
2,5,11,3,4,928,1197,-269
2,5,12,3,4,925,1225,-300
2,5,13,3,4,923,1253,-330
2,5,14,3,4,899,1293,-394
2,5,15,3,4,900,1303,-403
2,5,16,3,4,941,1243,-302
2,5,17,3,4,995,1170,-175
2,5,18,3,4,1097,1094,3
2,5,19,3,4,1210,1088,122
2,5,20,3,4,1287,1168,119
2,6,0,3,4,1302,1023,279
2,6,1,3,4,1116,1116,0
2,6,2,3,4,959,1251,-292
2,6,3,3,4,923,1422,-499
2,6,4,3,4,991,1634,-643
2,6,5,3,4,1092,1614,-522
2,6,6,3,4,1159,1613,-454
2,6,7,3,4,1171,1578,-407
2,6,8,3,4,1192,1457,-265
2,6,9,3,4,1215,1390,-175
2,6,10,3,4,1228,1403,-175
2,6,11,3,4,1235,1383,-148
2,6,12,3,4,1232,1421,-189
2,6,13,3,4,1228,1512,-284
2,6,14,3,4,1196,1603,-407
2,6,15,3,4,1172,1622,-450
2,6,16,3,4,1127,1629,-502
2,6,17,3,4,1085,1562,-477
2,6,18,3,4,1123,1422,-299
2,6,19,3,4,1188,1416,-228
2,6,20,3,4,1302,1381,-79
2,7,0,3,4,1147,1264,-117
2,7,1,3,4,929,1508,-579
2,7,2,3,4,800,1711,-911
2,7,3,3,4,781,2016,-1235
2,7,4,3,4,904,2302,-1398
2,7,5,3,4,1046,2254,-1208
2,7,6,3,4,1112,2177,-1065
2,7,7,3,4,1107,2058,-951
2,7,8,3,4,1086,1859,-773
2,7,9,3,4,1084,1716,-632
2,7,10,3,4,1084,1742,-658
2,7,11,3,4,1090,1713,-623
2,7,12,3,4,1105,1778,-673
2,7,13,3,4,1113,1969,-856
2,7,14,3,4,1122,2149,-1027
2,7,15,3,4,1126,2234,-1108
2,7,16,3,4,1056,2310,-1254
2,7,17,3,4,986,2218,-1232
2,7,18,3,4,977,2043,-1066
2,7,19,3,4,1015,2018,-1003
2,7,20,3,4,1157,1836,-679
2,8,0,3,4,1037,1518,-481
2,8,1,3,4,953,1759,-806
2,8,2,3,4,966,1982,-1016
2,8,3,3,4,1018,2284,-1266
2,8,4,3,4,1166,2599,-1433
2,8,5,3,4,1247,2619,-1372
2,8,6,3,4,1284,2379,-1095
2,8,7,3,4,1273,2187,-914
2,8,8,3,4,1220,1886,-666
2,8,9,3,4,1197,1621,-424
2,8,10,3,4,1199,1639,-440
2,8,11,3,4,1197,1603,-406
2,8,12,3,4,1225,1722,-497
2,8,13,3,4,1253,2032,-779
2,8,14,3,4,1293,2316,-1023
2,8,15,3,4,1303,2540,-1237
2,8,16,3,4,1243,2681,-1438
2,8,17,3,4,1170,2547,-1377
2,8,18,3,4,1094,2410,-1316
2,8,19,3,4,1088,2377,-1289
2,8,20,3,4,1168,2130,-962
2,9,0,3,4,1023,1624,-601
2,9,1,3,4,1116,1775,-659
2,9,2,3,4,1251,2008,-757
2,9,3,3,4,1422,2205,-783
2,9,4,3,4,1634,2522,-888
2,9,5,3,4,1614,2639,-1025
2,9,6,3,4,1613,2242,-629
2,9,7,3,4,1578,2063,-485
2,9,8,3,4,1457,1676,-219
2,9,9,3,4,1390,1309,81
2,9,10,3,4,1403,1317,86
2,9,11,3,4,1383,1268,115
2,9,12,3,4,1421,1438,-17
2,9,13,3,4,1512,1829,-317
2,9,14,3,4,1603,2145,-542
2,9,15,3,4,1622,2495,-873
2,9,16,3,4,1629,2672,-1043
2,9,17,3,4,1562,2479,-917
2,9,18,3,4,1422,2424,-1002
2,9,19,3,4,1416,2373,-957
2,9,20,3,4,1381,2144,-763
2,10,0,3,4,1264,1637,-373
2,10,1,3,4,1508,1763,-255
2,10,2,3,4,1711,2023,-312
2,10,3,3,4,2016,2168,-152
2,10,4,3,4,2302,2505,-203
2,10,5,3,4,2254,2658,-404
2,10,6,3,4,2177,2184,-7
2,10,7,3,4,2058,2058,0
2,10,8,3,4,1859,1637,222
2,10,9,3,4,1716,1238,478
2,10,10,3,4,1742,1255,487
2,10,11,3,4,1713,1185,528
2,10,12,3,4,1778,1377,401
2,10,13,3,4,1969,1798,171
2,10,14,3,4,2149,2066,83
2,10,15,3,4,2234,2480,-246
2,10,16,3,4,2310,2657,-347
2,10,17,3,4,2218,2391,-173
2,10,18,3,4,2043,2404,-361
2,10,19,3,4,2018,2293,-275
2,10,20,3,4,1836,2073,-237
2,11,0,3,4,1518,1515,3
2,11,1,3,4,1759,1711,48
2,11,2,3,4,1982,2012,-30
2,11,3,3,4,2284,2152,132
2,11,4,3,4,2599,2508,91
2,11,5,3,4,2619,2619,0
2,11,6,3,4,2379,2156,223
2,11,7,3,4,2187,2081,106
2,11,8,3,4,1886,1646,240
2,11,9,3,4,1621,1274,347
2,11,10,3,4,1639,1300,339
2,11,11,3,4,1603,1226,377
2,11,12,3,4,1722,1434,288
2,11,13,3,4,2032,1843,189
2,11,14,3,4,2316,2048,268
2,11,15,3,4,2540,2426,114
2,11,16,3,4,2681,2590,91
2,11,17,3,4,2547,2298,249
2,11,18,3,4,2410,2338,72
2,11,19,3,4,2377,2176,201
2,11,20,3,4,2130,1958,172
2,12,0,3,4,1624,1349,275
2,12,1,3,4,1775,1620,155
2,12,2,3,4,2008,1952,56
2,12,3,3,4,2205,2113,92
2,12,4,3,4,2522,2445,77
2,12,5,3,4,2639,2485,154
2,12,6,3,4,2242,2056,186
2,12,7,3,4,2063,1995,68
2,12,8,3,4,1676,1534,142
2,12,9,3,4,1309,1176,133
2,12,10,3,4,1317,1202,115
2,12,11,3,4,1268,1102,166
2,12,12,3,4,1438,1321,117
2,12,13,3,4,1829,1757,72
2,12,14,3,4,2145,1972,173
2,12,15,3,4,2495,2238,257
2,12,16,3,4,2672,2364,308
2,12,17,3,4,2479,2092,387
2,12,18,3,4,2424,2122,302
2,12,19,3,4,2373,2007,366
2,12,20,3,4,2144,1843,301
2,13,0,3,4,1637,1282,355
2,13,1,3,4,1763,1608,155
2,13,2,3,4,2023,1946,77
2,13,3,3,4,2168,2043,125
2,13,4,3,4,2505,2201,304
2,13,5,3,4,2658,2084,574
2,13,6,3,4,2184,1716,468
2,13,7,3,4,2058,1707,351
2,13,8,3,4,1637,1345,292
2,13,9,3,4,1238,1115,123
2,13,10,3,4,1255,1134,121
2,13,11,3,4,1185,1094,91
2,13,12,3,4,1377,1245,132
2,13,13,3,4,1798,1491,307
2,13,14,3,4,2066,1710,356
2,13,15,3,4,2480,1785,695
2,13,16,3,4,2657,1891,766
2,13,17,3,4,2391,1858,533
2,13,18,3,4,2404,1867,537
2,13,19,3,4,2293,1821,472
2,13,20,3,4,2073,1735,338
2,14,0,3,4,1515,1484,31
2,14,1,3,4,1711,1639,72
2,14,2,3,4,2012,1832,180
2,14,3,3,4,2152,1842,310
2,14,4,3,4,2508,1736,772
2,14,5,3,4,2619,1656,963
2,14,6,3,4,2156,1473,683
2,14,7,3,4,2081,1563,518
2,14,8,3,4,1646,1387,259
2,14,9,3,4,1274,1240,34
2,14,10,3,4,1300,1288,12
2,14,11,3,4,1226,1219,7
2,14,12,3,4,1434,1224,210
2,14,13,3,4,1843,1373,470
2,14,14,3,4,2048,1585,463
2,14,15,3,4,2426,1528,898
2,14,16,3,4,2590,1589,1001
2,14,17,3,4,2298,1643,655
2,14,18,3,4,2338,1525,813
2,14,19,3,4,2176,1556,620
2,14,20,3,4,1958,1685,273
2,15,0,3,4,1349,1656,-307
2,15,1,3,4,1620,1619,1
2,15,2,3,4,1952,1663,289
2,15,3,3,4,2113,1629,484
2,15,4,3,4,2445,1387,1058
2,15,5,3,4,2485,1465,1020
2,15,6,3,4,2056,1491,565
2,15,7,3,4,1995,1663,332
2,15,8,3,4,1534,1592,-58
2,15,9,3,4,1176,1466,-290
2,15,10,3,4,1202,1516,-314
2,15,11,3,4,1102,1427,-325
2,15,12,3,4,1321,1314,7
2,15,13,3,4,1757,1290,467
2,15,14,3,4,1972,1398,574
2,15,15,3,4,2238,1291,947
2,15,16,3,4,2364,1334,1030
2,15,17,3,4,2092,1481,611
2,15,18,3,4,2122,1283,839
2,15,19,3,4,2007,1303,704
2,15,20,3,4,1843,1571,272
2,16,0,3,4,1282,1781,-499
2,16,1,3,4,1608,1487,121
2,16,2,3,4,1946,1404,542
2,16,3,3,4,2043,1346,697
2,16,4,3,4,2201,1009,1192
2,16,5,3,4,2084,1296,788
2,16,6,3,4,1716,1437,279
2,16,7,3,4,1707,1571,136
2,16,8,3,4,1345,1504,-159
2,16,9,3,4,1115,1326,-211
2,16,10,3,4,1134,1369,-235
2,16,11,3,4,1094,1250,-156
2,16,12,3,4,1245,1150,95
2,16,13,3,4,1491,1121,370
2,16,14,3,4,1710,1180,530
2,16,15,3,4,1785,1134,651
2,16,16,3,4,1891,1163,728
2,16,17,3,4,1858,1235,623
2,16,18,3,4,1867,1050,817
2,16,19,3,4,1821,1103,718
2,16,20,3,4,1735,1464,271
2,17,0,3,4,1484,1530,-46
2,17,1,3,4,1639,1239,400
2,17,2,3,4,1832,1129,703
2,17,3,3,4,1842,1072,770
2,17,4,3,4,1736,845,891
2,17,5,3,4,1656,1186,470
2,17,6,3,4,1473,1296,177
2,17,7,3,4,1563,1369,194
2,17,8,3,4,1387,1236,151
2,17,9,3,4,1240,1052,188
2,17,10,3,4,1288,1095,193
2,17,11,3,4,1219,987,232
2,17,12,3,4,1224,990,234
2,17,13,3,4,1373,927,446
2,17,14,3,4,1585,922,663
2,17,15,3,4,1528,904,624
2,17,16,3,4,1589,895,694
2,17,17,3,4,1643,914,729
2,17,18,3,4,1525,842,683
2,17,19,3,4,1556,924,632
2,17,20,3,4,1685,1145,540
2,18,0,3,4,1656,1269,387
2,18,1,3,4,1619,1029,590
2,18,2,3,4,1663,948,715
2,18,3,3,4,1629,880,749
2,18,4,3,4,1387,715,672
2,18,5,3,4,1465,966,499
2,18,6,3,4,1491,1020,471
2,18,7,3,4,1663,1020,643
2,18,8,3,4,1592,926,666
2,18,9,3,4,1466,840,626
2,18,10,3,4,1516,861,655
2,18,11,3,4,1427,859,568
2,18,12,3,4,1314,941,373
2,18,13,3,4,1290,867,423
2,18,14,3,4,1398,865,533
2,18,15,3,4,1291,833,458
2,18,16,3,4,1334,798,536
2,18,17,3,4,1481,739,742
2,18,18,3,4,1283,708,575
2,18,19,3,4,1303,815,488
2,18,20,3,4,1571,879,692
2,0,0,4,4,1725,1773,-48
2,0,1,4,4,1736,1673,63
2,0,2,4,4,1728,1551,177
2,0,3,4,4,1729,1430,299
2,0,4,4,4,1759,1336,423
2,0,5,4,4,1713,1245,468
2,0,6,4,4,1662,1161,501
2,0,7,4,4,1617,1130,487
2,0,8,4,4,1546,1130,416
2,0,9,4,4,1520,1120,400
2,0,10,4,4,1507,1113,394
2,0,11,4,4,1510,1109,401
2,0,12,4,4,1525,1109,416
2,0,13,4,4,1572,1122,450
2,0,14,4,4,1611,1128,483
2,0,15,4,4,1667,1188,479
2,0,16,4,4,1715,1304,411
2,0,17,4,4,1704,1414,290
2,0,18,4,4,1715,1551,164
2,0,19,4,4,1724,1671,53
2,0,20,4,4,1707,1735,-28
2,1,0,4,4,1776,1777,-1
2,1,1,4,4,1798,1602,196
2,1,2,4,4,1787,1432,355
2,1,3,4,4,1760,1345,415
2,1,4,4,4,1743,1333,410
2,1,5,4,4,1632,1378,254
2,1,6,4,4,1520,1404,116
2,1,7,4,4,1431,1414,17
2,1,8,4,4,1333,1461,-128
2,1,9,4,4,1299,1480,-181
2,1,10,4,4,1280,1490,-210
2,1,11,4,4,1280,1495,-215
2,1,12,4,4,1295,1493,-198
2,1,13,4,4,1361,1479,-118
2,1,14,4,4,1431,1440,-9
2,1,15,4,4,1540,1432,108
2,1,16,4,4,1660,1428,232
2,1,17,4,4,1705,1447,258
2,1,18,4,4,1750,1546,204
2,1,19,4,4,1767,1648,119
2,1,20,4,4,1743,1763,-20
2,2,0,4,4,1821,1589,232
2,2,1,4,4,1848,1338,510
2,2,2,4,4,1827,1167,660
2,2,3,4,4,1754,1106,648
2,2,4,4,4,1656,1198,458
2,2,5,4,4,1493,1322,171
2,2,6,4,4,1342,1375,-33
2,2,7,4,4,1249,1372,-123
2,2,8,4,4,1181,1362,-181
2,2,9,4,4,1148,1360,-212
2,2,10,4,4,1128,1360,-232
2,2,11,4,4,1125,1365,-240
2,2,12,4,4,1137,1379,-242
2,2,13,4,4,1181,1395,-214
2,2,14,4,4,1241,1401,-160
2,2,15,4,4,1367,1408,-41
2,2,16,4,4,1533,1357,176
2,2,17,4,4,1653,1307,346
2,2,18,4,4,1755,1339,416
2,2,19,4,4,1799,1422,377
2,2,20,4,4,1776,1592,184
2,3,0,4,4,1823,1431,392
2,3,1,4,4,1813,1257,556
2,3,2,4,4,1757,1202,555
2,3,3,4,4,1646,1246,400
2,3,4,4,4,1506,1450,56
2,3,5,4,4,1320,1586,-266
2,3,6,4,4,1151,1662,-511
2,3,7,4,4,1059,1666,-607
2,3,8,4,4,1013,1607,-594
2,3,9,4,4,989,1588,-599
2,3,10,4,4,974,1592,-618
2,3,11,4,4,969,1590,-621
2,3,12,4,4,976,1615,-639
2,3,13,4,4,1017,1643,-626
2,3,14,4,4,1073,1669,-596
2,3,15,4,4,1203,1661,-458
2,3,16,4,4,1392,1582,-190
2,3,17,4,4,1546,1482,64
2,3,18,4,4,1688,1406,282
2,3,19,4,4,1771,1431,340
2,3,20,4,4,1777,1559,218
2,4,0,4,4,1773,1489,284
2,4,1,4,4,1673,1519,154
2,4,2,4,4,1551,1607,-56
2,4,3,4,4,1430,1792,-362
2,4,4,4,4,1336,2047,-711
2,4,5,4,4,1245,2091,-846
2,4,6,4,4,1161,2131,-970
2,4,7,4,4,1130,2091,-961
2,4,8,4,4,1130,1986,-856
2,4,9,4,4,1120,1938,-818
2,4,10,4,4,1113,1962,-849
2,4,11,4,4,1109,1950,-841
2,4,12,4,4,1109,1989,-880
2,4,13,4,4,1122,2068,-946
2,4,14,4,4,1128,2144,-1016
2,4,15,4,4,1188,2154,-966
2,4,16,4,4,1304,2116,-812
2,4,17,4,4,1414,2014,-600
2,4,18,4,4,1551,1871,-320
2,4,19,4,4,1671,1854,-183
2,4,20,4,4,1735,1857,-122
2,5,0,4,4,1777,1551,226
2,5,1,4,4,1602,1730,-128
2,5,2,4,4,1432,1919,-487
2,5,3,4,4,1345,2199,-854
2,5,4,4,4,1333,2509,-1176
2,5,5,4,4,1378,2484,-1106
2,5,6,4,4,1404,2393,-989
2,5,7,4,4,1414,2259,-845
2,5,8,4,4,1461,2029,-568
2,5,9,4,4,1480,1861,-381
2,5,10,4,4,1490,1874,-384
2,5,11,4,4,1495,1843,-348
2,5,12,4,4,1493,1925,-432
2,5,13,4,4,1479,2136,-657
2,5,14,4,4,1440,2354,-914
2,5,15,4,4,1432,2470,-1038
2,5,16,4,4,1428,2540,-1112
2,5,17,4,4,1447,2440,-993
2,5,18,4,4,1546,2259,-713
2,5,19,4,4,1648,2252,-604
2,5,20,4,4,1763,2126,-363
2,6,0,4,4,1589,1802,-213
2,6,1,4,4,1338,2087,-749
2,6,2,4,4,1167,2384,-1217
2,6,3,4,4,1106,2749,-1643
2,6,4,4,4,1198,3145,-1947
2,6,5,4,4,1322,3159,-1837
2,6,6,4,4,1375,2929,-1554
2,6,7,4,4,1372,2746,-1374
2,6,8,4,4,1362,2407,-1045
2,6,9,4,4,1360,2125,-765
2,6,10,4,4,1360,2147,-787
2,6,11,4,4,1365,2103,-738
2,6,12,4,4,1379,2232,-853
2,6,13,4,4,1395,2562,-1167
2,6,14,4,4,1401,2863,-1462
2,6,15,4,4,1408,3075,-1667
2,6,16,4,4,1357,3207,-1850
2,6,17,4,4,1307,3043,-1736
2,6,18,4,4,1339,2839,-1500
2,6,19,4,4,1422,2793,-1371
2,6,20,4,4,1592,2532,-940
2,7,0,4,4,1431,2076,-645
2,7,1,4,4,1257,2341,-1084
2,7,2,4,4,1202,2649,-1447
2,7,3,4,4,1246,2979,-1733
2,7,4,4,4,1450,3403,-1953
2,7,5,4,4,1586,3483,-1897
2,7,6,4,4,1662,3089,-1427
2,7,7,4,4,1666,2881,-1215
2,7,8,4,4,1607,2442,-835
2,7,9,4,4,1588,2050,-462
2,7,10,4,4,1592,2080,-488
2,7,11,4,4,1590,2021,-431
2,7,12,4,4,1615,2202,-587
2,7,13,4,4,1643,2644,-1001
2,7,14,4,4,1669,2996,-1327
2,7,15,4,4,1661,3346,-1685
2,7,16,4,4,1582,3545,-1963
2,7,17,4,4,1482,3323,-1841
2,7,18,4,4,1406,3201,-1795
2,7,19,4,4,1431,3139,-1708
2,7,20,4,4,1559,2833,-1274
2,8,0,4,4,1489,2165,-676
2,8,1,4,4,1519,2377,-858
2,8,2,4,4,1607,2691,-1084
2,8,3,4,4,1792,2945,-1153
2,8,4,4,4,2047,3380,-1333
2,8,5,4,4,2091,3528,-1437
2,8,6,4,4,2131,2964,-833
2,8,7,4,4,2091,2739,-648
2,8,8,4,4,1986,2209,-223
2,8,9,4,4,1938,1709,229
2,8,10,4,4,1962,1726,236
2,8,11,4,4,1950,1645,305
2,8,12,4,4,1989,1881,108
2,8,13,4,4,2068,2422,-354
2,8,14,4,4,2144,2817,-673
2,8,15,4,4,2154,3328,-1174
2,8,16,4,4,2116,3568,-1452
2,8,17,4,4,2014,3269,-1255
2,8,18,4,4,1871,3241,-1370
2,8,19,4,4,1854,3129,-1275
2,8,20,4,4,1857,2818,-961
2,9,0,4,4,1551,2053,-502
2,9,1,4,4,1730,2290,-560
2,9,2,4,4,1919,2685,-766
2,9,3,4,4,2199,2885,-686
2,9,4,4,4,2509,3351,-842
2,9,5,4,4,2484,3524,-1040
2,9,6,4,4,2393,2908,-515
2,9,7,4,4,2259,2769,-510
2,9,8,4,4,2029,2194,-165
2,9,9,4,4,1861,1683,178
2,9,10,4,4,1874,1705,169
2,9,11,4,4,1843,1616,227
2,9,12,4,4,1925,1888,37
2,9,13,4,4,2136,2436,-300
2,9,14,4,4,2354,2762,-408
2,9,15,4,4,2470,3267,-797
2,9,16,4,4,2540,3487,-947
2,9,17,4,4,2440,3123,-683
2,9,18,4,4,2259,3134,-875
2,9,19,4,4,2252,2951,-699
2,9,20,4,4,2126,2654,-528
2,10,0,4,4,1802,1907,-105
2,10,1,4,4,2087,2202,-115
2,10,2,4,4,2384,2619,-235
2,10,3,4,4,2749,2808,-59
2,10,4,4,4,3145,3249,-104
2,10,5,4,4,3159,3349,-190
2,10,6,4,4,2929,2766,163
2,10,7,4,4,2746,2689,57
2,10,8,4,4,2407,2090,317
2,10,9,4,4,2125,1605,520
2,10,10,4,4,2147,1643,504
2,10,11,4,4,2103,1520,583
2,10,12,4,4,2232,1801,431
2,10,13,4,4,2562,2369,193
2,10,14,4,4,2863,2652,211
2,10,15,4,4,3075,3044,31
2,10,16,4,4,3207,3228,-21
2,10,17,4,4,3043,2868,175
2,10,18,4,4,2839,2913,-74
2,10,19,4,4,2793,2769,24
2,10,20,4,4,2532,2546,-14
2,11,0,4,4,2076,1823,253
2,11,1,4,4,2341,2210,131
2,11,2,4,4,2649,2629,20
2,11,3,4,4,2979,2783,196
2,11,4,4,4,3403,3059,344
2,11,5,4,4,3483,2973,510
2,11,6,4,4,3089,2438,651
2,11,7,4,4,2881,2383,498
2,11,8,4,4,2442,1878,564
2,11,9,4,4,2050,1515,535
2,11,10,4,4,2080,1543,537
2,11,11,4,4,2021,1471,550
2,11,12,4,4,2202,1688,514
2,11,13,4,4,2644,2084,560
2,11,14,4,4,2996,2382,614
2,11,15,4,4,3346,2618,728
2,11,16,4,4,3545,2787,758
2,11,17,4,4,3323,2648,675
2,11,18,4,4,3201,2684,517
2,11,19,4,4,3139,2577,562
2,11,20,4,4,2833,2409,424
2,12,0,4,4,2165,1900,265
2,12,1,4,4,2377,2166,211
2,12,2,4,4,2691,2494,197
2,12,3,4,4,2945,2559,386
2,12,4,4,4,3380,2582,798
2,12,5,4,4,3528,2522,1006
2,12,6,4,4,2964,2197,767
2,12,7,4,4,2739,2274,465
2,12,8,4,4,2209,1944,265
2,12,9,4,4,1709,1685,24
2,12,10,4,4,1726,1738,-12
2,12,11,4,4,1645,1650,-5
2,12,12,4,4,1881,1735,146
2,12,13,4,4,2422,2011,411
2,12,14,4,4,2817,2281,536
2,12,15,4,4,3328,2315,1013
2,12,16,4,4,3568,2419,1149
2,12,17,4,4,3269,2375,894
2,12,18,4,4,3241,2255,986
2,12,19,4,4,3129,2214,915
2,12,20,4,4,2818,2266,552
2,13,0,4,4,2053,2048,5
2,13,1,4,4,2290,2110,180
2,13,2,4,4,2685,2270,415
2,13,3,4,4,2885,2285,600
2,13,4,4,4,3351,2128,1223
2,13,5,4,4,3524,2195,1329
2,13,6,4,4,2908,2101,807
2,13,7,4,4,2769,2271,498
2,13,8,4,4,2194,2036,158
2,13,9,4,4,1683,1797,-114
2,13,10,4,4,1705,1859,-154
2,13,11,4,4,1616,1721,-105
2,13,12,4,4,1888,1681,207
2,13,13,4,4,2436,1816,620
2,13,14,4,4,2762,2002,760
2,13,15,4,4,3267,1909,1358
2,13,16,4,4,3487,1972,1515
2,13,17,4,4,3123,2051,1072
2,13,18,4,4,3134,1858,1276
2,13,19,4,4,2951,1896,1055
2,13,20,4,4,2654,2159,495
2,14,0,4,4,1907,2255,-348
2,14,1,4,4,2202,2077,125
2,14,2,4,4,2619,2081,538
2,14,3,4,4,2808,2016,792
2,14,4,4,4,3249,1623,1626
2,14,5,4,4,3349,1784,1565
2,14,6,4,4,2766,1819,947
2,14,7,4,4,2689,1959,730
2,14,8,4,4,2090,1848,242
2,14,9,4,4,1605,1665,-60
2,14,10,4,4,1643,1710,-67
2,14,11,4,4,1520,1619,-99
2,14,12,4,4,1801,1517,284
2,14,13,4,4,2369,1448,921
2,14,14,4,4,2652,1590,1062
2,14,15,4,4,3044,1514,1530
2,14,16,4,4,3228,1586,1642
2,14,17,4,4,2868,1791,1077
2,14,18,4,4,2913,1612,1301
2,14,19,4,4,2769,1673,1096
2,14,20,4,4,2546,2030,516
2,15,0,4,4,1823,2148,-325
2,15,1,4,4,2210,1797,413
2,15,2,4,4,2629,1677,952
2,15,3,4,4,2783,1588,1195
2,15,4,4,4,3059,1226,1833
2,15,5,4,4,2973,1624,1349
2,15,6,4,4,2438,1777,661
2,15,7,4,4,2383,1936,447
2,15,8,4,4,1878,1835,43
2,15,9,4,4,1515,1622,-107
2,15,10,4,4,1543,1699,-156
2,15,11,4,4,1471,1543,-72
2,15,12,4,4,1688,1480,208
2,15,13,4,4,2084,1447,637
2,15,14,4,4,2382,1493,889
2,15,15,4,4,2618,1434,1184
2,15,16,4,4,2787,1423,1364
2,15,17,4,4,2648,1431,1217
2,15,18,4,4,2684,1230,1454
2,15,19,4,4,2577,1317,1260
2,15,20,4,4,2409,1676,733
2,16,0,4,4,1900,1833,67
2,16,1,4,4,2166,1500,666
2,16,2,4,4,2494,1386,1108
2,16,3,4,4,2559,1323,1236
2,16,4,4,4,2582,1107,1475
2,16,5,4,4,2522,1505,1017
2,16,6,4,4,2197,1648,549
2,16,7,4,4,2274,1728,546
2,16,8,4,4,1944,1575,369
2,16,9,4,4,1685,1397,288
2,16,10,4,4,1738,1432,306
2,16,11,4,4,1650,1361,289
2,16,12,4,4,1735,1398,337
2,16,13,4,4,2011,1310,701
2,16,14,4,4,2281,1282,999
2,16,15,4,4,2315,1214,1101
2,16,16,4,4,2419,1181,1238
2,16,17,4,4,2375,1147,1228
2,16,18,4,4,2255,1041,1214
2,16,19,4,4,2214,1155,1059
2,16,20,4,4,2266,1353,913
2,0,0,5,4,2187,2064,123
2,0,1,5,4,2210,1824,386
2,0,2,5,4,2203,1640,563
2,0,3,5,4,2184,1528,656
2,0,4,5,4,2175,1540,635
2,0,5,5,4,2057,1608,449
2,0,6,5,4,1937,1620,317
2,0,7,5,4,1846,1615,231
2,0,8,5,4,1744,1631,113
2,0,9,5,4,1708,1625,83
2,0,10,5,4,1689,1622,67
2,0,11,5,4,1691,1625,66
2,0,12,5,4,1709,1640,69
2,0,13,5,4,1771,1646,125
2,0,14,5,4,1840,1645,195
2,0,15,5,4,1955,1668,287
2,0,16,5,4,2078,1658,420
2,0,17,5,4,2123,1669,454
2,0,18,5,4,2169,1762,407
2,0,19,5,4,2185,1882,303
2,0,20,5,4,2155,2053,102
2,1,0,5,4,2251,1873,378
2,1,1,5,4,2284,1666,618
2,1,2,5,4,2260,1569,691
2,1,3,5,4,2182,1571,611
2,1,4,5,4,2085,1744,341
2,1,5,5,4,1918,1862,56
2,1,6,5,4,1765,1925,-160
2,1,7,5,4,1674,1931,-257
2,1,8,5,4,1602,1883,-281
2,1,9,5,4,1564,1864,-300
2,1,10,5,4,1542,1868,-326
2,1,11,5,4,1540,1865,-325
2,1,12,5,4,1556,1889,-333
2,1,13,5,4,1612,1925,-313
2,1,14,5,4,1675,1948,-273
2,1,15,5,4,1800,1943,-143
2,1,16,5,4,1961,1883,78
2,1,17,5,4,2067,1803,264
2,1,18,5,4,2173,1768,405
2,1,19,5,4,2227,1838,389
2,1,20,5,4,2204,1994,210
2,2,0,5,4,2263,1883,380
2,2,1,5,4,2257,1823,434
2,2,2,5,4,2194,1843,351
2,2,3,5,4,2079,2020,59
2,2,4,5,4,1950,2331,-381
2,2,5,5,4,1769,2430,-661
2,2,6,5,4,1605,2509,-904
2,2,7,5,4,1514,2484,-970
2,2,8,5,4,1457,2373,-916
2,2,9,5,4,1424,2329,-905
2,2,10,5,4,1404,2355,-951
2,2,11,5,4,1400,2343,-943
2,2,12,5,4,1411,2379,-968
2,2,13,5,4,1463,2458,-995
2,2,14,5,4,1520,2520,-1000
2,2,15,5,4,1649,2512,-863
2,2,16,5,4,1834,2455,-621
2,2,17,5,4,1974,2326,-352
2,2,18,5,4,2117,2183,-66
2,2,19,5,4,2206,2197,9
2,2,20,5,4,2211,2248,-37
2,3,0,5,4,2217,2017,200
2,3,1,5,4,2117,2133,-16
2,3,2,5,4,1993,2275,-282
2,3,3,5,4,1874,2569,-695
2,3,4,5,4,1790,2922,-1132
2,3,5,5,4,1659,2961,-1302
2,3,6,5,4,1529,2911,-1382
2,3,7,5,4,1452,2772,-1320
2,3,8,5,4,1400,2558,-1158
2,3,9,5,4,1380,2409,-1029
2,3,10,5,4,1367,2433,-1066
2,3,11,5,4,1362,2410,-1048
2,3,12,5,4,1366,2493,-1127
2,3,13,5,4,1407,2692,-1285
2,3,14,5,4,1449,2895,-1446
2,3,15,5,4,1561,3002,-1441
2,3,16,5,4,1731,3027,-1296
2,3,17,5,4,1858,2892,-1034
2,3,18,5,4,2000,2708,-708
2,3,19,5,4,2114,2690,-576
2,3,20,5,4,2168,2602,-434
2,4,0,5,4,2239,2089,150
2,4,1,5,4,2076,2309,-233
2,4,2,5,4,1907,2592,-685
2,4,3,5,4,1800,2932,-1132
2,4,4,5,4,1749,3352,-1603
2,4,5,5,4,1722,3389,-1667
2,4,6,5,4,1679,3145,-1466
2,4,7,5,4,1643,2947,-1304
2,4,8,5,4,1659,2577,-918
2,4,9,5,4,1668,2270,-602
2,4,10,5,4,1672,2279,-607
2,4,11,5,4,1676,2233,-557
2,4,12,5,4,1677,2379,-702
2,4,13,5,4,1678,2729,-1051
2,4,14,5,4,1669,3068,-1399
2,4,15,5,4,1720,3311,-1591
2,4,16,5,4,1791,3437,-1646
2,4,17,5,4,1866,3265,-1399
2,4,18,5,4,2000,3055,-1055
2,4,19,5,4,2109,3027,-918
2,4,20,5,4,2211,2822,-611
2,5,0,5,4,2064,2360,-296
2,5,1,5,4,1824,2669,-845
2,5,2,5,4,1640,3051,-1411
2,5,3,5,4,1528,3444,-1916
2,5,4,5,4,1540,3949,-2409
2,5,5,5,4,1608,4023,-2415
2,5,6,5,4,1620,3639,-2019
2,5,7,5,4,1615,3440,-1825
2,5,8,5,4,1631,2963,-1332
2,5,9,5,4,1625,2554,-929
2,5,10,5,4,1622,2588,-966
2,5,11,5,4,1625,2521,-896
2,5,12,5,4,1640,2712,-1072
2,5,13,5,4,1646,3174,-1528
2,5,14,5,4,1645,3543,-1898
2,5,15,5,4,1668,3881,-2213
2,5,16,5,4,1658,4071,-2413
2,5,17,5,4,1669,3819,-2150
2,5,18,5,4,1762,3630,-1868
2,5,19,5,4,1882,3555,-1673
2,5,20,5,4,2053,3235,-1182
2,6,0,5,4,1873,2617,-744
2,6,1,5,4,1666,2943,-1277
2,6,2,5,4,1569,3332,-1763
2,6,3,5,4,1571,3719,-2148
2,6,4,5,4,1744,4261,-2517
2,6,5,5,4,1862,4372,-2510
2,6,6,5,4,1925,3811,-1886
2,6,7,5,4,1931,3557,-1626
2,6,8,5,4,1883,2975,-1092
2,6,9,5,4,1864,2450,-586
2,6,10,5,4,1868,2489,-621
2,6,11,5,4,1865,2398,-533
2,6,12,5,4,1889,2645,-756
2,6,13,5,4,1925,3237,-1312
2,6,14,5,4,1948,3668,-1720
2,6,15,5,4,1943,4179,-2236
2,6,16,5,4,1883,4441,-2558
2,6,17,5,4,1803,4113,-2310
2,6,18,5,4,1768,4018,-2250
2,6,19,5,4,1838,3895,-2057
2,6,20,5,4,1994,3507,-1513
2,7,0,5,4,1883,2581,-698
2,7,1,5,4,1823,2904,-1081
2,7,2,5,4,1843,3353,-1510
2,7,3,5,4,2020,3662,-1642
2,7,4,5,4,2331,4226,-1895
2,7,5,5,4,2430,4394,-1964
2,7,6,5,4,2509,3688,-1179
2,7,7,5,4,2484,3450,-966
2,7,8,5,4,2373,2766,-393
2,7,9,5,4,2329,2154,175
2,7,10,5,4,2355,2176,179
2,7,11,5,4,2343,2076,267
2,7,12,5,4,2379,2392,-13
2,7,13,5,4,2458,3060,-602
2,7,14,5,4,2520,3513,-993
2,7,15,5,4,2512,4115,-1603
2,7,16,5,4,2455,4398,-1943
2,7,17,5,4,2326,4001,-1675
2,7,18,5,4,2183,3971,-1788
2,7,19,5,4,2197,3787,-1590
2,7,20,5,4,2248,3399,-1151
2,8,0,5,4,2017,2445,-428
2,8,1,5,4,2133,2781,-648
2,8,2,5,4,2275,3292,-1017
2,8,3,5,4,2569,3541,-972
2,8,4,5,4,2922,4092,-1170
2,8,5,5,4,2961,4254,-1293
2,8,6,5,4,2911,3518,-607
2,8,7,5,4,2772,3377,-605
2,8,8,5,4,2558,2638,-80
2,8,9,5,4,2409,2014,395
2,8,10,5,4,2433,2048,385
2,8,11,5,4,2410,1910,500
2,8,12,5,4,2493,2255,238
2,8,13,5,4,2692,2962,-270
2,8,14,5,4,2895,3366,-471
2,8,15,5,4,3002,3885,-883
2,8,16,5,4,3027,4125,-1098
2,8,17,5,4,2892,3693,-801
2,8,18,5,4,2708,3709,-1001
2,8,19,5,4,2690,3544,-854
2,8,20,5,4,2602,3242,-640
2,9,0,5,4,2089,2381,-292
2,9,1,5,4,2309,2792,-483
2,9,2,5,4,2592,3296,-704
2,9,3,5,4,2932,3478,-546
2,9,4,5,4,3352,3863,-511
2,9,5,5,4,3389,3837,-448
2,9,6,5,4,3145,3148,-3
2,9,7,5,4,2947,3077,-130
2,9,8,5,4,2577,2434,143
2,9,9,5,4,2270,1944,326
2,9,10,5,4,2279,1984,295
2,9,11,5,4,2233,1889,344
2,9,12,5,4,2379,2168,211
2,9,13,5,4,2729,2696,33
2,9,14,5,4,3068,3062,6
2,9,15,5,4,3311,3424,-113
2,9,16,5,4,3437,3651,-214
2,9,17,5,4,3265,3424,-159
2,9,18,5,4,3055,3475,-420
2,9,19,5,4,3027,3339,-312
2,9,20,5,4,2822,3112,-290
2,10,0,5,4,2360,2441,-81
2,10,1,5,4,2669,2768,-99
2,10,2,5,4,3051,3177,-126
2,10,3,5,4,3444,3299,145
2,10,4,5,4,3949,3440,509
2,10,5,5,4,4023,3411,612
2,10,6,5,4,3639,2919,720
2,10,7,5,4,3440,2950,490
2,10,8,5,4,2963,2477,486
2,10,9,5,4,2554,2085,469
2,10,10,5,4,2588,2147,441
2,10,11,5,4,2521,2027,494
2,10,12,5,4,2712,2178,534
2,10,13,5,4,3174,2604,570
2,10,14,5,4,3543,2953,590
2,10,15,5,4,3881,3148,733
2,10,16,5,4,4071,3315,756
2,10,17,5,4,3819,3165,654
2,10,18,5,4,3630,3072,558
2,10,19,5,4,3555,2970,585
2,10,20,5,4,3235,2940,295
2,11,0,5,4,2617,2464,153
2,11,1,5,4,2943,2637,306
2,11,2,5,4,3332,2932,400
2,11,3,5,4,3719,3002,717
2,11,4,5,4,4261,2974,1287
2,11,5,5,4,4372,3061,1311
2,11,6,5,4,3811,2825,986
2,11,7,5,4,3557,2982,575
2,11,8,5,4,2975,2593,382
2,11,9,5,4,2450,2242,208
2,11,10,5,4,2489,2309,180
2,11,11,5,4,2398,2152,246
2,11,12,5,4,2645,2192,453
2,11,13,5,4,3237,2454,783
2,11,14,5,4,3668,2698,970
2,11,15,5,4,4179,2696,1483
2,11,16,5,4,4441,2802,1639
2,11,17,5,4,4113,2783,1330
2,11,18,5,4,4018,2588,1430
2,11,19,5,4,3895,2554,1341
2,11,20,5,4,3507,2740,767
2,12,0,5,4,2581,2647,-66
2,12,1,5,4,2904,2568,336
2,12,2,5,4,3353,2688,665
2,12,3,5,4,3662,2672,990
2,12,4,5,4,4226,2364,1862
2,12,5,5,4,4394,2514,1880
2,12,6,5,4,3688,2429,1259
2,12,7,5,4,3450,2567,883
2,12,8,5,4,2766,2292,474
2,12,9,5,4,2154,1996,158
2,12,10,5,4,2176,2053,123
2,12,11,5,4,2076,1913,163
2,12,12,5,4,2392,1884,508
2,12,13,5,4,3060,1974,1086
2,12,14,5,4,3513,2194,1319
2,12,15,5,4,4115,2132,1983
2,12,16,5,4,4398,2224,2174
2,12,17,5,4,4001,2361,1640
2,12,18,5,4,3971,2187,1784
2,12,19,5,4,3787,2266,1521
2,12,20,5,4,3399,2618,781
2,13,0,5,4,2445,2622,-177
2,13,1,5,4,2781,2387,394
2,13,2,5,4,3292,2354,938
2,13,3,5,4,3541,2258,1283
2,13,4,5,4,4092,1840,2252
2,13,5,5,4,4254,2112,2142
2,13,6,5,4,3518,2159,1359
2,13,7,5,4,3377,2324,1053
2,13,8,5,4,2638,2179,459
2,13,9,5,4,2014,1961,53
2,13,10,5,4,2048,2040,8
2,13,11,5,4,1910,1912,-2
2,13,12,5,4,2255,1847,408
2,13,13,5,4,2962,1774,1188
2,13,14,5,4,3366,1903,1463
2,13,15,5,4,3885,1814,2071
2,13,16,5,4,4125,1846,2279
2,13,17,5,4,3693,1987,1706
2,13,18,5,4,3709,1792,1917
2,13,19,5,4,3544,1887,1657
2,13,20,5,4,3242,2242,1000
2,14,0,5,4,2381,2451,-70
2,14,1,5,4,2792,2058,734
2,14,2,5,4,3296,1934,1362
2,14,3,5,4,3478,1839,1639
2,14,4,5,4,3863,1488,2375
2,14,5,5,4,3837,1943,1894
2,14,6,5,4,3148,2129,1019
2,14,7,5,4,3077,2295,782
2,14,8,5,4,2434,2174,260
2,14,9,5,4,1944,1967,-23
2,14,10,5,4,1984,2036,-52
2,14,11,5,4,1889,1917,-28
2,14,12,5,4,2168,1888,280
2,14,13,5,4,2696,1830,866
2,14,14,5,4,3062,1853,1209
2,14,15,5,4,3424,1744,1680
2,14,16,5,4,3651,1709,1942
2,14,17,5,4,3424,1664,1760
2,14,18,5,4,3475,1429,2046
2,14,19,5,4,3339,1548,1791
2,14,20,5,4,3112,1884,1228
2,0,0,6,4,2662,2325,337
2,0,1,6,4,2696,2232,464
2,0,2,6,4,2676,2210,466
2,0,3,6,4,2606,2345,261
2,0,4,6,4,2517,2625,-108
2,0,5,6,4,2343,2706,-363
2,0,6,6,4,2182,2772,-590
2,0,7,6,4,2089,2749,-660
2,0,8,6,4,2013,2649,-636
2,0,9,6,4,1973,2605,-632
2,0,10,6,4,1951,2631,-680
2,0,11,6,4,1951,2618,-667
2,0,12,6,4,1970,2653,-683
2,0,13,6,4,2022,2740,-718
2,0,14,6,4,2084,2799,-715
2,0,15,6,4,2215,2794,-579
2,0,16,6,4,2379,2756,-377
2,0,17,6,4,2485,2647,-162
2,0,18,6,4,2592,2545,47
2,0,19,6,4,2645,2604,41
2,0,20,6,4,2616,2683,-67
2,1,0,6,4,2693,2411,282
2,1,1,6,4,2693,2437,256
2,1,2,6,4,2627,2511,116
2,1,3,6,4,2507,2797,-290
2,1,4,6,4,2379,3206,-827
2,1,5,6,4,2194,3300,-1106
2,1,6,6,4,2028,3289,-1261
2,1,7,6,4,1939,3165,-1226
2,1,8,6,4,1878,2945,-1067
2,1,9,6,4,1840,2800,-960
2,1,10,6,4,1818,2826,-1008
2,1,11,6,4,1815,2803,-988
2,1,12,6,4,1830,2883,-1053
2,1,13,6,4,1894,3082,-1188
2,1,14,6,4,1954,3271,-1317
2,1,15,6,4,2082,3360,-1278
2,1,16,6,4,2262,3366,-1104
2,1,17,6,4,2388,3204,-816
2,1,18,6,4,2535,3020,-485
2,1,19,6,4,2634,3033,-399
2,1,20,6,4,2639,2993,-354
2,2,0,6,4,2657,2555,102
2,2,1,6,4,2561,2712,-151
2,2,2,6,4,2430,2948,-518
2,2,3,6,4,2307,3302,-995
2,2,4,6,4,2234,3765,-1531
2,2,5,6,4,2108,3866,-1758
2,2,6,6,4,1983,3663,-1680
2,2,7,6,4,1907,3460,-1553
2,2,8,6,4,1844,3106,-1262
2,2,9,6,4,1815,2818,-1003
2,2,10,6,4,1797,2838,-1041
2,2,11,6,4,1793,2800,-1007
2,2,12,6,4,1801,2947,-1146
2,2,13,6,4,1853,3285,-1432
2,2,14,6,4,1896,3609,-1713
2,2,15,6,4,2007,3843,-1836
2,2,16,6,4,2173,3924,-1751
2,2,17,6,4,2286,3717,-1431
2,2,18,6,4,2429,3504,-1075
2,2,19,6,4,2549,3465,-916
2,2,20,6,4,2602,3298,-696
2,3,0,6,4,2683,2647,36
2,3,1,6,4,2520,2891,-371
2,3,2,6,4,2349,3259,-910
2,3,3,6,4,2244,3627,-1383
2,3,4,6,4,2203,4156,-1953
2,3,5,6,4,2136,4253,-2117
2,3,6,6,4,2047,3855,-1808
2,3,7,6,4,1965,3641,-1676
2,3,8,6,4,1929,3133,-1204
2,3,9,6,4,1928,2699,-771
2,3,10,6,4,1926,2720,-794
2,3,11,6,4,1929,2651,-722
2,3,12,6,4,1934,2859,-925
2,3,13,6,4,1963,3341,-1378
2,3,14,6,4,1990,3748,-1758
2,3,15,6,4,2093,4117,-2024
2,3,16,6,4,2218,4301,-2083
2,3,17,6,4,2310,4041,-1731
2,3,18,6,4,2449,3846,-1397
2,3,19,6,4,2552,3789,-1237
2,3,20,6,4,2644,3525,-881
2,4,0,6,4,2526,2901,-375
2,4,1,6,4,2298,3271,-973
2,4,2,6,4,2115,3734,-1619
2,4,3,6,4,1983,4184,-2201
2,4,4,6,4,1956,4807,-2851
2,4,5,6,4,1952,4912,-2960
2,4,6,6,4,1895,4361,-2466
2,4,7,6,4,1844,4116,-2272
2,4,8,6,4,1829,3496,-1667
2,4,9,6,4,1813,2954,-1141
2,4,10,6,4,1804,2997,-1193
2,4,11,6,4,1806,2898,-1092
2,4,12,6,4,1824,3155,-1331
2,4,13,6,4,1845,3767,-1922
2,4,14,6,4,1874,4215,-2341
2,4,15,6,4,1956,4714,-2758
2,4,16,6,4,2021,4967,-2946
2,4,17,6,4,2088,4609,-2521
2,4,18,6,4,2216,4447,-2231
2,4,19,6,4,2343,4311,-1968
2,4,20,6,4,2501,3909,-1408
2,5,0,6,4,2348,3033,-685
2,5,1,6,4,2152,3470,-1318
2,5,2,6,4,2042,3994,-1952
2,5,3,6,4,1993,4436,-2443
2,5,4,6,4,2086,5107,-3021
2,5,5,6,4,2148,5238,-3090
2,5,6,6,4,2170,4535,-2365
2,5,7,6,4,2174,4268,-2094
2,5,8,6,4,2152,3532,-1380
2,5,9,6,4,2129,2895,-766
2,5,10,6,4,2130,2939,-809
2,5,11,6,4,2125,2829,-704
2,5,12,6,4,2150,3156,-1006
2,5,13,6,4,2176,3875,-1699
2,5,14,6,4,2192,4364,-2172
2,5,15,6,4,2203,4966,-2763
2,5,16,6,4,2184,5271,-3087
2,5,17,6,4,2165,4845,-2680
2,5,18,6,4,2191,4748,-2557
2,5,19,6,4,2298,4553,-2255
2,5,20,6,4,2455,4088,-1633
2,6,0,6,4,2325,2973,-648
2,6,1,6,4,2232,3395,-1163
2,6,2,6,4,2210,3960,-1750
2,6,3,6,4,2345,4318,-1973
2,6,4,6,4,2625,4967,-2342
2,6,5,6,4,2706,5124,-2418
2,6,6,6,4,2772,4298,-1526
2,6,7,6,4,2749,4058,-1309
2,6,8,6,4,2649,3210,-561
2,6,9,6,4,2605,2485,120
2,6,10,6,4,2631,2519,112
2,6,11,6,4,2618,2370,248
2,6,12,6,4,2653,2759,-106
2,6,13,6,4,2740,3586,-846
2,6,14,6,4,2799,4117,-1318
2,6,15,6,4,2794,4733,-1939
2,6,16,6,4,2756,5036,-2280
2,6,17,6,4,2647,4571,-1924
2,6,18,6,4,2545,4546,-2001
2,6,19,6,4,2604,4380,-1776
2,6,20,6,4,2683,3987,-1304
2,7,0,6,4,2411,2919,-508
2,7,1,6,4,2437,3371,-934
2,7,2,6,4,2511,3969,-1458
2,7,3,6,4,2797,4211,-1414
2,7,4,6,4,3206,4706,-1500
2,7,5,6,4,3300,4742,-1442
2,7,6,6,4,3289,3900,-611
2,7,7,6,4,3165,3765,-600
2,7,8,6,4,2945,2982,-37
2,7,9,6,4,2800,2353,447
2,7,10,6,4,2826,2389,437
2,7,11,6,4,2803,2279,524
2,7,12,6,4,2883,2622,261
2,7,13,6,4,3082,3289,-207
2,7,14,6,4,3271,3776,-505
2,7,15,6,4,3360,4265,-905
2,7,16,6,4,3366,4548,-1182
2,7,17,6,4,3204,4249,-1045
2,7,18,6,4,3020,4271,-1251
2,7,19,6,4,3033,4114,-1081
2,7,20,6,4,2993,3808,-815
2,8,0,6,4,2555,2999,-444
2,8,1,6,4,2712,3350,-638
2,8,2,6,4,2948,3844,-896
2,8,3,6,4,3302,3994,-692
2,8,4,6,4,3765,4244,-479
2,8,5,6,4,3866,4275,-409
2,8,6,6,4,3663,3629,34
2,8,7,6,4,3460,3644,-184
2,8,8,6,4,3106,3033,73
2,8,9,6,4,2818,2514,304
2,8,10,6,4,2838,2588,250
2,8,11,6,4,2800,2445,355
2,8,12,6,4,2947,2658,289
2,8,13,6,4,3285,3216,69
2,8,14,6,4,3609,3633,-24
2,8,15,6,4,3843,3954,-111
2,8,16,6,4,3924,4179,-255
2,8,17,6,4,3717,3941,-224
2,8,18,6,4,3504,3863,-359
2,8,19,6,4,3465,3732,-267
2,8,20,6,4,3298,3643,-345
2,9,0,6,4,2647,3005,-358
2,9,1,6,4,2891,3239,-348
2,9,2,6,4,3259,3615,-356
2,9,3,6,4,3627,3742,-115
2,9,4,6,4,4156,3832,324
2,9,5,6,4,4253,3950,303
2,9,6,6,4,3855,3547,308
2,9,7,6,4,3641,3658,-17
2,9,8,6,4,3133,3126,7
2,9,9,6,4,2699,2642,57
2,9,10,6,4,2720,2718,2
2,9,11,6,4,2651,2529,122
2,9,12,6,4,2859,2635,224
2,9,13,6,4,3341,3047,294
2,9,14,6,4,3748,3370,378
2,9,15,6,4,4117,3529,588
2,9,16,6,4,4301,3698,603
2,9,17,6,4,4041,3573,468
2,9,18,6,4,3846,3405,441
2,9,19,6,4,3789,3310,479
2,9,20,6,4,3525,3414,111
2,10,0,6,4,2901,3063,-162
2,10,1,6,4,3271,3095,176
2,10,2,6,4,3734,3350,384
2,10,3,6,4,4184,3389,795
2,10,4,6,4,4807,3210,1597
2,10,5,6,4,4912,3380,1532
2,10,6,6,4,4361,3153,1208
2,10,7,6,4,4116,3278,838
2,10,8,6,4,3496,2849,647
2,10,9,6,4,2954,2441,513
2,10,10,6,4,2997,2503,494
2,10,11,6,4,2898,2344,554
2,10,12,6,4,3155,2395,760
2,10,13,6,4,3767,2612,1155
2,10,14,6,4,4215,2890,1325
2,10,15,6,4,4714,2919,1795
2,10,16,6,4,4967,3054,1913
2,10,17,6,4,4609,3093,1516
2,10,18,6,4,4447,2917,1530
2,10,19,6,4,4311,2924,1387
2,10,20,6,4,3909,3199,710
2,11,0,6,4,3033,3014,19
2,11,1,6,4,3470,2878,592
2,11,2,6,4,3994,2961,1033
2,11,3,6,4,4436,2914,1522
2,11,4,6,4,5107,2581,2526
2,11,5,6,4,5238,2842,2396
2,11,6,6,4,4535,2769,1766
2,11,7,6,4,4268,2932,1336
2,11,8,6,4,3532,2623,909
2,11,9,6,4,2895,2292,603
2,11,10,6,4,2939,2383,556
2,11,11,6,4,2829,2206,623
2,11,12,6,4,3156,2214,942
2,11,13,6,4,3875,2300,1575
2,11,14,6,4,4364,2507,1857
2,11,15,6,4,4966,2432,2534
2,11,16,6,4,5271,2484,2787
2,11,17,6,4,4845,2557,2288
2,11,18,6,4,4748,2367,2381
2,11,19,6,4,4553,2480,2073
2,11,20,6,4,4088,2830,1258
2,12,0,6,4,2973,2925,48
2,12,1,6,4,3395,2648,747
2,12,2,6,4,3960,2611,1349
2,12,3,6,4,4318,2509,1809
2,12,4,6,4,4967,2102,2865
2,12,5,6,4,5124,2431,2693
2,12,6,6,4,4298,2511,1787
2,12,7,6,4,4058,2683,1375
2,12,8,6,4,3210,2518,692
2,12,9,6,4,2485,2306,179
2,12,10,6,4,2519,2377,142
2,12,11,6,4,2370,2286,84
2,12,12,6,4,2759,2255,504
2,12,13,6,4,3586,2157,1429
2,12,14,6,4,4117,2263,1854
2,12,15,6,4,4733,2124,2609
2,12,16,6,4,5036,2132,2904
2,12,17,6,4,4571,2220,2351
2,12,18,6,4,4546,1991,2555
2,12,19,6,4,4380,2118,2262
2,12,20,6,4,3987,2450,1537
2,0,0,7,4,3104,2949,155
2,0,1,7,4,3105,3016,89
2,0,2,7,4,3043,3184,-141
2,0,3,7,4,2931,3530,-599
2,0,4,7,4,2811,4049,-1238
2,0,5,7,4,2619,4205,-1586
2,0,6,7,4,2445,4041,-1596
2,0,7,7,4,2354,3853,-1499
2,0,8,7,4,2289,3493,-1204
2,0,9,7,4,2249,3209,-960
2,0,10,7,4,2227,3231,-1004
2,0,11,7,4,2226,3193,-967
2,0,12,7,4,2244,3337,-1093
2,0,13,7,4,2304,3675,-1371
2,0,14,7,4,2363,3985,-1622
2,0,15,7,4,2497,4201,-1704
2,0,16,7,4,2680,4263,-1583
2,0,17,7,4,2806,4029,-1223
2,0,18,7,4,2954,3816,-862
2,0,19,7,4,3052,3808,-756
2,0,20,7,4,3051,3689,-638
2,1,0,7,4,3087,3113,-26
2,1,1,7,4,2997,3294,-297
2,1,2,7,4,2863,3615,-752
2,1,3,7,4,2735,3997,-1262
2,1,4,7,4,2663,4569,-1906
2,1,5,7,4,2533,4730,-2197
2,1,6,7,4,2406,4373,-1967
2,1,7,7,4,2332,4154,-1822
2,1,8,7,4,2265,3662,-1397
2,1,9,7,4,2231,3247,-1016
2,1,10,7,4,2211,3279,-1068
2,1,11,7,4,2208,3218,-1010
2,1,12,7,4,2220,3427,-1207
2,1,13,7,4,2284,3897,-1613
2,1,14,7,4,2330,4289,-1959
2,1,15,7,4,2440,4649,-2209
2,1,16,7,4,2601,4788,-2187
2,1,17,7,4,2700,4493,-1793
2,1,18,7,4,2847,4295,-1448
2,1,19,7,4,2977,4227,-1250
2,1,20,7,4,3030,4001,-971
2,2,0,7,4,3123,3188,-65
2,2,1,7,4,2964,3493,-529
2,2,2,7,4,2786,3942,-1156
2,2,3,7,4,2677,4367,-1690
2,2,4,7,4,2647,5014,-2367
2,2,5,7,4,2585,5142,-2557
2,2,6,7,4,2501,4577,-2076
2,2,7,7,4,2420,4317,-1897
2,2,8,7,4,2373,3666,-1293
2,2,9,7,4,2363,3099,-736
2,2,10,7,4,2356,3129,-773
2,2,11,7,4,2360,3028,-668
2,2,12,7,4,2369,3302,-933
2,2,13,7,4,2409,3934,-1525
2,2,14,7,4,2437,4420,-1983
2,2,15,7,4,2539,4950,-2411
2,2,16,7,4,2660,5197,-2537
2,2,17,7,4,2738,4831,-2093
2,2,18,7,4,2878,4663,-1785
2,2,19,7,4,2987,4545,-1558
2,2,20,7,4,3078,4199,-1121
2,3,0,7,4,2970,3317,-347
2,3,1,7,4,2742,3798,-1056
2,3,2,7,4,2557,4396,-1839
2,3,3,7,4,2427,4901,-2474
2,3,4,7,4,2410,5653,-3243
2,3,5,7,4,2366,5778,-3412
2,3,6,7,4,2263,5085,-2822
2,3,7,7,4,2166,4827,-2661
2,3,8,7,4,2099,4053,-1954
2,3,9,7,4,2073,3399,-1326
2,3,10,7,4,2058,3447,-1389
2,3,11,7,4,2059,3329,-1270
2,3,12,7,4,2081,3666,-1585
2,3,13,7,4,2130,4405,-2275
2,3,14,7,4,2195,4911,-2716
2,3,15,7,4,2329,5501,-3172
2,3,16,7,4,2448,5797,-3349
2,3,17,7,4,2532,5341,-2809
2,3,18,7,4,2665,5177,-2512
2,3,19,7,4,2786,4969,-2183
2,3,20,7,4,2934,4490,-1556
2,4,0,7,4,2810,3425,-615
2,4,1,7,4,2626,3961,-1335
2,4,2,7,4,2517,4601,-2084
2,4,3,7,4,2448,5092,-2644
2,4,4,7,4,2502,5848,-3346
2,4,5,7,4,2492,5968,-3476
2,4,6,7,4,2445,5145,-2700
2,4,7,7,4,2403,4876,-2473
2,4,8,7,4,2350,3976,-1626
2,4,9,7,4,2317,3226,-909
2,4,10,7,4,2312,3282,-970
2,4,11,7,4,2306,3123,-817
2,4,12,7,4,2334,3523,-1189
2,4,13,7,4,2375,4401,-2026
2,4,14,7,4,2421,4968,-2547
2,4,15,7,4,2491,5584,-3093
2,4,16,7,4,2547,5909,-3362
2,4,17,7,4,2584,5415,-2831
2,4,18,7,4,2645,5323,-2678
2,4,19,7,4,2759,5146,-2387
2,4,20,7,4,2903,4676,-1773
2,5,0,7,4,2800,3447,-647
2,5,1,7,4,2718,3985,-1267
2,5,2,7,4,2683,4637,-1954
2,5,3,7,4,2767,4988,-2221
2,5,4,7,4,2967,5581,-2614
2,5,5,7,4,2992,5612,-2620
2,5,6,7,4,3017,4680,-1663
2,5,7,7,4,2992,4446,-1454
2,5,8,7,4,2918,3554,-636
2,5,9,7,4,2870,2824,46
2,5,10,7,4,2893,2860,33
2,5,11,7,4,2878,2739,139
2,5,12,7,4,2914,3126,-212
2,5,13,7,4,2991,3913,-922
2,5,14,7,4,3043,4527,-1484
2,5,15,7,4,3054,5113,-2059
2,5,16,7,4,3057,5459,-2402
2,5,17,7,4,3009,5127,-2118
2,5,18,7,4,2968,5108,-2140
2,5,19,7,4,3064,4950,-1886
2,5,20,7,4,3144,4553,-1409
2,6,0,7,4,2853,3537,-684
2,6,1,7,4,2846,3929,-1083
2,6,2,7,4,2878,4517,-1639
2,6,3,7,4,3122,4727,-1605
2,6,4,7,4,3500,5087,-1587
2,6,5,7,4,3576,5180,-1604
2,6,6,7,4,3552,4381,-829
2,6,7,7,4,3430,4332,-902
2,6,8,7,4,3221,3581,-360
2,6,9,7,4,3076,2923,153
2,6,10,7,4,3102,2993,109
2,6,11,7,4,3078,2835,243
2,6,12,7,4,3157,3112,45
2,6,13,7,4,3364,3809,-445
2,6,14,7,4,3550,4347,-797
2,6,15,7,4,3642,4795,-1153
2,6,16,7,4,3667,5076,-1409
2,6,17,7,4,3525,4766,-1241
2,6,18,7,4,3382,4659,-1277
2,6,19,7,4,3440,4507,-1067
2,6,20,7,4,3428,4339,-911
2,7,0,7,4,2949,3563,-614
2,7,1,7,4,3016,3821,-805
2,7,2,7,4,3184,4282,-1098
2,7,3,7,4,3530,4437,-907
2,7,4,7,4,4049,4636,-587
2,7,5,7,4,4205,4814,-609
2,7,6,7,4,4041,4257,-216
2,7,7,7,4,3853,4352,-499
2,7,8,7,4,3493,3682,-189
2,7,9,7,4,3209,3071,138
2,7,10,7,4,3231,3159,72
2,7,11,7,4,3193,2947,246
2,7,12,7,4,3337,3115,222
2,7,13,7,4,3675,3659,16
2,7,14,7,4,3985,4050,-65
2,7,15,7,4,4201,4335,-134
2,7,16,7,4,4263,4562,-299
2,7,17,7,4,4029,4349,-320
2,7,18,7,4,3816,4196,-380
2,7,19,7,4,3808,4072,-264
2,7,20,7,4,3689,4117,-428
2,8,0,7,4,3113,3604,-491
2,8,1,7,4,3294,3697,-403
2,8,2,7,4,3615,4033,-418
2,8,3,7,4,3997,4129,-132
2,8,4,7,4,4569,4068,501
2,8,5,7,4,4730,4269,461
2,8,6,7,4,4373,3875,498
2,8,7,7,4,4154,3954,200
2,8,8,7,4,3662,3382,280
2,8,9,7,4,3247,2841,406
2,8,10,7,4,3279,2912,367
2,8,11,7,4,3218,2721,497
2,8,12,7,4,3427,2838,589
2,8,13,7,4,3897,3205,692
2,8,14,7,4,4289,3562,727
2,8,15,7,4,4649,3752,897
2,8,16,7,4,4788,3950,838
2,8,17,7,4,4493,3883,610
2,8,18,7,4,4295,3734,561
2,8,19,7,4,4227,3680,547
2,8,20,7,4,4001,3873,128
2,9,0,7,4,3188,3430,-242
2,9,1,7,4,3493,3405,88
2,9,2,7,4,3942,3623,319
2,9,3,7,4,4367,3631,736
2,9,4,7,4,5014,3427,1587
2,9,5,7,4,5142,3708,1434
2,9,6,7,4,4577,3493,1084
2,9,7,7,4,4317,3643,674
2,9,8,7,4,3666,3180,486
2,9,9,7,4,3099,2737,362
2,9,10,7,4,3129,2833,296
2,9,11,7,4,3028,2637,391
2,9,12,7,4,3302,2725,577
2,9,13,7,4,3934,2938,996
2,9,14,7,4,4420,3203,1217
2,9,15,7,4,4950,3219,1731
2,9,16,7,4,5197,3314,1883
2,9,17,7,4,4831,3289,1542
2,9,18,7,4,4663,3097,1566
2,9,19,7,4,4545,3138,1407
2,9,20,7,4,4199,3411,788
2,10,0,7,4,3317,3317,0
2,10,1,7,4,3798,3139,659
2,10,2,7,4,4396,3218,1178
2,10,3,7,4,4901,3165,1736
2,10,4,7,4,5653,2843,2810
2,10,5,7,4,5778,3161,2617
2,10,6,7,4,5085,3121,1964
2,10,7,7,4,4827,3291,1536
2,10,8,7,4,4053,2962,1091
2,10,9,7,4,3399,2637,762
2,10,10,7,4,3447,2720,727
2,10,11,7,4,3329,2580,749
2,10,12,7,4,3666,2622,1044
2,10,13,7,4,4405,2683,1722
2,10,14,7,4,4911,2867,2044
2,10,15,7,4,5501,2742,2759
2,10,16,7,4,5797,2770,3027
2,10,17,7,4,5341,2790,2551
2,10,18,7,4,5177,2566,2611
2,10,19,7,4,4969,2711,2258
2,10,20,7,4,4490,3038,1452
2,0,0,8,4,3498,3654,-156
2,0,1,8,4,3409,3896,-487
2,0,2,8,4,3279,4298,-1019
2,0,3,8,4,3159,4737,-1578
2,0,4,8,4,3095,5427,-2332
2,0,5,8,4,2958,5619,-2661
2,0,6,8,4,2823,5095,-2272
2,0,7,8,4,2747,4830,-2083
2,0,8,8,4,2676,4195,-1519
2,0,9,8,4,2640,3647,-1007
2,0,10,8,4,2620,3688,-1068
2,0,11,8,4,2619,3595,-976
2,0,12,8,4,2634,3870,-1236
2,0,13,8,4,2694,4490,-1796
2,0,14,8,4,2739,4961,-2222
2,0,15,8,4,2855,5482,-2627
2,0,16,8,4,3019,5684,-2665
2,0,17,8,4,3118,5283,-2165
2,0,18,8,4,3266,5112,-1846
2,0,19,8,4,3395,4983,-1588
2,0,20,8,4,3442,4675,-1233
2,1,0,8,4,3553,3604,-51
2,1,1,8,4,3400,4020,-620
2,1,2,8,4,3219,4604,-1385
2,1,3,8,4,3105,5084,-1979
2,1,4,8,4,3076,5860,-2784
2,1,5,8,4,3010,6008,-2998
2,1,6,8,4,2924,5301,-2377
2,1,7,8,4,2845,5028,-2183
2,1,8,8,4,2794,4223,-1429
2,1,9,8,4,2779,3544,-765
2,1,10,8,4,2770,3579,-809
2,1,11,8,4,2775,3459,-684
2,1,12,8,4,2788,3813,-1025
2,1,13,8,4,2840,4572,-1732
2,1,14,8,4,2871,5116,-2245
2,1,15,8,4,2972,5737,-2765
2,1,16,8,4,3088,6027,-2939
2,1,17,8,4,3152,5563,-2411
2,1,18,8,4,3296,5393,-2097
2,1,19,8,4,3415,5203,-1788
2,1,20,8,4,3506,4780,-1274
2,2,0,8,4,3410,3709,-299
2,2,1,8,4,3186,4289,-1103
2,2,2,8,4,2994,5003,-2009
2,2,3,8,4,2860,5557,-2697
2,2,4,8,4,2854,6394,-3540
2,2,5,8,4,2815,6508,-3693
2,2,6,8,4,2717,5695,-2978
2,2,7,8,4,2621,5435,-2814
2,2,8,8,4,2543,4497,-1954
2,2,9,8,4,2508,3730,-1222
2,2,10,8,4,2488,3790,-1302
2,2,11,8,4,2490,3623,-1133
2,2,12,8,4,2516,4033,-1517
2,2,13,8,4,2576,4931,-2355
2,2,14,8,4,2642,5515,-2873
2,2,15,8,4,2775,6119,-3344
2,2,16,8,4,2890,6435,-3545
2,2,17,8,4,2960,5911,-2951
2,2,18,8,4,3094,5752,-2658
2,2,19,8,4,3221,5562,-2341
2,2,20,8,4,3368,5078,-1710
2,3,0,8,4,3254,3899,-645
2,3,1,8,4,3070,4551,-1481
2,3,2,8,4,2959,5278,-2319
2,3,3,8,4,2892,5762,-2870
2,3,4,8,4,2956,6462,-3506
2,3,5,8,4,2906,6456,-3550
2,3,6,8,4,2813,5527,-2714
2,3,7,8,4,2725,5264,-2539
2,3,8,8,4,2620,4320,-1700
2,3,9,8,4,2577,3565,-988
2,3,10,8,4,2566,3623,-1057
2,3,11,8,4,2559,3492,-933
2,3,12,8,4,2591,3890,-1299
2,3,13,8,4,2660,4728,-2068
2,3,14,8,4,2742,5378,-2636
2,3,15,8,4,2864,5964,-3100
2,3,16,8,4,2974,6332,-3358
2,3,17,8,4,3028,5971,-2943
2,3,18,8,4,3094,5885,-2791
2,3,19,8,4,3202,5716,-2514
2,3,20,8,4,3336,5242,-1906
2,4,0,8,4,3262,4065,-803
2,4,1,8,4,3192,4543,-1351
2,4,2,8,4,3158,5185,-2027
2,4,3,8,4,3222,5504,-2282
2,4,4,8,4,3383,5962,-2579
2,4,5,8,4,3336,6050,-2714
2,4,6,8,4,3292,5161,-1869
2,4,7,8,4,3221,5013,-1792
2,4,8,8,4,3116,4153,-1037
2,4,9,8,4,3058,3394,-336
2,4,10,8,4,3075,3464,-389
2,4,11,8,4,3059,3295,-236
2,4,12,8,4,3098,3616,-518
2,4,13,8,4,3190,4433,-1243
2,4,14,8,4,3272,5098,-1826
2,4,15,8,4,3342,5643,-2301
2,4,16,8,4,3420,5987,-2567
2,4,17,8,4,3428,5644,-2216
2,4,18,8,4,3422,5496,-2074
2,4,19,8,4,3525,5343,-1818
2,4,20,8,4,3592,5084,-1492
2,5,0,8,4,3328,4101,-773
2,5,1,8,4,3332,4400,-1068
2,5,2,8,4,3351,4955,-1604
2,5,3,8,4,3544,5170,-1626
2,5,4,8,4,3842,5479,-1637
2,5,5,8,4,3862,5719,-1857
2,5,6,8,4,3797,5009,-1212
2,5,7,8,4,3673,5040,-1367
2,5,8,8,4,3490,4230,-740
2,5,9,8,4,3341,3480,-139
2,5,10,8,4,3364,3564,-200
2,5,11,8,4,3338,3337,1
2,5,12,8,4,3418,3569,-151
2,5,13,8,4,3615,4252,-637
2,5,14,8,4,3794,4764,-970
2,5,15,8,4,3902,5176,-1274
2,5,16,8,4,3968,5459,-1491
2,5,17,8,4,3887,5174,-1287
2,5,18,8,4,3805,4992,-1187
2,5,19,8,4,3900,4847,-947
2,5,20,8,4,3889,4813,-924
2,6,0,8,4,3391,4162,-771
2,6,1,8,4,3425,4279,-854
2,6,2,8,4,3551,4700,-1149
2,6,3,8,4,3855,4824,-969
2,6,4,8,4,4343,4872,-529
2,6,5,8,4,4481,5133,-652
2,6,6,8,4,4304,4585,-281
2,6,7,8,4,4118,4648,-530
2,6,8,8,4,3769,3938,-169
2,6,9,8,4,3485,3270,215
2,6,10,8,4,3507,3353,154
2,6,11,8,4,3468,3139,329
2,6,12,8,4,3611,3318,293
2,6,13,8,4,3957,3817,140
2,6,14,8,4,4264,4242,22
2,6,15,8,4,4483,4558,-75
2,6,16,8,4,4564,4814,-250
2,6,17,8,4,4350,4659,-309
2,6,18,8,4,4178,4525,-347
2,6,19,8,4,4215,4442,-227
2,6,20,8,4,4124,4576,-452
2,7,0,8,4,3507,3971,-464
2,7,1,8,4,3598,4007,-409
2,7,2,8,4,3851,4306,-455
2,7,3,8,4,4225,4371,-146
2,7,4,8,4,4853,4285,568
2,7,5,8,4,5069,4597,472
2,7,6,8,4,4751,4215,536
2,7,7,8,4,4547,4319,228
2,7,8,8,4,4049,3713,336
2,7,9,8,4,3638,3137,501
2,7,10,8,4,3672,3242,430
2,7,11,8,4,3611,3014,597
2,7,12,8,4,3817,3168,649
2,7,13,8,4,4287,3531,756
2,7,14,8,4,4665,3875,790
2,7,15,8,4,5007,4052,955
2,7,16,8,4,5127,4210,917
2,7,17,8,4,4805,4079,726
2,7,18,8,4,4607,3914,693
2,7,19,8,4,4570,3894,676
2,7,20,8,4,4392,4085,307
2,8,0,8,4,3654,3733,-79
2,8,1,8,4,3896,3666,230
2,8,2,8,4,4298,3880,418
2,8,3,8,4,4737,3882,855
2,8,4,8,4,5427,3689,1738
2,8,5,8,4,5619,4027,1592
2,8,6,8,4,5095,3845,1250
2,8,7,8,4,4830,4002,828
2,8,8,8,4,4195,3519,676
2,8,9,8,4,3647,3082,565
2,8,10,8,4,3688,3170,518
2,8,11,8,4,3595,3011,584
2,8,12,8,4,3870,3133,737
2,8,13,8,4,4490,3321,1169
2,8,14,8,4,4961,3563,1398
2,8,15,8,4,5482,3529,1953
2,8,16,8,4,5684,3600,2084
2,8,17,8,4,5283,3522,1761
2,8,18,8,4,5112,3296,1816
2,8,19,8,4,4983,3369,1614
2,8,20,8,4,4675,3619,1056
2,0,0,9,4,3964,3996,-32
2,0,1,9,4,3812,4511,-699
2,0,2,9,4,3635,5211,-1576
2,0,3,9,4,3529,5740,-2211
2,0,4,9,4,3508,6601,-3093
2,0,5,9,4,3435,6738,-3303
2,0,6,9,4,3341,5911,-2570
2,0,7,9,4,3260,5636,-2376
2,0,8,9,4,3205,4667,-1462
2,0,9,9,4,3188,3875,-687
2,0,10,9,4,3179,3922,-743
2,0,11,9,4,3186,3753,-567
2,0,12,9,4,3202,4180,-978
2,0,13,9,4,3250,5098,-1848
2,0,14,9,4,3280,5720,-2440
2,0,15,9,4,3387,6355,-2968
2,0,16,9,4,3506,6665,-3159
2,0,17,9,4,3570,6133,-2563
2,0,18,9,4,3715,5968,-2253
2,0,19,9,4,3833,5796,-1963
2,0,20,9,4,3918,5368,-1450
2,1,0,9,4,3840,4183,-343
2,1,1,9,4,3622,4879,-1257
2,1,2,9,4,3427,5680,-2253
2,1,3,9,4,3288,6227,-2939
2,1,4,9,4,3283,7008,-3725
2,1,5,9,4,3240,6996,-3756
2,1,6,9,4,3140,6077,-2937
2,1,7,9,4,3046,5823,-2777
2,1,8,9,4,2964,4841,-1877
2,1,9,9,4,2924,4069,-1145
2,1,10,9,4,2902,4131,-1229
2,1,11,9,4,2905,3992,-1087
2,1,12,9,4,2935,4400,-1465
2,1,13,9,4,3007,5258,-2251
2,1,14,9,4,3076,5925,-2849
2,1,15,9,4,3208,6499,-3291
2,1,16,9,4,3318,6858,-3540
2,1,17,9,4,3374,6467,-3093
2,1,18,9,4,3512,6314,-2802
2,1,19,9,4,3649,6132,-2483
2,1,20,9,4,3796,5644,-1848
2,2,0,9,4,3694,4517,-823
2,2,1,9,4,3514,5109,-1595
2,2,2,9,4,3396,5826,-2430
2,2,3,9,4,3325,6278,-2953
2,2,4,9,4,3400,6843,-3443
2,2,5,9,4,3355,6894,-3539
2,2,6,9,4,3267,6008,-2741
2,2,7,9,4,3180,5831,-2651
2,2,8,9,4,3064,4919,-1855
2,2,9,9,4,3012,4135,-1123
2,2,10,9,4,2996,4227,-1231
2,2,11,9,4,2990,4048,-1058
2,2,12,9,4,3026,4380,-1354
2,2,13,9,4,3106,5248,-2142
2,2,14,9,4,3189,5949,-2760
2,2,15,9,4,3310,6494,-3184
2,2,16,9,4,3416,6860,-3444
2,2,17,9,4,3456,6488,-3032
2,2,18,9,4,3523,6273,-2750
2,2,19,9,4,3637,6109,-2472
2,2,20,9,4,3770,5773,-2003
2,3,0,9,4,3706,4629,-923
2,3,1,9,4,3636,5014,-1378
2,3,2,9,4,3600,5623,-2023
2,3,3,9,4,3666,5947,-2281
2,3,4,9,4,3837,6354,-2517
2,3,5,9,4,3750,6589,-2839
2,3,6,9,4,3660,5789,-2129
2,3,7,9,4,3543,5721,-2178
2,3,8,9,4,3386,4802,-1416
2,3,9,9,4,3318,3951,-633
2,3,10,9,4,3329,4035,-706
2,3,11,9,4,3312,3797,-485
2,3,12,9,4,3355,4073,-718
2,3,13,9,4,3475,4876,-1401
2,3,14,9,4,3593,5515,-1922
2,3,15,9,4,3715,6024,-2309
2,3,16,9,4,3847,6370,-2523
2,3,17,9,4,3872,6052,-2180
2,3,18,9,4,3871,5829,-1958
2,3,19,9,4,3968,5683,-1715
2,3,20,9,4,4025,5558,-1533
2,4,0,9,4,3790,4700,-910
2,4,1,9,4,3806,4858,-1052
2,4,2,9,4,3826,5373,-1547
2,4,3,9,4,3999,5557,-1558
2,4,4,9,4,4258,5715,-1457
2,4,5,9,4,4206,6038,-1832
2,4,6,9,4,4072,5337,-1265
2,4,7,9,4,3902,5336,-1434
2,4,8,9,4,3688,4486,-798
2,4,9,9,4,3529,3679,-150
2,4,10,9,4,3546,3758,-212
2,4,11,9,4,3519,3529,-10
2,4,12,9,4,3602,3772,-170
2,4,13,9,4,3814,4410,-596
2,4,14,9,4,4023,4956,-933
2,4,15,9,4,4190,5399,-1209
2,4,16,9,4,4331,5711,-1380
2,4,17,9,4,4306,5484,-1178
2,4,18,9,4,4259,5321,-1062
2,4,19,9,4,4361,5217,-856
2,4,20,9,4,4337,5272,-935
2,5,0,9,4,3866,4529,-663
2,5,1,9,4,3911,4589,-678
2,5,2,9,4,4024,4973,-949
2,5,3,9,4,4277,5066,-789
2,5,4,9,4,4685,5089,-404
2,5,5,9,4,4767,5461,-694
2,5,6,9,4,4549,4925,-376
2,5,7,9,4,4361,5013,-652
2,5,8,9,4,4038,4269,-231
2,5,9,9,4,3750,3566,184
2,5,10,9,4,3769,3683,86
2,5,11,9,4,3728,3432,296
2,5,12,9,4,3872,3648,224
2,5,13,9,4,4208,4143,65
2,5,14,9,4,4508,4555,-47
2,5,15,9,4,4743,4858,-115
2,5,16,9,4,4865,5074,-209
2,5,17,9,4,4712,4855,-143
2,5,18,9,4,4601,4705,-104
2,5,19,9,4,4675,4656,19
2,5,20,9,4,4585,4788,-203
2,6,0,9,4,3949,4274,-325
2,6,1,9,4,4007,4268,-261
2,6,2,9,4,4218,4563,-345
2,6,3,9,4,4550,4622,-72
2,6,4,9,4,5147,4547,600
2,6,5,9,4,5345,4916,429
2,6,6,9,4,5014,4567,447
2,6,7,9,4,4812,4678,134
2,6,8,9,4,4325,4052,273
2,6,9,9,4,3914,3482,432
2,6,10,9,4,3948,3579,369
2,6,11,9,4,3886,3388,498
2,6,12,9,4,4091,3576,515
2,6,13,9,4,4569,3914,655
2,6,14,9,4,4944,4235,709
2,6,15,9,4,5289,4362,927
2,6,16,9,4,5428,4496,932
2,6,17,9,4,5126,4312,814
2,6,18,9,4,4969,4113,856
2,6,19,9,4,4977,4125,852
2,6,20,9,4,4827,4293,534
2,0,0,10,4,4251,4801,-550
2,0,1,10,4,4034,5437,-1403
2,0,2,10,4,3843,6228,-2385
2,0,3,10,4,3712,6743,-3031
2,0,4,10,4,3715,7389,-3674
2,0,5,10,4,3665,7434,-3769
2,0,6,10,4,3557,6558,-3001
2,0,7,10,4,3461,6390,-2929
2,0,8,10,4,3375,5440,-2065
2,0,9,10,4,3333,4639,-1306
2,0,10,10,4,3311,4735,-1424
2,0,11,10,4,3316,4548,-1232
2,0,12,10,4,3349,4890,-1541
2,0,13,10,4,3417,5778,-2361
2,0,14,10,4,3485,6496,-3011
2,0,15,10,4,3623,7029,-3406
2,0,16,10,4,3736,7386,-3650
2,0,17,10,4,3792,6984,-3192
2,0,18,10,4,3931,6702,-2771
2,0,19,10,4,4067,6525,-2458
2,0,20,10,4,4208,6175,-1967
2,1,0,10,4,4124,5081,-957
2,1,1,10,4,3950,5580,-1630
2,1,2,10,4,3829,6264,-2435
2,1,3,10,4,3753,6721,-2968
2,1,4,10,4,3829,7235,-3406
2,1,5,10,4,3780,7433,-3653
2,1,6,10,4,3690,6636,-2946
2,1,7,10,4,3605,6539,-2934
2,1,8,10,4,3485,5568,-2083
2,1,9,10,4,3428,4692,-1264
2,1,10,10,4,3410,4798,-1388
2,1,11,10,4,3405,4550,-1145
2,1,12,10,4,3445,4837,-1392
2,1,13,10,4,3537,5691,-2154
2,1,14,10,4,3623,6366,-2743
2,1,15,10,4,3743,6875,-3132
2,1,16,10,4,3844,7243,-3399
2,1,17,10,4,3870,6896,-3026
2,1,18,10,4,3941,6606,-2665
2,1,19,10,4,4065,6449,-2384
2,1,20,10,4,4198,6247,-2049
2,2,0,10,4,4146,5228,-1082
2,2,1,10,4,4080,5472,-1392
2,2,2,10,4,4037,6041,-2004
2,2,3,10,4,4099,6334,-2235
2,2,4,10,4,4281,6590,-2309
2,2,5,10,4,4199,6908,-2709
2,2,6,10,4,4114,6117,-2003
2,2,7,10,4,3998,6017,-2019
2,2,8,10,4,3830,5058,-1228
2,2,9,10,4,3753,4150,-397
2,2,10,10,4,3759,4229,-470
2,2,11,10,4,3743,3989,-246
2,2,12,10,4,3790,4276,-486
2,2,13,10,4,3921,5034,-1113
2,2,14,10,4,4040,5707,-1667
2,2,15,10,4,4161,6247,-2086
2,2,16,10,4,4289,6622,-2333
2,2,17,10,4,4300,6362,-2062
2,2,18,10,4,4300,6158,-1858
2,2,19,10,4,4403,6053,-1650
2,2,20,10,4,4459,6017,-1558
2,3,0,10,4,4234,5067,-833
2,3,1,10,4,4250,5168,-918
2,3,2,10,4,4268,5646,-1378
2,3,3,10,4,4443,5799,-1356
2,3,4,10,4,4712,5932,-1220
2,3,5,10,4,4620,6366,-1746
2,3,6,10,4,4440,5677,-1237
2,3,7,10,4,4224,5701,-1477
2,3,8,10,4,3958,4817,-859
2,3,9,10,4,3789,3975,-186
2,3,10,10,4,3800,4088,-288
2,3,11,10,4,3772,3822,-50
2,3,12,10,4,3859,4102,-243
2,3,13,10,4,4099,4736,-637
2,3,14,10,4,4344,5269,-925
2,3,15,10,4,4563,5699,-1136
2,3,16,10,4,4758,5971,-1213
2,3,17,10,4,4750,5680,-930
2,3,18,10,4,4708,5501,-793
2,3,19,10,4,4804,5431,-627
2,3,20,10,4,4770,5484,-714
2,4,0,10,4,4328,4832,-504
2,4,1,10,4,4385,4850,-465
2,4,2,10,4,4499,5230,-731
2,4,3,10,4,4732,5317,-585
2,4,4,10,4,5101,5351,-250
2,4,5,10,4,5111,5780,-669
2,4,6,10,4,4824,5277,-453
2,4,7,10,4,4590,5372,-782
2,4,8,10,4,4236,4608,-372
2,4,9,10,4,3938,3911,27
2,4,10,10,4,3951,4020,-69
2,4,11,10,4,3909,3806,103
2,4,12,10,4,4056,4056,0
2,4,13,10,4,4407,4526,-119
2,4,14,10,4,4737,4915,-178
2,4,15,10,4,5031,5168,-137
2,4,16,10,4,5228,5360,-132
2,4,17,10,4,5131,5088,43
2,4,18,10,4,5055,4904,151
2,4,19,10,4,5136,4887,249
2,4,20,10,4,5033,4996,37
2,0,0,11,4,4535,5680,-1145
2,0,1,11,4,4362,6038,-1676
2,0,2,11,4,4245,6682,-2437
2,0,3,11,4,4177,7108,-2931
2,0,4,11,4,4261,7471,-3210
2,0,5,11,4,4205,7752,-3547
2,0,6,11,4,4107,6964,-2857
2,0,7,11,4,4020,6835,-2815
2,0,8,11,4,3896,5824,-1928
2,0,9,11,4,3837,4891,-1054
2,0,10,11,4,3819,4992,-1173
2,0,11,11,4,3816,4742,-926
2,0,12,11,4,3859,5040,-1181
2,0,13,11,4,3947,5849,-1902
2,0,14,11,4,4032,6558,-2526
2,0,15,11,4,4158,7098,-2940
2,0,16,11,4,4262,7495,-3233
2,0,17,11,4,4288,7206,-2918
2,0,18,11,4,4360,6935,-2575
2,0,19,11,4,4483,6819,-2336
2,0,20,11,4,4610,6706,-2096
2,1,0,11,4,4576,5595,-1019
2,1,1,11,4,4516,5782,-1266
2,1,2,11,4,4470,6314,-1844
2,1,3,11,4,4527,6576,-2049
2,1,4,11,4,4710,6807,-2097
2,1,5,11,4,4624,7236,-2612
2,1,6,11,4,4537,6457,-1920
2,1,7,11,4,4423,6382,-1959
2,1,8,11,4,4251,5389,-1138
2,1,9,11,4,4169,4446,-277
2,1,10,11,4,4173,4559,-386
2,1,11,11,4,4158,4282,-124
2,1,12,11,4,4209,4606,-397
2,1,13,11,4,4352,5360,-1008
2,1,14,11,4,4474,6020,-1546
2,1,15,11,4,4594,6547,-1953
2,1,16,11,4,4717,6882,-2165
2,1,17,11,4,4714,6558,-1844
2,1,18,11,4,4718,6338,-1620
2,1,19,11,4,4831,6267,-1436
2,1,20,11,4,4887,6229,-1342
2,2,0,11,4,4674,5370,-696
2,2,1,11,4,4694,5429,-735
2,2,2,11,4,4705,5903,-1198
2,2,3,11,4,4876,6050,-1174
2,2,4,11,4,5156,6194,-1038
2,2,5,11,4,5069,6685,-1616
2,2,6,11,4,4894,6029,-1135
2,2,7,11,4,4679,6060,-1381
2,2,8,11,4,4402,5156,-754
2,2,9,11,4,4224,4320,-96
2,2,10,11,4,4230,4425,-195
2,2,11,11,4,4203,4196,7
2,2,12,11,4,4294,4510,-216
2,2,13,11,4,4545,5119,-574
2,2,14,11,4,4791,5629,-838
2,2,15,11,4,5009,6009,-1000
2,2,16,11,4,5200,6257,-1057
2,2,17,11,4,5178,5913,-735
2,2,18,11,4,5137,5700,-563
2,2,19,11,4,5239,5662,-423
2,2,20,11,4,5204,5692,-488
2,0,0,12,4,4987,5898,-911
2,0,1,12,4,4928,6043,-1115
2,0,2,12,4,4886,6571,-1685
2,0,3,12,4,4951,6827,-1876
2,0,4,12,4,5142,7069,-1927
2,0,5,12,4,5049,7555,-2506
2,0,6,12,4,4954,6809,-1855
2,0,7,12,4,4838,6741,-1903
2,0,8,12,4,4662,5728,-1066
2,0,9,12,4,4578,4791,-213
2,0,10,12,4,4582,4896,-314
2,0,11,12,4,4569,4656,-87
2,0,12,12,4,4623,5014,-391
2,0,13,12,4,4762,5743,-981
2,0,14,12,4,4883,6380,-1497
2,0,15,12,4,5009,6857,-1848
2,0,16,12,4,5135,7168,-2033
2,0,17,12,4,5132,6791,-1659
2,0,18,12,4,5137,6537,-1400
2,0,19,12,4,5249,6498,-1249
2,0,20,12,4,5299,6437,-1138
2,0,0,1,5,522,542,-20
2,0,1,1,5,523,544,-21
2,0,2,1,5,520,535,-15
2,0,3,1,5,530,535,-5
2,0,4,1,5,536,537,-1
2,0,5,1,5,528,531,-3
2,0,6,1,5,519,527,-8
2,0,7,1,5,517,528,-11
2,0,8,1,5,513,524,-11
2,0,9,1,5,512,520,-8
2,0,10,1,5,513,519,-6
2,0,11,1,5,516,522,-6
2,0,12,1,5,512,534,-22
2,0,13,1,5,512,538,-26
2,0,14,1,5,519,538,-19
2,0,15,1,5,523,535,-12
2,0,16,1,5,516,529,-13
2,0,17,1,5,521,525,-4
2,0,18,1,5,528,532,-4
2,0,19,1,5,520,530,-10
2,1,0,1,5,542,550,-8
2,1,1,1,5,544,552,-8
2,1,2,1,5,535,545,-10
2,1,3,1,5,535,551,-16
2,1,4,1,5,537,559,-22
2,1,5,1,5,531,562,-31
2,1,6,1,5,527,563,-36
2,1,7,1,5,528,562,-34
2,1,8,1,5,524,550,-26
2,1,9,1,5,520,543,-23
2,1,10,1,5,519,540,-21
2,1,11,1,5,522,542,-20
2,1,12,1,5,534,552,-18
2,1,13,1,5,538,555,-17
2,1,14,1,5,538,556,-18
2,1,15,1,5,535,553,-18
2,1,16,1,5,529,545,-16
2,1,17,1,5,525,538,-13
2,1,18,1,5,532,544,-12
2,1,19,1,5,530,541,-11
2,2,0,1,5,550,556,-6
2,2,1,1,5,552,559,-7
2,2,2,1,5,545,554,-9
2,2,3,1,5,551,559,-8
2,2,4,1,5,559,526,33
2,2,5,1,5,562,483,79
2,2,6,1,5,563,434,129
2,2,7,1,5,562,385,177
2,2,8,1,5,550,332,218
2,2,9,1,5,543,323,220
2,2,10,1,5,540,319,221
2,2,11,1,5,542,320,222
2,2,12,1,5,552,347,205
2,2,13,1,5,555,384,171
2,2,14,1,5,556,438,118
2,2,15,1,5,553,494,59
2,2,16,1,5,545,534,11
2,2,17,1,5,538,548,-10
2,2,18,1,5,544,560,-16
2,2,19,1,5,541,554,-13
2,3,0,1,5,556,588,-32
2,3,1,1,5,559,594,-35
2,3,2,1,5,554,569,-15
2,3,3,1,5,559,531,28
2,3,4,1,5,526,470,56
2,3,5,1,5,483,395,88
2,3,6,1,5,434,323,111
2,3,7,1,5,385,274,111
2,3,8,1,5,332,242,90
2,3,9,1,5,323,233,90
2,3,10,1,5,319,229,90
2,3,11,1,5,320,229,91
2,3,12,1,5,347,243,104
2,3,13,1,5,384,274,110
2,3,14,1,5,438,335,103
2,3,15,1,5,494,411,83
2,3,16,1,5,534,478,56
2,3,17,1,5,548,529,19
2,3,18,1,5,560,567,-7
2,3,19,1,5,554,571,-17
2,4,0,1,5,588,600,-12
2,4,1,1,5,594,595,-1
2,4,2,1,5,569,542,27
2,4,3,1,5,531,461,70
2,4,4,1,5,470,411,59
2,4,5,1,5,395,354,41
2,4,6,1,5,323,312,11
2,4,7,1,5,274,308,-34
2,4,8,1,5,242,334,-92
2,4,9,1,5,233,330,-97
2,4,10,1,5,229,327,-98
2,4,11,1,5,229,326,-97
2,4,12,1,5,243,316,-73
2,4,13,1,5,274,309,-35
2,4,14,1,5,335,325,10
2,4,15,1,5,411,367,44
2,4,16,1,5,478,417,61
2,4,17,1,5,529,481,48
2,4,18,1,5,567,541,26
2,4,19,1,5,571,568,3
2,5,0,1,5,600,529,71
2,5,1,1,5,595,491,104
2,5,2,1,5,542,434,108
2,5,3,1,5,461,383,78
2,5,4,1,5,411,363,48
2,5,5,1,5,354,345,9
2,5,6,1,5,312,332,-20
2,5,7,1,5,308,334,-26
2,5,8,1,5,334,345,-11
2,5,9,1,5,330,345,-15
2,5,10,1,5,327,344,-17
2,5,11,1,5,326,343,-17
2,5,12,1,5,316,351,-35
2,5,13,1,5,309,348,-39
2,5,14,1,5,325,350,-25
2,5,15,1,5,367,369,-2
2,5,16,1,5,417,398,19
2,5,17,1,5,481,428,53
2,5,18,1,5,541,478,63
2,5,19,1,5,568,522,46
2,6,0,1,5,529,434,95
2,6,1,1,5,491,361,130
2,6,2,1,5,434,318,116
2,6,3,1,5,383,333,50
2,6,4,1,5,363,379,-16
2,6,5,1,5,345,435,-90
2,6,6,1,5,332,475,-143
2,6,7,1,5,334,492,-158
2,6,8,1,5,345,486,-141
2,6,9,1,5,345,489,-144
2,6,10,1,5,344,490,-146
2,6,11,1,5,343,489,-146
2,6,12,1,5,351,489,-138
2,6,13,1,5,348,474,-126
2,6,14,1,5,350,455,-105
2,6,15,1,5,369,435,-66
2,6,16,1,5,398,411,-13
2,6,17,1,5,428,396,32
2,6,18,1,5,478,422,56
2,6,19,1,5,522,468,54
2,7,0,1,5,434,529,-95
2,7,1,1,5,361,497,-136
2,7,2,1,5,318,491,-173
2,7,3,1,5,333,491,-158
2,7,4,1,5,379,540,-161
2,7,5,1,5,435,612,-177
2,7,6,1,5,475,648,-173
2,7,7,1,5,492,650,-158
2,7,8,1,5,486,675,-189
2,7,9,1,5,489,694,-205
2,7,10,1,5,490,697,-207
2,7,11,1,5,489,705,-216
2,7,12,1,5,489,702,-213
2,7,13,1,5,474,687,-213
2,7,14,1,5,455,670,-215
2,7,15,1,5,435,625,-190
2,7,16,1,5,411,586,-175
2,7,17,1,5,396,580,-184
2,7,18,1,5,422,567,-145
2,7,19,1,5,468,569,-101
2,8,0,1,5,529,328,201
2,8,1,1,5,497,277,220
2,8,2,1,5,491,252,239
2,8,3,1,5,491,250,241
2,8,4,1,5,540,271,269
2,8,5,1,5,612,271,341
2,8,6,1,5,648,245,403
2,8,7,1,5,650,237,413
2,8,8,1,5,675,209,466
2,8,9,1,5,694,173,521
2,8,10,1,5,697,159,538
2,8,11,1,5,705,183,522
2,8,12,1,5,702,206,496
2,8,13,1,5,687,233,454
2,8,14,1,5,670,263,407
2,8,15,1,5,625,283,342
2,8,16,1,5,586,281,305
2,8,17,1,5,580,282,298
2,8,18,1,5,567,292,275
2,8,19,1,5,569,337,232
2,9,0,1,5,328,432,-104
2,9,1,1,5,277,446,-169
2,9,2,1,5,252,525,-273
2,9,3,1,5,250,622,-372
2,9,4,1,5,271,688,-417
2,9,5,1,5,271,668,-397
2,9,6,1,5,245,682,-437
2,9,7,1,5,237,678,-441
2,9,8,1,5,209,646,-437
2,9,9,1,5,173,636,-463
2,9,10,1,5,159,632,-473
2,9,11,1,5,183,629,-446
2,9,12,1,5,206,655,-449
2,9,13,1,5,233,679,-446
2,9,14,1,5,263,659,-396
2,9,15,1,5,283,655,-372
2,9,16,1,5,281,641,-360
2,9,17,1,5,282,578,-296
2,9,18,1,5,292,528,-236
2,9,19,1,5,337,522,-185
2,10,0,1,5,432,705,-273
2,10,1,1,5,446,741,-295
2,10,2,1,5,525,864,-339
2,10,3,1,5,622,1004,-382
2,10,4,1,5,688,1097,-409
2,10,5,1,5,668,1022,-354
2,10,6,1,5,682,1041,-359
2,10,7,1,5,678,996,-318
2,10,8,1,5,646,957,-311
2,10,9,1,5,636,941,-305
2,10,10,1,5,632,947,-315
2,10,11,1,5,629,942,-313
2,10,12,1,5,655,1006,-351
2,10,13,1,5,679,1051,-372
2,10,14,1,5,659,1035,-376
2,10,15,1,5,655,1062,-407
2,10,16,1,5,641,1086,-445
2,10,17,1,5,578,1013,-435
2,10,18,1,5,528,950,-422
2,10,19,1,5,522,900,-378
2,11,0,1,5,705,765,-60
2,11,1,1,5,741,815,-74
2,11,2,1,5,864,881,-17
2,11,3,1,5,1004,1001,3
2,11,4,1,5,1097,1107,-10
2,11,5,1,5,1022,981,41
2,11,6,1,5,1041,894,147
2,11,7,1,5,996,796,200
2,11,8,1,5,957,703,254
2,11,9,1,5,941,582,359
2,11,10,1,5,947,574,373
2,11,11,1,5,942,619,323
2,11,12,1,5,1006,755,251
2,11,13,1,5,1051,862,189
2,11,14,1,5,1035,951,84
2,11,15,1,5,1062,1070,-8
2,11,16,1,5,1086,1129,-43
2,11,17,1,5,1013,1075,-62
2,11,18,1,5,950,1036,-86
2,11,19,1,5,900,967,-67
2,12,0,1,5,765,725,40
2,12,1,1,5,815,832,-17
2,12,2,1,5,881,843,38
2,12,3,1,5,1001,966,35
2,12,4,1,5,1107,1092,15
2,12,5,1,5,981,1005,-24
2,12,6,1,5,894,858,36
2,12,7,1,5,796,781,15
2,12,8,1,5,703,658,45
2,12,9,1,5,582,505,77
2,12,10,1,5,574,496,78
2,12,11,1,5,619,547,72
2,12,12,1,5,755,703,52
2,12,13,1,5,862,810,52
2,12,14,1,5,951,932,19
2,12,15,1,5,1070,1054,16
2,12,16,1,5,1129,1074,55
2,12,17,1,5,1075,1013,62
2,12,18,1,5,1036,993,43
2,12,19,1,5,967,909,58
2,13,0,1,5,725,734,-9
2,13,1,1,5,832,836,-4
2,13,2,1,5,843,810,33
2,13,3,1,5,966,926,40
2,13,4,1,5,1092,1040,52
2,13,5,1,5,1005,964,41
2,13,6,1,5,858,837,21
2,13,7,1,5,781,787,-6
2,13,8,1,5,658,665,-7
2,13,9,1,5,505,541,-36
2,13,10,1,5,496,545,-49
2,13,11,1,5,547,573,-26
2,13,12,1,5,703,721,-18
2,13,13,1,5,810,792,18
2,13,14,1,5,932,910,22
2,13,15,1,5,1054,1019,35
2,13,16,1,5,1074,1017,57
2,13,17,1,5,1013,971,42
2,13,18,1,5,993,992,1
2,13,19,1,5,909,916,-7
2,14,0,1,5,734,748,-14
2,14,1,1,5,836,852,-16
2,14,2,1,5,810,847,-37
2,14,3,1,5,926,977,-51
2,14,4,1,5,1040,1096,-56
2,14,5,1,5,964,972,-8
2,14,6,1,5,837,840,-3
2,14,7,1,5,787,770,17
2,14,8,1,5,665,638,27
2,14,9,1,5,541,492,49
2,14,10,1,5,545,495,50
2,14,11,1,5,573,537,36
2,14,12,1,5,721,698,23
2,14,13,1,5,792,764,28
2,14,14,1,5,910,919,-9
2,14,15,1,5,1019,1056,-37
2,14,16,1,5,1017,1045,-28
2,14,17,1,5,971,988,-17
2,14,18,1,5,992,1003,-11
2,14,19,1,5,916,897,19
2,15,0,1,5,748,635,113
2,15,1,1,5,852,776,76
2,15,2,1,5,847,792,55
2,15,3,1,5,977,965,12
2,15,4,1,5,1096,1085,11
2,15,5,1,5,972,973,-1
2,15,6,1,5,840,841,-1
2,15,7,1,5,770,805,-35
2,15,8,1,5,638,684,-46
2,15,9,1,5,492,557,-65
2,15,10,1,5,495,548,-53
2,15,11,1,5,537,605,-68
2,15,12,1,5,698,765,-67
2,15,13,1,5,764,808,-44
2,15,14,1,5,919,885,34
2,15,15,1,5,1056,1004,52
2,15,16,1,5,1045,986,59
2,15,17,1,5,988,900,88
2,15,18,1,5,1003,847,156
2,15,19,1,5,897,798,99
2,16,0,1,5,635,599,36
2,16,1,1,5,776,682,94
2,16,2,1,5,792,719,73
2,16,3,1,5,965,887,78
2,16,4,1,5,1085,937,148
2,16,5,1,5,973,801,172
2,16,6,1,5,841,720,121
2,16,7,1,5,805,675,130
2,16,8,1,5,684,527,157
2,16,9,1,5,557,414,143
2,16,10,1,5,548,404,144
2,16,11,1,5,605,434,171
2,16,12,1,5,765,609,156
2,16,13,1,5,808,687,121
2,16,14,1,5,885,679,206
2,16,15,1,5,1004,778,226
2,16,16,1,5,986,812,174
2,16,17,1,5,900,736,164
2,16,18,1,5,847,668,179
2,16,19,1,5,798,748,50
2,17,0,1,5,599,712,-113
2,17,1,1,5,682,769,-87
2,17,2,1,5,719,746,-27
2,17,3,1,5,887,798,89
2,17,4,1,5,937,726,211
2,17,5,1,5,801,561,240
2,17,6,1,5,720,457,263
2,17,7,1,5,675,472,203
2,17,8,1,5,527,451,76
2,17,9,1,5,414,414,0
2,17,10,1,5,404,444,-40
2,17,11,1,5,434,451,-17
2,17,12,1,5,609,434,175
2,17,13,1,5,687,485,202
2,17,14,1,5,679,483,196
2,17,15,1,5,778,505,273
2,17,16,1,5,812,623,189
2,17,17,1,5,736,720,16
2,17,18,1,5,668,643,25
2,17,19,1,5,748,691,57
2,18,0,1,5,712,748,-36
2,18,1,1,5,769,638,131
2,18,2,1,5,746,620,126
2,18,3,1,5,798,615,183
2,18,4,1,5,726,568,158
2,18,5,1,5,561,561,0
2,18,6,1,5,457,639,-182
2,18,7,1,5,472,698,-226
2,18,8,1,5,451,757,-306
2,18,9,1,5,414,727,-313
2,18,10,1,5,444,714,-270
2,18,11,1,5,451,621,-170
2,18,12,1,5,434,678,-244
2,18,13,1,5,485,728,-243
2,18,14,1,5,483,640,-157
2,18,15,1,5,505,593,-88
2,18,16,1,5,623,705,-82
2,18,17,1,5,720,596,124
2,18,18,1,5,643,462,181
2,18,19,1,5,691,594,97
2,19,0,1,5,748,661,87
2,19,1,1,5,638,514,124
2,19,2,1,5,620,511,109
2,19,3,1,5,615,622,-7
2,19,4,1,5,568,636,-68
2,19,5,1,5,561,671,-110
2,19,6,1,5,639,781,-142
2,19,7,1,5,698,828,-130
2,19,8,1,5,757,801,-44
2,19,9,1,5,727,703,24
2,19,10,1,5,714,655,59
2,19,11,1,5,621,577,44
2,19,12,1,5,678,595,83
2,19,13,1,5,728,563,165
2,19,14,1,5,640,465,175
2,19,15,1,5,593,458,135
2,19,16,1,5,705,546,159
2,19,17,1,5,596,453,143
2,19,18,1,5,462,388,74
2,19,19,1,5,594,551,43
2,20,0,1,5,661,661,0
2,20,1,1,5,514,490,24
2,20,2,1,5,511,476,35
2,20,3,1,5,622,471,151
2,20,4,1,5,636,381,255
2,20,5,1,5,671,360,311
2,20,6,1,5,781,354,427
2,20,7,1,5,828,340,488
2,20,8,1,5,801,344,457
2,20,9,1,5,703,235,468
2,20,10,1,5,655,218,437
2,20,11,1,5,577,247,330
2,20,12,1,5,595,246,349
2,20,13,1,5,563,228,335
2,20,14,1,5,465,247,218
2,20,15,1,5,458,307,151
2,20,16,1,5,546,353,193
2,20,17,1,5,453,399,54
2,20,18,1,5,388,425,-37
2,20,19,1,5,551,543,8
2,21,0,1,5,661,407,254
2,21,1,1,5,490,347,143
2,21,2,1,5,476,318,158
2,21,3,1,5,471,337,134
2,21,4,1,5,381,368,13
2,21,5,1,5,360,377,-17
2,21,6,1,5,354,410,-56
2,21,7,1,5,340,426,-86
2,21,8,1,5,344,447,-103
2,21,9,1,5,235,379,-144
2,21,10,1,5,218,363,-145
2,21,11,1,5,247,391,-144
2,21,12,1,5,246,442,-196
2,21,13,1,5,228,396,-168
2,21,14,1,5,247,333,-86
2,21,15,1,5,307,358,-51
2,21,16,1,5,353,308,45
2,21,17,1,5,399,250,149
2,21,18,1,5,425,234,191
2,21,19,1,5,543,270,273
2,22,0,1,5,407,372,35
2,22,1,1,5,347,326,21
2,22,2,1,5,318,305,13
2,22,3,1,5,337,331,6
2,22,4,1,5,368,388,-20
2,22,5,1,5,377,417,-40
2,22,6,1,5,410,407,3
2,22,7,1,5,426,419,7
2,22,8,1,5,447,471,-24
2,22,9,1,5,379,435,-56
2,22,10,1,5,363,429,-66
2,22,11,1,5,391,468,-77
2,22,12,1,5,442,515,-73
2,22,13,1,5,396,450,-54
2,22,14,1,5,333,402,-69
2,22,15,1,5,358,380,-22
2,22,16,1,5,308,340,-32
2,22,17,1,5,250,266,-16
2,22,18,1,5,234,273,-39
2,22,19,1,5,270,278,-8
2,0,0,2,5,1064,1106,-42
2,0,1,2,5,1067,1111,-44
2,0,2,2,5,1055,1099,-44
2,0,3,2,5,1065,1110,-45
2,0,4,2,5,1073,1085,-12
2,0,5,2,5,1059,1045,14
2,0,6,2,5,1046,997,49
2,0,7,2,5,1045,947,98
2,0,8,2,5,1037,882,155
2,0,9,2,5,1032,866,166
2,0,10,2,5,1032,859,173
2,0,11,2,5,1038,862,176
2,0,12,2,5,1046,899,147
2,0,13,2,5,1050,939,111
2,0,14,2,5,1057,994,63
2,0,15,2,5,1058,1047,11
2,0,16,2,5,1045,1079,-34
2,0,17,2,5,1046,1086,-40
2,0,18,2,5,1060,1104,-44
2,0,19,2,5,1050,1095,-45
2,1,0,2,5,1092,1144,-52
2,1,1,2,5,1096,1153,-57
2,1,2,2,5,1080,1123,-43
2,1,3,2,5,1086,1090,-4
2,1,4,2,5,1096,996,100
2,1,5,2,5,1093,878,215
2,1,6,2,5,1090,757,333
2,1,7,2,5,1090,659,431
2,1,8,2,5,1074,574,500
2,1,9,2,5,1063,556,507
2,1,10,2,5,1059,548,511
2,1,11,2,5,1064,549,515
2,1,12,2,5,1086,590,496
2,1,13,2,5,1093,658,435
2,1,14,2,5,1094,773,321
2,1,15,2,5,1088,905,183
2,1,16,2,5,1074,1012,62
2,1,17,2,5,1063,1077,-14
2,1,18,2,5,1076,1127,-51
2,1,19,2,5,1071,1125,-54
2,2,0,2,5,1106,1188,-82
2,2,1,2,5,1111,1189,-78
2,2,2,2,5,1099,1111,-12
2,2,3,2,5,1110,992,118
2,2,4,2,5,1085,881,204
2,2,5,2,5,1045,749,296
2,2,6,2,5,997,635,362
2,2,7,2,5,947,582,365
2,2,8,2,5,882,576,306
2,2,9,2,5,866,563,303
2,2,10,2,5,859,556,303
2,2,11,2,5,862,555,307
2,2,12,2,5,899,559,340
2,2,13,2,5,939,583,356
2,2,14,2,5,994,660,334
2,2,15,2,5,1047,778,269
2,2,16,2,5,1079,895,184
2,2,17,2,5,1086,1010,76
2,2,18,2,5,1104,1108,-4
2,2,19,2,5,1095,1139,-44
2,3,0,2,5,1144,1129,15
2,3,1,2,5,1153,1086,67
2,3,2,2,5,1123,976,147
2,3,3,2,5,1090,844,246
2,3,4,2,5,996,774,222
2,3,5,2,5,878,699,179
2,3,6,2,5,757,644,113
2,3,7,2,5,659,642,17
2,3,8,2,5,574,679,-105
2,3,9,2,5,556,675,-119
2,3,10,2,5,548,671,-123
2,3,11,2,5,549,669,-120
2,3,12,2,5,590,667,-77
2,3,13,2,5,658,657,1
2,3,14,2,5,773,675,98
2,3,15,2,5,905,736,169
2,3,16,2,5,1012,815,197
2,3,17,2,5,1077,909,168
2,3,18,2,5,1127,1019,108
2,3,19,2,5,1125,1090,35
2,4,0,2,5,1188,963,225
2,4,1,2,5,1189,852,337
2,4,2,2,5,1111,752,359
2,4,3,2,5,992,716,276
2,4,4,2,5,881,742,139
2,4,5,2,5,749,780,-31
2,4,6,2,5,635,807,-172
2,4,7,2,5,582,826,-244
2,4,8,2,5,576,831,-255
2,4,9,2,5,563,834,-271
2,4,10,2,5,556,834,-278
2,4,11,2,5,555,832,-277
2,4,12,2,5,559,840,-281
2,4,13,2,5,583,822,-239
2,4,14,2,5,660,805,-145
2,4,15,2,5,778,804,-26
2,4,16,2,5,895,809,86
2,4,17,2,5,1010,824,186
2,4,18,2,5,1108,900,208
2,4,19,2,5,1139,990,149
2,5,0,2,5,1129,963,166
2,5,1,2,5,1086,858,228
2,5,2,2,5,976,809,167
2,5,3,2,5,844,824,20
2,5,4,2,5,774,919,-145
2,5,5,2,5,699,1047,-348
2,5,6,2,5,644,1123,-479
2,5,7,2,5,642,1142,-500
2,5,8,2,5,679,1161,-482
2,5,9,2,5,675,1183,-508
2,5,10,2,5,671,1187,-516
2,5,11,2,5,669,1194,-525
2,5,12,2,5,667,1191,-524
2,5,13,2,5,657,1161,-504
2,5,14,2,5,675,1125,-450
2,5,15,2,5,736,1060,-324
2,5,16,2,5,815,997,-182
2,5,17,2,5,909,976,-67
2,5,18,2,5,1019,989,30
2,5,19,2,5,1090,1037,53
2,6,0,2,5,963,857,106
2,6,1,2,5,852,774,78
2,6,2,2,5,752,743,9
2,6,3,2,5,716,741,-25
2,6,4,2,5,742,811,-69
2,6,5,2,5,780,883,-103
2,6,6,2,5,807,893,-86
2,6,7,2,5,826,887,-61
2,6,8,2,5,831,884,-53
2,6,9,2,5,834,867,-33
2,6,10,2,5,834,856,-22
2,6,11,2,5,832,888,-56
2,6,12,2,5,840,908,-68
2,6,13,2,5,822,920,-98
2,6,14,2,5,805,933,-128
2,6,15,2,5,804,908,-104
2,6,16,2,5,809,867,-58
2,6,17,2,5,824,862,-38
2,6,18,2,5,900,859,41
2,6,19,2,5,990,906,84
2,7,0,2,5,963,760,203
2,7,1,2,5,858,723,135
2,7,2,2,5,809,777,32
2,7,3,2,5,824,872,-48
2,7,4,2,5,919,959,-40
2,7,5,2,5,1047,939,108
2,7,6,2,5,1123,927,196
2,7,7,2,5,1142,915,227
2,7,8,2,5,1161,855,306
2,7,9,2,5,1183,809,374
2,7,10,2,5,1187,791,396
2,7,11,2,5,1194,812,382
2,7,12,2,5,1191,861,330
2,7,13,2,5,1161,912,249
2,7,14,2,5,1125,922,203
2,7,15,2,5,1060,938,122
2,7,16,2,5,997,922,75
2,7,17,2,5,976,860,116
2,7,18,2,5,989,820,169
2,7,19,2,5,1037,859,178
2,8,0,2,5,857,1137,-280
2,8,1,2,5,774,1187,-413
2,8,2,2,5,743,1389,-646
2,8,3,2,5,741,1626,-885
2,8,4,2,5,811,1785,-974
2,8,5,2,5,883,1690,-807
2,8,6,2,5,893,1723,-830
2,8,7,2,5,887,1674,-787
2,8,8,2,5,884,1603,-719
2,8,9,2,5,867,1577,-710
2,8,10,2,5,856,1579,-723
2,8,11,2,5,888,1571,-683
2,8,12,2,5,908,1661,-753
2,8,13,2,5,920,1730,-810
2,8,14,2,5,933,1694,-761
2,8,15,2,5,908,1717,-809
2,8,16,2,5,867,1727,-860
2,8,17,2,5,862,1591,-729
2,8,18,2,5,859,1478,-619
2,8,19,2,5,906,1422,-516
2,9,0,2,5,760,1470,-710
2,9,1,2,5,723,1556,-833
2,9,2,2,5,777,1745,-968
2,9,3,2,5,872,2005,-1133
2,9,4,2,5,959,2204,-1245
2,9,5,2,5,939,2003,-1064
2,9,6,2,5,927,1935,-1008
2,9,7,2,5,915,1792,-877
2,9,8,2,5,855,1660,-805
2,9,9,2,5,809,1523,-714
2,9,10,2,5,791,1521,-730
2,9,11,2,5,812,1561,-749
2,9,12,2,5,861,1761,-900
2,9,13,2,5,912,1913,-1001
2,9,14,2,5,922,1986,-1064
2,9,15,2,5,938,2132,-1194
2,9,16,2,5,922,2215,-1293
2,9,17,2,5,860,2088,-1228
2,9,18,2,5,820,1986,-1166
2,9,19,2,5,859,1867,-1008
2,10,0,2,5,1137,1490,-353
2,10,1,2,5,1187,1647,-460
2,10,2,2,5,1389,1724,-335
2,10,3,2,5,1626,1967,-341
2,10,4,2,5,1785,2199,-414
2,10,5,2,5,1690,1986,-296
2,10,6,2,5,1723,1752,-29
2,10,7,2,5,1674,1577,97
2,10,8,2,5,1603,1361,242
2,10,9,2,5,1577,1087,490
2,10,10,2,5,1579,1070,509
2,10,11,2,5,1571,1166,405
2,10,12,2,5,1661,1458,203
2,10,13,2,5,1730,1672,58
2,10,14,2,5,1694,1883,-189
2,10,15,2,5,1717,2124,-407
2,10,16,2,5,1727,2203,-476
2,10,17,2,5,1591,2088,-497
2,10,18,2,5,1478,2029,-551
2,10,19,2,5,1422,1876,-454
2,11,0,2,5,1470,1459,11
2,11,1,2,5,1556,1668,-112
2,11,2,2,5,1745,1653,92
2,11,3,2,5,2005,1892,113
2,11,4,2,5,2204,2132,72
2,11,5,2,5,2003,1969,34
2,11,6,2,5,1935,1695,240
2,11,7,2,5,1792,1568,224
2,11,8,2,5,1660,1323,337
2,11,9,2,5,1523,1046,477
2,11,10,2,5,1521,1041,480
2,11,11,2,5,1561,1120,441
2,11,12,2,5,1761,1424,337
2,11,13,2,5,1913,1602,311
2,11,14,2,5,1986,1842,144
2,11,15,2,5,2132,2073,59
2,11,16,2,5,2215,2091,124
2,11,17,2,5,2088,1984,104
2,11,18,2,5,1986,1985,1
2,11,19,2,5,1867,1825,42
2,12,0,2,5,1490,1482,8
2,12,1,2,5,1647,1688,-41
2,12,2,2,5,1724,1657,67
2,12,3,2,5,1967,1903,64
2,12,4,2,5,2199,2136,63
2,12,5,2,5,1986,1936,50
2,12,6,2,5,1752,1677,75
2,12,7,2,5,1577,1557,20
2,12,8,2,5,1361,1303,58
2,12,9,2,5,1087,1033,54
2,12,10,2,5,1070,1040,30
2,12,11,2,5,1166,1110,56
2,12,12,2,5,1458,1419,39
2,12,13,2,5,1672,1556,116
2,12,14,2,5,1883,1829,54
2,12,15,2,5,2124,2075,49
2,12,16,2,5,2203,2062,141
2,12,17,2,5,2088,1959,129
2,12,18,2,5,2029,1995,34
2,12,19,2,5,1876,1813,63
2,13,0,2,5,1459,1383,76
2,13,1,2,5,1668,1628,40
2,13,2,2,5,1653,1639,14
2,13,3,2,5,1892,1942,-50
2,13,4,2,5,2132,2181,-49
2,13,5,2,5,1969,1945,24
2,13,6,2,5,1695,1681,14
2,13,7,2,5,1568,1575,-7
2,13,8,2,5,1323,1322,1
2,13,9,2,5,1046,1049,-3
2,13,10,2,5,1041,1043,-2
2,13,11,2,5,1120,1142,-22
2,13,12,2,5,1424,1463,-39
2,13,13,2,5,1602,1572,30
2,13,14,2,5,1842,1804,38
2,13,15,2,5,2073,2060,13
2,13,16,2,5,2091,2031,60
2,13,17,2,5,1984,1888,96
2,13,18,2,5,1985,1850,135
2,13,19,2,5,1825,1695,130
2,14,0,2,5,1482,1234,248
2,14,1,2,5,1688,1458,230
2,14,2,2,5,1657,1511,146
2,14,3,2,5,1903,1852,51
2,14,4,2,5,2136,2022,114
2,14,5,2,5,1936,1774,162
2,14,6,2,5,1677,1561,116
2,14,7,2,5,1557,1480,77
2,14,8,2,5,1303,1211,92
2,14,9,2,5,1033,971,62
2,14,10,2,5,1040,952,88
2,14,11,2,5,1110,1039,71
2,14,12,2,5,1419,1374,45
2,14,13,2,5,1556,1495,61
2,14,14,2,5,1829,1564,265
2,14,15,2,5,2075,1782,293
2,14,16,2,5,2062,1798,264
2,14,17,2,5,1959,1636,323
2,14,18,2,5,1995,1515,480
2,14,19,2,5,1813,1546,267
2,15,0,2,5,1383,1311,72
2,15,1,2,5,1628,1451,177
2,15,2,2,5,1639,1465,174
2,15,3,2,5,1942,1685,257
2,15,4,2,5,2181,1663,518
2,15,5,2,5,1945,1362,583
2,15,6,2,5,1681,1177,504
2,15,7,2,5,1575,1147,428
2,15,8,2,5,1322,978,344
2,15,9,2,5,1049,828,221
2,15,10,2,5,1043,848,195
2,15,11,2,5,1142,885,257
2,15,12,2,5,1463,1043,420
2,15,13,2,5,1572,1172,400
2,15,14,2,5,1804,1162,642
2,15,15,2,5,2060,1283,777
2,15,16,2,5,2031,1435,596
2,15,17,2,5,1888,1456,432
2,15,18,2,5,1850,1311,539
2,15,19,2,5,1695,1439,256
2,16,0,2,5,1234,1460,-226
2,16,1,2,5,1458,1407,51
2,16,2,2,5,1511,1366,145
2,16,3,2,5,1852,1413,439
2,16,4,2,5,2022,1294,728
2,16,5,2,5,1774,1122,652
2,16,6,2,5,1561,1096,465
2,16,7,2,5,1480,1170,310
2,16,8,2,5,1211,1208,3
2,16,9,2,5,971,1141,-170
2,16,10,2,5,952,1158,-206
2,16,11,2,5,1039,1072,-33
2,16,12,2,5,1374,1112,262
2,16,13,2,5,1495,1213,282
2,16,14,2,5,1564,1123,441
2,16,15,2,5,1782,1098,684
2,16,16,2,5,1798,1328,470
2,16,17,2,5,1636,1316,320
2,16,18,2,5,1515,1105,410
2,16,19,2,5,1546,1285,261
2,17,0,2,5,1311,1409,-98
2,17,1,2,5,1451,1152,299
2,17,2,2,5,1465,1131,334
2,17,3,2,5,1685,1237,448
2,17,4,2,5,1663,1204,459
2,17,5,2,5,1362,1232,130
2,17,6,2,5,1177,1420,-243
2,17,7,2,5,1147,1526,-379
2,17,8,2,5,978,1558,-580
2,17,9,2,5,828,1430,-602
2,17,10,2,5,848,1369,-521
2,17,11,2,5,885,1198,-313
2,17,12,2,5,1043,1273,-230
2,17,13,2,5,1172,1291,-119
2,17,14,2,5,1162,1105,57
2,17,15,2,5,1283,1051,232
2,17,16,2,5,1435,1251,184
2,17,17,2,5,1456,1049,407
2,17,18,2,5,1311,850,461
2,17,19,2,5,1439,1145,294
2,18,0,2,5,1460,1322,138
2,18,1,2,5,1407,1004,403
2,18,2,2,5,1366,987,379
2,18,3,2,5,1413,1093,320
2,18,4,2,5,1294,1017,277
2,18,5,2,5,1122,1031,91
2,18,6,2,5,1096,1135,-39
2,18,7,2,5,1170,1168,2
2,18,8,2,5,1208,1145,63
2,18,9,2,5,1141,938,203
2,18,10,2,5,1158,873,285
2,18,11,2,5,1072,824,248
2,18,12,2,5,1112,841,271
2,18,13,2,5,1213,791,422
2,18,14,2,5,1123,712,411
2,18,15,2,5,1098,765,333
2,18,16,2,5,1328,899,429
2,18,17,2,5,1316,852,464
2,18,18,2,5,1105,813,292
2,18,19,2,5,1285,1094,191
2,19,0,2,5,1409,1068,341
2,19,1,2,5,1152,837,315
2,19,2,2,5,1131,794,337
2,19,3,2,5,1237,808,429
2,19,4,2,5,1204,749,455
2,19,5,2,5,1232,737,495
2,19,6,2,5,1420,764,656
2,19,7,2,5,1526,766,760
2,19,8,2,5,1558,791,767
2,19,9,2,5,1430,614,816
2,19,10,2,5,1369,581,788
2,19,11,2,5,1198,638,560
2,19,12,2,5,1273,688,585
2,19,13,2,5,1291,624,667
2,19,14,2,5,1105,580,525
2,19,15,2,5,1051,665,386
2,19,16,2,5,1251,661,590
2,19,17,2,5,1049,649,400
2,19,18,2,5,850,659,191
2,19,19,2,5,1145,813,332
2,20,0,2,5,1322,779,543
2,20,1,2,5,1004,673,331
2,20,2,2,5,987,623,364
2,20,3,2,5,1093,668,425
2,20,4,2,5,1017,756,261
2,20,5,2,5,1031,794,237
2,20,6,2,5,1135,817,318
2,20,7,2,5,1168,845,323
2,20,8,2,5,1145,918,227
2,20,9,2,5,938,814,124
2,20,10,2,5,873,792,81
2,20,11,2,5,824,859,-35
2,20,12,2,5,841,957,-116
2,20,13,2,5,791,846,-55
2,20,14,2,5,712,735,-23
2,20,15,2,5,765,738,27
2,20,16,2,5,899,648,251
2,20,17,2,5,852,516,336
2,20,18,2,5,813,507,306
2,20,19,2,5,1094,548,546
2,0,0,3,5,1614,1744,-130
2,0,1,3,5,1619,1748,-129
2,0,2,3,5,1600,1665,-65
2,0,3,3,5,1616,1551,65
2,0,4,3,5,1632,1407,225
2,0,5,3,5,1621,1232,389
2,0,6,3,5,1609,1069,540
2,0,7,3,5,1607,967,640
2,0,8,3,5,1587,908,679
2,0,9,3,5,1575,886,689
2,0,10,3,5,1572,875,697
2,0,11,3,5,1580,875,705
2,0,12,3,5,1598,906,692
2,0,13,3,5,1605,967,638
2,0,14,3,5,1613,1098,515
2,0,15,3,5,1611,1272,339
2,0,16,3,5,1590,1429,161
2,0,17,3,5,1584,1558,26
2,0,18,3,5,1604,1668,-64
2,0,19,3,5,1591,1693,-102
2,1,0,3,5,1648,1717,-69
2,1,1,3,5,1655,1680,-25
2,1,2,3,5,1634,1545,89
2,1,3,3,5,1645,1375,270
2,1,4,3,5,1622,1244,378
2,1,5,3,5,1576,1094,482
2,1,6,3,5,1524,967,557
2,1,7,3,5,1475,916,559
2,1,8,3,5,1406,921,485
2,1,9,3,5,1386,908,478
2,1,10,3,5,1378,900,478
2,1,11,3,5,1384,898,486
2,1,12,3,5,1433,910,523
2,1,13,3,5,1477,931,546
2,1,14,3,5,1532,1010,522
2,1,15,3,5,1582,1147,435
2,1,16,3,5,1608,1293,315
2,1,17,3,5,1611,1438,173
2,1,18,3,5,1636,1586,50
2,1,19,3,5,1625,1661,-36
2,2,0,3,5,1694,1563,131
2,2,1,3,5,1705,1447,258
2,2,2,3,5,1668,1294,374
2,2,3,3,5,1641,1177,464
2,2,4,3,5,1555,1153,402
2,2,5,3,5,1440,1134,306
2,2,6,3,5,1320,1119,201
2,2,7,3,5,1221,1134,87
2,2,8,3,5,1124,1165,-41
2,2,9,3,5,1099,1164,-65
2,2,10,3,5,1088,1161,-73
2,2,11,3,5,1091,1158,-67
2,2,12,3,5,1142,1156,-14
2,2,13,3,5,1213,1131,82
2,2,14,3,5,1329,1130,199
2,2,15,3,5,1458,1171,287
2,2,16,3,5,1557,1226,331
2,2,17,3,5,1615,1305,310
2,2,18,3,5,1671,1441,230
2,2,19,3,5,1666,1558,108
2,3,0,3,5,1744,1492,252
2,3,1,3,5,1748,1349,399
2,3,2,3,5,1665,1243,422
2,3,3,3,5,1551,1207,344
2,3,4,3,5,1407,1282,125
2,3,5,3,5,1232,1392,-160
2,3,6,3,5,1069,1455,-386
2,3,7,3,5,967,1476,-509
2,3,8,3,5,908,1506,-598
2,3,9,3,5,886,1528,-642
2,3,10,3,5,875,1531,-656
2,3,11,3,5,875,1537,-662
2,3,12,3,5,906,1542,-636
2,3,13,3,5,967,1509,-542
2,3,14,3,5,1098,1475,-377
2,3,15,3,5,1272,1429,-157
2,3,16,3,5,1429,1395,34
2,3,17,3,5,1558,1404,154
2,3,18,3,5,1668,1467,201
2,3,19,3,5,1693,1559,134
2,4,0,3,5,1717,1291,426
2,4,1,3,5,1680,1135,545
2,4,2,3,5,1545,1061,484
2,4,3,3,5,1375,1074,301
2,4,4,3,5,1244,1190,54
2,4,5,3,5,1094,1318,-224
2,4,6,3,5,967,1368,-401
2,4,7,3,5,916,1379,-463
2,4,8,3,5,921,1370,-449
2,4,9,3,5,908,1356,-448
2,4,10,3,5,900,1346,-446
2,4,11,3,5,898,1377,-479
2,4,12,3,5,910,1397,-487
2,4,13,3,5,931,1394,-463
2,4,14,3,5,1010,1388,-378
2,4,15,3,5,1147,1343,-196
2,4,16,3,5,1293,1278,15
2,4,17,3,5,1438,1258,180
2,4,18,3,5,1586,1281,305
2,4,19,3,5,1661,1374,287
2,5,0,3,5,1563,1289,274
2,5,1,3,5,1447,1220,227
2,5,2,3,5,1294,1268,26
2,5,3,3,5,1177,1363,-186
2,5,4,3,5,1153,1499,-346
2,5,5,3,5,1134,1551,-417
2,5,6,3,5,1119,1575,-456
2,5,7,3,5,1134,1565,-431
2,5,8,3,5,1165,1530,-365
2,5,9,3,5,1164,1503,-339
2,5,10,3,5,1161,1488,-327
2,5,11,3,5,1158,1517,-359
2,5,12,3,5,1156,1563,-407
2,5,13,3,5,1131,1599,-468
2,5,14,3,5,1130,1592,-462
2,5,15,3,5,1171,1563,-392
2,5,16,3,5,1226,1508,-282
2,5,17,3,5,1305,1440,-135
2,5,18,3,5,1441,1387,54
2,5,19,3,5,1558,1428,130
2,6,0,3,5,1492,1465,27
2,6,1,3,5,1349,1464,-115
2,6,2,3,5,1243,1641,-398
2,6,3,3,5,1207,1876,-669
2,6,4,3,5,1282,2056,-774
2,6,5,3,5,1392,1961,-569
2,6,6,3,5,1455,1968,-513
2,6,7,3,5,1476,1911,-435
2,6,8,3,5,1506,1812,-306
2,6,9,3,5,1528,1750,-222
2,6,10,3,5,1531,1738,-207
2,6,11,3,5,1537,1754,-217
2,6,12,3,5,1542,1867,-325
2,6,13,3,5,1509,1963,-454
2,6,14,3,5,1475,1957,-482
2,6,15,3,5,1429,2000,-571
2,6,16,3,5,1395,2008,-613
2,6,17,3,5,1404,1873,-469
2,6,18,3,5,1467,1770,-303
2,6,19,3,5,1559,1759,-200
2,7,0,3,5,1291,1902,-611
2,7,1,3,5,1135,2002,-867
2,7,2,3,5,1061,2270,-1209
2,7,3,3,5,1074,2627,-1553
2,7,4,3,5,1190,2892,-1702
2,7,5,3,5,1318,2671,-1353
2,7,6,3,5,1368,2617,-1249
2,7,7,3,5,1379,2470,-1091
2,7,8,3,5,1370,2306,-936
2,7,9,3,5,1356,2159,-803
2,7,10,3,5,1346,2153,-807
2,7,11,3,5,1377,2190,-813
2,7,12,3,5,1397,2416,-1019
2,7,13,3,5,1394,2592,-1198
2,7,14,3,5,1388,2645,-1257
2,7,15,3,5,1343,2787,-1444
2,7,16,3,5,1278,2856,-1578
2,7,17,3,5,1258,2666,-1408
2,7,18,3,5,1281,2514,-1233
2,7,19,3,5,1374,2389,-1015
2,8,0,3,5,1289,2195,-906
2,8,1,3,5,1220,2388,-1168
2,8,2,3,5,1268,2588,-1320
2,8,3,3,5,1363,2971,-1608
2,8,4,3,5,1499,3296,-1797
2,8,5,3,5,1551,3008,-1457
2,8,6,3,5,1575,2793,-1218
2,8,7,3,5,1565,2573,-1008
2,8,8,3,5,1530,2318,-788
2,8,9,3,5,1503,2028,-525
2,8,10,3,5,1488,2017,-529
2,8,11,3,5,1517,2108,-591
2,8,12,3,5,1563,2464,-901
2,8,13,3,5,1599,2723,-1124
2,8,14,3,5,1592,2918,-1326
2,8,15,3,5,1563,3186,-1623
2,8,16,3,5,1508,3289,-1781
2,8,17,3,5,1440,3101,-1661
2,8,18,3,5,1387,2979,-1592
2,8,19,3,5,1428,2776,-1348
2,9,0,3,5,1465,2224,-759
2,9,1,3,5,1464,2483,-1019
2,9,2,3,5,1641,2534,-893
2,9,3,3,5,1876,2893,-1017
2,9,4,3,5,2056,3239,-1183
2,9,5,3,5,1961,2950,-989
2,9,6,3,5,1968,2589,-621
2,9,7,3,5,1911,2364,-453
2,9,8,3,5,1812,2026,-214
2,9,9,3,5,1750,1628,122
2,9,10,3,5,1738,1615,123
2,9,11,3,5,1754,1739,15
2,9,12,3,5,1867,2179,-312
2,9,13,3,5,1963,2464,-501
2,9,14,3,5,1957,2793,-836
2,9,15,3,5,2000,3143,-1143
2,9,16,3,5,2008,3220,-1212
2,9,17,3,5,1873,3059,-1186
2,9,18,3,5,1770,3021,-1251
2,9,19,3,5,1759,2792,-1033
2,10,0,3,5,1902,2207,-305
2,10,1,3,5,2002,2520,-518
2,10,2,3,5,2270,2500,-230
2,10,3,3,5,2627,2869,-242
2,10,4,3,5,2892,3228,-336
2,10,5,3,5,2671,2941,-270
2,10,6,3,5,2617,2535,82
2,10,7,3,5,2470,2338,132
2,10,8,3,5,2306,1961,345
2,10,9,3,5,2159,1538,621
2,10,10,3,5,2153,1536,617
2,10,11,3,5,2190,1657,533
2,10,12,3,5,2416,2122,294
2,10,13,3,5,2592,2366,226
2,10,14,3,5,2645,2761,-116
2,10,15,3,5,2787,3129,-342
2,10,16,3,5,2856,3136,-280
2,10,17,3,5,2666,2972,-306
2,10,18,3,5,2514,2988,-474
2,10,19,3,5,2389,2722,-333
2,11,0,3,5,2195,2117,78
2,11,1,3,5,2388,2464,-76
2,11,2,3,5,2588,2449,139
2,11,3,3,5,2971,2868,103
2,11,4,3,5,3296,3221,75
2,11,5,3,5,3008,2909,99
2,11,6,3,5,2793,2518,275
2,11,7,3,5,2573,2362,211
2,11,8,3,5,2318,1987,331
2,11,9,3,5,2028,1590,438
2,11,10,3,5,2017,1588,429
2,11,11,3,5,2108,1715,393
2,11,12,3,5,2464,2184,280
2,11,13,3,5,2723,2364,359
2,11,14,3,5,2918,2714,204
2,11,15,3,5,3186,3079,107
2,11,16,3,5,3289,3048,241
2,11,17,3,5,3101,2859,242
2,11,18,3,5,2979,2842,137
2,11,19,3,5,2776,2611,165
2,12,0,3,5,2224,1982,242
2,12,1,3,5,2483,2310,173
2,12,2,3,5,2534,2358,176
2,12,3,3,5,2893,2829,64
2,12,4,3,5,3239,3118,121
2,12,5,3,5,2950,2746,204
2,12,6,3,5,2589,2401,188
2,12,7,3,5,2364,2250,114
2,12,8,3,5,2026,1849,177
2,12,9,3,5,1628,1463,165
2,12,10,3,5,1615,1447,168
2,12,11,3,5,1739,1576,163
2,12,12,3,5,2179,2072,107
2,12,13,3,5,2464,2259,205
2,12,14,3,5,2793,2483,310
2,12,15,3,5,3143,2838,305
2,12,16,3,5,3220,2843,377
2,12,17,3,5,3059,2624,435
2,12,18,3,5,3021,2518,503
2,12,19,3,5,2792,2443,349
2,13,0,3,5,2207,1946,261
2,13,1,3,5,2520,2227,293
2,13,2,3,5,2500,2257,243
2,13,3,3,5,2869,2650,219
2,13,4,3,5,3228,2748,480
2,13,5,3,5,2941,2335,606
2,13,6,3,5,2535,2018,517
2,13,7,3,5,2338,1952,386
2,13,8,3,5,1961,1662,299
2,13,9,3,5,1538,1385,153
2,13,10,3,5,1536,1396,140
2,13,11,3,5,1657,1490,167
2,13,12,3,5,2122,1808,314
2,13,13,3,5,2366,1980,386
2,13,14,3,5,2761,2047,714
2,13,15,3,5,3129,2287,842
2,13,16,3,5,3136,2421,715
2,13,17,3,5,2972,2356,616
2,13,18,3,5,2988,2158,830
2,13,19,3,5,2722,2237,485
2,14,0,3,5,2117,2059,58
2,14,1,3,5,2464,2089,375
2,14,2,3,5,2449,2085,364
2,14,3,3,5,2868,2300,568
2,14,4,3,5,3221,2231,990
2,14,5,3,5,2909,1923,986
2,14,6,3,5,2518,1816,702
2,14,7,3,5,2362,1845,517
2,14,8,3,5,1987,1735,252
2,14,9,3,5,1590,1555,35
2,14,10,3,5,1588,1562,26
2,14,11,3,5,1715,1506,209
2,14,12,3,5,2184,1721,463
2,14,13,3,5,2364,1900,464
2,14,14,3,5,2714,1802,912
2,14,15,3,5,3079,1876,1203
2,14,16,3,5,3048,2140,908
2,14,17,3,5,2859,2052,807
2,14,18,3,5,2842,1773,1069
2,14,19,3,5,2611,2033,578
2,15,0,3,5,1982,2121,-139
2,15,1,3,5,2310,1921,389
2,15,2,3,5,2358,1877,481
2,15,3,3,5,2829,2035,794
2,15,4,3,5,3118,1930,1188
2,15,5,3,5,2746,1793,953
2,15,6,3,5,2401,1877,524
2,15,7,3,5,2250,1998,252
2,15,8,3,5,1849,2009,-160
2,15,9,3,5,1463,1844,-381
2,15,10,3,5,1447,1813,-366
2,15,11,3,5,1576,1649,-73
2,15,12,3,5,2072,1707,365
2,15,13,3,5,2259,1776,483
2,15,14,3,5,2483,1588,895
2,15,15,3,5,2838,1556,1282
2,15,16,3,5,2843,1874,969
2,15,17,3,5,2624,1769,855
2,15,18,3,5,2518,1493,1025
2,15,19,3,5,2443,1836,607
2,16,0,3,5,1946,2070,-124
2,16,1,3,5,2227,1642,585
2,16,2,3,5,2257,1607,650
2,16,3,3,5,2650,1708,942
2,16,4,3,5,2748,1585,1163
2,16,5,3,5,2335,1592,743
2,16,6,3,5,2018,1774,244
2,16,7,3,5,1952,1866,86
2,16,8,3,5,1662,1902,-240
2,16,9,3,5,1385,1665,-280
2,16,10,3,5,1396,1587,-191
2,16,11,3,5,1490,1445,45
2,16,12,3,5,1808,1519,289
2,16,13,3,5,1980,1519,461
2,16,14,3,5,2047,1352,695
2,16,15,3,5,2287,1358,929
2,16,16,3,5,2421,1604,817
2,16,17,3,5,2356,1448,908
2,16,18,3,5,2158,1275,883
2,16,19,3,5,2237,1688,549
2,17,0,3,5,2059,1729,330
2,17,1,3,5,2089,1351,738
2,17,2,3,5,2085,1305,780
2,17,3,3,5,2300,1430,870
2,17,4,3,5,2231,1385,846
2,17,5,3,5,1923,1408,515
2,17,6,3,5,1816,1545,271
2,17,7,3,5,1845,1594,251
2,17,8,3,5,1735,1592,143
2,17,9,3,5,1555,1317,238
2,17,10,3,5,1562,1236,326
2,17,11,3,5,1506,1215,291
2,17,12,3,5,1721,1283,438
2,17,13,3,5,1900,1187,713
2,17,14,3,5,1802,1045,757
2,17,15,3,5,1876,1123,753
2,17,16,3,5,2140,1207,933
2,17,17,3,5,2052,1102,950
2,17,18,3,5,1773,1047,726
2,17,19,3,5,2033,1364,669
2,18,0,3,5,2121,1440,681
2,18,1,3,5,1921,1163,758
2,18,2,3,5,1877,1099,778
2,18,3,3,5,2035,1139,896
2,18,4,3,5,1930,1137,793
2,18,5,3,5,1793,1154,639
2,18,6,3,5,1877,1171,706
2,18,7,3,5,1998,1185,813
2,18,8,3,5,2009,1262,747
2,18,9,3,5,1844,1049,795
2,18,10,3,5,1813,1010,803
2,18,11,3,5,1649,1106,543
2,18,12,3,5,1707,1203,504
2,18,13,3,5,1776,1074,702
2,18,14,3,5,1588,982,606
2,18,15,3,5,1556,1045,511
2,18,16,3,5,1874,1001,873
2,18,17,3,5,1769,915,854
2,18,18,3,5,1493,932,561
2,18,19,3,5,1836,1091,745
2,0,0,4,5,2170,2151,19
2,0,1,4,5,2178,2041,137
2,0,2,4,5,2154,1863,291
2,0,3,4,5,2175,1708,467
2,0,4,4,5,2158,1623,535
2,0,5,4,5,2104,1529,575
2,0,6,4,5,2043,1442,601
2,0,7,4,5,1992,1408,584
2,0,8,4,5,1919,1407,512
2,0,9,4,5,1898,1397,501
2,0,10,4,5,1891,1390,501
2,0,11,4,5,1900,1387,513
2,0,12,4,5,1945,1399,546
2,0,13,4,5,1989,1405,584
2,0,14,4,5,2051,1465,586
2,0,15,4,5,2105,1582,523
2,0,16,4,5,2124,1704,420
2,0,17,4,5,2132,1834,298
2,0,18,4,5,2164,2008,156
2,0,19,4,5,2145,2129,16
2,1,0,4,5,2236,2092,144
2,1,1,4,5,2249,1944,305
2,1,2,4,5,2203,1785,418
2,1,3,4,5,2176,1668,508
2,1,4,4,5,2092,1693,399
2,1,5,4,5,1971,1746,225
2,1,6,4,5,1847,1767,80
2,1,7,4,5,1749,1784,-35
2,1,8,4,5,1648,1840,-192
2,1,9,4,5,1619,1858,-239
2,1,10,4,5,1607,1858,-251
2,1,11,4,5,1613,1863,-250
2,1,12,4,5,1676,1858,-182
2,1,13,4,5,1751,1818,-67
2,1,14,4,5,1867,1800,67
2,1,15,4,5,1993,1796,197
2,1,16,4,5,2086,1812,274
2,1,17,4,5,2140,1885,255
2,1,18,4,5,2203,2008,195
2,1,19,4,5,2196,2127,69
2,2,0,4,5,2294,1820,474
2,2,1,4,5,2300,1626,674
2,2,2,4,5,2210,1495,715
2,2,3,4,5,2102,1457,645
2,2,4,4,5,1966,1553,413
2,2,5,4,5,1794,1663,131
2,2,6,4,5,1632,1700,-68
2,2,7,4,5,1529,1713,-184
2,2,8,4,5,1458,1715,-257
2,2,9,4,5,1429,1701,-272
2,2,10,4,5,1415,1690,-275
2,2,11,4,5,1417,1720,-303
2,2,12,4,5,1458,1748,-290
2,2,13,4,5,1522,1742,-220
2,2,14,4,5,1654,1738,-84
2,2,15,4,5,1825,1712,113
2,2,16,4,5,1974,1676,298
2,2,17,4,5,2096,1686,410
2,2,18,4,5,2212,1759,453
2,2,19,4,5,2234,1896,338
2,3,0,4,5,2273,1723,550
2,3,1,4,5,2239,1581,658
2,3,2,4,5,2099,1586,513
2,3,3,4,5,1934,1696,238
2,3,4,4,5,1770,1878,-108
2,3,5,4,5,1577,1986,-409
2,3,6,4,5,1401,2050,-649
2,3,7,4,5,1301,2057,-756
2,3,8,4,5,1253,2016,-763
2,3,9,4,5,1231,1992,-761
2,3,10,4,5,1219,1978,-759
2,3,11,4,5,1218,2006,-788
2,3,12,4,5,1257,2052,-795
2,3,13,4,5,1315,2073,-758
2,3,14,4,5,1448,2047,-599
2,3,15,4,5,1641,1998,-357
2,3,16,4,5,1827,1919,-92
2,3,17,4,5,1986,1836,150
2,3,18,4,5,2146,1809,337
2,3,19,4,5,2215,1896,319
2,4,0,4,5,2151,1994,157
2,4,1,4,5,2041,1961,80
2,4,2,4,5,1863,2132,-269
2,4,3,4,5,1708,2367,-659
2,4,4,4,5,1623,2596,-973
2,4,5,4,5,1529,2573,-1044
2,4,6,4,5,1442,2616,-1174
2,4,7,4,5,1408,2561,-1153
2,4,8,4,5,1407,2487,-1080
2,4,9,4,5,1397,2444,-1047
2,4,10,4,5,1390,2435,-1045
2,4,11,4,5,1387,2459,-1072
2,4,12,4,5,1399,2569,-1170
2,4,13,4,5,1405,2650,-1245
2,4,14,4,5,1465,2627,-1162
2,4,15,4,5,1582,2625,-1043
2,4,16,4,5,1704,2594,-890
2,4,17,4,5,1834,2453,-619
2,4,18,4,5,2008,2337,-329
2,4,19,4,5,2129,2328,-199
2,5,0,4,5,2092,2230,-138
2,5,1,4,5,1944,2279,-335
2,5,2,4,5,1785,2522,-737
2,5,3,4,5,1668,2877,-1209
2,5,4,4,5,1693,3163,-1470
2,5,5,4,5,1746,2942,-1196
2,5,6,4,5,1767,2862,-1095
2,5,7,4,5,1784,2707,-923
2,5,8,4,5,1840,2515,-675
2,5,9,4,5,1858,2332,-474
2,5,10,4,5,1858,2312,-454
2,5,11,4,5,1863,2373,-510
2,5,12,4,5,1858,2622,-764
2,5,13,4,5,1818,2825,-1007
2,5,14,4,5,1800,2908,-1108
2,5,15,4,5,1796,3070,-1274
2,5,16,4,5,1812,3137,-1325
2,5,17,4,5,1885,2948,-1063
2,5,18,4,5,2008,2806,-798
2,5,19,4,5,2127,2726,-599
2,6,0,4,5,1820,2627,-807
2,6,1,4,5,1626,2834,-1208
2,6,2,4,5,1495,3113,-1618
2,6,3,4,5,1457,3593,-2136
2,6,4,4,5,1553,3984,-2431
2,6,5,4,5,1663,3676,-2013
2,6,6,4,5,1700,3475,-1775
2,6,7,4,5,1713,3251,-1538
2,6,8,4,5,1715,2964,-1249
2,6,9,4,5,1701,2664,-963
2,6,10,4,5,1690,2649,-959
2,6,11,4,5,1720,2737,-1017
2,6,12,4,5,1748,3119,-1371
2,6,13,4,5,1742,3402,-1660
2,6,14,4,5,1738,3577,-1839
2,6,15,4,5,1712,3841,-2129
2,6,16,4,5,1676,3930,-2254
2,6,17,4,5,1686,3679,-1993
2,6,18,4,5,1759,3507,-1748
2,6,19,4,5,1896,3298,-1402
2,7,0,4,5,1723,2929,-1206
2,7,1,4,5,1581,3224,-1643
2,7,2,4,5,1586,3398,-1812
2,7,3,4,5,1696,3897,-2201
2,7,4,4,5,1878,4336,-2458
2,7,5,4,5,1986,3972,-1986
2,7,6,4,5,2050,3630,-1580
2,7,7,4,5,2057,3360,-1303
2,7,8,4,5,2016,2983,-967
2,7,9,4,5,1992,2569,-577
2,7,10,4,5,1978,2562,-584
2,7,11,4,5,2006,2681,-675
2,7,12,4,5,2052,3185,-1133
2,7,13,4,5,2073,3515,-1442
2,7,14,4,5,2047,3828,-1781
2,7,15,4,5,1998,4205,-2207
2,7,16,4,5,1919,4306,-2387
2,7,17,4,5,1836,4072,-2236
2,7,18,4,5,1809,3971,-2162
2,7,19,4,5,1896,3692,-1796
2,8,0,4,5,1994,2972,-978
2,8,1,4,5,1961,3335,-1374
2,8,2,4,5,2132,3381,-1249
2,8,3,4,5,2367,3870,-1503
2,8,4,4,5,2596,4335,-1739
2,8,5,4,5,2573,3922,-1349
2,8,6,4,5,2616,3429,-813
2,8,7,4,5,2561,3134,-573
2,8,8,4,5,2487,2664,-177
2,8,9,4,5,2444,2120,324
2,8,10,4,5,2435,2110,325
2,8,11,4,5,2459,2276,183
2,8,12,4,5,2569,2877,-308
2,8,13,4,5,2650,3228,-578
2,8,14,4,5,2627,3712,-1085
2,8,15,4,5,2625,4199,-1574
2,8,16,4,5,2594,4265,-1671
2,8,17,4,5,2453,4047,-1594
2,8,18,4,5,2337,4024,-1687
2,8,19,4,5,2328,3689,-1361
2,9,0,4,5,2230,2842,-612
2,9,1,4,5,2279,3296,-1017
2,9,2,4,5,2522,3292,-770
2,9,3,4,5,2877,3834,-957
2,9,4,4,5,3163,4313,-1150
2,9,5,4,5,2942,3914,-972
2,9,6,4,5,2862,3376,-514
2,9,7,4,5,2707,3143,-436
2,9,8,4,5,2515,2645,-130
2,9,9,4,5,2332,2095,237
2,9,10,4,5,2312,2084,228
2,9,11,4,5,2373,2262,111
2,9,12,4,5,2622,2887,-265
2,9,13,4,5,2825,3174,-349
2,9,14,4,5,2908,3646,-738
2,9,15,4,5,3070,4133,-1063
2,9,16,4,5,3137,4122,-985
2,9,17,4,5,2948,3872,-924
2,9,18,4,5,2806,3835,-1029
2,9,19,4,5,2726,3520,-794
2,10,0,4,5,2627,2716,-89
2,10,1,4,5,2834,3146,-312
2,10,2,4,5,3113,3168,-55
2,10,3,4,5,3593,3755,-162
2,10,4,4,5,3984,4158,-174
2,10,5,4,5,3676,3710,-34
2,10,6,4,5,3475,3238,237
2,10,7,4,5,3251,3037,214
2,10,8,4,5,2964,2514,450
2,10,9,4,5,2664,2004,660
2,10,10,4,5,2649,1992,657
2,10,11,4,5,2737,2149,588
2,10,12,4,5,3119,2793,326
2,10,13,4,5,3402,3051,351
2,10,14,4,5,3577,3393,184
2,10,15,4,5,3841,3857,-16
2,10,16,4,5,3930,3860,70
2,10,17,4,5,3679,3595,84
2,10,18,4,5,3507,3510,-3
2,10,19,4,5,3298,3359,-61
2,11,0,4,5,2929,2694,235
2,11,1,4,5,3224,3079,145
2,11,2,4,5,3398,3104,294
2,11,3,4,5,3897,3627,270
2,11,4,4,5,4336,3844,492
2,11,5,4,5,3972,3307,665
2,11,6,4,5,3630,2858,772
2,11,7,4,5,3360,2722,638
2,11,8,4,5,2983,2300,683
2,11,9,4,5,2569,1877,692
2,11,10,4,5,2562,1891,671
2,11,11,4,5,2681,2027,654
2,11,12,4,5,3185,2506,679
2,11,13,4,5,3515,2744,771
2,11,14,4,5,3828,2966,862
2,11,15,4,5,4205,3343,862
2,11,16,4,5,4306,3466,840
2,11,17,4,5,4072,3344,728
2,11,18,4,5,3971,3161,810
2,11,19,4,5,3692,3134,558
2,12,0,4,5,2972,2694,278
2,12,1,4,5,3335,2865,470
2,12,2,4,5,3381,2877,504
2,12,3,4,5,3870,3265,605
2,12,4,4,5,4335,3316,1019
2,12,5,4,5,3922,2896,1026
2,12,6,4,5,3429,2657,772
2,12,7,4,5,3134,2650,484
2,12,8,4,5,2664,2419,245
2,12,9,4,5,2120,2112,8
2,12,10,4,5,2110,2110,0
2,12,11,4,5,2276,2111,165
2,12,12,4,5,2877,2486,391
2,12,13,4,5,3228,2708,520
2,12,14,4,5,3712,2687,1025
2,12,15,4,5,4199,2880,1319
2,12,16,4,5,4265,3126,1139
2,12,17,4,5,4047,2952,1095
2,12,18,4,5,4024,2620,1404
2,12,19,4,5,3689,2831,858
2,13,0,4,5,2842,2720,122
2,13,1,4,5,3296,2603,693
2,13,2,4,5,3292,2596,696
2,13,3,4,5,3834,2922,912
2,13,4,4,5,4313,2867,1446
2,13,5,4,5,3914,2594,1320
2,13,6,4,5,3376,2597,779
2,13,7,4,5,3143,2673,470
2,13,8,4,5,2645,2536,109
2,13,9,4,5,2095,2258,-163
2,13,10,4,5,2084,2217,-133
2,13,11,4,5,2262,2083,179
2,13,12,4,5,2887,2316,571
2,13,13,4,5,3174,2463,711
2,13,14,4,5,3646,2267,1379
2,13,15,4,5,4133,2334,1799
2,13,16,4,5,4122,2686,1436
2,13,17,4,5,3872,2505,1367
2,13,18,4,5,3835,2161,1674
2,13,19,4,5,3520,2584,936
2,14,0,4,5,2716,2782,-66
2,14,1,4,5,3146,2411,735
2,14,2,4,5,3168,2353,815
2,14,3,4,5,3755,2506,1249
2,14,4,4,5,4158,2311,1847
2,14,5,4,5,3710,2153,1557
2,14,6,4,5,3238,2231,1007
2,14,7,4,5,3037,2338,699
2,14,8,4,5,2514,2353,161
2,14,9,4,5,2004,2079,-75
2,14,10,4,5,1992,2031,-39
2,14,11,4,5,2149,1896,253
2,14,12,4,5,2793,1953,840
2,14,13,4,5,3051,2004,1047
2,14,14,4,5,3393,1835,1558
2,14,15,4,5,3857,1863,1994
2,14,16,4,5,3860,2227,1633
2,14,17,4,5,3595,2168,1427
2,14,18,4,5,3510,1918,1592
2,14,19,4,5,3359,2379,980
2,15,0,4,5,2694,2477,217
2,15,1,4,5,3079,1989,1090
2,15,2,4,5,3104,1925,1179
2,15,3,4,5,3627,2045,1582
2,15,4,4,5,3844,1953,1891
2,15,5,4,5,3307,1969,1338
2,15,6,4,5,2858,2184,674
2,15,7,4,5,2722,2292,430
2,15,8,4,5,2300,2349,-49
2,15,9,4,5,1877,2044,-167
2,15,10,4,5,1891,1950,-59
2,15,11,4,5,2027,1836,191
2,15,12,4,5,2506,1961,545
2,15,13,4,5,2744,1915,829
2,15,14,4,5,2966,1685,1281
2,15,15,4,5,3343,1716,1627
2,15,16,4,5,3466,1912,1554
2,15,17,4,5,3344,1698,1646
2,15,18,4,5,3161,1509,1652
2,15,19,4,5,3134,1958,1176
2,16,0,4,5,2694,2101,593
2,16,1,4,5,2865,1677,1188
2,16,2,4,5,2877,1610,1267
2,16,3,4,5,3265,1761,1504
2,16,4,4,5,3316,1773,1543
2,16,5,4,5,2896,1825,1071
2,16,6,4,5,2657,1952,705
2,16,7,4,5,2650,2013,637
2,16,8,4,5,2419,2063,356
2,16,9,4,5,2112,1752,360
2,16,10,4,5,2110,1665,445
2,16,11,4,5,2111,1683,428
2,16,12,4,5,2486,1798,688
2,16,13,4,5,2708,1637,1071
2,16,14,4,5,2687,1447,1240
2,16,15,4,5,2880,1503,1377
2,16,16,4,5,3126,1547,1579
2,16,17,4,5,2952,1368,1584
2,16,18,4,5,2620,1320,1300
2,16,19,4,5,2831,1642,1189
2,0,0,5,5,2758,2420,338
2,0,1,5,5,2772,2221,551
2,0,2,5,5,2723,2037,686
2,0,3,5,5,2706,1918,788
2,0,4,5,5,2628,1964,664
2,0,5,5,5,2499,2017,482
2,0,6,5,5,2366,2012,354
2,0,7,5,5,2266,2021,245
2,0,8,5,5,2161,2049,112
2,0,9,5,5,2131,2031,100
2,0,10,5,5,2120,2017,103
2,0,11,5,5,2129,2046,83
2,0,12,5,5,2188,2064,124
2,0,13,5,5,2263,2051,212
2,0,14,5,5,2386,2063,323
2,0,15,5,5,2516,2079,437
2,0,16,5,5,2602,2093,509
2,0,17,5,5,2661,2167,494
2,0,18,5,5,2731,2300,431
2,0,19,5,5,2716,2464,252
2,1,0,5,5,2836,2252,584
2,1,1,5,5,2844,2072,772
2,1,2,5,5,2745,2020,725
2,1,3,5,5,2637,2079,558
2,1,4,5,5,2503,2241,262
2,1,5,5,5,2325,2331,-6
2,1,6,5,5,2159,2382,-223
2,1,7,5,5,2057,2391,-334
2,1,8,5,5,1982,2361,-379
2,1,9,5,5,1949,2337,-388
2,1,10,5,5,1934,2322,-388
2,1,11,5,5,1939,2349,-410
2,1,12,5,5,1992,2403,-411
2,1,13,5,5,2060,2421,-361
2,1,14,5,5,2192,2397,-205
2,1,15,5,5,2360,2367,-7
2,1,16,5,5,2503,2317,186
2,1,17,5,5,2621,2264,357
2,1,18,5,5,2744,2287,457
2,1,19,5,5,2764,2418,346
2,2,0,5,5,2823,2428,395
2,2,1,5,5,2791,2322,469
2,2,2,5,5,2644,2450,194
2,2,3,5,5,2485,2700,-215
2,2,4,5,5,2329,2975,-646
2,2,5,5,5,2139,3008,-869
2,2,6,5,5,1964,3091,-1127
2,2,7,5,5,1863,3053,-1190
2,2,8,5,5,1803,2973,-1170
2,2,9,5,5,1774,2933,-1159
2,2,10,5,5,1759,2925,-1166
2,2,11,5,5,1760,2948,-1188
2,2,12,5,5,1809,3058,-1249
2,2,13,5,5,1870,3124,-1254
2,2,14,5,5,2004,3082,-1078
2,2,15,5,5,2194,3060,-866
2,2,16,5,5,2372,3005,-633
2,2,17,5,5,2524,2849,-325
2,2,18,5,5,2690,2759,-69
2,2,19,5,5,2756,2796,-40
2,3,0,5,5,2707,2759,-52
2,3,1,5,5,2600,2776,-176
2,3,2,5,5,2417,3013,-596
2,3,3,5,5,2267,3368,-1101
2,3,4,5,5,2149,3703,-1554
2,3,5,5,5,2012,3554,-1542
2,3,6,5,5,1876,3510,-1634
2,3,7,5,5,1793,3357,-1564
2,3,8,5,5,1739,3190,-1451
2,3,9,5,5,1720,3026,-1306
2,3,10,5,5,1709,3009,-1300
2,3,11,5,5,1707,3078,-1371
2,3,12,5,5,1746,3324,-1578
2,3,13,5,5,1789,3512,-1723
2,3,14,5,5,1903,3578,-1675
2,3,15,5,5,2076,3695,-1619
2,3,16,5,5,2238,3723,-1485
2,3,17,5,5,2382,3528,-1146
2,3,18,5,5,2568,3373,-805
2,3,19,5,5,2683,3295,-612
2,4,0,5,5,2680,2955,-275
2,4,1,5,5,2538,3111,-573
2,4,2,5,5,2354,3365,-1011
2,4,3,5,5,2199,3843,-1644
2,4,4,5,5,2163,4255,-2092
2,4,5,5,5,2141,3947,-1806
2,4,6,5,5,2090,3720,-1630
2,4,7,5,5,2058,3488,-1430
2,4,8,5,5,2082,3173,-1091
2,4,9,5,5,2091,2837,-746
2,4,10,5,5,2087,2808,-721
2,4,11,5,5,2092,2920,-828
2,4,12,5,5,2101,3325,-1224
2,4,13,5,5,2092,3635,-1543
2,4,14,5,5,2135,3840,-1705
2,4,15,5,5,2207,4124,-1917
2,4,16,5,5,2290,4211,-1921
2,4,17,5,5,2414,3961,-1547
2,4,18,5,5,2575,3799,-1224
2,4,19,5,5,2698,3635,-937
2,5,0,5,5,2420,3361,-941
2,5,1,5,5,2221,3670,-1449
2,5,2,5,5,2037,3923,-1886
2,5,3,5,5,1918,4519,-2601
2,5,4,5,5,1964,5024,-3060
2,5,5,5,5,2017,4640,-2623
2,5,6,5,5,2012,4312,-2300
2,5,7,5,5,2021,4038,-2017
2,5,8,5,5,2049,3629,-1580
2,5,9,5,5,2031,3205,-1174
2,5,10,5,5,2017,3194,-1177
2,5,11,5,5,2046,3310,-1264
2,5,12,5,5,2064,3840,-1776
2,5,13,5,5,2051,4194,-2143
2,5,14,5,5,2063,4487,-2424
2,5,15,5,5,2079,4860,-2781
2,5,16,5,5,2093,4947,-2854
2,5,17,5,5,2167,4650,-2483
2,5,18,5,5,2300,4499,-2199
2,5,19,5,5,2464,4214,-1750
2,6,0,5,5,2252,3677,-1425
2,6,1,5,5,2072,4076,-2004
2,6,2,5,5,2020,4245,-2225
2,6,3,5,5,2079,4874,-2795
2,6,4,5,5,2241,5432,-3191
2,6,5,5,5,2331,4944,-2613
2,6,6,5,5,2382,4470,-2088
2,6,7,5,5,2391,4130,-1739
2,6,8,5,5,2361,3621,-1260
2,6,9,5,5,2337,3061,-724
2,6,10,5,5,2322,3057,-735
2,6,11,5,5,2349,3218,-869
2,6,12,5,5,2403,3883,-1480
2,6,13,5,5,2421,4279,-1858
2,6,14,5,5,2397,4747,-2350
2,6,15,5,5,2367,5261,-2894
2,6,16,5,5,2317,5351,-3034
2,6,17,5,5,2264,5060,-2796
2,6,18,5,5,2287,4974,-2687
2,6,19,5,5,2418,4589,-2171
2,7,0,5,5,2428,3607,-1179
2,7,1,5,5,2322,4111,-1789
2,7,2,5,5,2450,4173,-1723
2,7,3,5,5,2700,4835,-2135
2,7,4,5,5,2975,5420,-2445
2,7,5,5,5,3008,4895,-1887
2,7,6,5,5,3091,4270,-1179
2,7,7,5,5,3053,3939,-886
2,7,8,5,5,2973,3348,-375
2,7,9,5,5,2933,2677,256
2,7,10,5,5,2925,2658,267
2,7,11,5,5,2948,2881,67
2,7,12,5,5,3058,3642,-584
2,7,13,5,5,3124,4036,-912
2,7,14,5,5,3082,4597,-1515
2,7,15,5,5,3060,5203,-2143
2,7,16,5,5,3005,5251,-2246
2,7,17,5,5,2849,4947,-2098
2,7,18,5,5,2759,4871,-2112
2,7,19,5,5,2796,4487,-1691
2,8,0,5,5,2759,3441,-682
2,8,1,5,5,2776,3978,-1202
2,8,2,5,5,3013,4011,-998
2,8,3,5,5,3368,4721,-1353
2,8,4,5,5,3703,5250,-1547
2,8,5,5,5,3554,4715,-1161
2,8,6,5,5,3510,4096,-586
2,8,7,5,5,3357,3818,-461
2,8,8,5,5,3190,3172,18
2,8,9,5,5,3026,2509,517
2,8,10,5,5,3009,2488,521
2,8,11,5,5,3078,2696,382
2,8,12,5,5,3324,3496,-172
2,8,13,5,5,3512,3861,-349
2,8,14,5,5,3578,4325,-747
2,8,15,5,5,3695,4911,-1216
2,8,16,5,5,3723,4934,-1211
2,8,17,5,5,3528,4608,-1080
2,8,18,5,5,3373,4503,-1130
2,8,19,5,5,3295,4268,-973
2,9,0,5,5,2955,3428,-473
2,9,1,5,5,3111,3915,-804
2,9,2,5,5,3365,3914,-549
2,9,3,5,5,3843,4553,-710
2,9,4,5,5,4255,4884,-629
2,9,5,5,5,3947,4271,-324
2,9,6,5,5,3720,3695,25
2,9,7,5,5,3488,3509,-21
2,9,8,5,5,3173,2965,208
2,9,9,5,5,2837,2418,419
2,9,10,5,5,2808,2436,372
2,9,11,5,5,2920,2600,320
2,9,12,5,5,3325,3227,98
2,9,13,5,5,3635,3536,99
2,9,14,5,5,3840,3876,-36
2,9,15,5,5,4124,4362,-238
2,9,16,5,5,4211,4483,-272
2,9,17,5,5,3961,4315,-354
2,9,18,5,5,3799,4153,-354
2,9,19,5,5,3635,4050,-415
2,10,0,5,5,3361,3442,-81
2,10,1,5,5,3670,3717,-47
2,10,2,5,5,3923,3724,199
2,10,3,5,5,4519,4242,277
2,10,4,5,5,5024,4412,612
2,10,5,5,5,4640,3868,772
2,10,6,5,5,4312,3497,815
2,10,7,5,5,4038,3420,618
2,10,8,5,5,3629,3057,572
2,10,9,5,5,3205,2604,601
2,10,10,5,5,3194,2605,589
2,10,11,5,5,3310,2648,662
2,10,12,5,5,3840,3184,656
2,10,13,5,5,4194,3472,722
2,10,14,5,5,4487,3606,881
2,10,15,5,5,4860,3936,924
2,10,16,5,5,4947,4171,776
2,10,17,5,5,4650,3940,710
2,10,18,5,5,4499,3623,876
2,10,19,5,5,4214,3728,486
2,11,0,5,5,3677,3355,322
2,11,1,5,5,4076,3379,697
2,11,2,5,5,4245,3388,857
2,11,3,5,5,4874,3887,987
2,11,4,5,5,5432,3952,1480
2,11,5,5,5,4944,3567,1377
2,11,6,5,5,4470,3438,1032
2,11,7,5,5,4130,3478,652
2,11,8,5,5,3621,3220,401
2,11,9,5,5,3061,2815,246
2,11,10,5,5,3057,2765,292
2,11,11,5,5,3218,2688,530
2,11,12,5,5,3883,3081,802
2,11,13,5,5,4279,3271,1008
2,11,14,5,5,4747,3152,1595
2,11,15,5,5,5261,3338,1923
2,11,16,5,5,5351,3672,1679
2,11,17,5,5,5060,3405,1655
2,11,18,5,5,4974,3008,1966
2,11,19,5,5,4589,3382,1207
2,12,0,5,5,3607,3381,226
2,12,1,5,5,4111,3093,1018
2,12,2,5,5,4173,3072,1101
2,12,3,5,5,4835,3393,1442
2,12,4,5,5,5420,3248,2172
2,12,5,5,5,4895,2954,1941
2,12,6,5,5,4270,2951,1319
2,12,7,5,5,3939,3013,926
2,12,8,5,5,3348,2880,468
2,12,9,5,5,2677,2493,184
2,12,10,5,5,2658,2435,223
2,12,11,5,5,2881,2330,551
2,12,12,5,5,3642,2562,1080
2,12,13,5,5,4036,2691,1345
2,12,14,5,5,4597,2514,2083
2,12,15,5,5,5203,2641,2562
2,12,16,5,5,5251,3039,2212
2,12,17,5,5,4947,2904,2043
2,12,18,5,5,4871,2586,2285
2,12,19,5,5,4487,3127,1360
2,13,0,5,5,3441,3189,252
2,13,1,5,5,3978,2758,1220
2,13,2,5,5,4011,2671,1340
2,13,3,5,5,4721,2843,1878
2,13,4,5,5,5250,2679,2571
2,13,5,5,5,4715,2530,2185
2,13,6,5,5,4096,2641,1455
2,13,7,5,5,3818,2764,1054
2,13,8,5,5,3172,2800,372
2,13,9,5,5,2509,2458,51
2,13,10,5,5,2488,2394,94
2,13,11,5,5,2696,2287,409
2,13,12,5,5,3496,2395,1101
2,13,13,5,5,3861,2400,1461
2,13,14,5,5,4325,2168,2157
2,13,15,5,5,4911,2221,2690
2,13,16,5,5,4934,2535,2399
2,13,17,5,5,4608,2418,2190
2,13,18,5,5,4503,2152,2351
2,13,19,5,5,4268,2649,1619
2,14,0,5,5,3428,2849,579
2,14,1,5,5,3915,2315,1600
2,14,2,5,5,3914,2230,1684
2,14,3,5,5,4553,2376,2177
2,14,4,5,5,4884,2341,2543
2,14,5,5,5,4271,2386,1885
2,14,6,5,5,3695,2591,1104
2,14,7,5,5,3509,2711,798
2,14,8,5,5,2965,2820,145
2,14,9,5,5,2418,2479,-61
2,14,10,5,5,2436,2379,57
2,14,11,5,5,2600,2304,296
2,14,12,5,5,3227,2476,751
2,14,13,5,5,3536,2365,1171
2,14,14,5,5,3876,2087,1789
2,14,15,5,5,4362,2096,2266
2,14,16,5,5,4483,2252,2231
2,14,17,5,5,4315,1964,2351
2,14,18,5,5,4153,1782,2371
2,14,19,5,5,4050,2236,1814
2,0,0,6,5,3358,2957,401
2,0,1,6,5,3367,2813,554
2,0,2,6,5,3265,2884,381
2,0,3,6,5,3167,3083,84
2,0,4,6,5,3039,3338,-299
2,0,5,6,5,2853,3353,-500
2,0,6,6,5,2678,3423,-745
2,0,7,6,5,2574,3387,-813
2,0,8,6,5,2495,3318,-823
2,0,9,6,5,2461,3278,-817
2,0,10,6,5,2447,3269,-822
2,0,11,6,5,2455,3291,-836
2,0,12,6,5,2504,3409,-905
2,0,13,6,5,2572,3472,-900
2,0,14,6,5,2711,3432,-721
2,0,15,6,5,2883,3429,-546
2,0,16,6,5,3019,3403,-384
2,0,17,6,5,3142,3277,-135
2,0,18,6,5,3272,3237,35
2,0,19,6,5,3284,3318,-34
2,1,0,6,5,3365,3193,172
2,1,1,6,5,3335,3137,198
2,1,2,6,5,3179,3331,-152
2,1,3,6,5,3020,3701,-681
2,1,4,6,5,2866,4082,-1216
2,1,5,6,5,2670,3989,-1319
2,1,6,6,5,2491,3985,-1494
2,1,7,6,5,2391,3849,-1458
2,1,8,6,5,2327,3676,-1349
2,1,9,6,5,2294,3515,-1221
2,1,10,6,5,2278,3499,-1221
2,1,11,6,5,2282,3567,-1285
2,1,12,6,5,2343,3813,-1470
2,1,13,6,5,2408,3986,-1578
2,1,14,6,5,2542,4033,-1491
2,1,15,6,5,2729,4130,-1401
2,1,16,6,5,2901,4134,-1233
2,1,17,6,5,3049,3924,-875
2,1,18,6,5,3222,3795,-573
2,1,19,6,5,3286,3763,-477
2,2,0,6,5,3257,3484,-227
2,2,1,6,5,3152,3608,-456
2,2,2,6,5,2962,3856,-894
2,2,3,6,5,2818,4334,-1516
2,2,4,6,5,2708,4795,-2087
2,2,5,6,5,2574,4559,-1985
2,2,6,6,5,2439,4368,-1929
2,2,7,6,5,2355,4138,-1783
2,2,8,6,5,2289,3848,-1559
2,2,9,6,5,2263,3531,-1268
2,2,10,6,5,2249,3505,-1256
2,2,11,6,5,2249,3625,-1376
2,2,12,6,5,2298,4027,-1729
2,2,13,6,5,2344,4322,-1978
2,2,14,6,5,2459,4510,-2051
2,2,15,6,5,2629,4749,-2120
2,2,16,6,5,2783,4797,-2014
2,2,17,6,5,2920,4541,-1621
2,2,18,6,5,3112,4366,-1254
2,2,19,6,5,3224,4204,-980
2,3,0,6,5,3236,3689,-453
2,3,1,6,5,3097,3947,-850
2,3,2,6,5,2908,4175,-1267
2,3,3,6,5,2758,4769,-2011
2,3,4,6,5,2689,5295,-2606
2,3,5,6,5,2624,4911,-2287
2,3,6,6,5,2524,4557,-2033
2,3,7,6,5,2443,4275,-1832
2,3,8,6,5,2414,3838,-1424
2,3,9,6,5,2414,3378,-964
2,3,10,6,5,2406,3353,-947
2,3,11,6,5,2412,3493,-1081
2,3,12,6,5,2448,4046,-1598
2,3,13,6,5,2476,4427,-1951
2,3,14,6,5,2573,4750,-2177
2,3,15,6,5,2701,5143,-2442
2,3,16,6,5,2824,5228,-2404
2,3,17,6,5,2962,4932,-1970
2,3,18,6,5,3135,4791,-1656
2,3,19,6,5,3252,4551,-1299
2,4,0,6,5,3008,4109,-1101
2,4,1,6,5,2815,4522,-1707
2,4,2,6,5,2606,4770,-2164
2,4,3,6,5,2449,5496,-3047
2,4,4,6,5,2434,6120,-3686
2,4,5,6,5,2412,5612,-3200
2,4,6,6,5,2335,5152,-2817
2,4,7,6,5,2295,4808,-2513
2,4,8,6,5,2291,4267,-1976
2,4,9,6,5,2264,3697,-1433
2,4,10,6,5,2246,3689,-1443
2,4,11,6,5,2275,3847,-1572
2,4,12,6,5,2307,4538,-2231
2,4,13,6,5,2325,4958,-2633
2,4,14,6,5,2398,5406,-3008
2,4,15,6,5,2490,5916,-3426
2,4,16,6,5,2571,5992,-3421
2,4,17,6,5,2696,5638,-2942
2,4,18,6,5,2867,5502,-2635
2,4,19,6,5,3035,5111,-2076
2,5,0,6,5,2852,4312,-1460
2,5,1,6,5,2667,4852,-2185
2,5,2,6,5,2562,5037,-2475
2,5,3,6,5,2540,5839,-3299
2,5,4,6,5,2652,6517,-3865
2,5,5,6,5,2685,5917,-3232
2,5,6,6,5,2694,5311,-2617
2,5,7,6,5,2699,4935,-2236
2,5,8,6,5,2695,4305,-1610
2,5,9,6,5,2667,3618,-951
2,5,10,6,5,2649,3605,-956
2,5,11,6,5,2675,3823,-1148
2,5,12,6,5,2719,4648,-1929
2,5,13,6,5,2730,5087,-2357
2,5,14,6,5,2722,5632,-2910
2,5,15,6,5,2734,6265,-3531
2,5,16,6,5,2734,6337,-3603
2,5,17,6,5,2745,5960,-3215
2,5,18,6,5,2828,5821,-2993
2,5,19,6,5,2986,5387,-2401
2,6,0,6,5,2957,4206,-1249
2,6,1,6,5,2813,4793,-1980
2,6,2,6,5,2884,4892,-2008
2,6,3,6,5,3083,5722,-2639
2,6,4,6,5,3338,6357,-3019
2,6,5,6,5,3353,5696,-2343
2,6,6,6,5,3423,4990,-1567
2,6,7,6,5,3387,4614,-1227
2,6,8,6,5,3318,3875,-557
2,6,9,6,5,3278,3091,187
2,6,10,6,5,3269,3062,207
2,6,11,6,5,3291,3315,-24
2,6,12,6,5,3409,4251,-842
2,6,13,6,5,3472,4723,-1251
2,6,14,6,5,3432,5276,-1844
2,6,15,6,5,3429,5981,-2552
2,6,16,6,5,3403,6063,-2660
2,6,17,6,5,3277,5683,-2406
2,6,18,6,5,3237,5539,-2302
2,6,19,6,5,3318,5235,-1917
2,7,0,6,5,3193,4153,-960
2,7,1,6,5,3137,4747,-1610
2,7,2,6,5,3331,4757,-1426
2,7,3,6,5,3701,5519,-1818
2,7,4,6,5,4082,5976,-1894
2,7,5,6,5,3989,5276,-1287
2,7,6,6,5,3985,4553,-568
2,7,7,6,5,3849,4290,-441
2,7,8,6,5,3676,3623,53
2,7,9,6,5,3515,2923,592
2,7,10,6,5,3499,2932,567
2,7,11,6,5,3567,3147,420
2,7,12,6,5,3813,3930,-117
2,7,13,6,5,3986,4346,-360
2,7,14,6,5,4033,4808,-775
2,7,15,6,5,4130,5416,-1286
2,7,16,6,5,4134,5557,-1423
2,7,17,6,5,3924,5328,-1404
2,7,18,6,5,3795,5146,-1351
2,7,19,6,5,3763,4959,-1196
2,8,0,6,5,3484,4176,-692
2,8,1,6,5,3608,4553,-945
2,8,2,6,5,3856,4534,-678
2,8,3,6,5,4334,5168,-834
2,8,4,6,5,4795,5452,-657
2,8,5,6,5,4559,4832,-273
2,8,6,6,5,4368,4334,34
2,8,7,6,5,4138,4207,-69
2,8,8,6,5,3848,3722,126
2,8,9,6,5,3531,3145,386
2,8,10,6,5,3505,3150,355
2,8,11,6,5,3625,3221,404
2,8,12,6,5,4027,3905,122
2,8,13,6,5,4322,4264,58
2,8,14,6,5,4510,4516,-6
2,8,15,6,5,4749,4955,-206
2,8,16,6,5,4797,5188,-391
2,8,17,6,5,4541,4911,-370
2,8,18,6,5,4366,4615,-249
2,8,19,6,5,4204,4644,-440
2,9,0,6,5,3689,4103,-414
2,9,1,6,5,3947,4231,-284
2,9,2,6,5,4175,4235,-60
2,9,3,6,5,4769,4864,-95
2,9,4,6,5,5295,5048,247
2,9,5,6,5,4911,4539,372
2,9,6,6,5,4557,4278,279
2,9,7,6,5,4275,4248,27
2,9,8,6,5,3838,3858,-20
2,9,9,6,5,3378,3307,71
2,9,10,6,5,3353,3260,93
2,9,11,6,5,3493,3225,268
2,9,12,6,5,4046,3779,267
2,9,13,6,5,4427,4035,392
2,9,14,6,5,4750,4071,679
2,9,15,6,5,5143,4394,749
2,9,16,6,5,5228,4717,511
2,9,17,6,5,4932,4393,539
2,9,18,6,5,4791,4011,780
2,9,19,6,5,4551,4279,272
2,10,0,6,5,4109,4016,93
2,10,1,6,5,4522,3869,653
2,10,2,6,5,4770,3864,906
2,10,3,6,5,5496,4358,1138
2,10,4,6,5,6120,4333,1787
2,10,5,6,5,5612,3927,1685
2,10,6,6,5,5152,3792,1360
2,10,7,6,5,4808,3818,990
2,10,8,6,5,4267,3564,703
2,10,9,6,5,3697,3050,647
2,10,10,6,5,3689,2983,706
2,10,11,6,5,3847,2935,912
2,10,12,6,5,4538,3327,1211
2,10,13,6,5,4958,3499,1459
2,10,14,6,5,5406,3399,2007
2,10,15,6,5,5916,3645,2271
2,10,16,6,5,5992,4025,1967
2,10,17,6,5,5638,3804,1834
2,10,18,6,5,5502,3433,2069
2,10,19,6,5,5111,3925,1186
2,11,0,6,5,4312,3788,524
2,11,1,6,5,4852,3440,1412
2,11,2,6,5,5037,3390,1647
2,11,3,6,5,5839,3730,2109
2,11,4,6,5,6517,3616,2901
2,11,5,6,5,5917,3331,2586
2,11,6,6,5,5311,3361,1950
2,11,7,6,5,4935,3439,1496
2,11,8,6,5,4305,3327,978
2,11,9,6,5,3618,2872,746
2,11,10,6,5,3605,2798,807
2,11,11,6,5,3823,2721,1102
2,11,12,6,5,4648,3004,1644
2,11,13,6,5,5087,3087,2000
2,11,14,6,5,5632,2847,2785
2,11,15,6,5,6265,2999,3266
2,11,16,6,5,6337,3347,2990
2,11,17,6,5,5960,3154,2806
2,11,18,6,5,5821,2820,3001
2,11,19,6,5,5387,3397,1990
2,12,0,6,5,4206,3561,645
2,12,1,6,5,4793,3084,1709
2,12,2,6,5,4892,2976,1916
2,12,3,6,5,5722,3174,2548
2,12,4,6,5,6357,3067,3290
2,12,5,6,5,5696,2947,2749
2,12,6,6,5,4990,3048,1942
2,12,7,6,5,4614,3183,1431
2,12,8,6,5,3875,3271,604
2,12,9,6,5,3091,2893,198
2,12,10,6,5,3062,2823,239
2,12,11,6,5,3315,2755,560
2,12,12,6,5,4251,2910,1341
2,12,13,6,5,4723,2850,1873
2,12,14,6,5,5276,2570,2706
2,12,15,6,5,5981,2601,3380
2,12,16,6,5,6063,2875,3188
2,12,17,6,5,5683,2684,2999
2,12,18,6,5,5539,2425,3114
2,12,19,6,5,5235,2927,2308
2,0,0,7,5,3887,3918,-31
2,0,1,7,5,3858,3969,-111
2,0,2,7,5,3699,4174,-475
2,0,3,7,5,3550,4667,-1117
2,0,4,7,5,3402,5174,-1772
2,0,5,7,5,3198,4994,-1796
2,0,6,7,5,3010,4843,-1833
2,0,7,7,5,2908,4630,-1722
2,0,8,7,5,2840,4334,-1494
2,0,9,7,5,2806,4020,-1214
2,0,10,7,5,2791,3995,-1204
2,0,11,7,5,2798,4114,-1316
2,0,12,7,5,2855,4516,-1661
2,0,13,7,5,2920,4796,-1876
2,0,14,7,5,3061,4965,-1904
2,0,15,7,5,3252,5184,-1932
2,0,16,7,5,3417,5208,-1791
2,0,17,7,5,3570,4937,-1367
2,0,18,7,5,3750,4788,-1038
2,0,19,7,5,3806,4672,-866
2,1,0,7,5,3799,4218,-419
2,1,1,7,5,3696,4444,-748
2,1,2,7,5,3497,4666,-1169
2,1,3,7,5,3353,5260,-1907
2,1,4,7,5,3245,5835,-2590
2,1,5,7,5,3105,5523,-2418
2,1,6,7,5,2966,5205,-2239
2,1,7,7,5,2883,4925,-2042
2,1,8,7,5,2813,4513,-1700
2,1,9,7,5,2783,4072,-1289
2,1,10,7,5,2768,4050,-1282
2,1,11,7,5,2771,4198,-1427
2,1,12,7,5,2832,4748,-1916
2,1,13,7,5,2882,5114,-2232
2,1,14,7,5,2997,5420,-2423
2,1,15,7,5,3164,5768,-2604
2,1,16,7,5,3312,5814,-2502
2,1,17,7,5,3445,5512,-2067
2,1,18,7,5,3644,5358,-1714
2,1,19,7,5,3754,5120,-1366
2,2,0,7,5,3786,4437,-651
2,2,1,7,5,3649,4799,-1150
2,2,2,7,5,3453,5022,-1569
2,2,3,7,5,3309,5746,-2437
2,2,4,7,5,3248,6391,-3143
2,2,5,7,5,3186,5883,-2697
2,2,6,7,5,3087,5397,-2310
2,2,7,7,5,3005,5045,-2040
2,2,8,7,5,2964,4476,-1512
2,2,9,7,5,2957,3870,-913
2,2,10,7,5,2946,3848,-902
2,2,11,7,5,2954,4030,-1076
2,2,12,7,5,3000,4744,-1744
2,2,13,7,5,3031,5191,-2160
2,2,14,7,5,3129,5669,-2540
2,2,15,7,5,3254,6199,-2945
2,2,16,7,5,3369,6273,-2904
2,2,17,7,5,3500,5920,-2420
2,2,18,7,5,3679,5794,-2115
2,2,19,7,5,3793,5448,-1655
2,3,0,7,5,3564,4744,-1180
2,3,1,7,5,3374,5298,-1924
2,3,2,7,5,3160,5562,-2402
2,3,3,7,5,3008,6461,-3453
2,3,4,7,5,2960,7205,-4245
2,3,5,7,5,2895,6585,-3690
2,3,6,7,5,2769,5993,-3224
2,3,7,7,5,2680,5613,-2933
2,3,8,7,5,2623,4951,-2328
2,3,9,7,5,2587,4254,-1667
2,3,10,7,5,2565,4237,-1672
2,3,11,7,5,2595,4452,-1857
2,3,12,7,5,2654,5303,-2649
2,3,13,7,5,2709,5766,-3057
2,3,14,7,5,2836,6291,-3455
2,3,15,7,5,2984,6920,-3936
2,3,16,7,5,3105,6978,-3873
2,3,17,7,5,3244,6538,-3294
2,3,18,7,5,3427,6349,-2922
2,3,19,7,5,3589,5909,-2320
2,4,0,7,5,3440,4911,-1471
2,4,1,7,5,3261,5534,-2273
2,4,2,7,5,3131,5756,-2625
2,4,3,7,5,3071,6726,-3655
2,4,4,7,5,3122,7454,-4332
2,4,5,7,5,3080,6718,-3638
2,4,6,7,5,3017,6031,-3014
2,4,7,7,5,2973,5610,-2637
2,4,8,7,5,2937,4832,-1895
2,4,9,7,5,2900,4032,-1132
2,4,10,7,5,2878,4009,-1131
2,4,11,7,5,2904,4257,-1353
2,4,12,7,5,2962,5257,-2295
2,4,13,7,5,3004,5774,-2770
2,4,14,7,5,3057,6311,-3254
2,4,15,7,5,3145,7043,-3898
2,4,16,7,5,3212,7149,-3937
2,4,17,7,5,3274,6696,-3422
2,4,18,7,5,3395,6489,-3094
2,4,19,7,5,3557,6135,-2578
2,5,0,7,5,3557,4918,-1361
2,5,1,7,5,3408,5562,-2154
2,5,2,7,5,3426,5638,-2212
2,5,3,7,5,3544,6520,-2976
2,5,4,7,5,3749,7083,-3334
2,5,5,7,5,3707,6257,-2550
2,5,6,7,5,3735,5447,-1712
2,5,7,7,5,3695,5086,-1391
2,5,8,7,5,3652,4326,-674
2,5,9,7,5,3608,3505,103
2,5,10,7,5,3596,3506,90
2,5,11,7,5,3617,3766,-149
2,5,12,7,5,3725,4685,-960
2,5,13,7,5,3781,5208,-1427
2,5,14,7,5,3757,5759,-2002
2,5,15,7,5,3796,6486,-2690
2,5,16,7,5,3820,6686,-2866
2,5,17,7,5,3758,6403,-2645
2,5,18,7,5,3778,6182,-2404
2,5,19,7,5,3886,5926,-2040
2,6,0,7,5,3722,4901,-1179
2,6,1,7,5,3628,5385,-1757
2,6,2,7,5,3765,5377,-1612
2,6,3,7,5,4084,6134,-2050
2,6,4,7,5,4445,6544,-2099
2,6,5,7,5,4334,5837,-1503
2,6,6,7,5,4317,5192,-875
2,6,7,7,5,4183,4988,-805
2,6,8,7,5,4021,4380,-359
2,6,9,7,5,3860,3650,210
2,6,10,7,5,3843,3646,197
2,6,11,7,5,3910,3768,142
2,6,12,7,5,4164,4608,-444
2,6,13,7,5,4334,5074,-740
2,6,14,7,5,4383,5448,-1065
2,6,15,7,5,4499,6009,-1510
2,6,16,7,5,4532,6262,-1730
2,6,17,7,5,4352,5924,-1572
2,6,18,7,5,4273,5608,-1335
2,6,19,7,5,4285,5553,-1268
2,7,0,7,5,3918,4837,-919
2,7,1,7,5,3969,5067,-1098
2,7,2,7,5,4174,5045,-871
2,7,3,7,5,4667,5790,-1123
2,7,4,7,5,5174,6088,-914
2,7,5,7,5,4994,5503,-509
2,7,6,7,5,4843,5115,-272
2,7,7,7,5,4630,5035,-405
2,7,8,7,5,4334,4523,-189
2,7,9,7,5,4020,3848,172
2,7,10,7,5,3995,3805,190
2,7,11,7,5,4114,3798,316
2,7,12,7,5,4516,4500,16
2,7,13,7,5,4796,4827,-31
2,7,14,7,5,4965,4981,-16
2,7,15,7,5,5184,5413,-229
2,7,16,7,5,5208,5734,-526
2,7,17,7,5,4937,5364,-427
2,7,18,7,5,4788,5003,-215
2,7,19,7,5,4672,5195,-523
2,8,0,7,5,4218,4764,-546
2,8,1,7,5,4444,4721,-277
2,8,2,7,5,4666,4711,-45
2,8,3,7,5,5260,5335,-75
2,8,4,7,5,5835,5429,406
2,8,5,7,5,5523,4899,624
2,8,6,7,5,5205,4632,573
2,8,7,7,5,4925,4588,337
2,8,8,7,5,4513,4202,311
2,8,9,7,5,4072,3542,530
2,8,10,7,5,4050,3478,572
2,8,11,7,5,4198,3472,726
2,8,12,7,5,4748,4025,723
2,8,13,7,5,5114,4263,851
2,8,14,7,5,5420,4318,1102
2,8,15,7,5,5768,4701,1067
2,8,16,7,5,5814,5070,744
2,8,17,7,5,5512,4792,720
2,8,18,7,5,5358,4436,922
2,8,19,7,5,5120,4822,298
2,9,0,7,5,4437,4423,14
2,9,1,7,5,4799,4216,583
2,9,2,7,5,5022,4182,840
2,9,3,7,5,5746,4695,1051
2,9,4,7,5,6391,4701,1690
2,9,5,7,5,5883,4304,1579
2,9,6,7,5,5397,4202,1195
2,9,7,7,5,5045,4244,801
2,9,8,7,5,4476,4011,465
2,9,9,7,5,3870,3429,441
2,9,10,7,5,3848,3346,502
2,9,11,7,5,4030,3326,704
2,9,12,7,5,4744,3769,975
2,9,13,7,5,5191,3895,1296
2,9,14,7,5,5669,3732,1937
2,9,15,7,5,6199,4003,2196
2,9,16,7,5,6273,4333,1940
2,9,17,7,5,5920,4054,1866
2,9,18,7,5,5794,3667,2127
2,9,19,7,5,5448,4195,1253
2,10,0,7,5,4744,4160,584
2,10,1,7,5,5298,3766,1532
2,10,2,7,5,5562,3695,1867
2,10,3,7,5,6461,4061,2400
2,10,4,7,5,7205,4004,3201
2,10,5,7,5,6585,3748,2837
2,10,6,7,5,5993,3768,2225
2,10,7,7,5,5613,3858,1755
2,10,8,7,5,4951,3798,1153
2,10,9,7,5,4254,3307,947
2,10,10,7,5,4237,3227,1010
2,10,11,7,5,4452,3189,1263
2,10,12,7,5,5303,3519,1784
2,10,13,7,5,5766,3537,2229
2,10,14,7,5,6291,3249,3042
2,10,15,7,5,6920,3379,3541
2,10,16,7,5,6978,3687,3291
2,10,17,7,5,6538,3420,3118
2,10,18,7,5,6349,3093,3256
2,10,19,7,5,5909,3675,2234
2,0,0,8,5,4321,4966,-645
2,0,1,8,5,4219,5296,-1077
2,0,2,8,5,4017,5513,-1496
2,0,3,8,5,3883,6237,-2354
2,0,4,8,5,3781,6931,-3150
2,0,5,8,5,3633,6495,-2862
2,0,6,8,5,3485,6045,-2560
2,0,7,8,5,3400,5695,-2295
2,0,8,8,5,3326,5151,-1825
2,0,9,8,5,3295,4564,-1269
2,0,10,8,5,3281,4545,-1264
2,0,11,8,5,3287,4735,-1448
2,0,12,8,5,3344,5446,-2102
2,0,13,8,5,3394,5878,-2484
2,0,14,8,5,3516,6339,-2823
2,0,15,8,5,3687,6824,-3137
2,0,16,8,5,3828,6859,-3031
2,0,17,8,5,3966,6500,-2534
2,0,18,8,5,4172,6361,-2189
2,0,19,8,5,4274,6017,-1743
2,1,0,8,5,4328,5072,-744
2,1,1,8,5,4193,5575,-1382
2,1,2,8,5,3988,5814,-1826
2,1,3,8,5,3844,6711,-2867
2,1,4,8,5,3785,7476,-3691
2,1,5,8,5,3717,6856,-3139
2,1,6,8,5,3614,6238,-2624
2,1,7,8,5,3533,5850,-2317
2,1,8,8,5,3488,5160,-1672
2,1,9,8,5,3477,4427,-950
2,1,10,8,5,3465,4396,-931
2,1,11,8,5,3476,4635,-1159
2,1,12,8,5,3534,5509,-1975
2,1,13,8,5,3569,5999,-2430
2,1,14,8,5,3667,6554,-2887
2,1,15,8,5,3789,7203,-3414
2,1,16,8,5,3898,7259,-3361
2,1,17,8,5,4025,6820,-2795
2,1,18,8,5,4211,6641,-2430
2,1,19,8,5,4323,6246,-1923
2,2,0,8,5,4114,5343,-1229
2,2,1,8,5,3926,5980,-2054
2,2,2,8,5,3705,6281,-2576
2,2,3,8,5,3559,7348,-3789
2,2,4,8,5,3519,8142,-4623
2,2,5,8,5,3457,7386,-3929
2,2,6,8,5,3332,6713,-3381
2,2,7,8,5,3242,6288,-3046
2,2,8,8,5,3173,5478,-2305
2,2,9,8,5,3130,4668,-1538
2,2,10,8,5,3105,4641,-1536
2,2,11,8,5,3137,4886,-1749
2,2,12,8,5,3206,5912,-2706
2,2,13,8,5,3264,6453,-3189
2,2,14,8,5,3392,6970,-3578
2,2,15,8,5,3537,7698,-4161
2,2,16,8,5,3650,7790,-4140
2,2,17,8,5,3782,7274,-3492
2,2,18,8,5,3971,7017,-3046
2,2,19,8,5,4130,6657,-2527
2,3,0,8,5,3996,5623,-1627
2,3,1,8,5,3820,6303,-2483
2,3,2,8,5,3685,6502,-2817
2,3,3,8,5,3630,7524,-3894
2,3,4,8,5,3648,8180,-4532
2,3,5,8,5,3563,7279,-3716
2,3,6,8,5,3451,6488,-3037
2,3,7,8,5,3358,6082,-2724
2,3,8,8,5,3269,5283,-2014
2,3,9,8,5,3223,4446,-1223
2,3,10,8,5,3197,4453,-1256
2,3,11,8,5,3224,4708,-1484
2,3,12,8,5,3309,5691,-2382
2,3,13,8,5,3388,6259,-2871
2,3,14,8,5,3495,6794,-3299
2,3,15,8,5,3639,7548,-3909
2,3,16,8,5,3746,7772,-4026
2,3,17,8,5,3822,7416,-3594
2,3,18,8,5,3955,7132,-3177
2,3,19,8,5,4111,6826,-2715
2,4,0,8,5,4145,5666,-1521
2,4,1,8,5,4002,6200,-2198
2,4,2,8,5,3995,6258,-2263
2,4,3,8,5,4075,7135,-3060
2,4,4,8,5,4219,7651,-3432
2,4,5,8,5,4102,6818,-2716
2,4,6,8,5,4058,6086,-2028
2,4,7,8,5,3969,5784,-1815
2,4,8,8,5,3894,5083,-1189
2,4,9,8,5,3841,4232,-391
2,4,10,8,5,3825,4220,-395
2,4,11,8,5,3846,4387,-541
2,4,12,8,5,3968,5363,-1395
2,4,13,8,5,4055,5936,-1881
2,4,14,8,5,4092,6399,-2307
2,4,15,8,5,4207,7079,-2872
2,4,16,8,5,4298,7391,-3093
2,4,17,8,5,4287,6999,-2712
2,4,18,8,5,4345,6644,-2299
2,4,19,8,5,4457,6520,-2063
2,5,0,8,5,4322,5562,-1240
2,5,1,8,5,4223,5899,-1676
2,5,2,8,5,4307,5888,-1581
2,5,3,8,5,4545,6756,-2211
2,5,4,8,5,4856,7180,-2324
2,5,5,8,5,4688,6508,-1820
2,5,6,8,5,4629,5973,-1344
2,5,7,8,5,4491,5816,-1325
2,5,8,8,5,4355,5181,-826
2,5,9,8,5,4190,4353,-163
2,5,10,8,5,4170,4301,-131
2,5,11,8,5,4236,4345,-109
2,5,12,8,5,4480,5203,-723
2,5,13,8,5,4643,5637,-994
2,5,14,8,5,4708,5913,-1205
2,5,15,8,5,4866,6467,-1601
2,5,16,8,5,4949,6808,-1859
2,5,17,8,5,4833,6377,-1544
2,5,18,8,5,4814,5996,-1182
2,5,19,8,5,4853,6104,-1251
2,6,0,8,5,4447,5498,-1051
2,6,1,8,5,4460,5557,-1097
2,6,2,8,5,4608,5521,-913
2,6,3,8,5,5050,6261,-1211
2,6,4,8,5,5537,6469,-932
2,6,5,8,5,5339,5863,-524
2,6,6,8,5,5175,5469,-294
2,6,7,8,5,4964,5375,-411
2,6,8,8,5,4679,4867,-188
2,6,9,8,5,4365,4083,282
2,6,10,8,5,4339,4023,316
2,6,11,8,5,4457,4045,412
2,6,12,8,5,4867,4746,121
2,6,13,8,5,5144,5055,89
2,6,14,8,5,5315,5228,87
2,6,15,8,5,5553,5720,-167
2,6,16,8,5,5606,6087,-481
2,6,17,8,5,5365,5763,-398
2,6,18,8,5,5266,5428,-162
2,6,19,8,5,5194,5738,-544
2,7,0,8,5,4652,5171,-519
2,7,1,8,5,4805,5068,-263
2,7,2,8,5,4984,5029,-45
2,7,3,8,5,5593,5672,-79
2,7,4,8,5,6214,5797,417
2,7,5,8,5,5958,5276,682
2,7,6,8,5,5680,5042,638
2,7,7,8,5,5417,5014,403
2,7,8,8,5,4999,4649,350
2,7,9,8,5,4561,3921,640
2,7,10,8,5,4540,3841,699
2,7,11,8,5,4687,3863,824
2,7,12,8,5,5237,4467,770
2,7,13,8,5,5588,4659,929
2,7,14,8,5,5875,4651,1224
2,7,15,8,5,6203,5059,1144
2,7,16,8,5,6225,5378,847
2,7,17,8,5,5908,5042,866
2,7,18,8,5,5780,4670,1110
2,7,19,8,5,5588,5092,496
2,8,0,8,5,4966,4795,171
2,8,1,8,5,5296,4542,754
2,8,2,8,5,5513,4487,1026
2,8,3,8,5,6237,5026,1211
2,8,4,8,5,6931,5089,1842
2,8,5,8,5,6495,4721,1774
2,8,6,8,5,6045,4609,1436
2,8,7,8,5,5695,4663,1032
2,8,8,8,5,5151,4482,669
2,8,9,8,5,4564,3864,700
2,8,10,8,5,4545,3775,770
2,8,11,8,5,4735,3794,941
2,8,12,8,5,5446,4284,1162
2,8,13,8,5,5878,4345,1533
2,8,14,8,5,6339,4134,2205
2,8,15,8,5,6824,4383,2441
2,8,16,8,5,6859,4673,2186
2,8,17,8,5,6500,4320,2180
2,8,18,8,5,6361,3940,2421
2,8,19,8,5,6017,4473,1544
2,0,0,9,5,4850,5671,-821
2,0,1,9,5,4716,6257,-1541
2,0,2,9,5,4508,6533,-2025
2,0,3,9,5,4374,7598,-3224
2,0,4,9,5,4321,8413,-4092
2,0,5,9,5,4245,7657,-3412
2,0,6,9,5,4133,6958,-2825
2,0,7,9,5,4050,6525,-2475
2,0,8,9,5,4001,5687,-1686
2,0,9,9,5,3989,4841,-852
2,0,10,9,5,3978,4800,-822
2,0,11,9,5,3992,5069,-1077
2,0,12,9,5,4046,6118,-2072
2,0,13,9,5,4081,6686,-2605
2,0,14,9,5,4186,7233,-3047
2,0,15,9,5,4312,7981,-3669
2,0,16,9,5,4414,8071,-3657
2,0,17,9,5,4546,7556,-3010
2,0,18,9,5,4739,7309,-2570
2,0,19,9,5,4843,6994,-2151
2,1,0,9,5,4656,6055,-1399
2,1,1,9,5,4470,6749,-2279
2,1,2,9,5,4240,7027,-2787
2,1,3,9,5,4094,8146,-4052
2,1,4,9,5,4056,8868,-4812
2,1,5,9,5,3988,7947,-3959
2,1,6,9,5,3859,7170,-3311
2,1,7,9,5,3770,6760,-2990
2,1,8,9,5,3697,5929,-2232
2,1,9,9,5,3650,5082,-1432
2,1,10,9,5,3624,5085,-1461
2,1,11,9,5,3659,5337,-1678
2,1,12,9,5,3740,6346,-2606
2,1,13,9,5,3802,6938,-3136
2,1,14,9,5,3930,7453,-3523
2,1,15,9,5,4072,8203,-4131
2,1,16,9,5,4179,8413,-4234
2,1,17,9,5,4307,7994,-3687
2,1,18,9,5,4503,7660,-3157
2,1,19,9,5,4660,7348,-2688
2,2,0,9,5,4546,6371,-1825
2,2,1,9,5,4372,6941,-2569
2,2,2,9,5,4230,7122,-2892
2,2,3,9,5,4181,8139,-3958
2,2,4,9,5,4207,8748,-4541
2,2,5,9,5,4125,7840,-3715
2,2,6,9,5,4014,7127,-3113
2,2,7,9,5,3920,6780,-2860
2,2,8,9,5,3819,6040,-2221
2,2,9,9,5,3766,5173,-1407
2,2,10,9,5,3737,5167,-1430
2,2,11,9,5,3766,5329,-1563
2,2,12,9,5,3861,6369,-2508
2,2,13,9,5,3943,6987,-3044
2,2,14,9,5,4051,7434,-3383
2,2,15,9,5,4192,8141,-3949
2,2,16,9,5,4291,8477,-4186
2,2,17,9,5,4360,8012,-3652
2,2,18,9,5,4499,7594,-3095
2,2,19,9,5,4652,7420,-2768
2,3,0,9,5,4701,6327,-1626
2,3,1,9,5,4561,6714,-2153
2,3,2,9,5,4549,6769,-2220
2,3,3,9,5,4634,7757,-3123
2,3,4,9,5,4745,8287,-3542
2,3,5,9,5,4585,7489,-2904
2,3,6,9,5,4492,6867,-2375
2,3,7,9,5,4354,6612,-2258
2,3,8,9,5,4226,5884,-1658
2,3,9,9,5,4164,4935,-771
2,3,10,9,5,4144,4875,-731
2,3,11,9,5,4166,4964,-798
2,3,12,9,5,4315,5958,-1643
2,3,13,9,5,4439,6499,-2060
2,3,14,9,5,4530,6864,-2334
2,3,15,9,5,4701,7537,-2836
2,3,16,9,5,4832,7937,-3105
2,3,17,9,5,4835,7452,-2617
2,3,18,9,5,4905,7032,-2127
2,3,19,9,5,5011,7071,-2060
2,4,0,9,5,4910,6223,-1313
2,4,1,9,5,4817,6389,-1572
2,4,2,9,5,4876,6364,-1488
2,4,3,9,5,5076,7227,-2151
2,4,4,9,5,5326,7561,-2235
2,4,5,9,5,5083,6868,-1785
2,4,6,9,5,4952,6327,-1375
2,4,7,9,5,4765,6156,-1391
2,4,8,9,5,4597,5525,-928
2,4,9,9,5,4423,4588,-165
2,4,10,9,5,4399,4519,-120
2,4,11,9,5,4465,4592,-127
2,4,12,9,5,4723,5449,-726
2,4,13,9,5,4917,5865,-948
2,4,14,9,5,5043,6160,-1117
2,4,15,9,5,5277,6774,-1497
2,4,16,9,5,5427,7161,-1734
2,4,17,9,5,5362,6776,-1414
2,4,18,9,5,5381,6421,-1040
2,4,19,9,5,5424,6647,-1223
2,5,0,9,5,5047,5905,-858
2,5,1,9,5,5055,5904,-849
2,5,2,9,5,5150,5839,-689
2,5,3,9,5,5511,6598,-1087
2,5,4,9,5,5948,6837,-889
2,5,5,9,5,5693,6240,-547
2,5,6,9,5,5487,5879,-392
2,5,7,9,5,5272,5801,-529
2,5,8,9,5,5013,5314,-301
2,5,9,9,5,4695,4462,233
2,5,10,9,5,4666,4386,280
2,5,11,9,5,4783,4436,347
2,5,12,9,5,5183,5188,-5
2,5,13,9,5,5453,5451,2
2,5,14,9,5,5640,5561,79
2,5,15,9,5,5920,6078,-158
2,5,16,9,5,6023,6395,-372
2,5,17,9,5,5846,6013,-167
2,5,18,9,5,5807,5662,145
2,5,19,9,5,5762,6008,-246
2,6,0,9,5,5181,5543,-362
2,6,1,9,5,5296,5394,-98
2,6,2,9,5,5418,5334,84
2,6,3,9,5,5976,6003,-27
2,6,4,9,5,6577,6185,392
2,6,5,9,5,6303,5693,610
2,6,6,9,5,6012,5449,563
2,6,7,9,5,5751,5433,318
2,6,8,9,5,5344,5120,224
2,6,9,9,5,4906,4356,550
2,6,10,9,5,4884,4270,614
2,6,11,9,5,5030,4331,699
2,6,12,9,5,5588,4982,606
2,6,13,9,5,5936,5109,827
2,6,14,9,5,6225,5053,1172
2,6,15,9,5,6572,5439,1133
2,6,16,9,5,6623,5718,905
2,6,17,9,5,6336,5308,1028
2,6,18,9,5,6258,4943,1315
2,6,19,9,5,6110,5370,740
2,0,0,10,5,5178,6803,-1625
2,0,1,10,5,4993,7387,-2394
2,0,2,10,5,4760,7647,-2887
2,0,3,10,5,4624,8761,-4137
2,0,4,10,5,4592,9436,-4844
2,0,5,10,5,4516,8508,-3992
2,0,6,10,5,4378,7809,-3431
2,0,7,10,5,4287,7458,-3171
2,0,8,10,5,4210,6686,-2476
2,0,9,10,5,4162,5809,-1647
2,0,10,10,5,4137,5799,-1662
2,0,11,10,5,4175,5958,-1783
2,0,12,10,5,4252,7024,-2772
2,0,13,10,5,4314,7666,-3352
2,0,14,10,5,4449,8093,-3644
2,0,15,10,5,4595,8796,-4201
2,0,16,10,5,4695,9118,-4423
2,0,17,10,5,4828,8590,-3762
2,0,18,10,5,5031,8122,-3091
2,0,19,10,5,5180,7942,-2762
2,1,0,10,5,5088,7032,-1944
2,1,1,10,5,4916,7455,-2539
2,1,2,10,5,4765,7633,-2868
2,1,3,10,5,4716,8761,-4045
2,1,4,10,5,4744,9384,-4640
2,1,5,10,5,4656,8511,-3855
2,1,6,10,5,4541,7908,-3367
2,1,7,10,5,4448,7608,-3160
2,1,8,10,5,4343,6841,-2498
2,1,9,10,5,4286,5876,-1590
2,1,10,10,5,4256,5822,-1566
2,1,11,10,5,4288,5906,-1618
2,1,12,10,5,4395,6964,-2569
2,1,13,10,5,4481,7550,-3069
2,1,14,10,5,4589,7899,-3310
2,1,15,10,5,4727,8599,-3872
2,1,16,10,5,4820,9023,-4203
2,1,17,10,5,4885,8465,-3580
2,1,18,10,5,5031,7982,-2951
2,1,19,10,5,5182,7971,-2789
2,2,0,10,5,5251,6988,-1737
2,2,1,10,5,5113,7204,-2091
2,2,2,10,5,5094,7245,-2151
2,2,3,10,5,5185,8228,-3043
2,2,4,10,5,5304,8668,-3364
2,2,5,10,5,5147,7849,-2702
2,2,6,10,5,5055,7221,-2166
2,2,7,10,5,4916,6952,-2036
2,2,8,10,5,4776,6228,-1452
2,2,9,10,5,4707,5170,-463
2,2,10,10,5,4684,5093,-409
2,2,11,10,5,4708,5211,-503
2,2,12,10,5,4867,6204,-1337
2,2,13,10,5,4994,6727,-1733
2,2,14,10,5,5086,7111,-2025
2,2,15,10,5,5254,7844,-2590
2,2,16,10,5,5377,8290,-2913
2,2,17,10,5,5373,7851,-2478
2,2,18,10,5,5449,7457,-2008
2,2,19,10,5,5552,7614,-2062
2,3,0,10,5,5466,6630,-1164
2,3,1,10,5,5376,6736,-1360
2,3,2,10,5,5430,6682,-1252
2,3,3,10,5,5635,7564,-1929
2,3,4,10,5,5852,7929,-2077
2,3,5,10,5,5566,7245,-1679
2,3,6,10,5,5386,6737,-1351
2,3,7,10,5,5150,6582,-1432
2,3,8,10,5,4929,5972,-1043
2,3,9,10,5,4746,4967,-221
2,3,10,10,5,4718,4882,-164
2,3,11,10,5,4785,4983,-198
2,3,12,10,5,5070,5891,-821
2,3,13,10,5,5301,6261,-960
2,3,14,10,5,5481,6493,-1012
2,3,15,10,5,5771,7132,-1361
2,3,16,10,5,5961,7469,-1508
2,3,17,10,5,5910,7026,-1116
2,3,18,10,5,5941,6655,-714
2,3,19,10,5,5978,6917,-939
2,4,0,10,5,5635,6277,-642
2,4,1,10,5,5649,6230,-581
2,4,2,10,5,5719,6144,-425
2,4,3,10,5,6042,6929,-887
2,4,4,10,5,6418,7225,-807
2,4,5,10,5,6088,6657,-569
2,4,6,10,5,5810,6286,-476
2,4,7,10,5,5546,6220,-674
2,4,8,10,5,5255,5785,-530
2,4,9,10,5,4928,4897,31
2,4,10,10,5,4895,4815,80
2,4,11,10,5,5012,4904,108
2,4,12,10,5,5426,5703,-277
2,4,13,10,5,5727,5901,-174
2,4,14,10,5,5975,5963,12
2,4,15,10,5,6331,6458,-127
2,4,16,10,5,6501,6735,-234
2,4,17,10,5,6375,6279,96
2,4,18,10,5,6374,5935,439
2,4,19,10,5,6333,6286,47
2,0,0,11,5,5610,7693,-2083
2,0,1,11,5,5439,7945,-2506
2,0,2,11,5,5285,8109,-2824
2,0,3,11,5,5246,9232,-3986
2,0,4,11,5,5280,9765,-4485
2,0,5,11,5,5184,8871,-3687
2,0,6,11,5,5060,8262,-3202
2,0,7,11,5,4965,7948,-2983
2,0,8,11,5,4856,7185,-2329
2,0,9,11,5,4798,6111,-1313
2,0,10,11,5,4769,6040,-1271
2,0,11,11,5,4804,6153,-1349
2,0,12,11,5,4907,7210,-2303
2,0,13,11,5,4993,7778,-2785
2,0,14,11,5,5108,8146,-3038
2,0,15,11,5,5250,8906,-3656
2,0,16,11,5,5336,9376,-4040
2,0,17,11,5,5406,8864,-3458
2,0,18,11,5,5559,8407,-2848
2,0,19,11,5,5702,8514,-2812
2,1,0,11,5,5793,7395,-1602
2,1,1,11,5,5657,7551,-1894
2,1,2,11,5,5629,7563,-1934
2,1,3,11,5,5720,8565,-2845
2,1,4,11,5,5841,9036,-3195
2,1,5,11,5,5678,8226,-2548
2,1,6,11,5,5582,7631,-2049
2,1,7,11,5,5444,7378,-1934
2,1,8,11,5,5300,6675,-1375
2,1,9,11,5,5227,5549,-322
2,1,10,11,5,5203,5456,-253
2,1,11,11,5,5230,5602,-372
2,1,12,11,5,5401,6646,-1245
2,1,13,11,5,5532,7123,-1591
2,1,14,11,5,5624,7444,-1820
2,1,15,11,5,5789,8202,-2413
2,1,16,11,5,5906,8598,-2692
2,1,17,11,5,5898,8101,-2203
2,1,18,11,5,5981,7691,-1710
2,1,19,11,5,6082,7884,-1802
2,2,0,11,5,6016,7002,-986
2,2,1,11,5,5928,7062,-1134
2,2,2,11,5,5975,6987,-1012
2,2,3,11,5,6186,7895,-1709
2,2,4,11,5,6411,8317,-1906
2,2,5,11,5,6128,7662,-1534
2,2,6,11,5,5949,7144,-1195
2,2,7,11,5,5712,7001,-1289
2,2,8,11,5,5479,6443,-964
2,2,9,11,5,5289,5402,-113
2,2,10,11,5,5258,5311,-53
2,2,11,11,5,5327,5451,-124
2,2,12,11,5,5622,6406,-784
2,2,13,11,5,5856,6711,-855
2,2,14,11,5,6037,6895,-858
2,2,15,11,5,6324,7512,-1188
2,2,16,11,5,6506,7809,-1303
2,2,17,11,5,6448,7292,-844
2,2,18,11,5,6485,6928,-443
2,2,19,11,5,6519,7195,-676
2,0,0,12,5,6315,7767,-1452
2,0,1,12,5,6180,7877,-1697
2,0,2,12,5,6149,7868,-1719
2,0,3,12,5,6250,8896,-2646
2,0,4,12,5,6377,9424,-3047
2,0,5,12,5,6206,8643,-2437
2,0,6,12,5,6101,8038,-1937
2,0,7,12,5,5961,7797,-1836
2,0,8,12,5,5813,7146,-1333
2,0,9,12,5,5739,5984,-245
2,0,10,12,5,5716,5885,-169
2,0,11,12,5,5746,6070,-324
2,0,12,12,5,5913,7161,-1248
2,0,13,12,5,6044,7573,-1529
2,0,14,12,5,6143,7846,-1703
2,0,15,12,5,6312,8582,-2270
2,0,16,12,5,6422,8938,-2516
2,0,17,12,5,6419,8367,-1948
2,0,18,12,5,6509,7964,-1455
2,0,19,12,5,6602,8162,-1560
2,0,0,1,6,633,650,-17
2,0,1,1,6,627,646,-19
2,0,2,1,6,626,642,-16
2,0,3,1,6,634,643,-9
2,0,4,1,6,639,643,-4
2,0,5,1,6,630,635,-5
2,0,6,1,6,621,630,-9
2,0,7,1,6,619,631,-12
2,0,8,1,6,616,628,-12
2,0,9,1,6,616,625,-9
2,0,10,1,6,618,626,-8
2,0,11,1,6,614,637,-23
2,0,12,1,6,614,641,-27
2,0,13,1,6,622,642,-20
2,0,14,1,6,627,640,-13
2,0,15,1,6,621,636,-15
2,0,16,1,6,619,640,-21
2,0,17,1,6,630,639,-9
2,0,18,1,6,630,634,-4
2,1,0,1,6,650,658,-8
2,1,1,1,6,646,660,-14
2,1,2,1,6,642,663,-21
2,1,3,1,6,643,666,-23
2,1,4,1,6,643,672,-29
2,1,5,1,6,635,671,-36
2,1,6,1,6,630,670,-40
2,1,7,1,6,631,668,-37
2,1,8,1,6,628,658,-30
2,1,9,1,6,625,653,-28
2,1,10,1,6,626,651,-25
2,1,11,1,6,637,659,-22
2,1,12,1,6,641,661,-20
2,1,13,1,6,642,664,-22
2,1,14,1,6,640,663,-23
2,1,15,1,6,636,656,-20
2,1,16,1,6,640,655,-15
2,1,17,1,6,639,653,-14
2,1,18,1,6,634,650,-16
2,2,0,1,6,658,671,-13
2,2,1,1,6,660,671,-11
2,2,2,1,6,663,669,-6
2,2,3,1,6,666,631,35
2,2,4,1,6,672,595,77
2,2,5,1,6,671,549,122
2,2,6,1,6,670,497,173
2,2,7,1,6,668,447,221
2,2,8,1,6,658,395,263
2,2,9,1,6,653,388,265
2,2,10,1,6,651,386,265
2,2,11,1,6,659,410,249
2,2,12,1,6,661,446,215
2,2,13,1,6,664,501,163
2,2,14,1,6,663,559,104
2,2,15,1,6,656,601,55
2,2,16,1,6,655,638,17
2,2,17,1,6,653,659,-6
2,2,18,1,6,650,671,-21
2,3,0,1,6,671,708,-37
2,3,1,1,6,671,688,-17
2,3,2,1,6,669,645,24
2,3,3,1,6,631,585,46
2,3,4,1,6,595,521,74
2,3,5,1,6,549,443,106
2,3,6,1,6,497,368,129
2,3,7,1,6,447,318,129
2,3,8,1,6,395,287,108
2,3,9,1,6,388,280,108
2,3,10,1,6,386,277,109
2,3,11,1,6,410,288,122
2,3,12,1,6,446,318,128
2,3,13,1,6,501,380,121
2,3,14,1,6,559,458,101
2,3,15,1,6,601,526,75
2,3,16,1,6,638,588,50
2,3,17,1,6,659,642,17
2,3,18,1,6,671,677,-6
2,4,0,1,6,708,709,-1
2,4,1,1,6,688,664,24
2,4,2,1,6,645,581,64
2,4,3,1,6,585,530,55
2,4,4,1,6,521,479,42
2,4,5,1,6,443,421,22
2,4,6,1,6,368,377,-9
2,4,7,1,6,318,373,-55
2,4,8,1,6,287,399,-112
2,4,9,1,6,280,395,-115
2,4,10,1,6,277,393,-116
2,4,11,1,6,288,381,-93
2,4,12,1,6,318,374,-56
2,4,13,1,6,380,390,-10
2,4,14,1,6,458,432,26
2,4,15,1,6,526,483,43
2,4,16,1,6,588,536,52
2,4,17,1,6,642,599,43
2,4,18,1,6,677,649,28
2,5,0,1,6,709,611,98
2,5,1,1,6,664,558,106
2,5,2,1,6,581,492,89
2,5,3,1,6,530,452,78
2,5,4,1,6,479,432,47
2,5,5,1,6,421,414,7
2,5,6,1,6,377,401,-24
2,5,7,1,6,373,403,-30
2,5,8,1,6,399,414,-15
2,5,9,1,6,395,413,-18
2,5,10,1,6,393,412,-19
2,5,11,1,6,381,420,-39
2,5,12,1,6,374,417,-43
2,5,13,1,6,390,419,-29
2,5,14,1,6,432,437,-5
2,5,15,1,6,483,466,17
2,5,16,1,6,536,505,31
2,5,17,1,6,599,544,55
2,5,18,1,6,649,593,56
2,6,0,1,6,611,491,120
2,6,1,1,6,558,443,115
2,6,2,1,6,492,423,69
2,6,3,1,6,452,428,24
2,6,4,1,6,432,475,-43
2,6,5,1,6,414,532,-118
2,6,6,1,6,401,574,-173
2,6,7,1,6,403,591,-188
2,6,8,1,6,414,584,-170
2,6,9,1,6,413,586,-173
2,6,10,1,6,412,586,-174
2,6,11,1,6,420,588,-168
2,6,12,1,6,417,573,-156
2,6,13,1,6,419,553,-134
2,6,14,1,6,437,532,-95
2,6,15,1,6,466,507,-41
2,6,16,1,6,505,495,10
2,6,17,1,6,544,506,38
2,6,18,1,6,593,547,46
2,7,0,1,6,491,623,-132
2,7,1,1,6,443,632,-189
2,7,2,1,6,423,612,-189
2,7,3,1,6,428,618,-190
2,7,4,1,6,475,675,-200
2,7,5,1,6,532,742,-210
2,7,6,1,6,574,785,-211
2,7,7,1,6,591,796,-205
2,7,8,1,6,584,821,-237
2,7,9,1,6,586,832,-246
2,7,10,1,6,586,835,-249
2,7,11,1,6,588,839,-251
2,7,12,1,6,573,833,-260
2,7,13,1,6,553,816,-263
2,7,14,1,6,532,763,-231
2,7,15,1,6,507,724,-217
2,7,16,1,6,495,714,-219
2,7,17,1,6,506,698,-192
2,7,18,1,6,547,698,-151
2,8,0,1,6,623,383,240
2,8,1,1,6,632,321,311
2,8,2,1,6,612,319,293
2,8,3,1,6,618,314,304
2,8,4,1,6,675,312,363
2,8,5,1,6,742,300,442
2,8,6,1,6,785,281,504
2,8,7,1,6,796,276,520
2,8,8,1,6,821,237,584
2,8,9,1,6,832,200,632
2,8,10,1,6,835,212,623
2,8,11,1,6,839,242,597
2,8,12,1,6,833,272,561
2,8,13,1,6,816,291,525
2,8,14,1,6,763,310,453
2,8,15,1,6,724,334,390
2,8,16,1,6,714,341,373
2,8,17,1,6,698,358,340
2,8,18,1,6,698,395,303
2,9,0,1,6,383,550,-167
2,9,1,1,6,321,569,-248
2,9,2,1,6,319,682,-363
2,9,3,1,6,314,764,-450
2,9,4,1,6,312,816,-504
2,9,5,1,6,300,800,-500
2,9,6,1,6,281,801,-520
2,9,7,1,6,276,803,-527
2,9,8,1,6,237,778,-541
2,9,9,1,6,200,760,-560
2,9,10,1,6,212,761,-549
2,9,11,1,6,242,774,-532
2,9,12,1,6,272,804,-532
2,9,13,1,6,291,791,-500
2,9,14,1,6,310,779,-469
2,9,15,1,6,334,770,-436
2,9,16,1,6,341,723,-382
2,9,17,1,6,358,677,-319
2,9,18,1,6,395,634,-239
2,10,0,1,6,550,880,-330
2,10,1,1,6,569,964,-395
2,10,2,1,6,682,1094,-412
2,10,3,1,6,764,1220,-456
2,10,4,1,6,816,1275,-459
2,10,5,1,6,800,1216,-416
2,10,6,1,6,801,1219,-418
2,10,7,1,6,803,1187,-384
2,10,8,1,6,778,1157,-379
2,10,9,1,6,760,1125,-365
2,10,10,1,6,761,1136,-375
2,10,11,1,6,774,1184,-410
2,10,12,1,6,804,1242,-438
2,10,13,1,6,791,1235,-444
2,10,14,1,6,779,1246,-467
2,10,15,1,6,770,1275,-505
2,10,16,1,6,723,1255,-532
2,10,17,1,6,677,1186,-509
2,10,18,1,6,634,1084,-450
2,11,0,1,6,880,966,-86
2,11,1,1,6,964,1028,-64
2,11,2,1,6,1094,1105,-11
2,11,3,1,6,1220,1233,-13
2,11,4,1,6,1275,1218,57
2,11,5,1,6,1216,1095,121
2,11,6,1,6,1219,1009,210
2,11,7,1,6,1187,927,260
2,11,8,1,6,1157,814,343
2,11,9,1,6,1125,685,440
2,11,10,1,6,1136,733,403
2,11,11,1,6,1184,870,314
2,11,12,1,6,1242,993,249
2,11,13,1,6,1235,1062,173
2,11,14,1,6,1246,1173,73
2,11,15,1,6,1275,1288,-13
2,11,16,1,6,1255,1326,-71
2,11,17,1,6,1186,1274,-88
2,11,18,1,6,1084,1167,-83
2,12,0,1,6,966,978,-12
2,12,1,1,6,1028,1002,26
2,12,2,1,6,1105,1076,29
2,12,3,1,6,1233,1215,18
2,12,4,1,6,1218,1192,26
2,12,5,1,6,1095,1111,-16
2,12,6,1,6,1009,951,58
2,12,7,1,6,927,891,36
2,12,8,1,6,814,754,60
2,12,9,1,6,685,596,89
2,12,10,1,6,733,653,80
2,12,11,1,6,870,796,74
2,12,12,1,6,993,920,73
2,12,13,1,6,1062,1028,34
2,12,14,1,6,1173,1145,28
2,12,15,1,6,1288,1231,57
2,12,16,1,6,1326,1262,64
2,12,17,1,6,1274,1210,64
2,12,18,1,6,1167,1127,40
2,13,0,1,6,978,988,-10
2,13,1,1,6,1002,979,23
2,13,2,1,6,1076,1041,35
2,13,3,1,6,1215,1162,53
2,13,4,1,6,1192,1140,52
2,13,5,1,6,1111,1091,20
2,13,6,1,6,951,930,21
2,13,7,1,6,891,896,-5
2,13,8,1,6,754,777,-23
2,13,9,1,6,596,645,-49
2,13,10,1,6,653,700,-47
2,13,11,1,6,796,814,-18
2,13,12,1,6,920,901,19
2,13,13,1,6,1028,1022,6
2,13,14,1,6,1145,1123,22
2,13,15,1,6,1231,1172,59
2,13,16,1,6,1262,1212,50
2,13,17,1,6,1210,1172,38
2,13,18,1,6,1127,1146,-19
2,14,0,1,6,988,998,-10
2,14,1,1,6,979,1016,-37
2,14,2,1,6,1041,1084,-43
2,14,3,1,6,1162,1215,-53
2,14,4,1,6,1140,1179,-39
2,14,5,1,6,1091,1090,1
2,14,6,1,6,930,934,-4
2,14,7,1,6,896,875,21
2,14,8,1,6,777,730,47
2,14,9,1,6,645,578,67
2,14,10,1,6,700,655,45
2,14,11,1,6,814,792,22
2,14,12,1,6,901,869,32
2,14,13,1,6,1022,1011,11
2,14,14,1,6,1123,1142,-19
2,14,15,1,6,1172,1205,-33
2,14,16,1,6,1212,1243,-31
2,14,17,1,6,1172,1174,-2
2,14,18,1,6,1146,1144,2
2,15,0,1,6,998,884,114
2,15,1,1,6,1016,906,110
2,15,2,1,6,1084,1040,44
2,15,3,1,6,1215,1204,11
2,15,4,1,6,1179,1192,-13
2,15,5,1,6,1090,1090,0
2,15,6,1,6,934,935,-1
2,15,7,1,6,875,932,-57
2,15,8,1,6,730,796,-66
2,15,9,1,6,578,655,-77
2,15,10,1,6,655,722,-67
2,15,11,1,6,792,859,-67
2,15,12,1,6,869,935,-66
2,15,13,1,6,1011,997,14
2,15,14,1,6,1142,1102,40
2,15,15,1,6,1205,1160,45
2,15,16,1,6,1243,1154,89
2,15,17,1,6,1174,1017,157
2,15,18,1,6,1144,987,157
2,16,0,1,6,884,790,94
2,16,1,1,6,906,794,112
2,16,2,1,6,1040,950,90
2,16,3,1,6,1204,1083,121
2,16,4,1,6,1192,1008,184
2,16,5,1,6,1090,911,179
2,16,6,1,6,935,787,148
2,16,7,1,6,932,758,174
2,16,8,1,6,796,610,186
2,16,9,1,6,655,475,180
2,16,10,1,6,722,544,178
2,16,11,1,6,859,676,183
2,16,12,1,6,935,770,165
2,16,13,1,6,997,762,235
2,16,14,1,6,1102,839,263
2,16,15,1,6,1160,952,208
2,16,16,1,6,1154,978,176
2,16,17,1,6,1017,829,188
2,16,18,1,6,987,823,164
2,17,0,1,6,790,891,-101
2,17,1,1,6,794,838,-44
2,17,2,1,6,950,874,76
2,17,3,1,6,1083,910,173
2,17,4,1,6,1008,799,209
2,17,5,1,6,911,636,275
2,17,6,1,6,787,541,246
2,17,7,1,6,758,579,179
2,17,8,1,6,610,526,84
2,17,9,1,6,475,517,-42
2,17,10,1,6,544,526,18
2,17,11,1,6,676,518,158
2,17,12,1,6,770,592,178
2,17,13,1,6,762,558,204
2,17,14,1,6,839,608,231
2,17,15,1,6,952,705,247
2,17,16,1,6,978,787,191
2,17,17,1,6,829,801,28
2,17,18,1,6,823,764,59
2,18,0,1,6,891,828,63
2,18,1,1,6,838,710,128
2,18,2,1,6,874,719,155
2,18,3,1,6,910,802,108
2,18,4,1,6,799,691,108
2,18,5,1,6,636,719,-83
2,18,6,1,6,541,770,-229
2,18,7,1,6,579,856,-277
2,18,8,1,6,526,914,-388
2,18,9,1,6,517,837,-320
2,18,10,1,6,526,779,-253
2,18,11,1,6,518,809,-291
2,18,12,1,6,592,886,-294
2,18,13,1,6,558,797,-239
2,18,14,1,6,608,703,-95
2,18,15,1,6,705,770,-65
2,18,16,1,6,787,784,3
2,18,17,1,6,801,670,131
2,18,18,1,6,764,663,101
2,19,0,1,6,828,704,124
2,19,1,1,6,710,587,123
2,19,2,1,6,719,690,29
2,19,3,1,6,802,866,-64
2,19,4,1,6,691,768,-77
2,19,5,1,6,719,824,-105
2,19,6,1,6,770,901,-131
2,19,7,1,6,856,980,-124
2,19,8,1,6,914,947,-33
2,19,9,1,6,837,787,50
2,19,10,1,6,779,730,49
2,19,11,1,6,809,715,94
2,19,12,1,6,886,715,171
2,19,13,1,6,797,611,186
2,19,14,1,6,703,542,161
2,19,15,1,6,770,621,149
2,19,16,1,6,784,591,193
2,19,17,1,6,670,508,162
2,19,18,1,6,663,599,64
2,20,0,1,6,704,693,11
2,20,1,1,6,587,548,39
2,20,2,1,6,690,560,130
2,20,3,1,6,866,616,250
2,20,4,1,6,768,422,346
2,20,5,1,6,824,386,438
2,20,6,1,6,901,398,503
2,20,7,1,6,980,428,552
2,20,8,1,6,947,380,567
2,20,9,1,6,787,259,528
2,20,10,1,6,730,273,457
2,20,11,1,6,715,290,425
2,20,12,1,6,715,316,399
2,20,13,1,6,611,283,328
2,20,14,1,6,542,331,211
2,20,15,1,6,621,408,213
2,20,16,1,6,591,442,149
2,20,17,1,6,508,495,13
2,20,18,1,6,599,598,1
2,21,0,1,6,693,444,249
2,21,1,1,6,548,392,156
2,21,2,1,6,560,413,147
2,21,3,1,6,616,488,128
2,21,4,1,6,422,417,5
2,21,5,1,6,386,447,-61
2,21,6,1,6,398,471,-73
2,21,7,1,6,428,542,-114
2,21,8,1,6,380,530,-150
2,21,9,1,6,259,412,-153
2,21,10,1,6,273,461,-188
2,21,11,1,6,290,503,-213
2,21,12,1,6,316,512,-196
2,21,13,1,6,283,416,-133
2,21,14,1,6,331,391,-60
2,21,15,1,6,408,406,2
2,21,16,1,6,442,362,80
2,21,17,1,6,495,304,191
2,21,18,1,6,598,290,308
2,22,0,1,6,444,437,7
2,22,1,1,6,392,374,18
2,22,2,1,6,413,385,28
2,22,3,1,6,488,457,31
2,22,4,1,6,417,486,-69
2,22,5,1,6,447,472,-25
2,22,6,1,6,471,467,4
2,22,7,1,6,542,551,-9
2,22,8,1,6,530,561,-31
2,22,9,1,6,412,527,-115
2,22,10,1,6,461,523,-62
2,22,11,1,6,503,575,-72
2,22,12,1,6,512,582,-70
2,22,13,1,6,416,492,-76
2,22,14,1,6,391,472,-81
2,22,15,1,6,406,434,-28
2,22,16,1,6,362,373,-11
2,22,17,1,6,304,340,-36
2,22,18,1,6,290,320,-30
2,0,0,2,6,1283,1329,-46
2,0,1,2,6,1273,1331,-58
2,0,2,2,6,1268,1332,-64
2,0,3,2,6,1277,1297,-20
2,0,4,2,6,1282,1267,15
2,0,5,2,6,1265,1220,45
2,0,6,2,6,1251,1167,84
2,0,7,2,6,1250,1115,135
2,0,8,2,6,1244,1053,191
2,0,9,2,6,1241,1041,200
2,0,10,2,6,1244,1037,207
2,0,11,2,6,1251,1069,182
2,0,12,2,6,1255,1107,148
2,0,13,2,6,1264,1165,99
2,0,14,2,6,1267,1222,45
2,0,15,2,6,1257,1257,0
2,0,16,2,6,1259,1293,-34
2,0,17,2,6,1269,1312,-43
2,0,18,2,6,1264,1321,-57
2,1,0,2,6,1308,1379,-71
2,1,1,2,6,1306,1359,-53
2,1,2,2,6,1305,1314,-9
2,1,3,2,6,1309,1216,93
2,1,4,2,6,1315,1116,199
2,1,5,2,6,1306,992,314
2,1,6,2,6,1300,865,435
2,1,7,2,6,1299,765,534
2,1,8,2,6,1286,682,604
2,1,9,2,6,1278,668,610
2,1,10,2,6,1277,663,614
2,1,11,2,6,1296,698,598
2,1,12,2,6,1302,764,538
2,1,13,2,6,1306,881,425
2,1,14,2,6,1303,1017,286
2,1,15,2,6,1292,1127,165
2,1,16,2,6,1295,1226,69
2,1,17,2,6,1292,1301,-9
2,1,18,2,6,1284,1348,-64
2,2,0,2,6,1329,1417,-88
2,2,1,2,6,1331,1352,-21
2,2,2,2,6,1332,1226,106
2,2,3,2,6,1297,1115,182
2,2,4,2,6,1267,1000,267
2,2,5,2,6,1220,864,356
2,2,6,2,6,1167,745,422
2,2,7,2,6,1115,691,424
2,2,8,2,6,1053,686,367
2,2,9,2,6,1041,675,366
2,2,10,2,6,1037,670,367
2,2,11,2,6,1069,669,400
2,2,12,2,6,1107,692,415
2,2,13,2,6,1165,770,395
2,2,14,2,6,1222,890,332
2,2,15,2,6,1257,1009,248
2,2,16,2,6,1293,1124,169
2,2,17,2,6,1312,1241,71
2,2,18,2,6,1321,1326,-5
2,3,0,2,6,1379,1320,59
2,3,1,2,6,1359,1222,137
2,3,2,2,6,1314,1073,241
2,3,3,2,6,1216,982,234
2,3,4,2,6,1116,911,205
2,3,5,2,6,992,835,157
2,3,6,2,6,865,778,87
2,3,7,2,6,765,776,-11
2,3,8,2,6,682,813,-131
2,3,9,2,6,668,808,-140
2,3,10,2,6,663,805,-142
2,3,11,2,6,698,801,-103
2,3,12,2,6,764,791,-27
2,3,13,2,6,881,809,72
2,3,14,2,6,1017,869,148
2,3,15,2,6,1127,949,178
2,3,16,2,6,1226,1041,185
2,3,17,2,6,1301,1143,158
2,3,18,2,6,1348,1242,106
2,4,0,2,6,1417,1102,315
2,4,1,2,6,1352,1001,351
2,4,2,2,6,1226,915,311
2,4,3,2,6,1115,880,235
2,4,4,2,6,1000,907,93
2,4,5,2,6,864,946,-82
2,4,6,2,6,745,975,-230
2,4,7,2,6,691,994,-303
2,4,8,2,6,686,998,-312
2,4,9,2,6,675,999,-324
2,4,10,2,6,670,998,-328
2,4,11,2,6,669,1008,-339
2,4,12,2,6,692,990,-298
2,4,13,2,6,770,972,-202
2,4,14,2,6,890,969,-79
2,4,15,2,6,1009,973,36
2,4,16,2,6,1124,1000,124
2,4,17,2,6,1241,1050,191
2,4,18,2,6,1326,1140,186
2,5,0,2,6,1320,1114,206
2,5,1,2,6,1222,1075,147
2,5,2,2,6,1073,1035,38
2,5,3,2,6,982,1046,-64
2,5,4,2,6,911,1150,-239
2,5,5,2,6,835,1274,-439
2,5,6,2,6,778,1359,-581
2,5,7,2,6,776,1387,-611
2,5,8,2,6,813,1405,-592
2,5,9,2,6,808,1418,-610
2,5,10,2,6,805,1421,-616
2,5,11,2,6,801,1427,-626
2,5,12,2,6,791,1406,-615
2,5,13,2,6,809,1369,-560
2,5,14,2,6,869,1295,-426
2,5,15,2,6,949,1231,-282
2,5,16,2,6,1041,1209,-168
2,5,17,2,6,1143,1204,-61
2,5,18,2,6,1242,1245,-3
2,6,0,2,6,1102,1006,96
2,6,1,2,6,1001,953,48
2,6,2,2,6,915,931,-16
2,6,3,2,6,880,932,-52
2,6,4,2,6,907,987,-80
2,6,5,2,6,946,1042,-96
2,6,6,2,6,975,1066,-91
2,6,7,2,6,994,1072,-78
2,6,8,2,6,998,1058,-60
2,6,9,2,6,999,1032,-33
2,6,10,2,6,998,1047,-49
2,6,11,2,6,1008,1081,-73
2,6,12,2,6,990,1105,-115
2,6,13,2,6,972,1107,-135
2,6,14,2,6,969,1073,-104
2,6,15,2,6,973,1058,-85
2,6,16,2,6,1000,1055,-55
2,6,17,2,6,1050,1056,-6
2,6,18,2,6,1140,1093,47
2,7,0,2,6,1114,933,181
2,7,1,2,6,1075,890,185
2,7,2,2,6,1035,1001,34
2,7,3,2,6,1046,1078,-32
2,7,4,2,6,1150,1128,22
2,7,5,2,6,1274,1100,174
2,7,6,2,6,1359,1082,277
2,7,7,2,6,1387,1079,308
2,7,8,2,6,1405,1015,390
2,7,9,2,6,1418,960,458
2,7,10,2,6,1421,973,448
2,7,11,2,6,1427,1016,411
2,7,12,2,6,1406,1076,330
2,7,13,2,6,1369,1082,287
2,7,14,2,6,1295,1089,206
2,7,15,2,6,1231,1104,127
2,7,16,2,6,1209,1064,145
2,7,17,2,6,1204,1035,169
2,7,18,2,6,1245,1029,216
2,8,0,2,6,1006,1430,-424
2,8,1,2,6,953,1533,-580
2,8,2,2,6,931,1776,-845
2,8,3,2,6,932,1984,-1052
2,8,4,2,6,987,2091,-1104
2,8,5,2,6,1042,2016,-974
2,8,6,2,6,1066,2020,-954
2,8,7,2,6,1072,1990,-918
2,8,8,2,6,1058,1935,-877
2,8,9,2,6,1032,1885,-853
2,8,10,2,6,1047,1897,-850
2,8,11,2,6,1081,1958,-877
2,8,12,2,6,1105,2046,-941
2,8,13,2,6,1107,2026,-919
2,8,14,2,6,1073,2025,-952
2,8,15,2,6,1058,2045,-987
2,8,16,2,6,1055,1978,-923
2,8,17,2,6,1056,1863,-807
2,8,18,2,6,1093,1718,-625
2,9,0,2,6,933,1846,-913
2,9,1,2,6,890,1992,-1102
2,9,2,2,6,1001,2199,-1198
2,9,3,2,6,1078,2453,-1375
2,9,4,2,6,1128,2493,-1365
2,9,5,2,6,1100,2311,-1211
2,9,6,2,6,1082,2228,-1146
2,9,7,2,6,1079,2114,-1035
2,9,8,2,6,1015,1971,-956
2,9,9,2,6,960,1810,-850
2,9,10,2,6,973,1869,-896
2,9,11,2,6,1016,2054,-1038
2,9,12,2,6,1076,2235,-1159
2,9,13,2,6,1082,2297,-1215
2,9,14,2,6,1089,2419,-1330
2,9,15,2,6,1104,2563,-1459
2,9,16,2,6,1064,2581,-1517
2,9,17,2,6,1035,2460,-1425
2,9,18,2,6,1029,2251,-1222
2,10,0,2,6,1430,1944,-514
2,10,1,2,6,1533,2030,-497
2,10,2,2,6,1776,2181,-405
2,10,3,2,6,1984,2448,-464
2,10,4,2,6,2091,2410,-319
2,10,5,2,6,2016,2206,-190
2,10,6,2,6,2020,1960,60
2,10,7,2,6,1990,1818,172
2,10,8,2,6,1935,1568,367
2,10,9,2,6,1885,1281,604
2,10,10,2,6,1897,1386,511
2,10,11,2,6,1958,1666,292
2,10,12,2,6,2046,1913,133
2,10,13,2,6,2026,2090,-64
2,10,14,2,6,2025,2318,-293
2,10,15,2,6,2045,2519,-474
2,10,16,2,6,1978,2588,-610
2,10,17,2,6,1863,2484,-621
2,10,18,2,6,1718,2294,-576
2,11,0,2,6,1846,1966,-120
2,11,1,2,6,1992,1981,11
2,11,2,2,6,2199,2117,82
2,11,3,2,6,2453,2377,76
2,11,4,2,6,2493,2332,161
2,11,5,2,6,2311,2202,109
2,11,6,2,6,2228,1881,347
2,11,7,2,6,2114,1787,327
2,11,8,2,6,1971,1531,440
2,11,9,2,6,1810,1241,569
2,11,10,2,6,1869,1353,516
2,11,11,2,6,2054,1610,444
2,11,12,2,6,2235,1821,414
2,11,13,2,6,2297,2050,247
2,11,14,2,6,2419,2268,151
2,11,15,2,6,2563,2403,160
2,11,16,2,6,2581,2474,107
2,11,17,2,6,2460,2382,78
2,11,18,2,6,2251,2273,-22
2,12,0,2,6,1944,1986,-42
2,12,1,2,6,2030,1995,35
2,12,2,2,6,2181,2125,56
2,12,3,2,6,2448,2377,71
2,12,4,2,6,2410,2319,91
2,12,5,2,6,2206,2181,25
2,12,6,2,6,1960,1864,96
2,12,7,2,6,1818,1771,47
2,12,8,2,6,1568,1507,61
2,12,9,2,6,1281,1223,58
2,12,10,2,6,1386,1355,31
2,12,11,2,6,1666,1606,60
2,12,12,2,6,1913,1770,143
2,12,13,2,6,2090,2033,57
2,12,14,2,6,2318,2265,53
2,12,15,2,6,2519,2377,142
2,12,16,2,6,2588,2455,133
2,12,17,2,6,2484,2346,138
2,12,18,2,6,2294,2290,4
2,13,0,2,6,1966,1882,84
2,13,1,2,6,1981,1922,59
2,13,2,2,6,2117,2124,-7
2,13,3,2,6,2377,2419,-42
2,13,4,2,6,2332,2371,-39
2,13,5,2,6,2202,2180,22
2,13,6,2,6,1881,1869,12
2,13,7,2,6,1787,1807,-20
2,13,8,2,6,1531,1526,5
2,13,9,2,6,1241,1233,8
2,13,10,2,6,1353,1377,-24
2,13,11,2,6,1610,1651,-41
2,13,12,2,6,1821,1804,17
2,13,13,2,6,2050,2008,42
2,13,14,2,6,2268,2244,24
2,13,15,2,6,2403,2365,38
2,13,16,2,6,2474,2397,77
2,13,17,2,6,2382,2191,191
2,13,18,2,6,2273,2131,142
2,14,0,2,6,1986,1674,312
2,14,1,2,6,1995,1700,295
2,14,2,2,6,2125,1990,135
2,14,3,2,6,2377,2287,90
2,14,4,2,6,2319,2200,119
2,14,5,2,6,2181,2001,180
2,14,6,2,6,1864,1722,142
2,14,7,2,6,1771,1690,81
2,14,8,2,6,1507,1406,101
2,14,9,2,6,1223,1130,93
2,14,10,2,6,1355,1266,89
2,14,11,2,6,1606,1535,71
2,14,12,2,6,1770,1705,65
2,14,13,2,6,2033,1759,274
2,14,14,2,6,2265,1941,324
2,14,15,2,6,2377,2112,265
2,14,16,2,6,2455,2132,323
2,14,17,2,6,2346,1846,500
2,14,18,2,6,2290,1810,480
2,15,0,2,6,1882,1681,201
2,15,1,2,6,1922,1632,290
2,15,2,2,6,2124,1824,300
2,15,3,2,6,2419,1993,426
2,15,4,2,6,2371,1807,564
2,15,5,2,6,2180,1547,633
2,15,6,2,6,1869,1328,541
2,15,7,2,6,1807,1337,470
2,15,8,2,6,1526,1136,390
2,15,9,2,6,1233,992,241
2,15,10,2,6,1377,1070,307
2,15,11,2,6,1651,1194,457
2,15,12,2,6,1804,1362,442
2,15,13,2,6,2008,1320,688
2,15,14,2,6,2244,1447,797
2,15,15,2,6,2365,1657,708
2,15,16,2,6,2397,1765,632
2,15,17,2,6,2191,1630,561
2,15,18,2,6,2131,1587,544
2,16,0,2,6,1674,1719,-45
2,16,1,2,6,1700,1548,152
2,16,2,2,6,1990,1593,397
2,16,3,2,6,2287,1712,575
2,16,4,2,6,2200,1490,710
2,16,5,2,6,2001,1355,646
2,16,6,2,6,1722,1311,411
2,16,7,2,6,1690,1435,255
2,16,8,2,6,1406,1440,-34
2,16,9,2,6,1130,1354,-224
2,16,10,2,6,1266,1305,-39
2,16,11,2,6,1535,1327,208
2,16,12,2,6,1705,1478,227
2,16,13,2,6,1759,1355,404
2,16,14,2,6,1941,1311,630
2,16,15,2,6,2112,1475,637
2,16,16,2,6,2132,1571,561
2,16,17,2,6,1846,1471,375
2,16,18,2,6,1810,1427,383
2,17,0,2,6,1681,1532,149
2,17,1,2,6,1632,1297,335
2,17,2,2,6,1824,1409,415
2,17,3,2,6,1993,1668,325
2,17,4,2,6,1807,1459,348
2,17,5,2,6,1547,1543,4
2,17,6,2,6,1328,1671,-343
2,17,7,2,6,1337,1836,-499
2,17,8,2,6,1136,1861,-725
2,17,9,2,6,992,1624,-632
2,17,10,2,6,1070,1509,-439
2,17,11,2,6,1194,1524,-330
2,17,12,2,6,1362,1601,-239
2,17,13,2,6,1320,1408,-88
2,17,14,2,6,1447,1245,202
2,17,15,2,6,1657,1391,266
2,17,16,2,6,1765,1375,390
2,17,17,2,6,1630,1178,452
2,17,18,2,6,1587,1262,325
2,18,0,2,6,1719,1397,322
2,18,1,2,6,1548,1135,413
2,18,2,2,6,1593,1250,343
2,18,3,2,6,1712,1482,230
2,18,4,2,6,1490,1190,300
2,18,5,2,6,1355,1210,145
2,18,6,2,6,1311,1299,12
2,18,7,2,6,1435,1408,27
2,18,8,2,6,1440,1327,113
2,18,9,2,6,1354,1046,308
2,18,10,2,6,1305,1003,302
2,18,11,2,6,1327,1005,322
2,18,12,2,6,1478,1031,447
2,18,13,2,6,1355,894,461
2,18,14,2,6,1311,873,438
2,18,15,2,6,1475,1029,446
2,18,16,2,6,1571,1033,538
2,18,17,2,6,1471,1003,468
2,18,18,2,6,1427,1197,230
2,19,0,2,6,1532,1137,395
2,19,1,2,6,1297,940,357
2,19,2,2,6,1409,973,436
2,19,3,2,6,1668,1104,564
2,19,4,2,6,1459,839,620
2,19,5,2,6,1543,833,710
2,19,6,2,6,1671,869,802
2,19,7,2,6,1836,970,866
2,19,8,2,6,1861,910,951
2,19,9,2,6,1624,671,953
2,19,10,2,6,1509,734,775
2,19,11,2,6,1524,793,731
2,19,12,2,6,1601,828,773
2,19,13,2,6,1408,699,709
2,19,14,2,6,1245,722,523
2,19,15,2,6,1391,814,577
2,19,16,2,6,1375,804,571
2,19,17,2,6,1178,799,379
2,19,18,2,6,1262,888,374
2,20,0,2,6,1397,881,516
2,20,1,2,6,1135,766,369
2,20,2,2,6,1250,798,452
2,20,3,2,6,1482,945,537
2,20,4,2,6,1190,903,287
2,20,5,2,6,1210,919,291
2,20,6,2,6,1299,938,361
2,20,7,2,6,1408,1093,315
2,20,8,2,6,1327,1091,236
2,20,9,2,6,1046,939,107
2,20,10,2,6,1003,984,19
2,20,11,2,6,1005,1078,-73
2,20,12,2,6,1031,1094,-63
2,20,13,2,6,894,908,-14
2,20,14,2,6,873,863,10
2,20,15,2,6,1029,840,189
2,20,16,2,6,1033,735,298
2,20,17,2,6,1003,644,359
2,20,18,2,6,1197,610,587
2,0,0,3,6,1941,2088,-147
2,0,1,3,6,1933,2023,-90
2,0,2,3,6,1931,1895,36
2,0,3,3,6,1943,1746,197
2,0,4,3,6,1954,1595,359
2,0,5,3,6,1936,1413,523
2,0,6,3,6,1921,1242,679
2,0,7,3,6,1918,1138,780
2,0,8,3,6,1902,1081,821
2,0,9,3,6,1894,1063,831
2,0,10,3,6,1895,1056,839
2,0,11,3,6,1910,1079,831
2,0,12,3,6,1916,1138,778
2,0,13,3,6,1928,1271,657
2,0,14,3,6,1930,1449,481
2,0,15,3,6,1913,1610,303
2,0,16,3,6,1914,1762,152
2,0,17,3,6,1922,1900,22
2,0,18,3,6,1914,1997,-83
2,1,0,3,6,1979,2028,-49
2,1,1,3,6,1977,1910,67
2,1,2,3,6,1974,1718,256
2,1,3,3,6,1940,1567,373
2,1,4,3,6,1910,1432,478
2,1,5,3,6,1855,1278,577
2,1,6,3,6,1797,1146,651
2,1,7,3,6,1746,1094,652
2,1,8,3,6,1681,1100,581
2,1,9,3,6,1666,1088,578
2,1,10,3,6,1663,1082,581
2,1,11,3,6,1706,1089,617
2,1,12,3,6,1748,1109,639
2,1,13,3,6,1807,1189,618
2,1,14,3,6,1862,1327,535
2,1,15,3,6,1893,1475,418
2,1,16,3,6,1933,1629,304
2,1,17,3,6,1951,1785,166
2,1,18,3,6,1955,1919,36
2,2,0,3,6,2037,1811,226
2,2,1,3,6,2019,1665,354
2,2,2,3,6,1977,1496,481
2,2,3,3,6,1882,1410,472
2,2,4,3,6,1788,1386,402
2,2,5,3,6,1663,1367,296
2,2,6,3,6,1535,1352,183
2,2,7,3,6,1433,1367,66
2,2,8,3,6,1340,1397,-57
2,2,9,3,6,1321,1394,-73
2,2,10,3,6,1314,1391,-77
2,2,11,3,6,1357,1389,-32
2,2,12,3,6,1425,1364,61
2,2,13,3,6,1545,1362,183
2,2,14,3,6,1680,1401,279
2,2,15,3,6,1783,1456,327
2,2,16,3,6,1881,1536,345
2,2,17,3,6,1954,1649,305
2,2,18,3,6,1998,1789,209
2,3,0,3,6,2088,1725,363
2,3,1,3,6,2023,1633,390
2,3,2,3,6,1895,1527,368
2,3,3,3,6,1746,1498,248
2,3,4,3,6,1595,1582,13
2,3,5,3,6,1413,1688,-275
2,3,6,3,6,1242,1760,-518
2,3,7,3,6,1138,1790,-652
2,3,8,3,6,1081,1819,-738
2,3,9,3,6,1063,1831,-768
2,3,10,3,6,1056,1833,-777
2,3,11,3,6,1079,1847,-768
2,3,12,3,6,1138,1823,-685
2,3,13,3,6,1271,1788,-517
2,3,14,3,6,1449,1732,-283
2,3,15,3,6,1610,1697,-87
2,3,16,3,6,1762,1714,48
2,3,17,3,6,1900,1748,152
2,3,18,3,6,1997,1838,159
2,4,0,3,6,2028,1497,531
2,4,1,3,6,1910,1396,514
2,4,2,3,6,1718,1354,364
2,4,3,3,6,1567,1360,207
2,4,4,3,6,1432,1462,-30
2,4,5,3,6,1278,1574,-296
2,4,6,3,6,1146,1640,-494
2,4,7,3,6,1094,1663,-569
2,4,8,3,6,1100,1642,-542
2,4,9,3,6,1088,1618,-530
2,4,10,3,6,1082,1633,-551
2,4,11,3,6,1089,1669,-580
2,4,12,3,6,1109,1678,-569
2,4,13,3,6,1189,1660,-471
2,4,14,3,6,1327,1605,-278
2,4,15,3,6,1475,1565,-90
2,4,16,3,6,1629,1550,79
2,4,17,3,6,1785,1562,223
2,4,18,3,6,1919,1640,279
2,5,0,3,6,1811,1556,255
2,5,1,3,6,1665,1522,143
2,5,2,3,6,1496,1613,-117
2,5,3,3,6,1410,1696,-286
2,5,4,3,6,1386,1803,-417
2,5,5,3,6,1367,1842,-475
2,5,6,3,6,1352,1867,-515
2,5,7,3,6,1367,1875,-508
2,5,8,3,6,1397,1836,-439
2,5,9,3,6,1394,1792,-398
2,5,10,3,6,1391,1808,-417
2,5,11,3,6,1389,1855,-466
2,5,12,3,6,1364,1909,-545
2,5,13,3,6,1362,1898,-536
2,5,14,3,6,1401,1852,-451
2,5,15,3,6,1456,1828,-372
2,5,16,3,6,1536,1778,-242
2,5,17,3,6,1649,1733,-84
2,5,18,3,6,1789,1727,62
2,6,0,3,6,1725,1813,-88
2,6,1,3,6,1633,1854,-221
2,6,2,3,6,1527,2095,-568
2,6,3,3,6,1498,2298,-800
2,6,4,3,6,1582,2403,-821
2,6,5,3,6,1688,2316,-628
2,6,6,3,6,1760,2301,-541
2,6,7,3,6,1790,2266,-476
2,6,8,3,6,1819,2172,-353
2,6,9,3,6,1831,2085,-254
2,6,10,3,6,1833,2109,-276
2,6,11,3,6,1847,2200,-353
2,6,12,3,6,1823,2318,-495
2,6,13,3,6,1788,2317,-529
2,6,14,3,6,1732,2335,-603
2,6,15,3,6,1697,2379,-682
2,6,16,3,6,1714,2319,-605
2,6,17,3,6,1748,2221,-473
2,6,18,3,6,1838,2113,-275
2,7,0,3,6,1497,2396,-899
2,7,1,3,6,1396,2561,-1165
2,7,2,3,6,1354,2881,-1527
2,7,3,3,6,1360,3217,-1857
2,7,4,3,6,1462,3309,-1847
2,7,5,3,6,1574,3111,-1537
2,7,6,3,6,1640,3029,-1389
2,7,7,3,6,1663,2917,-1254
2,7,8,3,6,1642,2749,-1107
2,7,9,3,6,1618,2570,-952
2,7,10,3,6,1633,2630,-997
2,7,11,3,6,1669,2828,-1159
2,7,12,3,6,1678,3039,-1361
2,7,13,3,6,1660,3088,-1428
2,7,14,3,6,1605,3198,-1593
2,7,15,3,6,1565,3333,-1768
2,7,16,3,6,1550,3304,-1754
2,7,17,3,6,1562,3137,-1575
2,7,18,3,6,1640,2885,-1245
2,8,0,3,6,1556,2824,-1268
2,8,1,3,6,1522,2994,-1472
2,8,2,3,6,1613,3275,-1662
2,8,3,3,6,1696,3668,-1972
2,8,4,3,6,1803,3685,-1882
2,8,5,3,6,1842,3422,-1580
2,8,6,3,6,1867,3179,-1312
2,8,7,3,6,1875,3005,-1130
2,8,8,3,6,1836,2725,-889
2,8,9,3,6,1792,2406,-614
2,8,10,3,6,1808,2522,-714
2,8,11,3,6,1855,2850,-995
2,8,12,3,6,1909,3155,-1246
2,8,13,3,6,1898,3325,-1427
2,8,14,3,6,1852,3564,-1712
2,8,15,3,6,1828,3794,-1966
2,8,16,3,6,1778,3843,-2065
2,8,17,3,6,1733,3670,-1937
2,8,18,3,6,1727,3378,-1651
2,9,0,3,6,1813,2932,-1119
2,9,1,3,6,1854,3009,-1155
2,9,2,3,6,2095,3222,-1127
2,9,3,3,6,2298,3610,-1312
2,9,4,3,6,2403,3550,-1147
2,9,5,3,6,2316,3297,-981
2,9,6,3,6,2301,2890,-589
2,9,7,3,6,2266,2714,-448
2,9,8,3,6,2172,2345,-173
2,9,9,3,6,2085,1926,159
2,9,10,3,6,2109,2086,23
2,9,11,3,6,2200,2480,-280
2,9,12,3,6,2318,2814,-496
2,9,13,3,6,2317,3112,-795
2,9,14,3,6,2335,3441,-1106
2,9,15,3,6,2379,3691,-1312
2,9,16,3,6,2319,3800,-1481
2,9,17,3,6,2221,3656,-1435
2,9,18,3,6,2113,3440,-1327
2,10,0,3,6,2396,2964,-568
2,10,1,3,6,2561,2997,-436
2,10,2,3,6,2881,3201,-320
2,10,3,3,6,3217,3592,-375
2,10,4,3,6,3309,3511,-202
2,10,5,3,6,3111,3292,-181
2,10,6,3,6,3029,2815,214
2,10,7,3,6,2917,2662,255
2,10,8,3,6,2749,2261,488
2,10,9,3,6,2570,1819,751
2,10,10,3,6,2630,2008,622
2,10,11,3,6,2828,2402,426
2,10,12,3,6,3039,2690,349
2,10,13,3,6,3088,3061,27
2,10,14,3,6,3198,3410,-212
2,10,15,3,6,3333,3608,-275
2,10,16,3,6,3304,3717,-413
2,10,17,3,6,3137,3556,-419
2,10,18,3,6,2885,3417,-532
2,11,0,3,6,2824,2870,-46
2,11,1,3,6,2994,2901,93
2,11,2,3,6,3275,3165,110
2,11,3,3,6,3668,3581,87
2,11,4,3,6,3685,3511,174
2,11,5,3,6,3422,3271,151
2,11,6,3,6,3179,2799,380
2,11,7,3,6,3005,2703,302
2,11,8,3,6,2725,2303,422
2,11,9,3,6,2406,1878,528
2,11,10,3,6,2522,2077,445
2,11,11,3,6,2850,2465,385
2,11,12,3,6,3155,2705,450
2,11,13,3,6,3325,3030,295
2,11,14,3,6,3564,3367,197
2,11,15,3,6,3794,3537,257
2,11,16,3,6,3843,3609,234
2,11,17,3,6,3670,3363,307
2,11,18,3,6,3378,3277,101
2,12,0,3,6,2932,2672,260
2,12,1,3,6,3009,2716,293
2,12,2,3,6,3222,3074,148
2,12,3,3,6,3610,3502,108
2,12,4,3,6,3550,3379,171
2,12,5,3,6,3297,3091,206
2,12,6,3,6,2890,2656,234
2,12,7,3,6,2714,2565,149
2,12,8,3,6,2345,2136,209
2,12,9,3,6,1926,1708,218
2,12,10,3,6,2086,1921,165
2,12,11,3,6,2480,2327,153
2,12,12,3,6,2814,2574,240
2,12,13,3,6,3112,2770,342
2,12,14,3,6,3441,3083,358
2,12,15,3,6,3691,3317,374
2,12,16,3,6,3800,3375,425
2,12,17,3,6,3656,3020,636
2,12,18,3,6,3440,2954,486
2,13,0,3,6,2964,2565,399
2,13,1,3,6,2997,2538,459
2,13,2,3,6,3201,2864,337
2,13,3,3,6,3592,3197,395
2,13,4,3,6,3511,2999,512
2,13,5,3,6,3292,2637,655
2,13,6,3,6,2815,2263,552
2,13,7,3,6,2662,2269,393
2,13,8,3,6,2261,1932,329
2,13,9,3,6,1819,1647,172
2,13,10,3,6,2008,1792,216
2,13,11,3,6,2402,2053,349
2,13,12,3,6,2690,2297,393
2,13,13,3,6,3061,2317,744
2,13,14,3,6,3410,2549,861
2,13,15,3,6,3608,2817,791
2,13,16,3,6,3717,2919,798
2,13,17,3,6,3556,2647,909
2,13,18,3,6,3417,2574,843
2,14,0,3,6,2870,2509,361
2,14,1,3,6,2901,2342,559
2,14,2,3,6,3165,2543,622
2,14,3,3,6,3581,2795,786
2,14,4,3,6,3511,2498,1013
2,14,5,3,6,3271,2266,1005
2,14,6,3,6,2799,2098,701
2,14,7,3,6,2703,2193,510
2,14,8,3,6,2303,2050,253
2,14,9,3,6,1878,1829,49
2,14,10,3,6,2077,1849,228
2,14,11,3,6,2465,2003,462
2,14,12,3,6,2705,2248,457
2,14,13,3,6,3030,2117,913
2,14,14,3,6,3367,2150,1217
2,14,15,3,6,3537,2427,1110
2,14,16,3,6,3609,2549,1060
2,14,17,3,6,3363,2300,1063
2,14,18,3,6,3277,2250,1027
2,15,0,3,6,2672,2423,249
2,15,1,3,6,2716,2135,581
2,15,2,3,6,3074,2283,791
2,15,3,3,6,3502,2578,924
2,15,4,3,6,3379,2258,1121
2,15,5,3,6,3091,2179,912
2,15,6,3,6,2656,2212,444
2,15,7,3,6,2565,2415,150
2,15,8,3,6,2136,2387,-251
2,15,9,3,6,1708,2141,-433
2,15,10,3,6,1921,2035,-114
2,15,11,3,6,2327,2042,285
2,15,12,3,6,2574,2193,381
2,15,13,3,6,2770,1966,804
2,15,14,3,6,3083,1853,1230
2,15,15,3,6,3317,2096,1221
2,15,16,3,6,3375,2162,1213
2,15,17,3,6,3020,1979,1041
2,15,18,3,6,2954,2026,928
2,16,0,3,6,2565,2225,340
2,16,1,3,6,2538,1845,693
2,16,2,3,6,2864,1969,895
2,16,3,3,6,3197,2284,913
2,16,4,3,6,2999,1881,1118
2,16,5,3,6,2637,1929,708
2,16,6,3,6,2263,2069,194
2,16,7,3,6,2269,2264,5
2,16,8,3,6,1932,2241,-309
2,16,9,3,6,1647,1883,-236
2,16,10,3,6,1792,1782,10
2,16,11,3,6,2053,1814,239
2,16,12,3,6,2297,1917,380
2,16,13,3,6,2317,1691,626
2,16,14,3,6,2549,1576,973
2,16,15,3,6,2817,1799,1018
2,16,16,3,6,2919,1817,1102
2,16,17,3,6,2647,1673,974
2,16,18,3,6,2574,1860,714
2,17,0,3,6,2509,1841,668
2,17,1,3,6,2342,1527,815
2,17,2,3,6,2543,1663,880
2,17,3,3,6,2795,1970,825
2,17,4,3,6,2498,1607,891
2,17,5,3,6,2266,1657,609
2,17,6,3,6,2098,1770,328
2,17,7,3,6,2193,1950,243
2,17,8,3,6,2050,1857,193
2,17,9,3,6,1829,1458,371
2,17,10,3,6,1849,1464,385
2,17,11,3,6,2003,1508,495
2,17,12,3,6,2248,1543,705
2,17,13,3,6,2117,1310,807
2,17,14,3,6,2150,1264,886
2,17,15,3,6,2427,1435,992
2,17,16,3,6,2549,1395,1154
2,17,17,3,6,2300,1307,993
2,17,18,3,6,2250,1487,763
2,18,0,3,6,2423,1574,849
2,18,1,3,6,2135,1314,821
2,18,2,3,6,2283,1358,925
2,18,3,3,6,2578,1561,1017
2,18,4,3,6,2258,1325,933
2,18,5,3,6,2179,1305,874
2,18,6,3,6,2212,1336,876
2,18,7,3,6,2415,1521,894
2,18,8,3,6,2387,1471,916
2,18,9,3,6,2141,1198,943
2,18,10,3,6,2035,1257,778
2,18,11,3,6,2042,1368,674
2,18,12,3,6,2193,1410,783
2,18,13,3,6,1966,1191,775
2,18,14,3,6,1853,1194,659
2,18,15,3,6,2096,1248,848
2,18,16,3,6,2162,1177,985
2,18,17,3,6,1979,1139,840
2,18,18,3,6,2026,1208,818
2,0,0,4,6,2612,2519,93
2,0,1,4,6,2604,2353,251
2,0,2,4,6,2600,2141,459
2,0,3,4,6,2574,1995,579
2,0,4,4,6,2549,1907,642
2,0,5,4,6,2485,1810,675
2,0,6,4,6,2418,1720,698
2,0,7,4,6,2365,1685,680
2,0,8,4,6,2297,1684,613
2,0,9,4,6,2282,1674,608
2,0,10,4,6,2281,1668,613
2,0,11,4,6,2320,1677,643
2,0,12,4,6,2362,1682,680
2,0,13,4,6,2429,1742,687
2,0,14,4,6,2489,1859,630
2,0,15,4,6,2514,1982,532
2,0,16,4,6,2552,2124,428
2,0,17,4,6,2581,2291,290
2,0,18,4,6,2585,2466,119
2,1,0,4,6,2687,2434,253
2,1,1,4,6,2665,2297,368
2,1,2,4,6,2619,2108,511
2,1,3,4,6,2525,2028,497
2,1,4,4,6,2431,2061,370
2,1,5,4,6,2298,2109,189
2,1,6,4,6,2165,2137,28
2,1,7,4,6,2064,2163,-99
2,1,8,4,6,1968,2218,-250
2,1,9,4,6,1946,2226,-280
2,1,10,4,6,1940,2226,-286
2,1,11,4,6,1994,2228,-234
2,1,12,4,6,2066,2197,-131
2,1,13,4,6,2187,2178,9
2,1,14,4,6,2320,2164,156
2,1,15,4,6,2419,2180,239
2,1,16,4,6,2521,2250,271
2,1,17,4,6,2593,2347,246
2,1,18,4,6,2632,2487,145
2,2,0,4,6,2746,2108,638
2,2,1,4,6,2683,1954,729
2,2,2,4,6,2558,1846,712
2,2,3,4,6,2412,1812,600
2,2,4,4,6,2267,1894,373
2,2,5,4,6,2084,1988,96
2,2,6,4,6,1912,2041,-129
2,2,7,4,6,1806,2066,-260
2,2,8,4,6,1739,2056,-317
2,2,9,4,6,1716,2031,-315
2,2,10,4,6,1707,2045,-338
2,2,11,4,6,1738,2089,-351
2,2,12,4,6,1799,2095,-296
2,2,13,4,6,1935,2079,-144
2,2,14,4,6,2112,2042,70
2,2,15,4,6,2266,2031,235
2,2,16,4,6,2417,2055,362
2,2,17,4,6,2553,2106,447
2,2,18,4,6,2647,2233,414
2,3,0,4,6,2699,2047,652
2,3,1,4,6,2581,1965,616
2,3,2,4,6,2387,2036,351
2,3,3,4,6,2198,2124,74
2,3,4,4,6,2027,2278,-251
2,3,5,4,6,1827,2374,-547
2,3,6,4,6,1643,2441,-798
2,3,7,4,6,1541,2466,-925
2,3,8,4,6,1495,2420,-925
2,3,9,4,6,1476,2378,-902
2,3,10,4,6,1468,2394,-926
2,3,11,4,6,1499,2443,-944
2,3,12,4,6,1555,2482,-927
2,3,13,4,6,1690,2451,-761
2,3,14,4,6,1886,2384,-498
2,3,15,4,6,2076,2335,-259
2,3,16,4,6,2267,2273,-6
2,3,17,4,6,2444,2239,205
2,3,18,4,6,2590,2274,316
2,4,0,4,6,2519,2436,83
2,4,1,4,6,2353,2486,-133
2,4,2,4,6,2141,2707,-566
2,4,3,4,6,1995,2916,-921
2,4,4,4,6,1907,3078,-1171
2,4,5,4,6,1810,3058,-1248
2,4,6,4,6,1720,3086,-1366
2,4,7,4,6,1685,3062,-1377
2,4,8,4,6,1684,2993,-1309
2,4,9,4,6,1674,2917,-1243
2,4,10,4,6,1668,2944,-1276
2,4,11,4,6,1677,3039,-1362
2,4,12,4,6,1682,3151,-1469
2,4,13,4,6,1742,3133,-1391
2,4,14,4,6,1859,3098,-1239
2,4,15,4,6,1982,3103,-1121
2,4,16,4,6,2124,3033,-909
2,4,17,4,6,2291,2919,-628
2,4,18,4,6,2466,2811,-345
2,5,0,4,6,2434,2779,-345
2,5,1,4,6,2297,2882,-585
2,5,2,4,6,2108,3200,-1092
2,5,3,4,6,2028,3531,-1503
2,5,4,4,6,2061,3621,-1560
2,5,5,4,6,2109,3411,-1302
2,5,6,4,6,2137,3310,-1173
2,5,7,4,6,2163,3193,-1030
2,5,8,4,6,2218,2986,-768
2,5,9,4,6,2226,2770,-544
2,5,10,4,6,2226,2842,-616
2,5,11,4,6,2228,3070,-842
2,5,12,4,6,2197,3311,-1114
2,5,13,4,6,2178,3379,-1201
2,5,14,4,6,2164,3508,-1344
2,5,15,4,6,2180,3667,-1487
2,5,16,4,6,2250,3645,-1395
2,5,17,4,6,2347,3495,-1148
2,5,18,4,6,2487,3280,-793
2,6,0,4,6,2108,3374,-1266
2,6,1,4,6,1954,3563,-1609
2,6,2,4,6,1846,3957,-2111
2,6,3,4,6,1812,4432,-2620
2,6,4,4,6,1894,4501,-2607
2,6,5,4,6,1988,4222,-2234
2,6,6,4,6,2041,3980,-1939
2,6,7,4,6,2066,3808,-1742
2,6,8,4,6,2056,3503,-1447
2,6,9,4,6,2031,3166,-1135
2,6,10,4,6,2045,3283,-1238
2,6,11,4,6,2089,3624,-1535
2,6,12,4,6,2095,3959,-1864
2,6,13,4,6,2079,4116,-2037
2,6,14,4,6,2042,4343,-2301
2,6,15,4,6,2031,4564,-2533
2,6,16,4,6,2055,4566,-2511
2,6,17,4,6,2106,4347,-2241
2,6,18,4,6,2233,4012,-1779
2,7,0,4,6,2047,3812,-1765
2,7,1,4,6,1965,3973,-2008
2,7,2,4,6,2036,4316,-2280
2,7,3,4,6,2124,4830,-2706
2,7,4,4,6,2278,4825,-2547
2,7,5,4,6,2374,4513,-2139
2,7,6,4,6,2441,4109,-1668
2,7,7,4,6,2466,3901,-1435
2,7,8,4,6,2420,3502,-1082
2,7,9,4,6,2378,3051,-673
2,7,10,4,6,2394,3222,-828
2,7,11,4,6,2443,3664,-1221
2,7,12,4,6,2482,4056,-1574
2,7,13,4,6,2451,4347,-1896
2,7,14,4,6,2384,4687,-2303
2,7,15,4,6,2335,4966,-2631
2,7,16,4,6,2273,5055,-2782
2,7,17,4,6,2239,4842,-2603
2,7,18,4,6,2274,4524,-2250
2,8,0,4,6,2436,3930,-1494
2,8,1,4,6,2486,4025,-1539
2,8,2,4,6,2707,4306,-1599
2,8,3,4,6,2916,4825,-1909
2,8,4,4,6,3078,4729,-1651
2,8,5,4,6,3058,4387,-1329
2,8,6,4,6,3086,3824,-738
2,8,7,4,6,3062,3589,-527
2,8,8,4,6,2993,3075,-82
2,8,9,4,6,2917,2504,413
2,8,10,4,6,2944,2741,203
2,8,11,4,6,3039,3272,-233
2,8,12,4,6,3151,3683,-532
2,8,13,4,6,3133,4123,-990
2,8,14,4,6,3098,4583,-1485
2,8,15,4,6,3103,4896,-1793
2,8,16,4,6,3033,5043,-2010
2,8,17,4,6,2919,4830,-1911
2,8,18,4,6,2811,4584,-1773
2,9,0,4,6,2779,3848,-1069
2,9,1,4,6,2882,3903,-1021
2,9,2,4,6,3200,4241,-1041
2,9,3,4,6,3531,4796,-1265
2,9,4,4,6,3621,4703,-1082
2,9,5,4,6,3411,4382,-971
2,9,6,4,6,3310,3750,-440
2,9,7,4,6,3193,3594,-401
2,9,8,4,6,2986,3057,-71
2,9,9,4,6,2770,2474,296
2,9,10,4,6,2842,2730,112
2,9,11,4,6,3070,3261,-191
2,9,12,4,6,3311,3625,-314
2,9,13,4,6,3379,4058,-679
2,9,14,4,6,3508,4512,-1004
2,9,15,4,6,3667,4768,-1101
2,9,16,4,6,3645,4871,-1226
2,9,17,4,6,3495,4573,-1078
2,9,18,4,6,3280,4404,-1124
2,10,0,4,6,3374,3660,-286
2,10,1,4,6,3563,3695,-132
2,10,2,4,6,3957,4115,-158
2,10,3,4,6,4432,4664,-232
2,10,4,4,6,4501,4519,-18
2,10,5,4,6,4222,4182,40
2,10,6,4,6,3980,3586,394
2,10,7,4,6,3808,3461,347
2,10,8,4,6,3503,2913,590
2,10,9,4,6,3166,2353,813
2,10,10,4,6,3283,2621,662
2,10,11,4,6,3624,3141,483
2,10,12,4,6,3959,3475,484
2,10,13,4,6,4116,3792,324
2,10,14,4,6,4343,4206,137
2,10,15,4,6,4564,4489,75
2,10,16,4,6,4566,4587,-21
2,10,17,4,6,4347,4192,155
2,10,18,4,6,4012,4100,-88
2,11,0,4,6,3812,3563,249
2,11,1,4,6,3973,3554,419
2,11,2,4,6,4316,3948,368
2,11,3,4,6,4830,4412,418
2,11,4,4,6,4825,4178,647
2,11,5,4,6,4513,3727,786
2,11,6,4,6,4109,3197,912
2,11,7,4,6,3901,3144,757
2,11,8,4,6,3502,2662,840
2,11,9,4,6,3051,2225,826
2,11,10,4,6,3222,2447,775
2,11,11,4,6,3664,2845,819
2,11,12,4,6,4056,3166,890
2,11,13,4,6,4347,3328,1019
2,11,14,4,6,4687,3691,996
2,11,15,4,6,4966,4022,944
2,11,16,4,6,5055,4162,893
2,11,17,4,6,4842,3821,1021
2,11,18,4,6,4524,3718,806
2,12,0,4,6,3930,3393,537
2,12,1,4,6,4025,3248,777
2,12,2,4,6,4306,3583,723
2,12,3,4,6,4825,3999,826
2,12,4,4,6,4729,3690,1039
2,12,5,4,6,4387,3356,1031
2,12,6,4,6,3824,3033,791
2,12,7,4,6,3589,3125,464
2,12,8,4,6,3075,2846,229
2,12,9,4,6,2504,2484,20
2,12,10,4,6,2741,2571,170
2,12,11,4,6,3272,2862,410
2,12,12,4,6,3683,3183,500
2,12,13,4,6,4123,3114,1009
2,12,14,4,6,4583,3252,1331
2,12,15,4,6,4896,3587,1309
2,12,16,4,6,5043,3703,1340
2,12,17,4,6,4830,3317,1513
2,12,18,4,6,4584,3237,1347
2,13,0,4,6,3848,3213,635
2,13,1,4,6,3903,2929,974
2,13,2,4,6,4241,3233,1008
2,13,3,4,6,4796,3661,1135
2,13,4,4,6,4703,3266,1437
2,13,5,4,6,4382,3090,1292
2,13,6,4,6,3750,2999,751
2,13,7,4,6,3594,3173,421
2,13,8,4,6,3057,2997,60
2,13,9,4,6,2474,2616,-142
2,13,10,4,6,2730,2579,151
2,13,11,4,6,3261,2718,543
2,13,12,4,6,3625,2963,662
2,13,13,4,6,4058,2728,1330
2,13,14,4,6,4512,2692,1820
2,13,15,4,6,4768,3048,1720
2,13,16,4,6,4871,3140,1731
2,13,17,4,6,4573,2808,1765
2,13,18,4,6,4404,2849,1555
2,14,0,4,6,3660,3116,544
2,14,1,4,6,3695,2683,1012
2,14,2,4,6,4115,2843,1272
2,14,3,4,6,4664,3194,1470
2,14,4,4,6,4519,2680,1839
2,14,5,4,6,4182,2565,1617
2,14,6,4,6,3586,2610,976
2,14,7,4,6,3461,2843,618
2,14,8,4,6,2913,2767,146
2,14,9,4,6,2353,2400,-47
2,14,10,4,6,2621,2308,313
2,14,11,4,6,3141,2332,809
2,14,12,4,6,3475,2509,966
2,14,13,4,6,3792,2249,1543
2,14,14,4,6,4206,2184,2022
2,14,15,4,6,4489,2504,1985
2,14,16,4,6,4587,2604,1983
2,14,17,4,6,4192,2474,1718
2,14,18,4,6,4100,2624,1476
2,15,0,4,6,3563,2669,894
2,15,1,4,6,3554,2237,1317
2,15,2,4,6,3948,2382,1566
2,15,3,4,6,4412,2772,1640
2,15,4,4,6,4178,2298,1880
2,15,5,4,6,3727,2376,1351
2,15,6,4,6,3197,2540,657
2,15,7,4,6,3144,2806,338
2,15,8,4,6,2662,2771,-109
2,15,9,4,6,2225,2295,-70
2,15,10,4,6,2447,2243,204
2,15,11,4,6,2845,2317,528
2,15,12,4,6,3166,2429,737
2,15,13,4,6,3328,2107,1221
2,15,14,4,6,3691,1967,1724
2,15,15,4,6,4022,2205,1817
2,15,16,4,6,4162,2179,1983
2,15,17,4,6,3821,1977,1844
2,15,18,4,6,3718,2150,1568
2,16,0,4,6,3393,2278,1115
2,16,1,4,6,3248,1901,1347
2,16,2,4,6,3583,2048,1535
2,16,3,4,6,3999,2427,1572
2,16,4,4,6,3690,2093,1597
2,16,5,4,6,3356,2129,1227
2,16,6,4,6,3033,2237,796
2,16,7,4,6,3125,2501,624
2,16,8,4,6,2846,2418,428
2,16,9,4,6,2484,1985,499
2,16,10,4,6,2571,1987,584
2,16,11,4,6,2862,2083,779
2,16,12,4,6,3183,2125,1058
2,16,13,4,6,3114,1802,1312
2,16,14,4,6,3252,1736,1516
2,16,15,4,6,3587,1869,1718
2,16,16,4,6,3703,1768,1935
2,16,17,4,6,3317,1647,1670
2,16,18,4,6,3237,1807,1430
2,0,0,5,6,3320,2817,503
2,0,1,5,6,3292,2618,674
2,0,2,5,6,3245,2427,818
2,0,3,5,6,3159,2342,817
2,0,4,5,6,3070,2373,697
2,0,5,5,6,2928,2409,519
2,0,6,5,6,2786,2418,368
2,0,7,5,6,2683,2439,244
2,0,8,5,6,2584,2455,129
2,0,9,5,6,2562,2426,136
2,0,10,5,6,2558,2438,120
2,0,11,5,6,2608,2470,138
2,0,12,5,6,2680,2469,211
2,0,13,5,6,2809,2469,340
2,0,14,5,6,2947,2474,473
2,0,15,5,6,3040,2514,526
2,0,16,5,6,3140,2591,549
2,0,17,5,6,3223,2705,518
2,0,18,5,6,3262,2882,380
2,1,0,5,6,3396,2658,738
2,1,1,5,6,3329,2523,806
2,1,2,5,6,3200,2528,672
2,1,3,5,6,3055,2576,479
2,1,4,5,6,2910,2710,200
2,1,5,5,6,2719,2788,-69
2,1,6,5,6,2542,2842,-300
2,1,7,5,6,2437,2869,-432
2,1,8,5,6,2367,2834,-467
2,1,9,5,6,2341,2791,-450
2,1,10,5,6,2333,2806,-473
2,1,11,5,6,2375,2863,-488
2,1,12,5,6,2440,2899,-459
2,1,13,5,6,2577,2870,-293
2,1,14,5,6,2752,2821,-69
2,1,15,5,6,2902,2801,101
2,1,16,5,6,3057,2778,279
2,1,17,5,6,3192,2783,409
2,1,18,5,6,3281,2867,414
2,2,0,5,6,3357,2927,430
2,2,1,5,6,3241,2929,312
2,2,2,5,6,3050,3130,-80
2,2,3,5,6,2864,3344,-480
2,2,4,5,6,2699,3553,-854
2,2,5,5,6,2498,3590,-1092
2,2,6,5,6,2313,3660,-1347
2,2,7,5,6,2209,3653,-1444
2,2,8,5,6,2153,3577,-1424
2,2,9,5,6,2129,3503,-1374
2,2,10,5,6,2119,3530,-1411
2,2,11,5,6,2158,3627,-1469
2,2,12,5,6,2216,3724,-1508
2,2,13,5,6,2354,3686,-1332
2,2,14,5,6,2549,3630,-1081
2,2,15,5,6,2732,3610,-878
2,2,16,5,6,2922,3528,-606
2,2,17,5,6,3097,3425,-328
2,2,18,5,6,3240,3358,-118
2,3,0,5,6,3190,3402,-212
2,3,1,5,6,3024,3514,-490
2,3,2,5,6,2810,3812,-1002
2,3,3,5,6,2626,4149,-1523
2,3,4,5,6,2502,4296,-1794
2,3,5,5,6,2359,4153,-1794
2,3,6,5,6,2217,4095,-1878
2,3,7,5,6,2132,3989,-1857
2,3,8,5,6,2079,3807,-1728
2,3,9,5,6,2062,3602,-1540
2,3,10,5,6,2054,3677,-1623
2,3,11,5,6,2087,3909,-1822
2,3,12,5,6,2128,4144,-2016
2,3,13,5,6,2243,4195,-1952
2,3,14,5,6,2418,4271,-1853
2,3,15,5,6,2583,4391,-1808
2,3,16,5,6,2762,4359,-1597
2,3,17,5,6,2950,4193,-1243
2,3,18,5,6,3137,3978,-841
2,4,0,5,6,3142,3757,-615
2,4,1,5,6,2985,3884,-899
2,4,2,5,6,2753,4276,-1523
2,4,3,5,6,2613,4746,-2133
2,4,4,5,6,2582,4813,-2231
2,4,5,5,6,2552,4522,-1970
2,4,6,5,6,2505,4261,-1756
2,4,7,5,6,2481,4084,-1603
2,4,8,5,6,2505,3740,-1235
2,4,9,5,6,2506,3366,-860
2,4,10,5,6,2503,3495,-992
2,4,11,5,6,2516,3866,-1350
2,4,12,5,6,2515,4231,-1716
2,4,13,5,6,2558,4407,-1849
2,4,14,5,6,2622,4653,-2031
2,4,15,5,6,2706,4898,-2192
2,4,16,5,6,2838,4907,-2069
2,4,17,5,6,2989,4705,-1716
2,4,18,5,6,3164,4407,-1243
2,5,0,5,6,2817,4362,-1545
2,5,1,5,6,2618,4542,-1924
2,5,2,5,6,2427,4998,-2571
2,5,3,5,6,2342,5594,-3252
2,5,4,5,6,2373,5641,-3268
2,5,5,5,6,2409,5313,-2904
2,5,6,5,6,2418,4910,-2492
2,5,7,5,6,2439,4704,-2265
2,5,8,5,6,2455,4280,-1825
2,5,9,5,6,2426,3811,-1385
2,5,10,5,6,2438,3983,-1545
2,5,11,5,6,2470,4438,-1968
2,5,12,5,6,2469,4860,-2391
2,5,13,5,6,2469,5138,-2669
2,5,14,5,6,2474,5466,-2992
2,5,15,5,6,2514,5736,-3222
2,5,16,5,6,2591,5778,-3187
2,5,17,5,6,2705,5519,-2814
2,5,18,5,6,2882,5158,-2276
2,6,0,5,6,2658,4810,-2152
2,6,1,5,6,2523,4989,-2466
2,6,2,5,6,2528,5400,-2872
2,6,3,5,6,2576,6045,-3469
2,6,4,5,6,2710,6004,-3294
2,6,5,5,6,2788,5603,-2815
2,6,6,5,6,2842,5043,-2201
2,6,7,5,6,2869,4776,-1907
2,6,8,5,6,2834,4232,-1398
2,6,9,5,6,2791,3629,-838
2,6,10,5,6,2806,3877,-1071
2,6,11,5,6,2863,4456,-1593
2,6,12,5,6,2899,4925,-2026
2,6,13,5,6,2870,5358,-2488
2,6,14,5,6,2821,5829,-3008
2,6,15,5,6,2801,6171,-3370
2,6,16,5,6,2778,6298,-3520
2,6,17,5,6,2783,6016,-3233
2,6,18,5,6,2867,5668,-2801
2,7,0,5,6,2927,4814,-1887
2,7,1,5,6,2929,4931,-2002
2,7,2,5,6,3130,5346,-2216
2,7,3,5,6,3344,6029,-2685
2,7,4,5,6,3553,5921,-2368
2,7,5,5,6,3590,5477,-1887
2,7,6,5,6,3660,4759,-1099
2,7,7,5,6,3653,4521,-868
2,7,8,5,6,3577,3871,-294
2,7,9,5,6,3503,3159,344
2,7,10,5,6,3530,3463,67
2,7,11,5,6,3627,4131,-504
2,7,12,5,6,3724,4618,-894
2,7,13,5,6,3686,5120,-1434
2,7,14,5,6,3630,5685,-2055
2,7,15,5,6,3610,6056,-2446
2,7,16,5,6,3528,6197,-2669
2,7,17,5,6,3425,5847,-2422
2,7,18,5,6,3358,5571,-2213
2,8,0,5,6,3402,4638,-1236
2,8,1,5,6,3514,4697,-1183
2,8,2,5,6,3812,5191,-1379
2,8,3,5,6,4149,5879,-1730
2,8,4,5,6,4296,5711,-1415
2,8,5,5,6,4153,5293,-1140
2,8,6,5,6,4095,4537,-442
2,8,7,5,6,3989,4352,-363
2,8,8,5,6,3807,3667,140
2,8,9,5,6,3602,2949,653
2,8,10,5,6,3677,3274,403
2,8,11,5,6,3909,3937,-28
2,8,12,5,6,4144,4395,-251
2,8,13,5,6,4195,4820,-625
2,8,14,5,6,4271,5351,-1080
2,8,15,5,6,4391,5720,-1329
2,8,16,5,6,4359,5849,-1490
2,8,17,5,6,4193,5402,-1209
2,8,18,5,6,3978,5227,-1249
2,9,0,5,6,3757,4551,-794
2,9,1,5,6,3884,4533,-649
2,9,2,5,6,4276,4989,-713
2,9,3,5,6,4746,5574,-828
2,9,4,5,6,4813,5318,-505
2,9,5,5,6,4522,4818,-296
2,9,6,5,6,4261,4127,134
2,9,7,5,6,4084,4040,44
2,9,8,5,6,3740,3439,301
2,9,9,5,6,3366,2870,496
2,9,10,5,6,3495,3147,348
2,9,11,5,6,3866,3659,207
2,9,12,5,6,4231,4067,164
2,9,13,5,6,4407,4350,57
2,9,14,5,6,4653,4814,-161
2,9,15,5,6,4898,5194,-296
2,9,16,5,6,4907,5374,-467
2,9,17,5,6,4705,4993,-288
2,9,18,5,6,4407,4864,-457
2,10,0,5,6,4362,4391,-29
2,10,1,5,6,4542,4264,278
2,10,2,5,6,4998,4667,331
2,10,3,5,6,5594,5214,380
2,10,4,5,6,5641,4869,772
2,10,5,5,6,5313,4446,867
2,10,6,5,6,4910,3967,943
2,10,7,5,6,4704,4000,704
2,10,8,5,6,4280,3576,704
2,10,9,5,6,3811,3062,749
2,10,10,5,6,3983,3226,757
2,10,11,5,6,4438,3654,784
2,10,12,5,6,4860,4052,808
2,10,13,5,6,5138,4125,1013
2,10,14,5,6,5466,4394,1072
2,10,15,5,6,5736,4792,944
2,10,16,5,6,5778,4946,832
2,10,17,5,6,5519,4491,1028
2,10,18,5,6,5158,4381,777
2,11,0,5,6,4810,4097,713
2,11,1,5,6,4989,3835,1154
2,11,2,5,6,5400,4273,1127
2,11,3,5,6,6045,4865,1180
2,11,4,5,6,6004,4458,1546
2,11,5,5,6,5603,4180,1423
2,11,6,5,6,5043,3934,1109
2,11,7,5,6,4776,4105,671
2,11,8,5,6,4232,3793,439
2,11,9,5,6,3629,3271,358
2,11,10,5,6,3877,3301,576
2,11,11,5,6,4456,3577,879
2,11,12,5,6,4925,3898,1027
2,11,13,5,6,5358,3725,1633
2,11,14,5,6,5829,3794,2035
2,11,15,5,6,6171,4208,1963
2,11,16,5,6,6298,4294,2004
2,11,17,5,6,6016,3825,2191
2,11,18,5,6,5668,3836,1832
2,12,0,5,6,4814,3906,908
2,12,1,5,6,4931,3477,1454
2,12,2,5,6,5346,3793,1553
2,12,3,5,6,6029,4277,1752
2,12,4,5,6,5921,3688,2233
2,12,5,5,6,5477,3476,2001
2,12,6,5,6,4759,3397,1362
2,12,7,5,6,4521,3601,920
2,12,8,5,6,3871,3377,494
2,12,9,5,6,3159,2875,284
2,12,10,5,6,3463,2852,611
2,12,11,5,6,4131,3008,1123
2,12,12,5,6,4618,3279,1339
2,12,13,5,6,5120,3011,2109
2,12,14,5,6,5685,3023,2662
2,12,15,5,6,6056,3456,2600
2,12,16,5,6,6197,3582,2615
2,12,17,5,6,5847,3303,2544
2,12,18,5,6,5571,3447,2124
2,13,0,5,6,4638,3560,1078
2,13,1,5,6,4697,3075,1622
2,13,2,5,6,5191,3256,1935
2,13,3,5,6,5879,3682,2197
2,13,4,5,6,5711,3097,2614
2,13,5,5,6,5293,3012,2281
2,13,6,5,6,4537,3081,1456
2,13,7,5,6,4352,3385,967
2,13,8,5,6,3667,3297,370
2,13,9,5,6,2949,2812,137
2,13,10,5,6,3274,2769,505
2,13,11,5,6,3937,2835,1102
2,13,12,5,6,4395,3021,1374
2,13,13,5,6,4820,2665,2155
2,13,14,5,6,5351,2575,2776
2,13,15,5,6,5720,2910,2810
2,13,16,5,6,5849,2966,2883
2,13,17,5,6,5402,2778,2624
2,13,18,5,6,5227,2914,2313
2,14,0,5,6,4551,3106,1445
2,14,1,5,6,4533,2611,1922
2,14,2,5,6,4989,2767,2222
2,14,3,5,6,5574,3229,2345
2,14,4,5,6,5318,2784,2534
2,14,5,5,6,4818,2848,1970
2,14,6,5,6,4127,3007,1120
2,14,7,5,6,4040,3357,683
2,14,8,5,6,3439,3332,107
2,14,9,5,6,2870,2822,48
2,14,10,5,6,3147,2766,381
2,14,11,5,6,3659,2892,767
2,14,12,5,6,4067,3011,1056
2,14,13,5,6,4350,2599,1751
2,14,14,5,6,4814,2439,2375
2,14,15,5,6,5194,2639,2555
2,14,16,5,6,5374,2552,2822
2,14,17,5,6,4993,2317,2676
2,14,18,5,6,4864,2470,2394
2,0,0,6,6,4029,3538,491
2,0,1,6,6,3956,3487,469
2,0,2,6,6,3826,3622,204
2,0,3,6,6,3689,3796,-107
2,0,4,6,6,3549,3985,-436
2,0,5,6,6,3349,4004,-655
2,0,6,6,6,3163,4061,-898
2,0,7,6,6,3056,4056,-1000
2,0,8,6,6,2983,3991,-1008
2,0,9,6,6,2957,3916,-959
2,0,10,6,6,2951,3942,-991
2,0,11,6,6,2989,4047,-1058
2,0,12,6,6,3054,4141,-1087
2,0,13,6,6,3199,4105,-906
2,0,14,6,6,3379,4067,-688
2,0,15,6,6,3523,4076,-553
2,0,16,6,6,3676,4033,-357
2,0,17,6,6,3822,3969,-147
2,0,18,6,6,3911,3951,-40
2,1,0,6,6,4007,3893,114
2,1,1,6,6,3887,3957,-70
2,1,2,6,6,3692,4235,-543
2,1,3,6,6,3507,4577,-1070
2,1,4,6,6,3342,4771,-1429
2,1,5,6,6,3133,4685,-1552
2,1,6,6,6,2943,4669,-1726
2,1,7,6,6,2840,4580,-1740
2,1,8,6,6,2781,4391,-1610
2,1,9,6,6,2754,4188,-1434
2,1,10,6,6,2745,4263,-1518
2,1,11,6,6,2795,4497,-1702
2,1,12,6,6,2857,4717,-1860
2,1,13,6,6,2996,4748,-1752
2,1,14,6,6,3189,4803,-1614
2,1,15,6,6,3368,4898,-1530
2,1,16,6,6,3562,4854,-1292
2,1,17,6,6,3736,4699,-963
2,1,18,6,6,3874,4525,-651
2,2,0,6,6,3848,4380,-532
2,2,1,6,6,3684,4516,-832
2,2,2,6,6,3473,4888,-1415
2,2,3,6,6,3292,5364,-2072
2,2,4,6,6,3174,5488,-2314
2,2,5,6,6,3030,5264,-2234
2,2,6,6,6,2887,5046,-2159
2,2,7,6,6,2800,4880,-2080
2,2,8,6,6,2737,4561,-1824
2,2,9,6,6,2715,4198,-1483
2,2,10,6,6,2705,4330,-1625
2,2,11,6,6,2746,4705,-1959
2,2,12,6,6,2789,5064,-2275
2,2,13,6,6,2907,5223,-2316
2,2,14,6,6,3081,5416,-2335
2,2,15,6,6,3239,5622,-2383
2,2,16,6,6,3417,5621,-2204
2,2,17,6,6,3603,5403,-1800
2,2,18,6,6,3787,5105,-1318
2,3,0,6,6,3813,4745,-932
2,3,1,6,6,3656,4863,-1207
2,3,2,6,6,3422,5317,-1895
2,3,3,6,6,3244,5908,-2664
2,3,4,6,6,3177,5953,-2776
2,3,5,6,6,3101,5613,-2512
2,3,6,6,6,3002,5191,-2189
2,3,7,6,6,2928,4980,-2052
2,3,8,6,6,2900,4517,-1617
2,3,9,6,6,2894,4011,-1117
2,3,10,6,6,2889,4195,-1306
2,3,11,6,6,2926,4680,-1754
2,3,12,6,6,2961,5132,-2171
2,3,13,6,6,3059,5429,-2370
2,3,14,6,6,3181,5776,-2595
2,3,15,6,6,3307,6070,-2763
2,3,16,6,6,3476,6119,-2643
2,3,17,6,6,3648,5877,-2229
2,3,18,6,6,3835,5553,-1718
2,4,0,6,6,3525,5360,-1835
2,4,1,6,6,3306,5558,-2252
2,4,2,6,6,3072,6082,-3010
2,4,3,6,6,2927,6809,-3882
2,4,4,6,6,2894,6820,-3926
2,4,5,6,6,2852,6403,-3551
2,4,6,6,6,2786,5844,-3058
2,4,7,6,6,2757,5579,-2822
2,4,8,6,6,2742,5010,-2268
2,4,9,6,6,2706,4389,-1683
2,4,10,6,6,2715,4638,-1923
2,4,11,6,6,2758,5230,-2472
2,4,12,6,6,2787,5729,-2942
2,4,13,6,6,2849,6149,-3300
2,4,14,6,6,2932,6608,-3676
2,4,15,6,6,3040,6941,-3901
2,4,16,6,6,3179,7021,-3842
2,4,17,6,6,3347,6693,-3346
2,4,18,6,6,3559,6302,-2743
2,5,0,6,6,3367,5694,-2327
2,5,1,6,6,3187,5895,-2708
2,5,2,6,6,3109,6440,-3331
2,5,3,6,6,3106,7249,-4143
2,5,4,6,6,3189,7196,-4007
2,5,5,6,6,3209,6693,-3484
2,5,6,6,6,3219,5978,-2759
2,5,7,6,6,3242,5708,-2466
2,5,8,6,6,3233,5028,-1795
2,5,9,6,6,3186,4284,-1098
2,5,10,6,6,3199,4599,-1400
2,5,11,6,6,3244,5315,-2071
2,5,12,6,6,3273,5860,-2587
2,5,13,6,6,3260,6355,-3095
2,5,14,6,6,3253,6931,-3678
2,5,15,6,6,3284,7331,-4047
2,5,16,6,6,3314,7452,-4138
2,5,17,6,6,3382,7033,-3651
2,5,18,6,6,3516,6655,-3139
2,6,0,6,6,3538,5604,-2066
2,6,1,6,6,3487,5725,-2238
2,6,2,6,6,3622,6296,-2674
2,6,3,6,6,3796,7112,-3316
2,6,4,6,6,3985,6929,-2944
2,6,5,6,6,4004,6388,-2384
2,6,6,6,6,4061,5546,-1485
2,6,7,6,6,4056,5279,-1223
2,6,8,6,6,3991,4481,-490
2,6,9,6,6,3916,3634,282
2,6,10,6,6,3942,4007,-65
2,6,11,6,6,4047,4807,-760
2,6,12,6,6,4141,5388,-1247
2,6,13,6,6,4105,5882,-1777
2,6,14,6,6,4067,6524,-2457
2,6,15,6,6,4076,7008,-2932
2,6,16,6,6,4033,7175,-3142
2,6,17,6,6,3969,6676,-2707
2,6,18,6,6,3951,6394,-2443
2,7,0,6,6,3893,5529,-1636
2,7,1,6,6,3957,5535,-1578
2,7,2,6,6,4235,6065,-1830
2,7,3,6,6,4577,6789,-2212
2,7,4,6,6,4771,6510,-1739
2,7,5,6,6,4685,5929,-1244
2,7,6,6,6,4669,5078,-409
2,7,7,6,6,4580,4931,-351
2,7,8,6,6,4391,4193,198
2,7,9,6,6,4188,3466,722
2,7,10,6,6,4263,3800,463
2,7,11,6,6,4497,4455,42
2,7,12,6,6,4717,4987,-270
2,7,13,6,6,4748,5378,-630
2,7,14,6,6,4803,5959,-1156
2,7,15,6,6,4898,6425,-1527
2,7,16,6,6,4854,6636,-1782
2,7,17,6,6,4699,6203,-1504
2,7,18,6,6,4525,5991,-1466
2,8,0,6,6,4380,5379,-999
2,8,1,6,6,4516,5243,-727
2,8,2,6,6,4888,5708,-820
2,8,3,6,6,5364,6376,-1012
2,8,4,6,6,5488,6009,-521
2,8,5,6,6,5264,5537,-273
2,8,6,6,6,5046,4897,149
2,8,7,6,6,4880,4896,-16
2,8,8,6,6,4561,4353,208
2,8,9,6,6,4198,3707,491
2,8,10,6,6,4330,3926,404
2,8,11,6,6,4705,4468,237
2,8,12,6,6,5064,4953,111
2,8,13,6,6,5223,5147,76
2,8,14,6,6,5416,5517,-101
2,8,15,6,6,5622,5964,-342
2,8,16,6,6,5621,6158,-537
2,8,17,6,6,5403,5663,-260
2,8,18,6,6,5105,5527,-422
2,9,0,6,6,4745,5095,-350
2,9,1,6,6,4863,4851,12
2,9,2,6,6,5317,5357,-40
2,9,3,6,6,5908,6080,-172
2,9,4,6,6,5953,5637,316
2,9,5,6,6,5613,5270,343
2,9,6,6,6,5191,4868,323
2,9,7,6,6,4980,4980,0
2,9,8,6,6,4517,4523,-6
2,9,9,6,6,4011,3849,162
2,9,10,6,6,4195,3956,239
2,9,11,6,6,4680,4369,311
2,9,12,6,6,5132,4767,365
2,9,13,6,6,5429,4736,693
2,9,14,6,6,5776,4936,840
2,9,15,6,6,6070,5413,657
2,9,16,6,6,6119,5537,582
2,9,17,6,6,5877,4999,878
2,9,18,6,6,5553,4980,573
2,10,0,6,6,5360,4790,570
2,10,1,6,6,5558,4383,1175
2,10,2,6,6,6082,4833,1249
2,10,3,6,6,6809,5481,1328
2,10,4,6,6,6820,4880,1940
2,10,5,6,6,6403,4566,1837
2,10,6,6,6,5844,4332,1512
2,10,7,6,6,5579,4533,1046
2,10,8,6,6,5010,4173,837
2,10,9,6,6,4389,3530,859
2,10,10,6,6,4638,3574,1064
2,10,11,6,6,5230,3867,1363
2,10,12,6,6,5729,4214,1515
2,10,13,6,6,6149,4008,2141
2,10,14,6,6,6608,4125,2483
2,10,15,6,6,6941,4616,2325
2,10,16,6,6,7021,4736,2285
2,10,17,6,6,6693,4320,2373
2,10,18,6,6,6302,4434,1868
2,11,0,6,6,5694,4350,1344
2,11,1,6,6,5895,3869,2026
2,11,2,6,6,6440,4206,2234
2,11,3,6,6,7249,4765,2484
2,11,4,6,6,7196,4105,3091
2,11,5,6,6,6693,3923,2770
2,11,6,6,6,5978,3868,2110
2,11,7,6,6,5708,4143,1565
2,11,8,6,6,5028,3907,1121
2,11,9,6,6,4284,3287,997
2,11,10,6,6,4599,3313,1286
2,11,11,6,6,5315,3511,1804
2,11,12,6,6,5860,3791,2069
2,11,13,6,6,6355,3427,2928
2,11,14,6,6,6931,3414,3517
2,11,15,6,6,7331,3862,3469
2,11,16,6,6,7452,3944,3508
2,11,17,6,6,7033,3607,3426
2,11,18,6,6,6655,3737,2918
2,12,0,6,6,5604,3997,1607
2,12,1,6,6,5725,3449,2276
2,12,2,6,6,6296,3641,2655
2,12,3,6,6,7112,4139,2973
2,12,4,6,6,6929,3583,3346
2,12,5,6,6,6388,3484,2904
2,12,6,6,6,5546,3548,1998
2,12,7,6,6,5279,3936,1343
2,12,8,6,6,4481,3858,623
2,12,9,6,6,3634,3339,295
2,12,10,6,6,4007,3292,715
2,12,11,6,6,4807,3410,1397
2,12,12,6,6,5388,3603,1785
2,12,13,6,6,5882,3157,2725
2,12,14,6,6,6524,3047,3477
2,12,15,6,6,7008,3344,3664
2,12,16,6,6,7175,3339,3836
2,12,17,6,6,6676,3118,3558
2,12,18,6,6,6394,3234,3160
2,0,0,7,6,4640,4871,-231
2,0,1,7,6,4514,4959,-445
2,0,2,7,6,4318,5311,-993
2,0,3,7,6,4141,5792,-1651
2,0,4,7,6,3981,5963,-1982
2,0,5,7,6,3763,5796,-2033
2,0,6,7,6,3564,5620,-2056
2,0,7,7,6,3459,5471,-2012
2,0,8,7,6,3397,5145,-1748
2,0,9,7,6,3370,4784,-1414
2,0,10,7,6,3363,4916,-1553
2,0,11,7,6,3409,5293,-1884
2,0,12,7,6,3471,5637,-2166
2,0,13,7,6,3618,5776,-2158
2,0,14,7,6,3816,5948,-2132
2,0,15,7,6,3989,6129,-2140
2,0,16,7,6,4181,6116,-1935
2,0,17,7,6,4366,5909,-1543
2,0,18,7,6,4504,5652,-1148
2,1,0,7,6,4498,5368,-870
2,1,1,7,6,4330,5495,-1165
2,1,2,7,6,4115,5929,-1814
2,1,3,7,6,3935,6526,-2591
2,1,4,7,6,3817,6628,-2811
2,1,5,7,6,3665,6355,-2690
2,1,6,7,6,3517,5976,-2459
2,1,7,7,6,3431,5776,-2345
2,1,8,7,6,3365,5338,-1973
2,1,9,7,6,3340,4843,-1503
2,1,10,7,6,3331,5030,-1699
2,1,11,7,6,3383,5519,-2136
2,1,12,7,6,3430,5965,-2535
2,1,13,7,6,3549,6245,-2696
2,1,14,7,6,3721,6539,-2818
2,1,15,7,6,3875,6794,-2919
2,1,16,7,6,4057,6833,-2776
2,1,17,7,6,4242,6575,-2333
2,1,18,7,6,4421,6251,-1830
2,2,0,7,6,4471,5743,-1272
2,2,1,7,6,4316,5879,-1563
2,2,2,7,6,4085,6401,-2316
2,2,3,7,6,3910,7123,-3213
2,2,4,7,6,3849,7132,-3283
2,2,5,7,6,3772,6703,-2931
2,2,6,7,6,3672,6125,-2453
2,2,7,7,6,3596,5855,-2259
2,2,8,7,6,3558,5247,-1689
2,2,9,7,6,3547,4589,-1042
2,2,10,7,6,3540,4850,-1310
2,2,11,7,6,3585,5472,-1887
2,2,12,7,6,3622,6001,-2379
2,2,13,7,6,3723,6440,-2717
2,2,14,7,6,3844,6918,-3074
2,2,15,7,6,3963,7275,-3312
2,2,16,7,6,4131,7362,-3231
2,2,17,7,6,4301,7051,-2750
2,2,18,7,6,4485,6697,-2212
2,3,0,7,6,4196,6244,-2048
2,3,1,7,6,3977,6464,-2487
2,3,2,7,6,3741,7122,-3381
2,3,3,7,6,3558,8013,-4455
2,3,4,7,6,3489,8012,-4523
2,3,5,7,6,3401,7493,-4092
2,3,6,7,6,3283,6779,-3496
2,3,7,7,6,3204,6511,-3307
2,3,8,7,6,3137,5806,-2669
2,3,9,7,6,3094,5044,-1950
2,3,10,7,6,3101,5360,-2259
2,3,11,7,6,3168,6089,-2921
2,3,12,7,6,3233,6664,-3431
2,3,13,7,6,3350,7146,-3796
2,3,14,7,6,3491,7710,-4219
2,3,15,7,6,3641,8101,-4460
2,3,16,7,6,3817,8175,-4358
2,3,17,7,6,4006,7710,-3704
2,3,18,7,6,4230,7289,-3059
2,4,0,7,6,4075,6484,-2409
2,4,1,7,6,3875,6689,-2814
2,4,2,7,6,3754,7390,-3636
2,4,3,7,6,3691,8332,-4641
2,4,4,7,6,3710,8204,-4494
2,4,5,7,6,3652,7604,-3952
2,4,6,7,6,3587,6765,-3178
2,4,7,7,6,3560,6466,-2906
2,4,8,7,6,3520,5638,-2118
2,4,9,7,6,3466,4759,-1293
2,4,10,7,6,3476,5143,-1667
2,4,11,7,6,3532,5991,-2459
2,4,12,7,6,3591,6630,-3039
2,4,13,7,6,3640,7117,-3477
2,4,14,7,6,3711,7770,-4059
2,4,15,7,6,3810,8283,-4473
2,4,16,7,6,3902,8430,-4528
2,4,17,7,6,4024,7862,-3838
2,4,18,7,6,4193,7478,-3285
2,5,0,7,6,4247,6495,-2248
2,5,1,7,6,4151,6563,-2412
2,5,2,7,6,4203,7170,-2967
2,5,3,7,6,4326,8022,-3696
2,5,4,7,6,4464,7728,-3264
2,5,5,7,6,4425,7024,-2599
2,5,6,7,6,4438,6087,-1649
2,5,7,7,6,4429,5858,-1429
2,5,8,7,6,4390,5007,-617
2,5,9,7,6,4311,4151,160
2,5,10,7,6,4335,4533,-198
2,5,11,7,6,4428,5325,-897
2,5,12,7,6,4515,5980,-1465
2,5,13,7,6,4495,6440,-1945
2,5,14,7,6,4499,7132,-2633
2,5,15,7,6,4559,7713,-3154
2,5,16,7,6,4569,7962,-3393
2,5,17,7,6,4568,7477,-2909
2,5,18,7,6,4600,7158,-2558
2,6,0,7,6,4504,6357,-1853
2,6,1,7,6,4515,6245,-1730
2,6,2,7,6,4727,6784,-2057
2,6,3,7,6,5029,7591,-2562
2,6,4,7,6,5203,7201,-1998
2,6,5,7,6,5099,6648,-1549
2,6,6,7,6,5070,5848,-778
2,6,7,7,6,4983,5787,-804
2,6,8,7,6,4805,5107,-302
2,6,9,7,6,4601,4303,298
2,6,10,7,6,4675,4579,96
2,6,11,7,6,4917,5264,-347
2,6,12,7,6,5134,5873,-739
2,6,13,7,6,5167,6175,-1008
2,6,14,7,6,5240,6662,-1422
2,6,15,7,6,5364,7195,-1831
2,6,16,7,6,5359,7420,-2061
2,6,17,7,6,5243,6873,-1630
2,6,18,7,6,5118,6654,-1536
2,7,0,7,6,4871,6083,-1212
2,7,1,7,6,4959,5830,-871
2,7,2,7,6,5311,6398,-1087
2,7,3,7,6,5792,7242,-1450
2,7,4,7,6,5963,6777,-814
2,7,5,7,6,5796,6361,-565
2,7,6,7,6,5620,5798,-178
2,7,7,7,6,5471,5876,-405
2,7,8,7,6,5145,5300,-155
2,7,9,7,6,4784,4494,290
2,7,10,7,6,4916,4656,260
2,7,11,7,6,5293,5183,110
2,7,12,7,6,5637,5668,-31
2,7,13,7,6,5776,5758,18
2,7,14,7,6,5948,6059,-111
2,7,15,7,6,6129,6585,-456
2,7,16,7,6,6116,6749,-633
2,7,17,7,6,5909,6171,-262
2,7,18,7,6,5652,6126,-474
2,8,0,7,6,5368,5788,-420
2,8,1,7,6,5495,5399,96
2,8,2,7,6,5929,5917,12
2,8,3,7,6,6526,6696,-170
2,8,4,7,6,6628,6059,569
2,8,5,7,6,6355,5656,699
2,8,6,7,6,5976,5266,710
2,8,7,7,6,5776,5408,368
2,8,8,7,6,5338,4903,435
2,8,9,7,6,4843,4108,735
2,8,10,7,6,5030,4229,801
2,8,11,7,6,5519,4659,860
2,8,12,7,6,5965,5083,882
2,8,13,7,6,6245,5019,1226
2,8,14,7,6,6539,5267,1272
2,8,15,7,6,6794,5821,973
2,8,16,7,6,6833,5979,854
2,8,17,7,6,6575,5494,1081
2,8,18,7,6,6251,5578,673
2,9,0,7,6,5743,5234,509
2,9,1,7,6,5879,4775,1104
2,9,2,7,6,6401,5246,1155
2,9,3,7,6,7123,5969,1154
2,9,4,7,6,7132,5297,1835
2,9,5,7,6,6703,5013,1690
2,9,6,7,6,6125,4803,1322
2,9,7,7,6,5855,5075,780
2,9,8,7,6,5247,4703,544
2,9,9,7,6,4589,3942,647
2,9,10,7,6,4850,4035,815
2,9,11,7,6,5472,4370,1102
2,9,12,7,6,6001,4726,1275
2,9,13,7,6,6440,4424,2016
2,9,14,7,6,6918,4516,2402
2,9,15,7,6,7275,5022,2253
2,9,16,7,6,7362,5098,2264
2,9,17,7,6,7051,4624,2427
2,9,18,7,6,6697,4724,1973
2,10,0,7,6,6244,4787,1457
2,10,1,7,6,6464,4243,2221
2,10,2,7,6,7122,4591,2531
2,10,3,7,6,8013,5222,2791
2,10,4,7,6,8012,4591,3421
2,10,5,7,6,7493,4395,3098
2,10,6,7,6,6779,4335,2444
2,10,7,7,6,6511,4694,1817
2,10,8,7,6,5806,4468,1338
2,10,9,7,6,5044,3814,1230
2,10,10,7,6,5360,3836,1524
2,10,11,7,6,6089,4086,2003
2,10,12,7,6,6664,4373,2291
2,10,13,7,6,7146,3919,3227
2,10,14,7,6,7710,3886,3824
2,10,15,7,6,8101,4296,3805
2,10,16,7,6,8175,4317,3858
2,10,17,7,6,7710,3947,3763
2,10,18,7,6,7289,4057,3232
2,0,0,8,6,5131,6366,-1235
2,0,1,8,6,4957,6511,-1554
2,0,2,8,6,4741,7013,-2272
2,0,3,8,6,4569,7741,-3172
2,0,4,8,6,4456,7807,-3351
2,0,5,8,6,4295,7445,-3150
2,0,6,8,6,4138,6910,-2772
2,0,7,8,6,4050,6651,-2601
2,0,8,8,6,3981,6068,-2087
2,0,9,8,6,3956,5421,-1465
2,0,10,8,6,3949,5685,-1736
2,0,11,8,6,3997,6311,-2314
2,0,12,8,6,4044,6834,-2790
2,0,13,8,6,4171,7256,-3085
2,0,14,8,6,4348,7681,-3333
2,0,15,8,6,4496,7999,-3503
2,0,16,8,6,4676,8076,-3400
2,0,17,8,6,4872,7749,-2877
2,0,18,8,6,5051,7395,-2344
2,1,0,8,6,5121,6627,-1506
2,1,1,8,6,4962,6785,-1823
2,1,2,8,6,4727,7441,-2714
2,1,3,8,6,4553,8327,-3774
2,1,4,8,6,4492,8324,-3832
2,1,5,8,6,4407,7793,-3386
2,1,6,8,6,4302,7060,-2758
2,1,7,8,6,4227,6787,-2560
2,1,8,8,6,4186,6043,-1857
2,1,9,8,6,4172,5244,-1072
2,1,10,8,6,4166,5572,-1406
2,1,11,8,6,4222,6331,-2109
2,1,12,8,6,4263,6936,-2673
2,1,13,8,6,4365,7437,-3072
2,1,14,8,6,4484,8020,-3536
2,1,15,8,6,4599,8435,-3836
2,1,16,8,6,4771,8516,-3745
2,1,17,8,6,4940,8068,-3128
2,1,18,8,6,5119,7684,-2565
2,2,0,8,6,4854,7034,-2180
2,2,1,8,6,4637,7258,-2621
2,2,2,8,6,4404,8072,-3668
2,2,3,8,6,4224,9096,-4872
2,2,4,8,6,4161,9020,-4859
2,2,5,8,6,4072,8404,-4332
2,2,6,8,6,3953,7566,-3613
2,2,7,8,6,3872,7269,-3397
2,2,8,8,6,3795,6416,-2621
2,2,9,8,6,3747,5519,-1772
2,2,10,8,6,3752,5904,-2152
2,2,11,8,6,3827,6765,-2938
2,2,12,8,6,3894,7434,-3540
2,2,13,8,6,4014,7908,-3894
2,2,14,8,6,4154,8549,-4395
2,2,15,8,6,4297,9053,-4756
2,2,16,8,6,4472,9153,-4681
2,2,17,8,6,4659,8539,-3880
2,2,18,8,6,4880,8112,-3232
2,3,0,8,6,4746,7375,-2629
2,3,1,8,6,4546,7527,-2981
2,3,2,8,6,4423,8264,-3841
2,3,3,8,6,4322,9242,-4920
2,3,4,8,6,4305,9003,-4698
2,3,5,8,6,4201,8240,-4039
2,3,6,8,6,4084,7306,-3222
2,3,7,8,6,4007,7045,-3038
2,3,8,8,6,3915,6164,-2249
2,3,9,8,6,3854,5276,-1422
2,3,10,8,6,3862,5669,-1807
2,3,11,8,6,3942,6509,-2567
2,3,12,8,6,4037,7222,-3185
2,3,13,8,6,4141,7675,-3534
2,3,14,8,6,4270,8378,-4108
2,3,15,8,6,4411,8988,-4577
2,3,16,8,6,4540,9217,-4677
2,3,17,8,6,4683,8663,-3980
2,3,18,8,6,4864,8242,-3378
2,4,0,8,6,4955,7323,-2368
2,4,1,8,6,4839,7273,-2434
2,4,2,8,6,4848,7889,-3041
2,4,3,8,6,4911,8824,-3913
2,4,4,8,6,4985,8419,-3434
2,4,5,8,6,4868,7743,-2875
2,4,6,8,6,4806,6857,-2051
2,4,7,8,6,4747,6714,-1967
2,4,8,8,6,4677,5921,-1244
2,4,9,8,6,4591,4988,-397
2,4,10,8,6,4612,5312,-700
2,4,11,8,6,4716,6134,-1418
2,4,12,8,6,4833,6866,-2033
2,4,13,8,6,4875,7237,-2362
2,4,14,8,6,4957,7835,-2878
2,4,15,8,6,5085,8483,-3398
2,4,16,8,6,5157,8746,-3589
2,4,17,8,6,5210,8147,-2937
2,4,18,8,6,5277,7821,-2544
2,5,0,8,6,5213,7061,-1848
2,5,1,8,6,5179,6832,-1653
2,5,2,8,6,5308,7474,-2166
2,5,3,8,6,5559,8457,-2898
2,5,4,8,6,5682,7969,-2287
2,5,5,8,6,5520,7472,-1952
2,5,6,8,6,5447,6749,-1302
2,5,7,8,6,5356,6767,-1411
2,5,8,8,6,5204,6054,-850
2,5,9,8,6,4996,5090,-94
2,5,10,8,6,5068,5309,-241
2,5,11,8,6,5298,5979,-681
2,5,12,8,6,5508,6588,-1080
2,5,13,8,6,5557,6786,-1229
2,5,14,8,6,5672,7204,-1532
2,5,15,8,6,5847,7816,-1969
2,5,16,8,6,5895,8011,-2116
2,5,17,8,6,5842,7381,-1539
2,5,18,8,6,5767,7253,-1486
2,6,0,8,6,5482,6776,-1294
2,6,1,8,6,5517,6378,-861
2,6,2,8,6,5803,6958,-1155
2,6,3,8,6,6244,7858,-1614
2,6,4,8,6,6395,7199,-804
2,6,5,8,6,6210,6747,-537
2,6,6,8,6,6021,6196,-175
2,6,7,8,6,5874,6304,-430
2,6,8,8,6,5559,5680,-121
2,6,9,8,6,5197,4753,444
2,6,10,8,6,5328,4929,399
2,6,11,8,6,5713,5473,240
2,6,12,8,6,6054,5984,70
2,6,13,8,6,6195,6041,154
2,6,14,8,6,6385,6390,-5
2,6,15,8,6,6595,6993,-398
2,6,16,8,6,6621,7191,-570
2,6,17,8,6,6453,6666,-213
2,6,18,8,6,6245,6724,-479
2,7,0,8,6,5859,6232,-373
2,7,1,8,6,5938,5791,147
2,7,2,8,6,6352,6330,22
2,7,3,8,6,6954,7184,-230
2,7,4,8,6,7103,6476,627
2,7,5,8,6,6887,6103,784
2,7,6,8,6,6550,5737,813
2,7,7,8,6,6367,5950,417
2,7,8,8,6,5922,5433,489
2,7,9,8,6,5429,4520,909
2,7,10,8,6,5616,4690,926
2,7,11,8,6,6107,5162,945
2,7,12,8,6,6538,5595,943
2,7,13,8,6,6798,5435,1363
2,7,14,8,6,7071,5658,1413
2,7,15,8,6,7301,6227,1074
2,7,16,8,6,7328,6341,987
2,7,17,8,6,7081,5798,1283
2,7,18,8,6,6798,5868,930
2,8,0,8,6,6366,5671,695
2,8,1,8,6,6511,5149,1362
2,8,2,8,6,7013,5631,1382
2,8,3,8,6,7741,6426,1315
2,8,4,8,6,7807,5783,2024
2,8,5,8,6,7445,5485,1960
2,8,6,8,6,6910,5270,1640
2,8,7,8,6,6651,5626,1025
2,8,8,8,6,6068,5264,804
2,8,9,8,6,5421,4469,952
2,8,10,8,6,5685,4558,1127
2,8,11,8,6,6311,4945,1366
2,8,12,8,6,6834,5308,1526
2,8,13,8,6,7256,4916,2340
2,8,14,8,6,7681,4988,2693
2,8,15,8,6,7999,5456,2543
2,8,16,8,6,8076,5471,2605
2,8,17,8,6,7749,4964,2785
2,8,18,8,6,7395,5044,2351
2,0,0,9,6,5754,7417,-1663
2,0,1,9,6,5589,7579,-1990
2,0,2,9,6,5353,8391,-3038
2,0,3,9,6,5187,9410,-4223
2,0,4,9,6,5131,9332,-4201
2,0,5,9,6,5037,8704,-3667
2,0,6,9,6,4923,7847,-2924
2,0,7,9,6,4846,7545,-2699
2,0,8,9,6,4802,6653,-1851
2,0,9,9,6,4788,5719,-931
2,0,10,9,6,4784,6116,-1332
2,0,11,9,6,4836,7007,-2171
2,0,12,9,6,4877,7706,-2829
2,0,13,9,6,4987,8199,-3212
2,0,14,9,6,5111,8859,-3748
2,0,15,9,6,5220,9387,-4167
2,0,16,9,6,5390,9494,-4104
2,0,17,9,6,5570,8897,-3327
2,0,18,9,6,5749,8507,-2758
2,1,0,9,6,5504,7925,-2421
2,1,1,9,6,5283,8096,-2813
2,1,2,9,6,5046,8946,-3900
2,1,3,9,6,4867,10006,-5139
2,1,4,9,6,4804,9819,-5015
2,1,5,9,6,4707,9040,-4333
2,1,6,9,6,4583,8107,-3524
2,1,7,9,6,4503,7848,-3345
2,1,8,9,6,4423,6942,-2519
2,1,9,9,6,4372,6036,-1664
2,1,10,9,6,4378,6430,-2052
2,1,11,9,6,4464,7283,-2819
2,1,12,9,6,4535,8026,-3491
2,1,13,9,6,4656,8466,-3810
2,1,14,9,6,4794,9157,-4363
2,1,15,9,6,4933,9758,-4825
2,1,16,9,6,5112,9940,-4828
2,1,17,9,6,5298,9340,-4042
2,1,18,9,6,5514,8876,-3362
2,2,0,9,6,5404,8203,-2799
2,2,1,9,6,5206,8237,-3031
2,2,2,9,6,5086,8983,-3897
2,2,3,9,6,4988,10044,-5056
2,2,4,9,6,4977,9694,-4717
2,2,5,9,6,4872,8959,-4087
2,2,6,9,6,4754,8076,-3322
2,2,7,9,6,4675,7901,-3226
2,2,8,9,6,4573,7078,-2505
2,2,9,9,6,4507,6113,-1606
2,2,10,9,6,4513,6448,-1935
2,2,11,9,6,4601,7318,-2717
2,2,12,9,6,4698,8108,-3410
2,2,13,9,6,4805,8472,-3667
2,2,14,9,6,4933,9081,-4148
2,2,15,9,6,5067,9758,-4691
2,2,16,9,6,5195,10001,-4806
2,2,17,9,6,5336,9333,-3997
2,2,18,9,6,5514,8905,-3391
2,3,0,9,6,5626,8027,-2401
2,3,1,9,6,5510,7860,-2350
2,3,2,9,6,5517,8579,-3062
2,3,3,9,6,5542,9690,-4148
2,3,4,9,6,5580,9187,-3607
2,3,5,9,6,5417,8567,-3150
2,3,6,9,6,5303,7758,-2455
2,3,7,9,6,5194,7694,-2500
2,3,8,9,6,5072,6868,-1796
2,3,9,9,6,4979,5775,-796
2,3,10,9,6,4998,6042,-1044
2,3,11,9,6,5126,6849,-1723
2,3,12,9,6,5279,7581,-2302
2,3,13,9,6,5376,7848,-2472
2,3,14,9,6,5516,8377,-2861
2,3,15,9,6,5686,9104,-3418
2,3,16,9,6,5795,9337,-3542
2,3,17,9,6,5869,8655,-2786
2,3,18,9,6,5948,8420,-2472
2,4,0,9,6,5921,7754,-1833
2,4,1,9,6,5867,7380,-1513
2,4,2,9,6,5953,8034,-2081
2,4,3,9,6,6144,9073,-2929
2,4,4,9,6,6203,8391,-2188
2,4,5,9,6,5963,7858,-1895
2,4,6,9,6,5815,7147,-1332
2,4,7,9,6,5674,7195,-1521
2,4,8,9,6,5491,6434,-943
2,4,9,9,6,5276,5349,-73
2,4,10,9,6,5345,5582,-237
2,4,11,9,6,5586,6269,-683
2,4,12,9,6,5826,6904,-1078
2,4,13,9,6,5937,7069,-1132
2,4,14,9,6,6130,7535,-1405
2,4,15,9,6,6373,8224,-1851
2,4,16,9,6,6483,8453,-1970
2,4,17,9,6,6484,7876,-1392
2,4,18,9,6,6444,7851,-1407
2,5,0,9,6,6191,7220,-1029
2,5,1,9,6,6181,6770,-589
2,5,2,9,6,6384,7371,-987
2,5,3,9,6,6774,8346,-1572
2,5,4,9,6,6874,7616,-742
2,5,5,9,6,6631,7194,-563
2,5,6,9,6,6398,6667,-269
2,5,7,9,6,6247,6846,-599
2,5,8,9,6,5958,6210,-252
2,5,9,9,6,5592,5165,427
2,5,10,9,6,5721,5390,331
2,5,11,9,6,6094,5976,118
2,5,12,9,6,6428,6496,-68
2,5,13,9,6,6585,6457,128
2,5,14,9,6,6817,6781,36
2,5,15,9,6,7078,7399,-321
2,5,16,9,6,7157,7553,-396
2,5,17,9,6,7052,6970,82
2,5,18,9,6,6894,7014,-120
2,6,0,9,6,6470,6669,-199
2,6,1,9,6,6496,6165,331
2,6,2,9,6,6844,6715,129
2,6,3,9,6,7406,7641,-235
2,6,4,9,6,7535,6962,573
2,6,5,9,6,7301,6575,726
2,6,6,9,6,6951,6204,747
2,6,7,9,6,6770,6501,269
2,6,8,9,6,6336,5994,342
2,6,9,9,6,5842,5047,795
2,6,10,9,6,6028,5213,815
2,6,11,9,6,6527,5737,790
2,6,12,9,6,6955,6177,778
2,6,13,9,6,7217,5927,1290
2,6,14,9,6,7508,6130,1378
2,6,15,9,6,7767,6661,1106
2,6,16,9,6,7833,6714,1119
2,6,17,9,6,7625,6138,1487
2,6,18,9,6,7391,6188,1203
2,0,0,10,6,6137,8753,-2616
2,0,1,10,6,5910,8806,-2896
2,0,2,10,6,5672,9665,-3993
2,0,3,10,6,5501,10808,-5307
2,0,4,10,6,5443,10510,-5067
2,0,5,10,6,5337,9759,-4422
2,0,6,10,6,5204,8877,-3673
2,0,7,10,6,5122,8704,-3582
2,0,8,10,6,5039,7856,-2817
2,0,9,10,6,4988,6873,-1885
2,0,10,10,6,4996,7209,-2213
2,0,11,10,6,5078,8092,-3014
2,0,12,10,6,5149,8912,-3763
2,0,13,10,6,5278,9263,-3985
2,0,14,10,6,5421,9860,-4439
2,0,15,10,6,5554,10528,-4974
2,0,16,10,6,5731,10724,-4993
2,0,17,10,6,5928,10010,-4082
2,0,18,10,6,6144,9539,-3395
2,1,0,10,6,6054,8907,-2853
2,1,1,10,6,5852,8824,-2972
2,1,2,10,6,5728,9673,-3945
2,1,3,10,6,5631,10910,-5279
2,1,4,10,6,5620,10462,-4842
2,1,5,10,6,5507,9783,-4276
2,1,6,10,6,5384,8977,-3593
2,1,7,10,6,5306,8881,-3575
2,1,8,10,6,5201,8025,-2824
2,1,9,10,6,5132,6900,-1768
2,1,10,10,6,5139,7178,-2039
2,1,11,10,6,5238,8033,-2795
2,1,12,10,6,5339,8823,-3484
2,1,13,10,6,5447,9083,-3636
2,1,14,10,6,5573,9623,-4050
2,1,15,10,6,5703,10379,-4676
2,1,16,10,6,5835,10592,-4757
2,1,17,10,6,5975,9841,-3866
2,1,18,10,6,6148,9504,-3356
2,2,0,10,6,6284,8720,-2436
2,2,1,10,6,6170,8408,-2238
2,2,2,10,6,6180,9139,-2959
2,2,3,10,6,6208,10306,-4098
2,2,4,10,6,6252,9609,-3357
2,2,5,10,6,6088,8953,-2865
2,2,6,10,6,5973,8156,-2183
2,2,7,10,6,5862,8122,-2260
2,2,8,10,6,5730,7248,-1518
2,2,9,10,6,5632,6034,-402
2,2,10,10,6,5649,6315,-666
2,2,11,10,6,5785,7139,-1354
2,2,12,10,6,5940,7897,-1957
2,2,13,10,6,6040,8131,-2091
2,2,14,10,6,6179,8708,-2529
2,2,15,10,6,6342,9512,-3170
2,2,16,10,6,6450,9779,-3329
2,2,17,10,6,6522,9150,-2628
2,2,18,10,6,6598,9018,-2420
2,3,0,10,6,6592,8198,-1606
2,3,1,10,6,6538,7772,-1234
2,3,2,10,6,6622,8447,-1825
2,3,3,10,6,6775,9561,-2786
2,3,4,10,6,6798,8808,-2010
2,3,5,10,6,6512,8305,-1793
2,3,6,10,6,6312,7618,-1306
2,3,7,10,6,6121,7737,-1616
2,3,8,10,6,5886,6964,-1078
2,3,9,10,6,5664,5761,-97
2,3,10,10,6,5731,6043,-312
2,3,11,10,6,5996,6772,-776
2,3,12,10,6,6272,7416,-1144
2,3,13,10,6,6438,7485,-1047
2,3,14,10,6,6689,7926,-1237
2,3,15,10,6,6974,8630,-1656
2,3,16,10,6,7121,8815,-1694
2,3,17,10,6,7143,8180,-1037
2,3,18,10,6,7115,8141,-1026
2,4,0,10,6,6899,7657,-758
2,4,1,10,6,6869,7144,-275
2,4,2,10,6,7029,7756,-727
2,4,3,10,6,7359,8803,-1444
2,4,4,10,6,7395,8102,-707
2,4,5,10,6,7074,7666,-592
2,4,6,10,6,6766,7134,-368
2,4,7,10,6,6565,7397,-832
2,4,8,10,6,6245,6771,-526
2,4,9,10,6,5872,5692,180
2,4,10,10,6,5998,5913,85
2,4,11,10,6,6382,6551,-169
2,4,12,10,6,6746,7078,-332
2,4,13,10,6,6965,6949,16
2,4,14,10,6,7275,7253,22
2,4,15,10,6,7604,7833,-229
2,4,16,10,6,7745,7926,-181
2,4,17,10,6,7694,7310,384
2,4,18,10,6,7571,7334,237
2,0,0,11,6,6687,9600,-2913
2,0,1,11,6,6479,9372,-2893
2,0,2,11,6,6354,10233,-3879
2,0,3,11,6,6265,11526,-5261
2,0,4,11,6,6259,10884,-4625
2,0,5,11,6,6137,10169,-4032
2,0,6,11,6,6005,9375,-3370
2,0,7,11,6,5925,9309,-3384
2,0,8,11,6,5817,8405,-2588
2,0,9,11,6,5748,7159,-1411
2,0,10,11,6,5757,7451,-1694
2,0,11,11,6,5852,8323,-2471
2,0,12,11,6,5953,9139,-3186
2,0,13,11,6,6069,9366,-3297
2,0,14,11,6,6200,9954,-3754
2,0,15,11,6,6324,10787,-4463
2,0,16,11,6,6454,11034,-4580
2,0,17,11,6,6605,10336,-3731
2,0,18,11,6,6778,10102,-3324
2,1,0,11,6,6934,9164,-2230
2,1,1,11,6,6816,8800,-1984
2,1,2,11,6,6822,9552,-2730
2,1,3,11,6,6851,10794,-3943
2,1,4,11,6,6895,10026,-3131
2,1,5,11,6,6723,9400,-2677
2,1,6,11,6,6603,8627,-2024
2,1,7,11,6,6493,8664,-2171
2,1,8,11,6,6358,7778,-1420
2,1,9,11,6,6257,6446,-189
2,1,10,11,6,6275,6776,-501
2,1,11,11,6,6422,7642,-1220
2,1,12,11,6,6581,8409,-1828
2,1,13,11,6,6682,8547,-1865
2,1,14,11,6,6819,9099,-2280
2,1,15,11,6,6978,9918,-2940
2,1,16,11,6,7090,10141,-3051
2,1,17,11,6,7161,9454,-2293
2,1,18,11,6,7232,9308,-2076
2,2,0,11,6,7250,8635,-1385
2,2,1,11,6,7198,8146,-948
2,2,2,11,6,7285,8832,-1547
2,2,3,11,6,7441,10018,-2577
2,2,4,11,6,7470,9294,-1824
2,2,5,11,6,7183,8777,-1594
2,2,6,11,6,6982,8085,-1103
2,2,7,11,6,6789,8288,-1499
2,2,8,11,6,6544,7525,-981
2,2,9,11,6,6317,6288,29
2,2,10,11,6,6382,6566,-184
2,2,11,11,6,6655,7347,-692
2,2,12,11,6,6933,7998,-1065
2,2,13,11,6,7102,7977,-875
2,2,14,11,6,7352,8398,-1046
2,2,15,11,6,7630,9064,-1434
2,2,16,11,6,7776,9188,-1412
2,2,17,11,6,7796,8520,-724
2,2,18,11,6,7765,8461,-696
2,0,0,12,6,7567,9601,-2034
2,0,1,12,6,7443,9174,-1731
2,0,2,12,6,7448,9937,-2489
2,0,3,12,6,7485,11251,-3766
2,0,4,12,6,7534,10512,-2978
2,0,5,12,6,7353,9872,-2519
2,0,6,12,6,7224,9094,-1870
2,0,7,12,6,7112,9215,-2103
2,0,8,12,6,6974,8339,-1365
2,0,9,12,6,6873,6973,-100
2,0,10,12,6,6893,7299,-406
2,0,11,12,6,7036,8217,-1181
2,0,12,12,6,7195,8991,-1796
2,0,13,12,6,7304,9039,-1735
2,0,14,12,6,7446,9571,-2125
2,0,15,12,6,7599,10352,-2753
2,0,16,12,6,7709,10514,-2805
2,0,17,12,6,7791,9794,-2003
2,0,18,12,6,7862,9628,-1766
2,0,0,1,7,737,752,-15
2,0,1,1,7,733,753,-20
2,0,2,1,7,730,750,-20
2,0,3,1,7,737,749,-12
2,0,4,1,7,741,747,-6
2,0,5,1,7,732,738,-6
2,0,6,1,7,723,733,-10
2,0,7,1,7,722,735,-13
2,0,8,1,7,720,733,-13
2,0,9,1,7,721,732,-11
2,0,10,1,7,716,741,-25
2,0,11,1,7,716,744,-28
2,0,12,1,7,724,745,-21
2,0,13,1,7,730,744,-14
2,0,14,1,7,725,741,-16
2,0,15,1,7,724,747,-23
2,0,16,1,7,728,754,-26
2,0,17,1,7,732,741,-9
2,1,0,1,7,752,766,-14
2,1,1,1,7,753,778,-25
2,1,2,1,7,750,778,-28
2,1,3,1,7,749,779,-30
2,1,4,1,7,747,781,-34
2,1,5,1,7,738,778,-40
2,1,6,1,7,733,776,-43
2,1,7,1,7,735,776,-41
2,1,8,1,7,733,768,-35
2,1,9,1,7,732,764,-32
2,1,10,1,7,741,768,-27
2,1,11,1,7,744,768,-24
2,1,12,1,7,745,770,-25
2,1,13,1,7,744,771,-27
2,1,14,1,7,741,766,-25
2,1,15,1,7,747,766,-19
2,1,16,1,7,754,770,-16
2,1,17,1,7,741,759,-18
2,2,0,1,7,766,783,-17
2,2,1,1,7,778,786,-8
2,2,2,1,7,778,741,37
2,2,3,1,7,779,700,79
2,2,4,1,7,781,661,120
2,2,5,1,7,778,612,166
2,2,6,1,7,776,559,217
2,2,7,1,7,776,510,266
2,2,8,1,7,768,460,308
2,2,9,1,7,764,455,309
2,2,10,1,7,768,476,292
2,2,11,1,7,768,509,259
2,2,12,1,7,770,563,207
2,2,13,1,7,771,622,149
2,2,14,1,7,766,666,100
2,2,15,1,7,766,705,61
2,2,16,1,7,770,749,21
2,2,17,1,7,759,770,-11
2,3,0,1,7,783,802,-19
2,3,1,1,7,786,764,22
2,3,2,1,7,741,699,42
2,3,3,1,7,700,636,64
2,3,4,1,7,661,569,92
2,3,5,1,7,612,488,124
2,3,6,1,7,559,412,147
2,3,7,1,7,510,363,147
2,3,8,1,7,460,334,126
2,3,9,1,7,455,328,127
2,3,10,1,7,476,336,140
2,3,11,1,7,509,363,146
2,3,12,1,7,563,424,139
2,3,13,1,7,622,503,119
2,3,14,1,7,666,573,93
2,3,15,1,7,705,636,69
2,3,16,1,7,749,701,48
2,3,17,1,7,770,752,18
2,4,0,1,7,802,778,24
2,4,1,1,7,764,703,61
2,4,2,1,7,699,650,49
2,4,3,1,7,636,598,38
2,4,4,1,7,569,546,23
2,4,5,1,7,488,486,2
2,4,6,1,7,412,442,-30
2,4,7,1,7,363,438,-75
2,4,8,1,7,334,464,-130
2,4,9,1,7,328,461,-133
2,4,10,1,7,336,448,-112
2,4,11,1,7,363,439,-76
2,4,12,1,7,424,455,-31
2,4,13,1,7,503,497,6
2,4,14,1,7,573,548,25
2,4,15,1,7,636,602,34
2,4,16,1,7,701,654,47
2,4,17,1,7,752,707,45
2,5,0,1,7,778,678,100
2,5,1,1,7,703,616,87
2,5,2,1,7,650,561,89
2,5,3,1,7,598,521,77
2,5,4,1,7,546,501,45
2,5,5,1,7,486,483,3
2,5,6,1,7,442,470,-28
2,5,7,1,7,438,472,-34
2,5,8,1,7,464,482,-18
2,5,9,1,7,461,481,-20
2,5,10,1,7,448,489,-41
2,5,11,1,7,439,486,-47
2,5,12,1,7,455,488,-33
2,5,13,1,7,497,506,-9
2,5,14,1,7,548,534,14
2,5,15,1,7,602,573,29
2,5,16,1,7,654,621,33
2,5,17,1,7,707,659,48
2,6,0,1,7,678,573,105
2,6,1,1,7,616,548,68
2,6,2,1,7,561,518,43
2,6,3,1,7,521,524,-3
2,6,4,1,7,501,572,-71
2,6,5,1,7,483,631,-148
2,6,6,1,7,470,673,-203
2,6,7,1,7,472,689,-217
2,6,8,1,7,482,681,-199
2,6,9,1,7,481,682,-201
2,6,10,1,7,489,685,-196
2,6,11,1,7,486,672,-186
2,6,12,1,7,488,652,-164
2,6,13,1,7,506,630,-124
2,6,14,1,7,534,604,-70
2,6,15,1,7,573,591,-18
2,6,16,1,7,621,605,16
2,6,17,1,7,659,631,28
2,7,0,1,7,573,758,-185
2,7,1,1,7,548,753,-205
2,7,2,1,7,518,739,-221
2,7,3,1,7,524,753,-229
2,7,4,1,7,572,805,-233
2,7,5,1,7,631,879,-248
2,7,6,1,7,673,931,-258
2,7,7,1,7,689,942,-253
2,7,8,1,7,681,959,-278
2,7,9,1,7,682,970,-288
2,7,10,1,7,685,969,-284
2,7,11,1,7,672,970,-298
2,7,12,1,7,652,962,-310
2,7,13,1,7,630,909,-279
2,7,14,1,7,604,862,-258
2,7,15,1,7,591,852,-261
2,7,16,1,7,605,832,-227
2,7,17,1,7,631,829,-198
2,8,0,1,7,758,427,331
2,8,1,1,7,753,388,365
2,8,2,1,7,739,383,356
2,8,3,1,7,753,355,398
2,8,4,1,7,805,341,464
2,8,5,1,7,879,336,543
2,8,6,1,7,931,320,611
2,8,7,1,7,942,304,638
2,8,8,1,7,959,264,695
2,8,9,1,7,970,253,717
2,8,10,1,7,969,271,698
2,8,11,1,7,970,308,662
2,8,12,1,7,962,330,632
2,8,13,1,7,909,338,571
2,8,14,1,7,862,361,501
2,8,15,1,7,852,394,458
2,8,16,1,7,832,417,415
2,8,17,1,7,829,461,368
2,9,0,1,7,427,673,-246
2,9,1,1,7,388,726,-338
2,9,2,1,7,383,824,-441
2,9,3,1,7,355,892,-537
2,9,4,1,7,341,948,-607
2,9,5,1,7,336,919,-583
2,9,6,1,7,320,926,-606
2,9,7,1,7,304,935,-631
2,9,8,1,7,264,902,-638
2,9,9,1,7,253,889,-636
2,9,10,1,7,271,906,-635
2,9,11,1,7,308,923,-615
2,9,12,1,7,330,916,-586
2,9,13,1,7,338,911,-573
2,9,14,1,7,361,894,-533
2,9,15,1,7,394,852,-458
2,9,16,1,7,417,822,-405
2,9,17,1,7,461,783,-322
2,10,0,1,7,673,1103,-430
2,10,1,1,7,726,1194,-468
2,10,2,1,7,824,1310,-486
2,10,3,1,7,892,1398,-506
2,10,4,1,7,948,1469,-521
2,10,5,1,7,919,1394,-475
2,10,6,1,7,926,1410,-484
2,10,7,1,7,935,1387,-452
2,10,8,1,7,902,1341,-439
2,10,9,1,7,889,1314,-425
2,10,10,1,7,906,1378,-472
2,10,11,1,7,923,1420,-497
2,10,12,1,7,916,1426,-510
2,10,13,1,7,911,1446,-535
2,10,14,1,7,894,1459,-565
2,10,15,1,7,852,1444,-592
2,10,16,1,7,822,1428,-606
2,10,17,1,7,783,1320,-537
2,11,0,1,7,1103,1179,-76
2,11,1,1,7,1194,1252,-58
2,11,2,1,7,1310,1337,-27
2,11,3,1,7,1398,1344,54
2,11,4,1,7,1469,1332,137
2,11,5,1,7,1394,1210,184
2,11,6,1,7,1410,1140,270
2,11,7,1,7,1387,1038,349
2,11,8,1,7,1341,917,424
2,11,9,1,7,1314,844,470
2,11,10,1,7,1378,984,394
2,11,11,1,7,1420,1108,312
2,11,12,1,7,1426,1193,233
2,11,13,1,7,1446,1284,162
2,11,14,1,7,1459,1391,68
2,11,15,1,7,1444,1485,-41
2,11,16,1,7,1428,1525,-97
2,11,17,1,7,1320,1405,-85
2,12,0,1,7,1179,1148,31
2,12,1,1,7,1252,1235,17
2,12,2,1,7,1337,1325,12
2,12,3,1,7,1344,1315,29
2,12,4,1,7,1332,1298,34
2,12,5,1,7,1210,1204,6
2,12,6,1,7,1140,1061,79
2,12,7,1,7,1038,987,51
2,12,8,1,7,917,845,72
2,12,9,1,7,844,753,91
2,12,10,1,7,984,902,82
2,12,11,1,7,1108,1013,95
2,12,12,1,7,1193,1138,55
2,12,13,1,7,1284,1241,43
2,12,14,1,7,1391,1322,69
2,12,15,1,7,1485,1419,66
2,12,16,1,7,1525,1459,66
2,12,17,1,7,1405,1344,61
2,13,0,1,7,1148,1131,17
2,13,1,1,7,1235,1210,25
2,13,2,1,7,1325,1277,48
2,13,3,1,7,1315,1262,53
2,13,4,1,7,1298,1267,31
2,13,5,1,7,1204,1184,20
2,13,6,1,7,1061,1039,22
2,13,7,1,7,987,1008,-21
2,13,8,1,7,845,881,-36
2,13,9,1,7,753,800,-47
2,13,10,1,7,902,941,-39
2,13,11,1,7,1013,994,19
2,13,12,1,7,1138,1131,7
2,13,13,1,7,1241,1235,6
2,13,14,1,7,1322,1276,46
2,13,15,1,7,1419,1367,52
2,13,16,1,7,1459,1413,46
2,13,17,1,7,1344,1326,18
2,14,0,1,7,1131,1162,-31
2,14,1,1,7,1210,1253,-43
2,14,2,1,7,1277,1322,-45
2,14,3,1,7,1262,1298,-36
2,14,4,1,7,1267,1297,-30
2,14,5,1,7,1184,1184,0
2,14,6,1,7,1039,1039,0
2,14,7,1,7,1008,967,41
2,14,8,1,7,881,816,65
2,14,9,1,7,800,738,62
2,14,10,1,7,941,910,31
2,14,11,1,7,994,963,31
2,14,12,1,7,1131,1116,15
2,14,13,1,7,1235,1234,1
2,14,14,1,7,1276,1291,-15
2,14,15,1,7,1367,1403,-36
2,14,16,1,7,1413,1429,-16
2,14,17,1,7,1326,1315,11
2,15,0,1,7,1162,1014,148
2,15,1,1,7,1253,1154,99
2,15,2,1,7,1322,1279,43
2,15,3,1,7,1298,1311,-13
2,15,4,1,7,1297,1309,-12
2,15,5,1,7,1184,1184,0
2,15,6,1,7,1039,1062,-23
2,15,7,1,7,967,1044,-77
2,15,8,1,7,816,894,-78
2,15,9,1,7,738,829,-91
2,15,10,1,7,910,976,-66
2,15,11,1,7,963,1029,-66
2,15,12,1,7,1116,1124,-8
2,15,13,1,7,1234,1214,20
2,15,14,1,7,1291,1258,33
2,15,15,1,7,1403,1328,75
2,15,16,1,7,1429,1271,158
2,15,17,1,7,1315,1157,158
2,16,0,1,7,1014,902,112
2,16,1,1,7,1154,1025,129
2,16,2,1,7,1279,1146,133
2,16,3,1,7,1311,1154,157
2,16,4,1,7,1309,1118,191
2,16,5,1,7,1184,978,206
2,16,6,1,7,1062,870,192
2,16,7,1,7,1044,841,203
2,16,8,1,7,894,671,223
2,16,9,1,7,829,615,214
2,16,10,1,7,976,786,190
2,16,11,1,7,1029,837,192
2,16,12,1,7,1124,845,279
2,16,13,1,7,1214,922,292
2,16,14,1,7,1258,1013,245
2,16,15,1,7,1328,1118,210
2,16,16,1,7,1271,1071,200
2,16,17,1,7,1157,984,173
2,17,0,1,7,902,960,-58
2,17,1,1,7,1025,966,59
2,17,2,1,7,1146,986,160
2,17,3,1,7,1154,983,171
2,17,4,1,7,1118,874,244
2,17,5,1,7,978,720,258
2,17,6,1,7,870,648,222
2,17,7,1,7,841,654,187
2,17,8,1,7,671,629,42
2,17,9,1,7,615,599,16
2,17,10,1,7,786,593,193
2,17,11,1,7,837,676,161
2,17,12,1,7,845,665,180
2,17,13,1,7,922,683,239
2,17,14,1,7,1013,808,205
2,17,15,1,7,1118,869,249
2,17,16,1,7,1071,868,203
2,17,17,1,7,984,922,62
2,18,0,1,7,960,900,60
2,18,1,1,7,966,809,157
2,18,2,1,7,986,906,80
2,18,3,1,7,983,925,58
2,18,4,1,7,874,849,25
2,18,5,1,7,720,850,-130
2,18,6,1,7,648,928,-280
2,18,7,1,7,654,1013,-359
2,18,8,1,7,629,1024,-395
2,18,9,1,7,599,902,-303
2,18,10,1,7,593,967,-374
2,18,11,1,7,676,1017,-341
2,18,12,1,7,665,955,-290
2,18,13,1,7,683,860,-177
2,18,14,1,7,808,880,-72
2,18,15,1,7,869,849,20
2,18,16,1,7,868,858,10
2,18,17,1,7,922,871,51
2,19,0,1,7,900,777,123
2,19,1,1,7,809,766,43
2,19,2,1,7,906,934,-28
2,19,3,1,7,925,998,-73
2,19,4,1,7,849,921,-72
2,19,5,1,7,850,944,-94
2,19,6,1,7,928,1053,-125
2,19,7,1,7,1013,1126,-113
2,19,8,1,7,1024,1031,-7
2,19,9,1,7,902,862,40
2,19,10,1,7,967,868,99
2,19,11,1,7,1017,835,182
2,19,12,1,7,955,763,192
2,19,13,1,7,860,688,172
2,19,14,1,7,880,705,175
2,19,15,1,7,849,666,183
2,19,16,1,7,858,646,212
2,19,17,1,7,871,719,152
2,20,0,1,7,777,751,26
2,20,1,1,7,766,632,134
2,20,2,1,7,934,705,229
2,20,3,1,7,998,657,341
2,20,4,1,7,921,448,473
2,20,5,1,7,944,430,514
2,20,6,1,7,1053,486,567
2,20,7,1,7,1126,464,662
2,20,8,1,7,1031,404,627
2,20,9,1,7,862,314,548
2,20,10,1,7,868,316,552
2,20,11,1,7,835,360,475
2,20,12,1,7,763,371,392
2,20,13,1,7,688,367,321
2,20,14,1,7,705,432,273
2,20,15,1,7,666,497,169
2,20,16,1,7,646,538,108
2,20,17,1,7,719,668,51
2,21,0,1,7,751,489,262
2,21,1,1,7,632,487,145
2,21,2,1,7,705,564,141
2,21,3,1,7,657,537,120
2,21,4,1,7,448,487,-39
2,21,5,1,7,430,508,-78
2,21,6,1,7,486,587,-101
2,21,7,1,7,464,625,-161
2,21,8,1,7,404,563,-159
2,21,9,1,7,314,510,-196
2,21,10,1,7,316,573,-257
2,21,11,1,7,360,573,-213
2,21,12,1,7,371,532,-161
2,21,13,1,7,367,474,-107
2,21,14,1,7,432,439,-7
2,21,15,1,7,497,460,37
2,21,16,1,7,538,416,122
2,21,17,1,7,668,360,308
2,22,0,1,7,489,485,4
2,22,1,1,7,487,454,33
2,22,2,1,7,564,511,53
2,22,3,1,7,537,555,-18
2,22,4,1,7,487,541,-54
2,22,5,1,7,508,532,-24
2,22,6,1,7,587,599,-12
2,22,7,1,7,625,641,-16
2,22,8,1,7,563,653,-90
2,22,9,1,7,510,621,-111
2,22,10,1,7,573,630,-57
2,22,11,1,7,573,642,-69
2,22,12,1,7,532,624,-92
2,22,13,1,7,474,562,-88
2,22,14,1,7,439,526,-87
2,22,15,1,7,460,467,-7
2,22,16,1,7,416,447,-31
2,22,17,1,7,360,387,-27
2,0,0,2,7,1489,1549,-60
2,0,1,2,7,1486,1564,-78
2,0,2,2,7,1480,1519,-39
2,0,3,2,7,1486,1479,7
2,0,4,2,7,1488,1442,46
2,0,5,2,7,1470,1390,80
2,0,6,2,7,1456,1335,121
2,0,7,2,7,1457,1286,171
2,0,8,2,7,1453,1228,225
2,0,9,2,7,1453,1219,234
2,0,10,2,7,1457,1244,213
2,0,11,2,7,1460,1277,183
2,0,12,2,7,1469,1333,136
2,0,13,2,7,1474,1393,81
2,0,14,2,7,1466,1432,34
2,0,15,2,7,1471,1471,0
2,0,16,2,7,1482,1519,-37
2,0,17,2,7,1473,1529,-56
2,1,0,2,7,1518,1585,-67
2,1,1,2,7,1531,1550,-19
2,1,2,2,7,1528,1440,88
2,1,3,2,7,1528,1336,192
2,1,4,2,7,1528,1230,298
2,1,5,2,7,1516,1100,416
2,1,6,2,7,1509,971,538
2,1,7,2,7,1511,873,638
2,1,8,2,7,1501,794,707
2,1,9,2,7,1496,783,713
2,1,10,2,7,1509,812,697
2,1,11,2,7,1512,872,640
2,1,12,2,7,1515,987,528
2,1,13,2,7,1515,1125,390
2,1,14,2,7,1507,1239,268
2,1,15,2,7,1513,1341,172
2,1,16,2,7,1524,1450,74
2,1,17,2,7,1500,1522,-22
2,2,0,2,7,1549,1580,-31
2,2,1,2,7,1564,1467,97
2,2,2,2,7,1519,1349,170
2,2,3,2,7,1479,1234,245
2,2,4,2,7,1442,1115,327
2,2,5,2,7,1390,974,416
2,2,6,2,7,1335,854,481
2,2,7,2,7,1286,801,485
2,2,8,2,7,1228,798,430
2,2,9,2,7,1219,789,430
2,2,10,2,7,1244,784,460
2,2,11,2,7,1277,802,475
2,2,12,2,7,1333,879,454
2,2,13,2,7,1393,1000,393
2,2,14,2,7,1432,1121,311
2,2,15,2,7,1471,1238,233
2,2,16,2,7,1519,1355,164
2,2,17,2,7,1529,1459,70
2,3,0,2,7,1585,1456,129
2,3,1,2,7,1550,1319,231
2,3,2,2,7,1440,1211,229
2,3,3,2,7,1336,1119,217
2,3,4,2,7,1230,1047,183
2,3,5,2,7,1100,969,131
2,3,6,2,7,971,912,59
2,3,7,2,7,873,910,-37
2,3,8,2,7,794,946,-152
2,3,9,2,7,783,942,-159
2,3,10,2,7,812,937,-125
2,3,11,2,7,872,925,-53
2,3,12,2,7,987,943,44
2,3,13,2,7,1125,1003,122
2,3,14,2,7,1239,1082,157
2,3,15,2,7,1341,1175,166
2,3,16,2,7,1450,1275,175
2,3,17,2,7,1522,1366,156
2,4,0,2,7,1580,1251,329
2,4,1,2,7,1467,1164,303
2,4,2,2,7,1349,1079,270
2,4,3,2,7,1234,1045,189
2,4,4,2,7,1115,1073,42
2,4,5,2,7,974,1114,-140
2,4,6,2,7,854,1143,-289
2,4,7,2,7,801,1161,-360
2,4,8,2,7,798,1163,-365
2,4,9,2,7,789,1163,-374
2,4,10,2,7,784,1174,-390
2,4,11,2,7,802,1158,-356
2,4,12,2,7,879,1140,-261
2,4,13,2,7,1000,1136,-136
2,4,14,2,7,1121,1138,-17
2,4,15,2,7,1238,1164,74
2,4,16,2,7,1355,1226,129
2,4,17,2,7,1459,1290,169
2,5,0,2,7,1456,1331,125
2,5,1,2,7,1319,1301,18
2,5,2,2,7,1211,1257,-46
2,5,3,2,7,1119,1277,-158
2,5,4,2,7,1047,1377,-330
2,5,5,2,7,969,1510,-541
2,5,6,2,7,912,1604,-692
2,5,7,2,7,910,1631,-721
2,5,8,2,7,946,1640,-694
2,5,9,2,7,942,1652,-710
2,5,10,2,7,937,1654,-717
2,5,11,2,7,925,1642,-717
2,5,12,2,7,943,1614,-671
2,5,13,2,7,1003,1539,-536
2,5,14,2,7,1082,1466,-384
2,5,15,2,7,1175,1443,-268
2,5,16,2,7,1275,1437,-162
2,5,17,2,7,1366,1460,-94
2,6,0,2,7,1251,1185,66
2,6,1,2,7,1164,1141,23
2,6,2,2,7,1079,1122,-43
2,6,3,2,7,1045,1108,-63
2,6,4,2,7,1073,1146,-73
2,6,5,2,7,1114,1215,-101
2,6,6,2,7,1143,1251,-108
2,6,7,2,7,1161,1246,-85
2,6,8,2,7,1163,1223,-60
2,6,9,2,7,1163,1223,-60
2,6,10,2,7,1174,1240,-66
2,6,11,2,7,1158,1278,-120
2,6,12,2,7,1140,1292,-152
2,6,13,2,7,1136,1247,-111
2,6,14,2,7,1138,1223,-85
2,6,15,2,7,1164,1246,-82
2,6,16,2,7,1226,1249,-23
2,6,17,2,7,1290,1290,0
2,7,0,2,7,1331,1100,231
2,7,1,2,7,1301,1114,187
2,7,2,2,7,1257,1207,50
2,7,3,2,7,1277,1247,30
2,7,4,2,7,1377,1289,88
2,7,5,2,7,1510,1255,255
2,7,6,2,7,1604,1246,358
2,7,7,2,7,1631,1239,392
2,7,8,2,7,1640,1166,474
2,7,9,2,7,1652,1142,510
2,7,10,2,7,1654,1177,477
2,7,11,2,7,1642,1231,411
2,7,12,2,7,1614,1246,368
2,7,13,2,7,1539,1249,290
2,7,14,2,7,1466,1255,211
2,7,15,2,7,1443,1246,197
2,7,16,2,7,1437,1239,198
2,7,17,2,7,1460,1244,216
2,8,0,2,7,1185,1776,-591
2,8,1,2,7,1141,1920,-779
2,8,2,2,7,1122,2134,-1012
2,8,3,2,7,1108,2290,-1182
2,8,4,2,7,1146,2417,-1271
2,8,5,2,7,1215,2313,-1098
2,8,6,2,7,1251,2336,-1085
2,8,7,2,7,1246,2322,-1076
2,8,8,2,7,1223,2243,-1020
2,8,9,2,7,1223,2203,-980
2,8,10,2,7,1240,2284,-1044
2,8,11,2,7,1278,2343,-1065
2,8,12,2,7,1292,2342,-1050
2,8,13,2,7,1247,2357,-1110
2,8,14,2,7,1223,2353,-1130
2,8,15,2,7,1246,2296,-1050
2,8,16,2,7,1249,2250,-1001
2,8,17,2,7,1290,2103,-813
2,9,0,2,7,1100,2282,-1182
2,9,1,2,7,1114,2446,-1332
2,9,2,2,7,1207,2647,-1440
2,9,3,2,7,1247,2742,-1495
2,9,4,2,7,1289,2801,-1512
2,9,5,2,7,1255,2604,-1349
2,9,6,2,7,1246,2550,-1304
2,9,7,2,7,1239,2425,-1186
2,9,8,2,7,1166,2258,-1092
2,9,9,2,7,1142,2158,-1016
2,9,10,2,7,1177,2362,-1185
2,9,11,2,7,1231,2528,-1297
2,9,12,2,7,1246,2619,-1373
2,9,13,2,7,1249,2730,-1481
2,9,14,2,7,1255,2850,-1595
2,9,15,2,7,1246,2929,-1683
2,9,16,2,7,1239,2953,-1714
2,9,17,2,7,1244,2725,-1481
2,10,0,2,7,1776,2327,-551
2,10,1,2,7,1920,2487,-567
2,10,2,2,7,2134,2662,-528
2,10,3,2,7,2290,2659,-369
2,10,4,2,7,2417,2630,-213
2,10,5,2,7,2313,2414,-101
2,10,6,2,7,2336,2201,135
2,10,7,2,7,2322,2025,297
2,10,8,2,7,2243,1762,481
2,10,9,2,7,2203,1597,606
2,10,10,2,7,2284,1886,398
2,10,11,2,7,2343,2121,222
2,10,12,2,7,2342,2331,11
2,10,13,2,7,2357,2525,-168
2,10,14,2,7,2353,2713,-360
2,10,15,2,7,2296,2904,-608
2,10,16,2,7,2250,2984,-734
2,10,17,2,7,2103,2749,-646
2,11,0,2,7,2282,2279,3
2,11,1,2,7,2446,2445,1
2,11,2,2,7,2647,2602,45
2,11,3,2,7,2742,2577,165
2,11,4,2,7,2801,2565,236
2,11,5,2,7,2604,2388,216
2,11,6,2,7,2550,2100,450
2,11,7,2,7,2425,1995,430
2,11,8,2,7,2258,1726,532
2,11,9,2,7,2158,1553,605
2,11,10,2,7,2362,1843,519
2,11,11,2,7,2528,2007,521
2,11,12,2,7,2619,2269,350
2,11,13,2,7,2730,2476,254
2,11,14,2,7,2850,2598,252
2,11,15,2,7,2929,2786,143
2,11,16,2,7,2953,2872,81
2,11,17,2,7,2725,2670,55
2,12,0,2,7,2327,2293,34
2,12,1,2,7,2487,2463,24
2,12,2,2,7,2662,2599,63
2,12,3,2,7,2659,2560,99
2,12,4,2,7,2630,2564,66
2,12,5,2,7,2414,2368,46
2,12,6,2,7,2201,2078,123
2,12,7,2,7,2025,1975,50
2,12,8,2,7,1762,1697,65
2,12,9,2,7,1597,1538,59
2,12,10,2,7,1886,1851,35
2,12,11,2,7,2121,1957,164
2,12,12,2,7,2331,2247,84
2,12,13,2,7,2525,2469,56
2,12,14,2,7,2713,2567,146
2,12,15,2,7,2904,2770,134
2,12,16,2,7,2984,2842,142
2,12,17,2,7,2749,2641,108
2,13,0,2,7,2279,2176,103
2,13,1,2,7,2445,2407,38
2,13,2,2,7,2602,2601,1
2,13,3,2,7,2577,2609,-32
2,13,4,2,7,2565,2606,-41
2,13,5,2,7,2388,2368,20
2,13,6,2,7,2100,2101,-1
2,13,7,2,7,1995,2011,-16
2,13,8,2,7,1726,1710,16
2,13,9,2,7,1553,1567,-14
2,13,10,2,7,1843,1886,-43
2,13,11,2,7,2007,1992,15
2,13,12,2,7,2269,2240,29
2,13,13,2,7,2476,2448,28
2,13,14,2,7,2598,2549,49
2,13,15,2,7,2786,2731,55
2,13,16,2,7,2872,2700,172
2,13,17,2,7,2670,2472,198
2,14,0,2,7,2293,1916,377
2,14,1,2,7,2463,2179,284
2,14,2,2,7,2599,2425,174
2,14,3,2,7,2560,2465,95
2,14,4,2,7,2564,2427,137
2,14,5,2,7,2368,2162,206
2,14,6,2,7,2078,1932,146
2,14,7,2,7,1975,1885,90
2,14,8,2,7,1697,1565,132
2,14,9,2,7,1538,1444,94
2,14,10,2,7,1851,1762,89
2,14,11,2,7,1957,1866,91
2,14,12,2,7,2247,1969,278
2,14,13,2,7,2469,2136,333
2,14,14,2,7,2567,2271,296
2,14,15,2,7,2770,2446,324
2,14,16,2,7,2842,2342,500
2,14,17,2,7,2641,2141,500
2,15,0,2,7,2176,1862,314
2,15,1,2,7,2407,1991,416
2,15,2,2,7,2601,2132,469
2,15,3,2,7,2609,2137,472
2,15,4,2,7,2606,1992,614
2,15,5,2,7,2368,1698,670
2,15,6,2,7,2101,1518,583
2,15,7,2,7,2011,1495,516
2,15,8,2,7,1710,1300,410
2,15,9,2,7,1567,1214,353
2,15,10,2,7,1886,1379,507
2,15,11,2,7,1992,1513,479
2,15,12,2,7,2240,1510,730
2,15,13,2,7,2448,1605,843
2,15,14,2,7,2549,1821,728
2,15,15,2,7,2731,1987,744
2,15,16,2,7,2700,1939,761
2,15,17,2,7,2472,1906,566
2,16,0,2,7,1916,1860,56
2,16,1,2,7,2179,1775,404
2,16,2,2,7,2425,1892,533
2,16,3,2,7,2465,1908,557
2,16,4,2,7,2427,1723,704
2,16,5,2,7,2162,1570,592
2,16,6,2,7,1932,1576,356
2,16,7,2,7,1885,1667,218
2,16,8,2,7,1565,1653,-88
2,16,9,2,7,1444,1501,-57
2,16,10,2,7,1762,1560,202
2,16,11,2,7,1866,1693,173
2,16,12,2,7,1969,1620,349
2,16,13,2,7,2136,1543,593
2,16,14,2,7,2271,1688,583
2,16,15,2,7,2446,1718,728
2,16,16,2,7,2342,1726,616
2,16,17,2,7,2141,1793,348
2,17,0,2,7,1862,1677,185
2,17,1,2,7,1991,1575,416
2,17,2,2,7,2132,1840,292
2,17,3,2,7,2137,1923,214
2,17,4,2,7,1992,1770,222
2,17,5,2,7,1698,1794,-96
2,17,6,2,7,1518,1981,-463
2,17,7,2,7,1495,2139,-644
2,17,8,2,7,1300,2055,-755
2,17,9,2,7,1214,1764,-550
2,17,10,2,7,1379,1835,-456
2,17,11,2,7,1513,1852,-339
2,17,12,2,7,1510,1718,-208
2,17,13,2,7,1605,1548,57
2,17,14,2,7,1821,1585,236
2,17,15,2,7,1987,1515,472
2,17,16,2,7,1939,1504,435
2,17,17,2,7,1906,1590,316
2,18,0,2,7,1860,1528,332
2,18,1,2,7,1775,1398,377
2,18,2,2,7,1892,1639,253
2,18,3,2,7,1908,1655,253
2,18,4,2,7,1723,1369,354
2,18,5,2,7,1570,1374,196
2,18,6,2,7,1576,1539,37
2,18,7,2,7,1667,1590,77
2,18,8,2,7,1653,1435,218
2,18,9,2,7,1501,1176,325
2,18,10,2,7,1560,1184,376
2,18,11,2,7,1693,1195,498
2,18,12,2,7,1620,1134,486
2,18,13,2,7,1543,1055,488
2,18,14,2,7,1688,1137,551
2,18,15,2,7,1718,1163,555
2,18,16,2,7,1726,1184,542
2,18,17,2,7,1793,1387,406
2,19,0,2,7,1677,1240,437
2,19,1,2,7,1575,1119,456
2,19,2,2,7,1840,1269,571
2,19,3,2,7,1923,1194,729
2,19,4,2,7,1770,935,835
2,19,5,2,7,1794,938,856
2,19,6,2,7,1981,1073,908
2,19,7,2,7,2139,1089,1050
2,19,8,2,7,2055,967,1088
2,19,9,2,7,1764,824,940
2,19,10,2,7,1835,889,946
2,19,11,2,7,1852,933,919
2,19,12,2,7,1718,903,815
2,19,13,2,7,1548,841,707
2,19,14,2,7,1585,871,714
2,19,15,2,7,1515,957,558
2,19,16,2,7,1504,954,550
2,19,17,2,7,1590,1028,562
2,20,0,2,7,1528,974,554
2,20,1,2,7,1398,941,457
2,20,2,2,7,1639,1075,564
2,20,3,2,7,1655,1092,563
2,20,4,2,7,1369,1028,341
2,20,5,2,7,1374,1040,334
2,20,6,2,7,1539,1186,353
2,20,7,2,7,1590,1266,324
2,20,8,2,7,1435,1216,219
2,20,9,2,7,1176,1131,45
2,20,10,2,7,1184,1203,-19
2,20,11,2,7,1195,1215,-20
2,20,12,2,7,1134,1156,-22
2,20,13,2,7,1055,1036,19
2,20,14,2,7,1137,965,172
2,20,15,2,7,1163,927,236
2,20,16,2,7,1184,863,321
2,20,17,2,7,1387,747,640
2,0,0,3,7,2255,2363,-108
2,0,1,3,7,2264,2253,11
2,0,2,3,7,2258,2090,168
2,0,3,3,7,2265,1934,331
2,0,4,3,7,2269,1776,493
2,0,5,3,7,2248,1586,662
2,0,6,3,7,2232,1413,819
2,0,7,3,7,2233,1311,922
2,0,8,3,7,2221,1258,963
2,0,9,3,7,2217,1244,973
2,0,10,3,7,2225,1260,965
2,0,11,3,7,2228,1311,917
2,0,12,3,7,2239,1442,797
2,0,13,3,7,2245,1622,623
2,0,14,3,7,2232,1787,445
2,0,15,3,7,2237,1943,294
2,0,16,3,7,2252,2104,148
2,0,17,3,7,2232,2229,3
2,1,0,3,7,2301,2258,43
2,1,1,3,7,2317,2083,234
2,1,2,3,7,2269,1910,359
2,1,3,3,7,2228,1755,473
2,1,4,3,7,2189,1616,573
2,1,5,3,7,2128,1457,671
2,1,6,3,7,2068,1324,744
2,1,7,3,7,2021,1273,748
2,1,8,3,7,1961,1280,681
2,1,9,3,7,1951,1270,681
2,1,10,3,7,1985,1273,712
2,1,11,3,7,2021,1288,733
2,1,12,3,7,2078,1367,711
2,1,13,3,7,2137,1506,631
2,1,14,3,7,2173,1655,518
2,1,15,3,7,2218,1811,407
2,1,16,3,7,2273,1976,297
2,1,17,3,7,2270,2118,152
2,2,0,3,7,2351,2029,322
2,2,1,3,7,2328,1867,461
2,2,2,3,7,2218,1729,489
2,2,3,3,7,2115,1643,472
2,2,4,3,7,2011,1619,392
2,2,5,3,7,1878,1600,278
2,2,6,3,7,1747,1585,162
2,2,7,3,7,1649,1599,50
2,2,8,3,7,1562,1627,-65
2,2,9,3,7,1547,1624,-77
2,2,10,3,7,1580,1622,-42
2,2,11,3,7,1640,1597,43
2,2,12,3,7,1757,1595,162
2,2,13,3,7,1896,1633,263
2,2,14,3,7,2005,1686,319
2,2,15,3,7,2107,1766,341
2,2,16,3,7,2220,1880,340
2,2,17,3,7,2281,1997,284
2,3,0,3,7,2363,2009,354
2,3,1,3,7,2253,1917,336
2,3,2,3,7,2090,1818,272
2,3,3,3,7,1934,1798,136
2,3,4,3,7,1776,1878,-102
2,3,5,3,7,1586,1993,-407
2,3,6,3,7,1413,2074,-661
2,3,7,3,7,1311,2103,-792
2,3,8,3,7,1258,2122,-864
2,3,9,3,7,1244,2133,-889
2,3,10,3,7,1260,2143,-883
2,3,11,3,7,1311,2128,-817
2,3,12,3,7,1442,2102,-660
2,3,13,3,7,1622,2045,-423
2,3,14,3,7,1787,2000,-213
2,3,15,3,7,1943,2016,-73
2,3,16,3,7,2104,2058,46
2,3,17,3,7,2229,2119,110
2,4,0,3,7,2258,1758,500
2,4,1,3,7,2083,1689,394
2,4,2,3,7,1910,1640,270
2,4,3,3,7,1755,1632,123
2,4,4,3,7,1616,1718,-102
2,4,5,3,7,1457,1846,-389
2,4,6,3,7,1324,1924,-600
2,4,7,3,7,1273,1935,-662
2,4,8,3,7,1280,1904,-624
2,4,9,3,7,1270,1905,-635
2,4,10,3,7,1273,1925,-652
2,4,11,3,7,1288,1950,-662
2,4,12,3,7,1367,1944,-577
2,4,13,3,7,1506,1877,-371
2,4,14,3,7,1655,1827,-172
2,4,15,3,7,1811,1837,-26
2,4,16,3,7,1976,1854,122
2,4,17,3,7,2118,1921,197
2,5,0,3,7,2029,1858,171
2,5,1,3,7,1867,1867,0
2,5,2,3,7,1729,1946,-217
2,5,3,3,7,1643,2000,-357
2,5,4,3,7,1619,2094,-475
2,5,5,3,7,1600,2134,-534
2,5,6,3,7,1585,2177,-592
2,5,7,3,7,1599,2181,-582
2,5,8,3,7,1627,2125,-498
2,5,9,3,7,1624,2112,-488
2,5,10,3,7,1622,2146,-524
2,5,11,3,7,1597,2201,-604
2,5,12,3,7,1595,2208,-613
2,5,13,3,7,1633,2158,-525
2,5,14,3,7,1686,2117,-431
2,5,15,3,7,1766,2098,-332
2,5,16,3,7,1880,2071,-191
2,5,17,3,7,1997,2073,-76
2,6,0,3,7,2009,2203,-194
2,6,1,3,7,1917,2308,-391
2,6,2,3,7,1818,2517,-699
2,6,3,3,7,1798,2645,-847
2,6,4,3,7,1878,2758,-880
2,6,5,3,7,1993,2649,-656
2,6,6,3,7,2074,2656,-582
2,6,7,3,7,2103,2626,-523
2,6,8,3,7,2122,2507,-385
2,6,9,3,7,2133,2456,-323
2,6,10,3,7,2143,2555,-412
2,6,11,3,7,2128,2651,-523
2,6,12,3,7,2102,2672,-570
2,6,13,3,7,2045,2695,-650
2,6,14,3,7,2000,2714,-714
2,6,15,3,7,2016,2690,-674
2,6,16,3,7,2058,2667,-609
2,6,17,3,7,2119,2564,-445
2,7,0,3,7,1758,2955,-1197
2,7,1,3,7,1689,3172,-1483
2,7,2,3,7,1640,3471,-1831
2,7,3,3,7,1632,3634,-2002
2,7,4,3,7,1718,3749,-2031
2,7,5,3,7,1846,3523,-1677
2,7,6,3,7,1924,3476,-1552
2,7,7,3,7,1935,3360,-1425
2,7,8,3,7,1904,3160,-1256
2,7,9,3,7,1905,3047,-1142
2,7,10,3,7,1925,3268,-1343
2,7,11,3,7,1950,3451,-1501
2,7,12,3,7,1944,3535,-1591
2,7,13,3,7,1877,3641,-1764
2,7,14,3,7,1827,3744,-1917
2,7,15,3,7,1837,3781,-1944
2,7,16,3,7,1854,3775,-1921
2,7,17,3,7,1921,3508,-1587
2,8,0,3,7,1858,3430,-1572
2,8,1,3,7,1867,3681,-1814
2,8,2,3,7,1946,3972,-2026
2,8,3,3,7,2000,4057,-2057
2,8,4,3,7,2094,4099,-2005
2,8,5,3,7,2134,3808,-1674
2,8,6,3,7,2177,3611,-1434
2,8,7,3,7,2181,3412,-1231
2,8,8,3,7,2125,3103,-978
2,8,9,3,7,2112,2911,-799
2,8,10,3,7,2146,3264,-1118
2,8,11,3,7,2201,3541,-1340
2,8,12,3,7,2208,3757,-1549
2,8,13,3,7,2158,3971,-1813
2,8,14,3,7,2117,4172,-2055
2,8,15,3,7,2098,4348,-2250
2,8,16,3,7,2071,4412,-2341
2,8,17,3,7,2073,4069,-1996
2,9,0,3,7,2203,3458,-1255
2,9,1,3,7,2308,3697,-1389
2,9,2,3,7,2517,3939,-1422
2,9,3,3,7,2645,3921,-1276
2,9,4,3,7,2758,3897,-1139
2,9,5,3,7,2649,3598,-949
2,9,6,3,7,2656,3240,-584
2,9,7,3,7,2626,3033,-407
2,9,8,3,7,2507,2643,-136
2,9,9,3,7,2456,2397,59
2,9,10,3,7,2555,2827,-272
2,9,11,3,7,2651,3115,-464
2,9,12,3,7,2672,3462,-790
2,9,13,3,7,2695,3760,-1065
2,9,14,3,7,2714,3989,-1275
2,9,15,3,7,2690,4271,-1581
2,9,16,3,7,2667,4397,-1730
2,9,17,3,7,2564,4075,-1511
2,10,0,3,7,2955,3441,-486
2,10,1,3,7,3172,3698,-526
2,10,2,3,7,3471,3924,-453
2,10,3,3,7,3634,3875,-241
2,10,4,3,7,3749,3862,-113
2,10,5,3,7,3523,3572,-49
2,10,6,3,7,3476,3139,337
2,10,7,3,7,3360,2962,398
2,10,8,3,7,3160,2542,618
2,10,9,3,7,3047,2291,756
2,10,10,3,7,3268,2753,515
2,10,11,3,7,3451,2970,481
2,10,12,3,7,3535,3385,150
2,10,13,3,7,3641,3710,-69
2,10,14,3,7,3744,3889,-145
2,10,15,3,7,3781,4189,-408
2,10,16,3,7,3775,4301,-526
2,10,17,3,7,3508,3985,-477
2,11,0,3,7,3430,3307,123
2,11,1,3,7,3681,3617,64
2,11,2,3,7,3972,3878,94
2,11,3,3,7,4057,3871,186
2,11,4,3,7,4099,3873,226
2,11,5,3,7,3808,3552,256
2,11,6,3,7,3611,3140,471
2,11,7,3,7,3412,3019,393
2,11,8,3,7,3103,2591,512
2,11,9,3,7,2911,2367,544
2,11,10,3,7,3264,2827,437
2,11,11,3,7,3541,2986,555
2,11,12,3,7,3757,3371,386
2,11,13,3,7,3971,3683,288
2,11,14,3,7,4172,3825,347
2,11,15,3,7,4348,4098,250
2,11,16,3,7,4412,4113,299
2,11,17,3,7,4069,3798,271
2,12,0,3,7,3458,3078,380
2,12,1,3,7,3697,3432,265
2,12,2,3,7,3939,3747,192
2,12,3,3,7,3921,3763,158
2,12,4,3,7,3897,3724,173
2,12,5,3,7,3598,3346,252
2,12,6,3,7,3240,2971,269
2,12,7,3,7,3033,2852,181
2,12,8,3,7,2643,2381,262
2,12,9,3,7,2397,2182,215
2,12,10,3,7,2827,2672,155
2,12,11,3,7,3115,2829,286
2,12,12,3,7,3462,3085,377
2,12,13,3,7,3760,3370,390
2,12,14,3,7,3989,3562,427
2,12,15,3,7,4271,3849,422
2,12,16,3,7,4397,3771,626
2,12,17,3,7,4075,3456,619
2,13,0,3,7,3441,2876,565
2,13,1,3,7,3698,3145,553
2,13,2,3,7,3924,3411,513
2,13,3,3,7,3875,3448,427
2,13,4,3,7,3862,3301,561
2,13,5,3,7,3572,2882,690
2,13,6,3,7,3139,2580,559
2,13,7,3,7,2962,2539,423
2,13,8,3,7,2542,2194,348
2,13,9,3,7,2291,2043,248
2,13,10,3,7,2753,2355,398
2,13,11,3,7,2970,2542,428
2,13,12,3,7,3385,2634,751
2,13,13,3,7,3710,2819,891
2,13,14,3,7,3889,3079,810
2,13,15,3,7,4189,3315,874
2,13,16,3,7,4301,3210,1091
2,13,17,3,7,3985,3063,922
2,14,0,3,7,3307,2762,545
2,14,1,3,7,3617,2800,817
2,14,2,3,7,3878,3038,840
2,14,3,3,7,3871,3062,809
2,14,4,3,7,3873,2841,1032
2,14,5,3,7,3552,2548,1004
2,14,6,3,7,3140,2446,694
2,14,7,3,7,3019,2508,511
2,14,8,3,7,2591,2324,267
2,14,9,3,7,2367,2116,251
2,14,10,3,7,2827,2346,481
2,14,11,3,7,2986,2530,456
2,14,12,3,7,3371,2465,906
2,14,13,3,7,3683,2465,1218
2,14,14,3,7,3825,2701,1124
2,14,15,3,7,4098,2836,1262
2,14,16,3,7,4113,2797,1316
2,14,17,3,7,3798,2777,1021
2,15,0,3,7,3078,2637,441
2,15,1,3,7,3432,2541,891
2,15,2,3,7,3747,2826,921
2,15,3,3,7,3763,2906,857
2,15,4,3,7,3724,2644,1080
2,15,5,3,7,3346,2514,832
2,15,6,3,7,2971,2629,342
2,15,7,3,7,2852,2793,59
2,15,8,3,7,2381,2684,-303
2,15,9,3,7,2182,2363,-181
2,15,10,3,7,2672,2428,244
2,15,11,3,7,2829,2528,301
2,15,12,3,7,3085,2383,702
2,15,13,3,7,3370,2231,1139
2,15,14,3,7,3562,2393,1169
2,15,15,3,7,3849,2384,1465
2,15,16,3,7,3771,2372,1399
2,15,17,3,7,3456,2512,944
2,16,0,3,7,2876,2428,448
2,16,1,3,7,3145,2207,938
2,16,2,3,7,3411,2545,866
2,16,3,3,7,3448,2580,868
2,16,4,3,7,3301,2218,1083
2,16,5,3,7,2882,2224,658
2,16,6,3,7,2580,2467,113
2,16,7,3,7,2539,2603,-64
2,16,8,3,7,2194,2459,-265
2,16,9,3,7,2043,2078,-35
2,16,10,3,7,2355,2151,204
2,16,11,3,7,2542,2212,330
2,16,12,3,7,2634,2089,545
2,16,13,3,7,2819,1915,904
2,16,14,3,7,3079,2017,1062
2,16,15,3,7,3315,2012,1303
2,16,16,3,7,3210,2042,1168
2,16,17,3,7,3063,2258,805
2,17,0,3,7,2762,2017,745
2,17,1,3,7,2800,1885,915
2,17,2,3,7,3038,2203,835
2,17,3,3,7,3062,2192,870
2,17,4,3,7,2841,1856,985
2,17,5,3,7,2548,1882,666
2,17,6,3,7,2446,2126,320
2,17,7,3,7,2508,2215,293
2,17,8,3,7,2324,1998,326
2,17,9,3,7,2116,1686,430
2,17,10,3,7,2346,1757,589
2,17,11,3,7,2530,1768,762
2,17,12,3,7,2465,1666,799
2,17,13,3,7,2465,1529,936
2,17,14,3,7,2701,1576,1125
2,17,15,3,7,2836,1623,1213
2,17,16,3,7,2797,1600,1197
2,17,17,3,7,2777,1747,1030
2,18,0,3,7,2637,1725,912
2,18,1,3,7,2541,1573,968
2,18,2,3,7,2826,1780,1046
2,18,3,3,7,2906,1749,1157
2,18,4,3,7,2644,1476,1168
2,18,5,3,7,2514,1470,1044
2,18,6,3,7,2629,1672,957
2,18,7,3,7,2793,1730,1063
2,18,8,3,7,2684,1620,1064
2,18,9,3,7,2363,1445,918
2,18,10,3,7,2428,1519,909
2,18,11,3,7,2528,1575,953
2,18,12,3,7,2383,1527,856
2,18,13,3,7,2231,1403,828
2,18,14,3,7,2393,1397,996
2,18,15,3,7,2384,1424,960
2,18,16,3,7,2372,1401,971
2,18,17,3,7,2512,1415,1097
2,0,0,4,7,3038,2831,207
2,0,1,4,7,3050,2631,419
2,0,2,4,7,2999,2428,571
2,0,3,4,7,2965,2279,686
2,0,4,4,7,2930,2188,742
2,0,5,4,7,2860,2088,772
2,0,6,4,7,2791,1997,794
2,0,7,4,7,2743,1962,781
2,0,8,4,7,2681,1961,720
2,0,9,4,7,2672,1952,720
2,0,10,4,7,2701,1958,743
2,0,11,4,7,2737,1960,777
2,0,12,4,7,2802,2019,783
2,0,13,4,7,2867,2136,731
2,0,14,4,7,2898,2259,639
2,0,15,4,7,2942,2402,540
2,0,16,4,7,3001,2581,420
2,0,17,4,7,3002,2749,253
2,1,0,4,7,3103,2787,316
2,1,1,4,7,3081,2620,461
2,1,2,4,7,2968,2468,500
2,1,3,4,7,2864,2396,468
2,1,4,4,7,2758,2424,334
2,1,5,4,7,2616,2479,137
2,1,6,4,7,2480,2516,-36
2,1,7,4,7,2384,2541,-157
2,1,8,4,7,2295,2586,-291
2,1,9,4,7,2279,2594,-315
2,1,10,4,7,2321,2591,-270
2,1,11,4,7,2384,2567,-183
2,1,12,4,7,2502,2557,-55
2,1,13,4,7,2640,2542,98
2,1,14,4,7,2746,2548,198
2,1,15,4,7,2854,2618,236
2,1,16,4,7,2974,2712,262
2,1,17,4,7,3022,2826,196
2,2,0,4,7,3129,2436,693
2,2,1,4,7,3031,2305,726
2,2,2,4,7,2868,2201,667
2,2,3,4,7,2713,2153,560
2,2,4,4,7,2557,2219,338
2,2,5,4,7,2364,2329,35
2,2,6,4,7,2189,2394,-205
2,2,7,4,7,2087,2407,-320
2,2,8,4,7,2026,2386,-360
2,2,9,4,7,2008,2386,-378
2,2,10,4,7,2028,2414,-386
2,2,11,4,7,2079,2436,-357
2,2,12,4,7,2212,2432,-220
2,2,13,4,7,2393,2383,10
2,2,14,4,7,2553,2361,192
2,2,15,4,7,2709,2410,299
2,2,16,4,7,2874,2475,399
2,2,17,4,7,2988,2580,408
2,3,0,4,7,3041,2431,610
2,3,1,4,7,2869,2415,454
2,3,2,4,7,2651,2464,187
2,3,3,4,7,2455,2524,-69
2,3,4,4,7,2277,2666,-389
2,3,5,4,7,2069,2765,-696
2,3,6,4,7,1883,2850,-967
2,3,7,4,7,1783,2870,-1087
2,3,8,4,7,1740,2806,-1066
2,3,9,4,7,1725,2794,-1069
2,3,10,4,7,1749,2831,-1082
2,3,11,4,7,1797,2873,-1076
2,3,12,4,7,1930,2860,-930
2,3,13,4,7,2128,2788,-660
2,3,14,4,7,2321,2721,-400
2,3,15,4,7,2516,2689,-173
2,3,16,4,7,2725,2676,49
2,3,17,4,7,2888,2704,184
2,4,0,4,7,2831,2961,-130
2,4,1,4,7,2631,3061,-430
2,4,2,4,7,2428,3256,-828
2,4,3,4,7,2279,3398,-1119
2,4,4,4,7,2188,3563,-1375
2,4,5,4,7,2088,3528,-1440
2,4,6,4,7,1997,3587,-1590
2,4,7,4,7,1962,3568,-1606
2,4,8,4,7,1961,3466,-1505
2,4,9,4,7,1952,3426,-1474
2,4,10,4,7,1958,3524,-1566
2,4,11,4,7,1960,3621,-1661
2,4,12,4,7,2019,3634,-1615
2,4,13,4,7,2136,3604,-1468
2,4,14,4,7,2259,3576,-1317
2,4,15,4,7,2402,3542,-1140
2,4,16,4,7,2581,3499,-918
2,4,17,4,7,2749,3393,-644
2,5,0,4,7,2787,3382,-595
2,5,1,4,7,2620,3560,-940
2,5,2,4,7,2468,3854,-1386
2,5,3,4,7,2396,3989,-1593
2,5,4,4,7,2424,4090,-1666
2,5,5,4,7,2479,3859,-1380
2,5,6,4,7,2516,3796,-1280
2,5,7,4,7,2541,3664,-1123
2,5,8,4,7,2586,3424,-838
2,5,9,4,7,2594,3300,-706
2,5,10,4,7,2591,3539,-948
2,5,11,4,7,2567,3759,-1192
2,5,12,4,7,2557,3865,-1308
2,5,13,4,7,2542,3979,-1437
2,5,14,4,7,2548,4105,-1557
2,5,15,4,7,2618,4175,-1557
2,5,16,4,7,2712,4192,-1480
2,5,17,4,7,2826,3969,-1143
2,6,0,4,7,2436,4103,-1667
2,6,1,4,7,2305,4407,-2102
2,6,2,4,7,2201,4796,-2595
2,6,3,4,7,2153,4949,-2796
2,6,4,4,7,2219,5047,-2828
2,6,5,4,7,2329,4727,-2398
2,6,6,4,7,2394,4537,-2143
2,6,7,4,7,2407,4347,-1940
2,6,8,4,7,2386,4005,-1619
2,6,9,4,7,2386,3800,-1414
2,6,10,4,7,2414,4170,-1756
2,6,11,4,7,2436,4464,-2028
2,6,12,4,7,2432,4673,-2241
2,6,13,4,7,2383,4882,-2499
2,6,14,4,7,2361,5066,-2705
2,6,15,4,7,2410,5200,-2790
2,6,16,4,7,2475,5234,-2759
2,6,17,4,7,2580,4852,-2272
2,7,0,4,7,2431,4561,-2130
2,7,1,4,7,2415,4891,-2476
2,7,2,4,7,2464,5249,-2785
2,7,3,4,7,2524,5319,-2795
2,7,4,4,7,2666,5366,-2700
2,7,5,4,7,2765,4992,-2227
2,7,6,4,7,2850,4650,-1800
2,7,7,4,7,2870,4420,-1550
2,7,8,4,7,2806,3984,-1178
2,7,9,4,7,2794,3711,-917
2,7,10,4,7,2831,4205,-1374
2,7,11,4,7,2873,4535,-1662
2,7,12,4,7,2860,4888,-2028
2,7,13,4,7,2788,5206,-2418
2,7,14,4,7,2721,5448,-2727
2,7,15,4,7,2689,5715,-3026
2,7,16,4,7,2676,5825,-3149
2,7,17,4,7,2704,5395,-2691
2,8,0,4,7,2961,4620,-1659
2,8,1,4,7,3061,4950,-1889
2,8,2,4,7,3256,5261,-2005
2,8,3,4,7,3398,5219,-1821
2,8,4,4,7,3563,5194,-1631
2,8,5,4,7,3528,4782,-1254
2,8,6,4,7,3587,4279,-692
2,8,7,4,7,3568,4000,-432
2,8,8,4,7,3466,3459,7
2,8,9,4,7,3426,3135,291
2,8,10,4,7,3524,3737,-213
2,8,11,4,7,3621,4078,-457
2,8,12,4,7,3634,4578,-944
2,8,13,4,7,3604,4994,-1390
2,8,14,4,7,3576,5280,-1704
2,8,15,4,7,3542,5674,-2132
2,8,16,4,7,3499,5826,-2327
2,8,17,4,7,3393,5390,-1997
2,9,0,4,7,3382,4455,-1073
2,9,1,4,7,3560,4852,-1292
2,9,2,4,7,3854,5203,-1349
2,9,3,4,7,3989,5186,-1197
2,9,4,4,7,4090,5171,-1081
2,9,5,4,7,3859,4756,-897
2,9,6,4,7,3796,4201,-405
2,9,7,4,7,3664,4006,-342
2,9,8,4,7,3424,3436,-12
2,9,9,4,7,3300,3120,180
2,9,10,4,7,3539,3729,-190
2,9,11,4,7,3759,3999,-240
2,9,12,4,7,3865,4509,-644
2,9,13,4,7,3979,4924,-945
2,9,14,4,7,4105,5147,-1042
2,9,15,4,7,4175,5517,-1342
2,9,16,4,7,4192,5572,-1380
2,9,17,4,7,3969,5142,-1173
2,10,0,4,7,4103,4209,-106
2,10,1,4,7,4407,4642,-235
2,10,2,4,7,4796,5024,-228
2,10,3,4,7,4949,5025,-76
2,10,4,4,7,5047,4991,56
2,10,5,4,7,4727,4530,197
2,10,6,4,7,4537,4010,527
2,10,7,4,7,4347,3860,487
2,10,8,4,7,4005,3262,743
2,10,9,4,7,3800,2982,818
2,10,10,4,7,4170,3613,557
2,10,11,4,7,4464,3823,641
2,10,12,4,7,4673,4216,457
2,10,13,4,7,4882,4605,277
2,10,14,4,7,5066,4838,228
2,10,15,4,7,5200,5216,-16
2,10,16,4,7,5234,5184,50
2,10,17,4,7,4852,4782,70
2,11,0,4,7,4561,4038,523
2,11,1,4,7,4891,4398,493
2,11,2,4,7,5249,4733,516
2,11,3,4,7,5319,4746,573
2,11,4,4,7,5366,4598,768
2,11,5,4,7,4992,4066,926
2,11,6,4,7,4650,3619,1031
2,11,7,4,7,4420,3506,914
2,11,8,4,7,3984,3010,974
2,11,9,4,7,3711,2781,930
2,11,10,4,7,4205,3265,940
2,11,11,4,7,4535,3505,1030
2,11,12,4,7,4888,3750,1138
2,11,13,4,7,5206,4053,1153
2,11,14,4,7,5448,4370,1078
2,11,15,4,7,5715,4718,997
2,11,16,4,7,5825,4639,1186
2,11,17,4,7,5395,4378,1017
2,12,0,4,7,4620,3776,844
2,12,1,4,7,4950,3954,996
2,12,2,4,7,5261,4317,944
2,12,3,4,7,5219,4373,846
2,12,4,4,7,5194,4150,1044
2,12,5,4,7,4782,3732,1050
2,12,6,4,7,4279,3508,771
2,12,7,4,7,4000,3552,448
2,12,8,4,7,3459,3218,241
2,12,9,4,7,3135,2945,190
2,12,10,4,7,3737,3322,415
2,12,11,4,7,4078,3559,519
2,12,12,4,7,4578,3589,989
2,12,13,4,7,4994,3679,1315
2,12,14,4,7,5280,3959,1321
2,12,15,4,7,5674,4164,1510
2,12,16,4,7,5826,4068,1758
2,12,17,4,7,5390,3934,1456
2,13,0,4,7,4455,3539,916
2,13,1,4,7,4852,3566,1286
2,13,2,4,7,5203,3972,1231
2,13,3,4,7,5186,4060,1126
2,13,4,4,7,5171,3762,1409
2,13,5,4,7,4756,3492,1264
2,13,6,4,7,4201,3499,702
2,13,7,4,7,4006,3634,372
2,13,8,4,7,3436,3355,81
2,13,9,4,7,3120,2978,142
2,13,10,4,7,3729,3214,515
2,13,11,4,7,3999,3365,634
2,13,12,4,7,4509,3228,1281
2,13,13,4,7,4924,3153,1771
2,13,14,4,7,5147,3406,1741
2,13,15,4,7,5517,3502,2015
2,13,16,4,7,5572,3443,2129
2,13,17,4,7,5142,3496,1646
2,14,0,4,7,4209,3388,821
2,14,1,4,7,4642,3173,1469
2,14,2,4,7,5024,3531,1493
2,14,3,4,7,5025,3563,1462
2,14,4,4,7,4991,3092,1899
2,14,5,4,7,4530,2944,1586
2,14,6,4,7,4010,3115,895
2,14,7,4,7,3860,3257,603
2,14,8,4,7,3262,3088,174
2,14,9,4,7,2982,2677,305
2,14,10,4,7,3613,2744,869
2,14,11,4,7,3823,2888,935
2,14,12,4,7,4216,2754,1462
2,14,13,4,7,4605,2598,2007
2,14,14,4,7,4838,2825,2013
2,14,15,4,7,5216,2881,2335
2,14,16,4,7,5184,2910,2274
2,14,17,4,7,4782,3180,1602
2,15,0,4,7,4038,2917,1121
2,15,1,4,7,4398,2694,1704
2,15,2,4,7,4733,3109,1624
2,15,3,4,7,4746,3117,1629
2,15,4,4,7,4598,2705,1893
2,15,5,4,7,4066,2732,1334
2,15,6,4,7,3619,3054,565
2,15,7,4,7,3506,3228,278
2,15,8,4,7,3010,3022,-12
2,15,9,4,7,2781,2588,193
2,15,10,4,7,3265,2724,541
2,15,11,4,7,3505,2785,720
2,15,12,4,7,3750,2621,1129
2,15,13,4,7,4053,2389,1664
2,15,14,4,7,4370,2456,1914
2,15,15,4,7,4718,2472,2246
2,15,16,4,7,4639,2458,2181
2,15,17,4,7,4378,2618,1760
2,16,0,4,7,3776,2502,1274
2,16,1,4,7,3954,2339,1615
2,16,2,4,7,4317,2714,1603
2,16,3,4,7,4373,2747,1626
2,16,4,4,7,4150,2397,1753
2,16,5,4,7,3732,2414,1318
2,16,6,4,7,3508,2725,783
2,16,7,4,7,3552,2856,696
2,16,8,4,7,3218,2651,567
2,16,9,4,7,2945,2307,638
2,16,10,4,7,3322,2387,935
2,16,11,4,7,3559,2410,1149
2,16,12,4,7,3589,2290,1299
2,16,13,4,7,3679,2091,1588
2,16,14,4,7,3959,2102,1857
2,16,15,4,7,4164,2090,2074
2,16,16,4,7,4068,2047,2021
2,16,17,4,7,3934,2134,1800
2,0,0,5,7,3840,3214,626
2,0,1,5,7,3814,3008,806
2,0,2,5,7,3698,2851,847
2,0,3,5,7,3601,2751,850
2,0,4,5,7,3499,2765,734
2,0,5,5,7,3348,2815,533
2,0,6,5,7,3203,2836,367
2,0,7,5,7,3106,2845,261
2,0,8,5,7,3015,2850,165
2,0,9,5,7,3000,2847,153
2,0,10,5,7,3037,2862,175
2,0,11,5,7,3100,2875,225
2,0,12,5,7,3226,2887,339
2,0,13,5,7,3370,2880,490
2,0,14,5,7,3471,2909,562
2,0,15,5,7,3578,3012,566
2,0,16,5,7,3702,3129,573
2,0,17,5,7,3754,3287,467
2,1,0,5,7,3881,3109,772
2,1,1,5,7,3784,3031,753
2,1,2,5,7,3618,3025,593
2,1,3,5,7,3462,3045,417
2,1,4,5,7,3304,3167,137
2,1,5,5,7,3102,3248,-146
2,1,6,5,7,2922,3320,-398
2,1,7,5,7,2822,3342,-520
2,1,8,5,7,2759,3288,-529
2,1,9,5,7,2740,3275,-535
2,1,10,5,7,2769,3320,-551
2,1,11,5,7,2823,3359,-536
2,1,12,5,7,2957,3348,-391
2,1,13,5,7,3137,3294,-157
2,1,14,5,7,3294,3255,39
2,1,15,5,7,3456,3262,194
2,1,16,5,7,3628,3297,331
2,1,17,5,7,3729,3363,366
2,2,0,5,7,3807,3534,273
2,2,1,5,7,3647,3609,38
2,2,2,5,7,3429,3774,-345
2,2,3,5,7,3234,3922,-688
2,2,4,5,7,3058,4135,-1077
2,2,5,5,7,2847,4159,-1312
2,2,6,5,7,2659,4260,-1601
2,2,7,5,7,2559,4257,-1698
2,2,8,5,7,2508,4147,-1639
2,2,9,5,7,2489,4108,-1619
2,2,10,5,7,2517,4209,-1692
2,2,11,5,7,2565,4293,-1728
2,2,12,5,7,2700,4286,-1586
2,2,13,5,7,2899,4234,-1335
2,2,14,5,7,3087,4180,-1093
2,2,15,5,7,3282,4133,-851
2,2,16,5,7,3495,4104,-609
2,2,17,5,7,3647,4024,-377
2,3,0,5,7,3614,4140,-526
2,3,1,5,7,3417,4313,-896
2,3,2,5,7,3169,4593,-1424
2,3,3,5,7,2979,4742,-1763
2,3,4,5,7,2849,4895,-2046
2,3,5,5,7,2700,4738,-2038
2,3,6,5,7,2556,4727,-2171
2,3,7,5,7,2472,4606,-2134
2,3,8,5,7,2421,4383,-1962
2,3,9,5,7,2407,4270,-1863
2,3,10,5,7,2434,4508,-2074
2,3,11,5,7,2469,4729,-2260
2,3,12,5,7,2582,4827,-2245
2,3,13,5,7,2758,4888,-2130
2,3,14,5,7,2925,4967,-2042
2,3,15,5,7,3107,5027,-1920
2,3,16,5,7,3330,5024,-1694
2,3,17,5,7,3519,4798,-1279
2,4,0,5,7,3589,4530,-941
2,4,1,5,7,3384,4795,-1411
2,4,2,5,7,3167,5179,-2012
2,4,3,5,7,3032,5304,-2272
2,4,4,5,7,2993,5388,-2395
2,4,5,5,7,2967,5063,-2096
2,4,6,5,7,2928,4857,-1929
2,4,7,5,7,2904,4651,-1747
2,4,8,5,7,2920,4269,-1349
2,4,9,5,7,2922,4053,-1131
2,4,10,5,7,2927,4441,-1514
2,4,11,5,7,2930,4772,-1842
2,4,12,5,7,2981,5003,-2022
2,4,13,5,7,3045,5220,-2175
2,4,14,5,7,3121,5427,-2306
2,4,15,5,7,3254,5594,-2340
2,4,16,5,7,3413,5651,-2238
2,4,17,5,7,3578,5313,-1735
2,5,0,5,7,3214,5234,-2020
2,5,1,5,7,3008,5617,-2609
2,5,2,5,7,2851,6073,-3222
2,5,3,5,7,2751,6211,-3460
2,5,4,5,7,2765,6314,-3549
2,5,5,5,7,2815,5911,-3096
2,5,6,5,7,2836,5576,-2740
2,5,7,5,7,2845,5355,-2510
2,5,8,5,7,2850,4886,-2036
2,5,9,5,7,2847,4600,-1753
2,5,10,5,7,2862,5111,-2249
2,5,11,5,7,2875,5458,-2583
2,5,12,5,7,2887,5804,-2917
2,5,13,5,7,2880,6117,-3237
2,5,14,5,7,2909,6342,-3433
2,5,15,5,7,3012,6567,-3555
2,5,16,5,7,3129,6647,-3518
2,5,17,5,7,3287,6178,-2891
2,6,0,5,7,3109,5723,-2614
2,6,1,5,7,3031,6144,-3113
2,6,2,5,7,3025,6571,-3546
2,6,3,5,7,3045,6617,-3572
2,6,4,5,7,3167,6663,-3496
2,6,5,5,7,3248,6176,-2928
2,6,6,5,7,3320,5689,-2369
2,6,7,5,7,3342,5387,-2045
2,6,8,5,7,3288,4800,-1512
2,6,9,5,7,3275,4449,-1174
2,6,10,5,7,3320,5115,-1795
2,6,11,5,7,3359,5498,-2139
2,6,12,5,7,3348,6004,-2656
2,6,13,5,7,3294,6440,-3146
2,6,14,5,7,3255,6739,-3484
2,6,15,5,7,3262,7118,-3856
2,6,16,5,7,3297,7254,-3957
2,6,17,5,7,3363,6710,-3347
2,7,0,5,7,3534,5634,-2100
2,7,1,5,7,3609,6104,-2495
2,7,2,5,7,3774,6540,-2766
2,7,3,5,7,3922,6530,-2608
2,7,4,5,7,4135,6503,-2368
2,7,5,5,7,4159,5966,-1807
2,7,6,5,7,4260,5341,-1081
2,7,7,5,7,4257,5044,-787
2,7,8,5,7,4147,4353,-206
2,7,9,5,7,4108,3964,144
2,7,10,5,7,4209,4713,-504
2,7,11,5,7,4293,5107,-814
2,7,12,5,7,4286,5702,-1416
2,7,13,5,7,4234,6208,-1974
2,7,14,5,7,4180,6538,-2358
2,7,15,5,7,4133,7002,-2869
2,7,16,5,7,4104,7097,-2993
2,7,17,5,7,4024,6547,-2523
2,8,0,5,7,4140,5357,-1217
2,8,1,5,7,4313,5877,-1564
2,8,2,5,7,4593,6349,-1756
2,8,3,5,7,4742,6340,-1598
2,8,4,5,7,4895,6289,-1394
2,8,5,5,7,4738,5734,-996
2,8,6,5,7,4727,5071,-344
2,8,7,5,7,4606,4847,-241
2,8,8,5,7,4383,4107,276
2,8,9,5,7,4270,3735,535
2,8,10,5,7,4508,4515,-7
2,8,11,5,7,4729,4836,-107
2,8,12,5,7,4827,5354,-527
2,8,13,5,7,4888,5846,-958
2,8,14,5,7,4967,6160,-1193
2,8,15,5,7,5027,6635,-1608
2,8,16,5,7,5024,6643,-1619
2,8,17,5,7,4798,6126,-1328
2,9,0,5,7,4530,5169,-639
2,9,1,5,7,4795,5608,-813
2,9,2,5,7,5179,6010,-831
2,9,3,5,7,5304,6008,-704
2,9,4,5,7,5388,5865,-477
2,9,5,5,7,5063,5250,-187
2,9,6,5,7,4857,4658,199
2,9,7,5,7,4651,4514,137
2,9,8,5,7,4269,3891,378
2,9,9,5,7,4053,3581,472
2,9,10,5,7,4441,4206,235
2,9,11,5,7,4772,4499,273
2,9,12,5,7,5003,4881,122
2,9,13,5,7,5220,5288,-68
2,9,14,5,7,5427,5646,-219
2,9,15,5,7,5594,6085,-491
2,9,16,5,7,5651,6052,-401
2,9,17,5,7,5313,5704,-391
2,10,0,5,7,5234,4938,296
2,10,1,5,7,5617,5207,410
2,10,2,5,7,6073,5639,434
2,10,3,5,7,6211,5671,540
2,10,4,5,7,6314,5447,867
2,10,5,5,7,5911,4916,995
2,10,6,5,7,5576,4547,1029
2,10,7,5,7,5355,4519,836
2,10,8,5,7,4886,4034,852
2,10,9,5,7,4600,3683,917
2,10,10,5,7,5111,4232,879
2,10,11,5,7,5458,4522,936
2,10,12,5,7,5804,4705,1099
2,10,13,5,7,6117,4913,1204
2,10,14,5,7,6342,5250,1092
2,10,15,5,7,6567,5567,1000
2,10,16,5,7,6647,5497,1150
2,10,17,5,7,6178,5249,929
2,11,0,5,7,5723,4553,1170
2,11,1,5,7,6144,4720,1424
2,11,2,5,7,6571,5251,1320
2,11,3,5,7,6617,5371,1246
2,11,4,5,7,6663,5071,1592
2,11,5,5,7,6176,4676,1500
2,11,6,5,7,5689,4561,1128
2,11,7,5,7,5387,4678,709
2,11,8,5,7,4800,4249,551
2,11,9,5,7,4449,3807,642
2,11,10,5,7,5115,4190,925
2,11,11,5,7,5498,4394,1104
2,11,12,5,7,6004,4352,1652
2,11,13,5,7,6440,4367,2073
2,11,14,5,7,6739,4664,2075
2,11,15,5,7,7118,4830,2288
2,11,16,5,7,7254,4714,2540
2,11,17,5,7,6710,4653,2057
2,12,0,5,7,5634,4290,1344
2,12,1,5,7,6104,4198,1906
2,12,2,5,7,6540,4677,1863
2,12,3,5,7,6530,4717,1813
2,12,4,5,7,6503,4210,2293
2,12,5,5,7,5966,3922,2044
2,12,6,5,7,5341,3985,1356
2,12,7,5,7,5044,4098,946
2,12,8,5,7,4353,3759,594
2,12,9,5,7,3964,3292,672
2,12,10,5,7,4713,3530,1183
2,12,11,5,7,5107,3725,1382
2,12,12,5,7,5702,3599,2103
2,12,13,5,7,6208,3520,2688
2,12,14,5,7,6538,3838,2700
2,12,15,5,7,7002,3999,3003
2,12,16,5,7,7097,3981,3116
2,12,17,5,7,6547,4164,2383
2,13,0,5,7,5357,3877,1480
2,13,1,5,7,5877,3660,2217
2,13,2,5,7,6349,4095,2254
2,13,3,5,7,6340,4100,2240
2,13,4,5,7,6289,3579,2710
2,13,5,5,7,5734,3452,2282
2,13,6,5,7,5071,3702,1369
2,13,7,5,7,4847,3882,965
2,13,8,5,7,4107,3651,456
2,13,9,5,7,3735,3187,548
2,13,10,5,7,4515,3317,1198
2,13,11,5,7,4836,3461,1375
2,13,12,5,7,5354,3286,2068
2,13,13,5,7,5846,3072,2774
2,13,14,5,7,6160,3264,2896
2,13,15,5,7,6635,3341,3294
2,13,16,5,7,6643,3326,3317
2,13,17,5,7,6126,3540,2586
2,14,0,5,7,5169,3402,1767
2,14,1,5,7,5608,3148,2460
2,14,2,5,7,6010,3620,2390
2,14,3,5,7,6008,3672,2336
2,14,4,5,7,5865,3246,2619
2,14,5,5,7,5250,3264,1986
2,14,6,5,7,4658,3653,1005
2,14,7,5,7,4514,3869,645
2,14,8,5,7,3891,3675,216
2,14,9,5,7,3581,3209,372
2,14,10,5,7,4206,3354,852
2,14,11,5,7,4499,3427,1072
2,14,12,5,7,4881,3245,1636
2,14,13,5,7,5288,2951,2337
2,14,14,5,7,5646,2982,2664
2,14,15,5,7,6085,2939,3146
2,14,16,5,7,6052,2905,3147
2,14,17,5,7,5704,3005,2699
2,0,0,6,7,4618,4212,406
2,0,1,6,7,4517,4225,292
2,0,2,6,7,4348,4335,13
2,0,3,6,7,4199,4443,-244
2,0,4,6,7,4045,4636,-591
2,0,5,6,7,3834,4642,-808
2,0,6,6,7,3645,4730,-1085
2,0,7,6,7,3544,4729,-1185
2,0,8,6,7,3479,4629,-1150
2,0,9,6,7,3461,4589,-1128
2,0,10,6,7,3485,4698,-1213
2,0,11,6,7,3539,4779,-1240
2,0,12,6,7,3681,4774,-1093
2,0,13,6,7,3867,4740,-873
2,0,14,6,7,4019,4714,-695
2,0,15,6,7,4180,4706,-526
2,0,16,6,7,4356,4725,-369
2,0,17,6,7,4461,4683,-222
2,1,0,6,7,4559,4713,-154
2,1,1,6,7,4400,4861,-461
2,1,2,6,7,4179,5111,-932
2,1,3,6,7,3983,5266,-1283
2,1,4,6,7,3805,5467,-1662
2,1,5,6,7,3585,5369,-1784
2,1,6,6,7,3392,5400,-2008
2,1,7,6,7,3294,5295,-2001
2,1,8,6,7,3241,5064,-1823
2,1,9,6,7,3221,4952,-1731
2,1,10,6,7,3258,5193,-1935
2,1,11,6,7,3309,5401,-2092
2,1,12,6,7,3445,5479,-2034
2,1,13,6,7,3643,5518,-1875
2,1,14,6,7,3828,5571,-1743
2,1,15,6,7,4029,5618,-1589
2,1,16,6,7,4249,5629,-1380
2,1,17,6,7,4388,5429,-1041
2,2,0,6,7,4380,5288,-908
2,2,1,6,7,4195,5548,-1353
2,2,2,6,7,3947,5918,-1971
2,2,3,6,7,3758,6057,-2299
2,2,4,6,7,3630,6193,-2563
2,2,5,6,7,3478,5942,-2464
2,2,6,6,7,3332,5788,-2456
2,2,7,6,7,3248,5593,-2345
2,2,8,6,7,3189,5228,-2039
2,2,9,6,7,3171,5023,-1852
2,2,10,6,7,3202,5410,-2208
2,2,11,6,7,3237,5742,-2505
2,2,12,6,7,3352,5965,-2613
2,2,13,6,7,3529,6129,-2600
2,2,14,6,7,3691,6289,-2598
2,2,15,6,7,3873,6446,-2573
2,2,16,6,7,4100,6483,-2383
2,2,17,6,7,4278,6142,-1864
2,3,0,6,7,4372,5661,-1289
2,3,1,6,7,4170,6005,-1835
2,3,2,6,7,3908,6456,-2548
2,3,3,6,7,3732,6566,-2834
2,3,4,6,7,3654,6655,-3001
2,3,5,6,7,3579,6247,-2668
2,3,6,6,7,3487,5896,-2409
2,3,7,6,7,3414,5659,-2245
2,3,8,6,7,3380,5150,-1770
2,3,9,6,7,3377,4853,-1476
2,3,10,6,7,3403,5382,-1979
2,3,11,6,7,3439,5766,-2327
2,3,12,6,7,3544,6134,-2590
2,3,13,6,7,3667,6455,-2788
2,3,14,6,7,3787,6703,-2916
2,3,15,6,7,3959,6961,-3002
2,3,16,6,7,4162,7064,-2902
2,3,17,6,7,4348,6639,-2291
2,4,0,6,7,4016,6396,-2380
2,4,1,6,7,3772,6870,-3098
2,4,2,6,7,3550,7395,-3845
2,4,3,6,7,3387,7509,-4122
2,4,4,6,7,3334,7611,-4277
2,4,5,6,7,3303,7095,-3792
2,4,6,6,7,3248,6615,-3367
2,4,7,6,7,3208,6322,-3114
2,4,8,6,7,3184,5702,-2518
2,4,9,6,7,3175,5338,-2163
2,4,10,6,7,3198,6021,-2823
2,4,11,6,7,3238,6421,-3183
2,4,12,6,7,3311,6920,-3609
2,4,13,6,7,3383,7351,-3968
2,4,14,6,7,3482,7633,-4151
2,4,15,6,7,3648,7970,-4322
2,4,16,6,7,3830,8076,-4246
2,4,17,6,7,4039,7493,-3454
2,5,0,6,7,3887,6737,-2850
2,5,1,6,7,3734,7298,-3564
2,5,2,6,7,3675,7850,-4175
2,5,3,6,7,3643,7928,-4285
2,5,4,6,7,3713,7972,-4259
2,5,5,6,7,3734,7360,-3626
2,5,6,6,7,3762,6751,-2989
2,5,7,6,7,3780,6431,-2651
2,5,8,6,7,3752,5694,-1942
2,5,9,6,7,3736,5278,-1542
2,5,10,6,7,3768,6091,-2323
2,5,11,6,7,3798,6527,-2729
2,5,12,6,7,3803,7128,-3325
2,5,13,6,7,3791,7654,-3863
2,5,14,6,7,3803,7997,-4194
2,5,15,6,7,3864,8446,-4582
2,5,16,6,7,3951,8525,-4574
2,5,17,6,7,4070,7867,-3797
2,6,0,6,7,4212,6536,-2324
2,6,1,6,7,4225,7129,-2904
2,6,2,6,7,4335,7686,-3351
2,6,3,6,7,4443,7684,-3241
2,6,4,6,7,4636,7621,-2985
2,6,5,6,7,4642,6944,-2302
2,6,6,6,7,4730,6211,-1481
2,6,7,6,7,4729,5885,-1156
2,6,8,6,7,4629,5024,-395
2,6,9,6,7,4589,4579,10
2,6,10,6,7,4698,5499,-801
2,6,11,6,7,4779,5944,-1165
2,6,12,6,7,4774,6547,-1773
2,6,13,6,7,4740,7130,-2390
2,6,14,6,7,4714,7551,-2837
2,6,15,6,7,4706,8120,-3414
2,6,16,6,7,4725,8168,-3443
2,6,17,6,7,4683,7531,-2848
2,7,0,6,7,4713,6317,-1604
2,7,1,6,7,4861,6843,-1982
2,7,2,6,7,5111,7335,-2224
2,7,3,6,7,5266,7323,-2057
2,7,4,6,7,5467,7163,-1696
2,7,5,6,7,5369,6454,-1085
2,7,6,6,7,5400,5719,-319
2,7,7,6,7,5295,5501,-206
2,7,8,6,7,5064,4736,328
2,7,9,6,7,4952,4334,618
2,7,10,6,7,5193,5108,85
2,7,11,6,7,5401,5512,-111
2,7,12,6,7,5479,6019,-540
2,7,13,6,7,5518,6529,-1011
2,7,14,6,7,5571,6968,-1397
2,7,15,6,7,5618,7504,-1886
2,7,16,6,7,5629,7511,-1882
2,7,17,6,7,5429,7048,-1619
2,8,0,6,7,5288,6069,-781
2,8,1,6,7,5548,6417,-869
2,8,2,6,7,5918,6916,-998
2,8,3,6,7,6057,6933,-876
2,8,4,6,7,6193,6714,-521
2,8,5,6,7,5942,6100,-158
2,8,6,6,7,5788,5586,202
2,8,7,6,7,5593,5527,66
2,8,8,6,7,5228,4915,313
2,8,9,6,7,5023,4483,540
2,8,10,6,7,5410,5173,237
2,8,11,6,7,5742,5516,226
2,8,12,6,7,5965,5836,129
2,8,13,6,7,6129,6148,-19
2,8,14,6,7,6289,6526,-237
2,8,15,6,7,6446,6934,-488
2,8,16,6,7,6483,6910,-427
2,8,17,6,7,6142,6575,-433
2,9,0,6,7,5661,5715,-54
2,9,1,6,7,6005,5973,32
2,9,2,6,7,6456,6573,-117
2,9,3,6,7,6566,6669,-103
2,9,4,6,7,6655,6368,287
2,9,5,6,7,6247,5860,387
2,9,6,6,7,5896,5600,296
2,9,7,6,7,5659,5645,14
2,9,8,6,7,5150,5065,85
2,9,9,6,7,4853,4545,308
2,9,10,6,7,5382,5100,282
2,9,11,6,7,5766,5357,409
2,9,12,6,7,6134,5468,666
2,9,13,6,7,6455,5601,854
2,9,14,6,7,6703,5955,748
2,9,15,6,7,6961,6233,728
2,9,16,6,7,7064,6143,921
2,9,17,6,7,6639,5968,671
2,10,0,6,7,6396,5304,1092
2,10,1,6,7,6870,5352,1518
2,10,2,6,7,7395,5956,1439
2,10,3,6,7,7509,6028,1481
2,10,4,6,7,7611,5519,2092
2,10,5,6,7,7095,5106,1989
2,10,6,6,7,6615,5047,1568
2,10,7,6,7,6322,5142,1180
2,10,8,6,7,5702,4653,1049
2,10,9,6,7,5338,4121,1217
2,10,10,6,7,6021,4506,1515
2,10,11,6,7,6421,4754,1667
2,10,12,6,7,6920,4723,2197
2,10,13,6,7,7351,4734,2617
2,10,14,6,7,7633,5096,2537
2,10,15,6,7,7970,5327,2643
2,10,16,6,7,8076,5252,2824
2,10,17,6,7,7493,5321,2172
2,11,0,6,7,6737,4779,1958
2,11,1,6,7,7298,4685,2613
2,11,2,6,7,7850,5241,2609
2,11,3,6,7,7928,5254,2674
2,11,4,6,7,7972,4697,3275
2,11,5,6,7,7360,4430,2930
2,11,6,6,7,6751,4572,2179
2,11,7,6,7,6431,4723,1708
2,11,8,6,7,5694,4322,1372
2,11,9,6,7,5278,3802,1476
2,11,10,6,7,6091,4103,1988
2,11,11,6,7,6527,4298,2229
2,11,12,6,7,7128,4131,2997
2,11,13,6,7,7654,3994,3660
2,11,14,6,7,7997,4277,3720
2,11,15,6,7,8446,4459,3987
2,11,16,6,7,8525,4397,4128
2,11,17,6,7,7867,4524,3343
2,12,0,6,7,6536,4362,2174
2,12,1,6,7,7129,4114,3015
2,12,2,6,7,7686,4606,3080
2,12,3,6,7,7684,4655,3029
2,12,4,6,7,7621,4120,3501
2,12,5,6,7,6944,3984,2960
2,12,6,6,7,6211,4301,1910
2,12,7,6,7,5885,4523,1362
2,12,8,6,7,5024,4304,720
2,12,9,6,7,4579,3808,771
2,12,10,6,7,5499,3947,1552
2,12,11,6,7,5944,4103,1841
2,12,12,6,7,6547,3910,2637
2,12,13,6,7,7130,3634,3496
2,12,14,6,7,7551,3790,3761
2,12,15,6,7,8120,3808,4312
2,12,16,6,7,8168,3773,4395
2,12,17,6,7,7531,3927,3604
2,0,0,7,7,5296,5861,-565
2,0,1,7,7,5133,6096,-963
2,0,2,7,7,4909,6436,-1527
2,0,3,7,7,4720,6581,-1861
2,0,4,7,7,4546,6765,-2219
2,0,5,7,7,4317,6573,-2256
2,0,6,7,7,4115,6461,-2346
2,0,7,7,7,4016,6282,-2266
2,0,8,7,7,3961,5909,-1948
2,0,9,7,7,3942,5705,-1763
2,0,10,7,7,3974,6095,-2121
2,0,11,7,7,4025,6414,-2389
2,0,12,7,7,4169,6617,-2448
2,0,13,7,7,4373,6759,-2386
2,0,14,7,7,4553,6893,-2340
2,0,15,7,7,4753,7037,-2284
2,0,16,7,7,4977,7088,-2111
2,0,17,7,7,5120,6773,-1653
2,1,0,7,7,5132,6419,-1287
2,1,1,7,7,4948,6758,-1810
2,1,2,7,7,4697,7195,-2498
2,1,3,7,7,4507,7319,-2812
2,1,4,7,7,4377,7460,-3083
2,1,5,7,7,4216,7126,-2910
2,1,6,7,7,4065,6827,-2762
2,1,7,7,7,3983,6601,-2618
2,1,8,7,7,3922,6109,-2187
2,1,9,7,7,3903,5823,-1920
2,1,10,7,7,3943,6351,-2408
2,1,11,7,7,3981,6736,-2755
2,1,12,7,7,4097,7096,-2999
2,1,13,7,7,4273,7364,-3091
2,1,14,7,7,4432,7565,-3133
2,1,15,7,7,4620,7813,-3193
2,1,16,7,7,4854,7896,-3042
2,1,17,7,7,5019,7468,-2449
2,2,0,7,7,5138,6823,-1685
2,2,1,7,7,4948,7258,-2310
2,2,2,7,7,4686,7778,-3092
2,2,3,7,7,4511,7864,-3353
2,2,4,7,7,4435,7952,-3517
2,2,5,7,7,4357,7431,-3074
2,2,6,7,7,4263,6935,-2672
2,2,7,7,7,4190,6626,-2436
2,2,8,7,7,4148,5966,-1818
2,2,9,7,7,4141,5591,-1450
2,2,10,7,7,4171,6292,-2121
2,2,11,7,7,4207,6729,-2522
2,2,12,7,7,4314,7250,-2936
2,2,13,7,7,4438,7689,-3251
2,2,14,7,7,4553,7994,-3441
2,2,15,7,7,4725,8364,-3639
2,2,16,7,7,4932,8493,-3561
2,2,17,7,7,5107,7954,-2847
2,3,0,7,7,4799,7410,-2611
2,3,1,7,7,4558,8024,-3466
2,3,2,7,7,4291,8674,-4383
2,3,3,7,7,4087,8820,-4733
2,3,4,7,7,3995,8920,-4925
2,3,5,7,7,3915,8279,-4364
2,3,6,7,7,3807,7677,-3870
2,3,7,7,7,3718,7366,-3648
2,3,8,7,7,3644,6596,-2952
2,3,9,7,7,3630,6167,-2537
2,3,10,7,7,3674,6997,-3323
2,3,11,7,7,3747,7450,-3703
2,3,12,7,7,3874,8044,-4170
2,3,13,7,7,4005,8565,-4560
2,3,14,7,7,4148,8891,-4743
2,3,15,7,7,4353,9298,-4945
2,3,16,7,7,4579,9347,-4768
2,3,17,7,7,4809,8650,-3841
2,4,0,7,7,4689,7639,-2950
2,4,1,7,7,4498,8323,-3825
2,4,2,7,7,4374,8996,-4622
2,4,3,7,7,4279,9082,-4803
2,4,4,7,7,4282,9090,-4808
2,4,5,7,7,4222,8338,-4116
2,4,6,7,7,4174,7621,-3447
2,4,7,7,7,4143,7272,-3129
2,4,8,7,7,4086,6365,-2279
2,4,9,7,7,4064,5893,-1829
2,4,10,7,7,4104,6877,-2773
2,4,11,7,7,4161,7364,-3203
2,4,12,7,7,4227,7973,-3746
2,4,13,7,7,4294,8576,-4282
2,4,14,7,7,4376,9010,-4634
2,4,15,7,7,4500,9564,-5064
2,4,16,7,7,4652,9596,-4944
2,4,17,7,7,4822,8851,-4029
2,5,0,7,7,4990,7496,-2506
2,5,1,7,7,4928,8095,-3167
2,5,2,7,7,4985,8672,-3687
2,5,3,7,7,5041,8667,-3626
2,5,4,7,7,5182,8495,-3313
2,5,5,7,7,5128,7664,-2536
2,5,6,7,7,5172,6859,-1687
2,5,7,7,7,5167,6539,-1372
2,5,8,7,7,5093,5653,-560
2,5,9,7,7,5050,5178,-128
2,5,10,7,7,5146,6092,-946
2,5,11,7,7,5218,6620,-1402
2,5,12,7,7,5229,7212,-1983
2,5,13,7,7,5237,7813,-2576
2,5,14,7,7,5262,8359,-3097
2,5,15,7,7,5308,8989,-3681
2,5,16,7,7,5379,9036,-3657
2,5,17,7,7,5390,8453,-3063
2,6,0,7,7,5391,7217,-1826
2,6,1,7,7,5477,7652,-2175
2,6,2,7,7,5672,8241,-2569
2,6,3,7,7,5787,8248,-2461
2,6,4,7,7,5968,8012,-2044
2,6,5,7,7,5852,7304,-1452
2,6,6,7,7,5870,6647,-777
2,6,7,7,7,5767,6514,-747
2,6,8,7,7,5546,5760,-214
2,6,9,7,7,5433,5236,197
2,6,10,7,7,5682,6075,-393
2,6,11,7,7,5887,6529,-642
2,6,12,7,7,5967,6974,-1007
2,6,13,7,7,6024,7389,-1365
2,6,14,7,7,6105,7848,-1743
2,6,15,7,7,6191,8353,-2162
2,6,16,7,7,6250,8369,-2119
2,6,17,7,7,6088,7919,-1831
2,7,0,7,7,5861,6846,-985
2,7,1,7,7,6096,7183,-1087
2,7,2,7,7,6436,7850,-1414
2,7,3,7,7,6581,7931,-1350
2,7,4,7,7,6765,7635,-870
2,7,5,7,7,6573,7044,-471
2,7,6,7,7,6461,6639,-178
2,7,7,7,7,6282,6653,-371
2,7,8,7,7,5909,5946,-37
2,7,9,7,7,5705,5345,360
2,7,10,7,7,6095,6041,54
2,7,11,7,7,6414,6351,63
2,7,12,7,7,6617,6599,18
2,7,13,7,7,6759,6836,-77
2,7,14,7,7,6893,7231,-338
2,7,15,7,7,7037,7600,-563
2,7,16,7,7,7088,7556,-468
2,7,17,7,7,6773,7294,-521
2,8,0,7,7,6419,6466,-47
2,8,1,7,7,6758,6605,153
2,8,2,7,7,7195,7278,-83
2,8,3,7,7,7319,7326,-7
2,8,4,7,7,7460,6816,644
2,8,5,7,7,7126,6290,836
2,8,6,7,7,6827,6086,741
2,8,7,7,7,6601,6109,492
2,8,8,7,7,6109,5469,640
2,8,9,7,7,5823,4859,964
2,8,10,7,7,6351,5416,935
2,8,11,7,7,6736,5717,1019
2,8,12,7,7,7096,5839,1257
2,8,13,7,7,7364,5968,1396
2,8,14,7,7,7565,6387,1178
2,8,15,7,7,7813,6730,1083
2,8,16,7,7,7896,6681,1215
2,8,17,7,7,7468,6636,832
2,9,0,7,7,6823,5793,1030
2,9,1,7,7,7258,5839,1419
2,9,2,7,7,7778,6520,1258
2,9,3,7,7,7864,6565,1299
2,9,4,7,7,7952,6006,1946
2,9,5,7,7,7431,5614,1817
2,9,6,7,7,6935,5634,1301
2,9,7,7,7,6626,5767,859
2,9,8,7,7,5966,5216,750
2,9,9,7,7,5591,4631,960
2,9,10,7,7,6292,5079,1213
2,9,11,7,7,6729,5327,1402
2,9,12,7,7,7250,5255,1995
2,9,13,7,7,7689,5208,2481
2,9,14,7,7,7994,5535,2459
2,9,15,7,7,8364,5787,2577
2,9,16,7,7,8493,5668,2825
2,9,17,7,7,7954,5681,2273
2,10,0,7,7,7410,5264,2146
2,10,1,7,7,8024,5139,2885
2,10,2,7,7,8674,5752,2922
2,10,3,7,7,8820,5809,3011
2,10,4,7,7,8920,5238,3682
2,10,5,7,7,8279,4962,3317
2,10,6,7,7,7677,5171,2506
2,10,7,7,7,7366,5364,2002
2,10,8,7,7,6596,4975,1621
2,10,9,7,7,6167,4423,1744
2,10,10,7,7,6997,4733,2264
2,10,11,7,7,7450,4940,2510
2,10,12,7,7,8044,4755,3289
2,10,13,7,7,8565,4556,4009
2,10,14,7,7,8891,4803,4088
2,10,15,7,7,9298,4926,4372
2,10,16,7,7,9347,4844,4503
2,10,17,7,7,8650,4911,3739
2,0,0,8,7,5869,7581,-1712
2,0,1,8,7,5681,8011,-2330
2,0,2,8,7,5427,8517,-3090
2,0,3,8,7,5244,8617,-3373
2,0,4,8,7,5118,8757,-3639
2,0,5,8,7,4948,8310,-3362
2,0,6,8,7,4788,7866,-3078
2,0,7,8,7,4705,7568,-2863
2,0,8,8,7,4642,6925,-2283
2,0,9,8,7,4624,6561,-1937
2,0,10,8,7,4659,7261,-2602
2,0,11,8,7,4697,7699,-3002
2,0,12,8,7,4821,8212,-3391
2,0,13,8,7,5003,8598,-3595
2,0,14,8,7,5157,8856,-3699
2,0,15,8,7,5344,9216,-3872
2,0,16,8,7,5582,9325,-3743
2,0,17,8,7,5751,8783,-3032
2,1,0,8,7,5890,7837,-1947
2,1,1,8,7,5701,8412,-2711
2,1,2,8,7,5436,9057,-3621
2,1,3,8,7,5260,9175,-3915
2,1,4,8,7,5182,9261,-4079
2,1,5,8,7,5095,8615,-3520
2,1,6,8,7,4996,7997,-3001
2,1,7,8,7,4925,7670,-2745
2,1,8,8,7,4881,6860,-1979
2,1,9,8,7,4873,6420,-1547
2,1,10,8,7,4912,7268,-2356
2,1,11,8,7,4951,7758,-2807
2,1,12,8,7,5059,8374,-3315
2,1,13,8,7,5182,8903,-3721
2,1,14,8,7,5294,9252,-3958
2,1,15,8,7,5472,9692,-4220
2,1,16,8,7,5686,9764,-4078
2,1,17,8,7,5848,9111,-3263
2,2,0,8,7,5565,8312,-2747
2,2,1,8,7,5336,9049,-3713
2,2,2,8,7,5069,9820,-4751
2,2,3,8,7,4866,9974,-5108
2,2,4,8,7,4776,10038,-5262
2,2,5,8,7,4693,9257,-4564
2,2,6,8,7,4583,8547,-3964
2,2,7,8,7,4494,8207,-3713
2,2,8,8,7,4412,7267,-2855
2,2,9,8,7,4394,6782,-2388
2,2,10,8,7,4442,7783,-3341
2,2,11,8,7,4515,8287,-3772
2,2,12,8,7,4644,8889,-4245
2,2,13,8,7,4776,9487,-4711
2,2,14,8,7,4914,9904,-4990
2,2,15,8,7,5119,10416,-5297
2,2,16,8,7,5349,10418,-5069
2,2,17,8,7,5568,9634,-4066
2,3,0,8,7,5472,8599,-3127
2,3,1,8,7,5284,9289,-4005
2,3,2,8,7,5115,9982,-4867
2,3,3,8,7,4979,10065,-5086
2,3,4,8,7,4943,9964,-5021
2,3,5,8,7,4834,9058,-4224
2,3,6,8,7,4733,8269,-3536
2,3,7,8,7,4653,7926,-3273
2,3,8,8,7,4546,6994,-2448
2,3,9,8,7,4519,6492,-1973
2,3,10,8,7,4580,7470,-2890
2,3,11,8,7,4670,8040,-3370
2,3,12,8,7,4790,8638,-3848
2,3,13,8,7,4916,9259,-4343
2,3,14,8,7,5042,9818,-4776
2,3,15,8,7,5205,10433,-5228
2,3,16,8,7,5401,10464,-5063
2,3,17,8,7,5592,9773,-4181
2,4,0,8,7,5792,8396,-2604
2,4,1,8,7,5692,8904,-3212
2,4,2,8,7,5684,9578,-3894
2,4,3,8,7,5677,9592,-3915
2,4,4,8,7,5751,9344,-3593
2,4,5,8,7,5616,8514,-2898
2,4,6,8,7,5584,7787,-2203
2,4,7,8,7,5530,7552,-2022
2,4,8,8,7,5427,6677,-1250
2,4,9,8,7,5378,6080,-702
2,4,10,8,7,5482,7059,-1577
2,4,11,8,7,5581,7637,-2056
2,4,12,8,7,5653,8167,-2514
2,4,13,8,7,5740,8673,-2933
2,4,14,8,7,5835,9239,-3404
2,4,15,8,7,5944,9838,-3894
2,4,16,8,7,6080,9894,-3814
2,4,17,8,7,6142,9324,-3182
2,5,0,8,7,6169,7994,-1825
2,5,1,8,7,6180,8418,-2238
2,5,2,8,7,6322,9175,-2853
2,5,3,8,7,6385,9246,-2861
2,5,4,8,7,6514,8933,-2419
2,5,5,8,7,6338,8248,-1910
2,5,6,8,7,6312,7700,-1388
2,5,7,8,7,6205,7640,-1435
2,5,8,8,7,6010,6791,-781
2,5,9,8,7,5894,6098,-204
2,5,10,8,7,6130,6943,-813
2,5,11,8,7,6326,7364,-1038
2,5,12,8,7,6422,7737,-1315
2,5,13,8,7,6521,8077,-1556
2,5,14,8,7,6653,8553,-1900
2,5,15,8,7,6793,9019,-2226
2,5,16,8,7,6904,9015,-2111
2,5,17,8,7,6795,8638,-1843
2,6,0,8,7,6539,7597,-1058
2,6,1,8,7,6712,7815,-1103
2,6,2,8,7,6997,8555,-1558
2,6,3,8,7,7102,8588,-1486
2,6,4,8,7,7266,8083,-817
2,6,5,8,7,7056,7474,-418
2,6,6,8,7,6931,7125,-194
2,6,7,8,7,6754,7117,-363
2,6,8,8,7,6391,6350,41
2,6,9,8,7,6186,5659,527
2,6,10,8,7,6584,6357,227
2,6,11,8,7,6900,6711,189
2,6,12,8,7,7105,6970,135
2,6,13,8,7,7265,7203,62
2,6,14,8,7,7427,7663,-236
2,6,15,8,7,7610,8097,-487
2,6,16,8,7,7709,8094,-385
2,6,17,8,7,7432,7962,-530
2,7,0,8,7,6992,6955,37
2,7,1,8,7,7306,7092,214
2,7,2,8,7,7713,7842,-129
2,7,3,8,7,7843,7863,-20
2,7,4,8,7,8032,7303,729
2,7,5,8,7,7757,6798,959
2,7,6,8,7,7500,6673,827
2,7,7,8,7,7290,6734,556
2,7,8,8,7,6790,6032,758
2,7,9,8,7,6505,5369,1136
2,7,10,8,7,7036,5989,1047
2,7,11,8,7,7408,6290,1118
2,7,12,8,7,7748,6371,1377
2,7,13,8,7,7994,6442,1552
2,7,14,8,7,8169,6826,1343
2,7,15,8,7,8404,7190,1214
2,7,16,8,7,8501,7097,1404
2,7,17,8,7,8099,6996,1103
2,8,0,8,7,7581,6278,1303
2,8,1,8,7,8011,6293,1718
2,8,2,8,7,8517,7031,1486
2,8,3,8,7,8617,7120,1497
2,8,4,8,7,8757,6547,2210
2,8,5,8,7,8310,6146,2164
2,8,6,8,7,7866,6233,1633
2,8,7,8,7,7568,6408,1160
2,8,8,8,7,6925,5869,1056
2,8,9,8,7,6561,5252,1309
2,8,10,8,7,7261,5709,1552
2,8,11,8,7,7699,5969,1730
2,8,12,8,7,8212,5879,2333
2,8,13,8,7,8598,5770,2828
2,8,14,8,7,8856,6061,2795
2,8,15,8,7,9216,6254,2962
2,8,16,8,7,9325,6115,3210
2,8,17,8,7,8783,6068,2715
2,0,0,9,7,6627,8739,-2112
2,0,1,9,7,6434,9437,-3003
2,0,2,9,7,6166,10203,-4037
2,0,3,9,7,5997,10329,-4332
2,0,4,9,7,5923,10379,-4456
2,0,5,9,7,5827,9593,-3766
2,0,6,9,7,5719,8867,-3148
2,0,7,9,7,5647,8511,-2864
2,0,8,9,7,5601,7531,-1930
2,0,9,9,7,5594,7035,-1441
2,0,10,9,7,5628,8054,-2426
2,0,11,9,7,5667,8595,-2928
2,0,12,9,7,5783,9219,-3436
2,0,13,9,7,5912,9825,-3913
2,0,14,9,7,6019,10265,-4246
2,0,15,9,7,6196,10810,-4614
2,0,16,9,7,6414,10835,-4421
2,0,17,9,7,6580,10095,-3515
2,1,0,9,7,6317,9272,-2955
2,1,1,9,7,6089,10015,-3926
2,1,2,9,7,5819,10806,-4987
2,1,3,9,7,5615,10957,-5342
2,1,4,9,7,5523,10912,-5389
2,1,5,9,7,5431,9977,-4546
2,1,6,9,7,5316,9195,-3879
2,1,7,9,7,5229,8861,-3632
2,1,8,9,7,5145,7896,-2751
2,1,9,9,7,5126,7381,-2255
2,1,10,9,7,5183,8376,-3193
2,1,11,9,7,5259,8963,-3704
2,1,12,9,7,5389,9554,-4165
2,1,13,9,7,5520,10170,-4650
2,1,14,9,7,5655,10712,-5057
2,1,15,9,7,5866,11285,-5419
2,1,16,9,7,6103,11286,-5183
2,1,17,9,7,6309,10556,-4247
2,2,0,9,7,6238,9499,-3261
2,2,1,9,7,6062,10098,-4036
2,2,2,9,7,5893,10888,-4995
2,2,3,9,7,5758,10990,-5232
2,2,4,9,7,5724,10813,-5089
2,2,5,9,7,5612,9908,-4296
2,2,6,9,7,5509,9197,-3688
2,2,7,9,7,5429,8939,-3510
2,2,8,9,7,5314,8018,-2704
2,2,9,9,7,5283,7394,-2111
2,2,10,9,7,5348,8437,-3089
2,2,11,9,7,5438,9057,-3619
2,2,12,9,7,5560,9593,-4033
2,2,13,9,7,5687,10119,-4432
2,2,14,9,7,5808,10698,-4890
2,2,15,9,7,5971,11282,-5311
2,2,16,9,7,6171,11322,-5151
2,2,17,9,7,6351,10644,-4293
2,3,0,9,7,6575,9173,-2598
2,3,1,9,7,6478,9670,-3192
2,3,2,9,7,6425,10512,-4087
2,3,3,9,7,6377,10590,-4213
2,3,4,9,7,6412,10265,-3853
2,3,5,9,7,6228,9458,-3230
2,3,6,9,7,6143,8840,-2697
2,3,7,9,7,6040,8678,-2638
2,3,8,9,7,5887,7708,-1821
2,3,9,9,7,5833,6942,-1109
2,3,10,9,7,5958,7927,-1969
2,3,11,9,7,6090,8472,-2382
2,3,12,9,7,6216,8930,-2714
2,3,13,9,7,6362,9361,-2999
2,3,14,9,7,6501,9944,-3443
2,3,15,9,7,6649,10504,-3855
2,3,16,9,7,6829,10540,-3711
2,3,17,9,7,6912,10043,-3131
2,4,0,9,7,6971,8745,-1774
2,4,1,9,7,6944,9050,-2106
2,4,2,9,7,7021,9880,-2859
2,4,3,9,7,7021,9903,-2882
2,4,4,9,7,7083,9381,-2298
2,4,5,9,7,6826,8678,-1852
2,4,6,9,7,6724,8186,-1462
2,4,7,9,7,6568,8104,-1536
2,4,8,9,7,6344,7195,-851
2,4,9,9,7,6222,6412,-190
2,4,10,9,7,6466,7259,-793
2,4,11,9,7,6689,7724,-1035
2,4,12,9,7,6846,8108,-1262
2,4,13,9,7,7024,8444,-1420
2,4,14,9,7,7226,8985,-1759
2,4,15,9,7,7429,9516,-2087
2,4,16,9,7,7605,9553,-1948
2,4,17,9,7,7547,9306,-1759
2,5,0,9,7,7317,8086,-769
2,5,1,9,7,7415,8302,-887
2,5,2,9,7,7647,9119,-1472
2,5,3,9,7,7700,9125,-1425
2,5,4,9,7,7812,8570,-758
2,5,5,9,7,7542,7982,-440
2,5,6,9,7,7373,7712,-339
2,5,7,9,7,7192,7742,-550
2,5,8,9,7,6855,6913,-58
2,5,9,9,7,6647,6169,478
2,5,10,9,7,7032,6930,102
2,5,11,9,7,7339,7284,55
2,5,12,9,7,7560,7502,58
2,5,13,9,7,7762,7677,85
2,5,14,9,7,7975,8102,-127
2,5,15,9,7,8212,8557,-345
2,5,16,9,7,8363,8510,-147
2,5,17,9,7,8139,8322,-183
2,6,0,9,7,7670,7440,230
2,6,1,9,7,7922,7546,376
2,6,2,9,7,8274,8353,-79
2,6,3,9,7,8364,8418,-54
2,6,4,9,7,8533,7844,689
2,6,5,9,7,8240,7330,910
2,6,6,9,7,7970,7272,698
2,6,7,9,7,7762,7375,387
2,6,8,9,7,7272,6685,587
2,6,9,9,7,6986,5990,996
2,6,10,9,7,7525,6619,906
2,6,11,9,7,7894,6932,962
2,6,12,9,7,8236,6995,1241
2,6,13,9,7,8500,7004,1496
2,6,14,9,7,8703,7352,1351
2,6,15,9,7,8977,7657,1320
2,6,16,9,7,9122,7544,1578
2,6,17,9,7,8758,7383,1375
2,0,0,10,7,7054,10172,-3118
2,0,1,10,7,6822,10824,-4002
2,0,2,10,7,6549,11712,-5163
2,0,3,10,7,6352,11882,-5530
2,0,4,10,7,6264,11761,-5497
2,0,5,10,7,6163,10827,-4664
2,0,6,10,7,6039,10123,-4084
2,0,7,10,7,5951,9874,-3923
2,0,8,10,7,5865,8920,-3055
2,0,9,10,7,5847,8283,-2436
2,0,10,10,7,5899,9343,-3444
2,0,11,10,7,5975,9980,-4005
2,0,12,10,7,6113,10509,-4396
2,0,13,10,7,6250,11030,-4780
2,0,14,10,7,6380,11592,-5212
2,0,15,10,7,6590,12134,-5544
2,0,16,10,7,6831,12144,-5313
2,0,17,10,7,7041,11427,-4386
2,1,0,10,7,6990,10276,-3286
2,1,1,10,7,6815,10864,-4049
2,1,2,10,7,6643,11822,-5179
2,1,3,10,7,6507,11988,-5481
2,1,4,10,7,6471,11734,-5263
2,1,5,10,7,6350,10852,-4502
2,1,6,10,7,6242,10250,-4008
2,1,7,10,7,6164,10065,-3901
2,1,8,10,7,6047,9049,-3002
2,1,9,10,7,6015,8256,-2241
2,1,10,10,7,6089,9305,-3216
2,1,11,10,7,6182,9892,-3710
2,1,12,10,7,6305,10356,-4051
2,1,13,10,7,6431,10807,-4376
2,1,14,10,7,6549,11403,-4854
2,1,15,10,7,6718,11948,-5230
2,1,16,10,7,6925,11968,-5043
2,1,17,10,7,7092,11363,-4271
2,2,0,10,7,7341,9924,-2583
2,2,1,10,7,7256,10302,-3046
2,2,2,10,7,7203,11217,-4014
2,2,3,10,7,7156,11247,-4091
2,2,4,10,7,7193,10713,-3520
2,2,5,10,7,7006,9888,-2882
2,2,6,10,7,6919,9326,-2407
2,2,7,10,7,6816,9142,-2326
2,2,8,10,7,6655,8112,-1457
2,2,9,10,7,6597,7256,-659
2,2,10,10,7,6726,8243,-1517
2,2,11,10,7,6858,8832,-1974
2,2,12,10,7,6986,9301,-2315
2,2,13,10,7,7133,9728,-2595
2,2,14,10,7,7267,10376,-3109
2,2,15,10,7,7415,11001,-3586
2,2,16,10,7,7599,11078,-3479
2,2,17,10,7,7671,10711,-3040
2,3,0,10,7,7754,9234,-1480
2,3,1,10,7,7730,9537,-1807
2,3,2,10,7,7762,10444,-2682
2,3,3,10,7,7721,10440,-2719
2,3,4,10,7,7744,9868,-2124
2,3,5,10,7,7438,9186,-1748
2,3,6,10,7,7283,8773,-1490
2,3,7,10,7,7078,8729,-1651
2,3,8,10,7,6804,7758,-954
2,3,9,10,7,6677,6922,-245
2,3,10,10,7,6942,7832,-890
2,3,11,10,7,7198,8297,-1099
2,3,12,10,7,7409,8640,-1231
2,3,13,10,7,7646,8918,-1272
2,3,14,10,7,7892,9424,-1532
2,3,15,10,7,8134,9976,-1842
2,3,16,10,7,8354,9969,-1615
2,3,17,10,7,8317,9666,-1349
2,4,0,10,7,8119,8571,-452
2,4,1,10,7,8179,8756,-577
2,4,2,10,7,8346,9630,-1284
2,4,3,10,7,8336,9680,-1344
2,4,4,10,7,8381,9111,-730
2,4,5,10,7,8030,8514,-484
2,4,6,10,7,7785,8311,-526
2,4,7,10,7,7555,8383,-828
2,4,8,10,7,7189,7566,-377
2,4,9,10,7,6975,6790,185
2,4,10,10,7,7368,7560,-192
2,4,11,10,7,7702,7926,-224
2,4,12,10,7,7984,8126,-142
2,4,13,10,7,8265,8239,26
2,4,14,10,7,8548,8628,-80
2,4,15,10,7,8848,9024,-176
2,4,16,10,7,9064,8957,107
2,4,17,10,7,8891,8709,182
2,0,0,11,7,7727,11027,-3300
2,0,1,11,7,7548,11496,-3948
2,0,2,11,7,7373,12527,-5154
2,0,3,11,7,7244,12645,-5401
2,0,4,11,7,7212,12182,-4970
2,0,5,11,7,7082,11282,-4200
2,0,6,11,7,6965,10736,-3771
2,0,7,11,7,6886,10529,-3643
2,0,8,11,7,6767,9453,-2686
2,0,9,11,7,6736,8570,-1834
2,0,10,11,7,6805,9621,-2816
2,0,11,11,7,6898,10252,-3354
2,0,12,11,7,7029,10727,-3698
2,0,13,11,7,7161,11174,-4013
2,0,14,11,7,7274,11835,-4561
2,0,15,11,7,7442,12445,-5003
2,0,16,11,7,7653,12506,-4853
2,0,17,11,7,7824,12031,-4207
2,1,0,11,7,8093,10413,-2320
2,1,1,11,7,8009,10789,-2780
2,1,2,11,7,7953,11781,-3828
2,1,3,11,7,7905,11784,-3879
2,1,4,11,7,7940,11200,-3260
2,1,5,11,7,7744,10396,-2652
2,1,6,11,7,7652,9913,-2261
2,1,7,11,7,7551,9767,-2216
2,1,8,11,7,7388,8675,-1287
2,1,9,11,7,7329,7766,-437
2,1,10,11,7,7467,8816,-1349
2,1,11,11,7,7602,9405,-1803
2,1,12,11,7,7731,9833,-2102
2,1,13,11,7,7877,10202,-2325
2,1,14,11,7,8008,10815,-2807
2,1,15,11,7,8162,11461,-3299
2,1,16,11,7,8353,11494,-3141
2,1,17,11,7,8412,11071,-2659
2,2,0,11,7,8520,9719,-1199
2,2,1,11,7,8508,9991,-1483
2,2,2,11,7,8540,10955,-2415
2,2,3,11,7,8500,10995,-2495
2,2,4,11,7,8525,10409,-1884
2,2,5,11,7,8216,9718,-1502
2,2,6,11,7,8059,9372,-1313
2,2,7,11,7,7854,9370,-1516
2,2,8,11,7,7572,8411,-839
2,2,9,11,7,7441,7543,-102
2,2,10,11,7,7710,8462,-752
2,2,11,11,7,7966,8939,-973
2,2,12,11,7,8179,9264,-1085
2,2,13,11,7,8417,9480,-1063
2,2,14,11,7,8658,9950,-1292
2,2,15,11,7,8900,10443,-1543
2,2,16,11,7,9124,10416,-1292
2,2,17,11,7,9076,10053,-977
2,0,0,12,7,8830,10898,-2068
2,0,1,12,7,8742,11243,-2501
2,0,2,12,7,8683,12292,-3609
2,0,3,12,7,8642,12339,-3697
2,0,4,12,7,8681,11741,-3060
2,0,5,12,7,8476,10928,-2452
2,0,6,12,7,8375,10512,-2137
2,0,7,12,7,8273,10408,-2135
2,0,8,12,7,8108,9328,-1220
2,0,9,12,7,8050,8387,-337
2,0,10,12,7,8183,9446,-1263
2,0,11,12,7,8318,10047,-1729
2,0,12,12,7,8455,10457,-2002
2,0,13,12,7,8607,10764,-2157
2,0,14,12,7,8733,11341,-2608
2,0,15,12,7,8886,11928,-3042
2,0,16,12,7,9081,11941,-2860
2,0,17,12,7,9144,11458,-2314
2,0,0,1,8,843,859,-16
2,0,1,1,8,837,861,-24
2,0,2,1,8,833,856,-23
2,0,3,1,8,839,853,-14
2,0,4,1,8,843,850,-7
2,0,5,1,8,834,841,-7
2,0,6,1,8,826,837,-11
2,0,7,1,8,826,840,-14
2,0,8,1,8,825,840,-15
2,0,9,1,8,819,847,-28
2,0,10,1,8,818,848,-30
2,0,11,1,8,826,848,-22
2,0,12,1,8,832,847,-15
2,0,13,1,8,828,845,-17
2,0,14,1,8,828,852,-24
2,0,15,1,8,833,861,-28
2,0,16,1,8,830,856,-26
2,1,0,1,8,859,884,-25
2,1,1,1,8,861,893,-32
2,1,2,1,8,856,891,-35
2,1,3,1,8,853,888,-35
2,1,4,1,8,850,888,-38
2,1,5,1,8,841,884,-43
2,1,6,1,8,837,884,-47
2,1,7,1,8,840,886,-46
2,1,8,1,8,840,879,-39
2,1,9,1,8,847,881,-34
2,1,10,1,8,848,877,-29
2,1,11,1,8,848,877,-29
2,1,12,1,8,847,877,-30
2,1,13,1,8,845,874,-29
2,1,14,1,8,852,876,-24
2,1,15,1,8,861,881,-20
2,1,16,1,8,856,876,-20
2,2,0,1,8,884,898,-14
2,2,1,1,8,893,858,35
2,2,2,1,8,891,810,81
2,2,3,1,8,888,766,122
2,2,4,1,8,888,724,164
2,2,5,1,8,884,674,210
2,2,6,1,8,884,622,262
2,2,7,1,8,886,575,311
2,2,8,1,8,879,527,352
2,2,9,1,8,881,545,336
2,2,10,1,8,877,575,302
2,2,11,1,8,877,626,251
2,2,12,1,8,877,684,193
2,2,13,1,8,874,729,145
2,2,14,1,8,876,770,106
2,2,15,1,8,881,816,65
2,2,16,1,8,876,860,16
2,3,0,1,8,898,878,20
2,3,1,1,8,858,818,40
2,3,2,1,8,810,750,60
2,3,3,1,8,766,684,82
2,3,4,1,8,724,614,110
2,3,5,1,8,674,532,142
2,3,6,1,8,622,457,165
2,3,7,1,8,575,410,165
2,3,8,1,8,527,382,145
2,3,9,1,8,545,387,158
2,3,10,1,8,575,411,164
2,3,11,1,8,626,469,157
2,3,12,1,8,684,547,137
2,3,13,1,8,729,618,111
2,3,14,1,8,770,683,87
2,3,15,1,8,816,749,67
2,3,16,1,8,860,811,49
2,4,0,1,8,878,817,61
2,4,1,1,8,818,772,46
2,4,2,1,8,750,718,32
2,4,3,1,8,684,665,19
2,4,4,1,8,614,611,3
2,4,5,1,8,532,551,-19
2,4,6,1,8,457,507,-50
2,4,7,1,8,410,503,-93
2,4,8,1,8,382,530,-148
2,4,9,1,8,387,516,-129
2,4,10,1,8,411,506,-95
2,4,11,1,8,469,520,-51
2,4,12,1,8,547,562,-15
2,4,13,1,8,618,613,5
2,4,14,1,8,683,667,16
2,4,15,1,8,749,720,29
2,4,16,1,8,811,762,49
2,5,0,1,8,817,736,81
2,5,1,1,8,772,685,87
2,5,2,1,8,718,630,88
2,5,3,1,8,665,590,75
2,5,4,1,8,611,570,41
2,5,5,1,8,551,552,-1
2,5,6,1,8,507,539,-32
2,5,7,1,8,503,540,-37
2,5,8,1,8,530,550,-20
2,5,9,1,8,516,558,-42
2,5,10,1,8,506,555,-49
2,5,11,1,8,520,557,-37
2,5,12,1,8,562,575,-13
2,5,13,1,8,613,603,10
2,5,14,1,8,667,641,26
2,5,15,1,8,720,689,31
2,5,16,1,8,762,736,26
2,6,0,1,8,736,678,58
2,6,1,1,8,685,643,42
2,6,2,1,8,630,614,16
2,6,3,1,8,590,621,-31
2,6,4,1,8,570,671,-101
2,6,5,1,8,552,730,-178
2,6,6,1,8,539,771,-232
2,6,7,1,8,540,786,-246
2,6,8,1,8,550,777,-227
2,6,9,1,8,558,781,-223
2,6,10,1,8,555,769,-214
2,6,11,1,8,557,751,-194
2,6,12,1,8,575,729,-154
2,6,13,1,8,603,702,-99
2,6,14,1,8,641,688,-47
2,6,15,1,8,689,701,-12
2,6,16,1,8,736,730,6
2,7,0,1,8,678,879,-201
2,7,1,1,8,643,880,-237
2,7,2,1,8,614,874,-260
2,7,3,1,8,621,883,-262
2,7,4,1,8,671,942,-271
2,7,5,1,8,730,1025,-295
2,7,6,1,8,771,1077,-306
2,7,7,1,8,786,1080,-294
2,7,8,1,8,777,1097,-320
2,7,9,1,8,781,1104,-323
2,7,10,1,8,769,1100,-331
2,7,11,1,8,751,1099,-348
2,7,12,1,8,729,1055,-326
2,7,13,1,8,702,1008,-306
2,7,14,1,8,688,990,-302
2,7,15,1,8,701,970,-269
2,7,16,1,8,730,963,-233
2,8,0,1,8,879,494,385
2,8,1,1,8,880,452,428
2,8,2,1,8,874,424,450
2,8,3,1,8,883,384,499
2,8,4,1,8,942,377,565
2,8,5,1,8,1025,375,650
2,8,6,1,8,1077,348,729
2,8,7,1,8,1080,331,749
2,8,8,1,8,1097,317,780
2,8,9,1,8,1104,312,792
2,8,10,1,8,1100,337,763
2,8,11,1,8,1099,366,733
2,8,12,1,8,1055,377,678
2,8,13,1,8,1008,389,619
2,8,14,1,8,990,421,569
2,8,15,1,8,970,470,500
2,8,16,1,8,963,520,443
2,9,0,1,8,494,830,-336
2,9,1,1,8,452,868,-416
2,9,2,1,8,424,952,-528
2,9,3,1,8,384,1024,-640
2,9,4,1,8,377,1067,-690
2,9,5,1,8,375,1044,-669
2,9,6,1,8,348,1058,-710
2,9,7,1,8,331,1059,-728
2,9,8,1,8,317,1031,-714
2,9,9,1,8,312,1034,-722
2,9,10,1,8,337,1055,-718
2,9,11,1,8,366,1035,-669
2,9,12,1,8,377,1036,-659
2,9,13,1,8,389,1026,-637
2,9,14,1,8,421,976,-555
2,9,15,1,8,470,951,-481
2,9,16,1,8,520,928,-408
2,10,0,1,8,830,1333,-503
2,10,1,1,8,868,1410,-542
2,10,2,1,8,952,1488,-536
2,10,3,1,8,1024,1592,-568
2,10,4,1,8,1067,1647,-580
2,10,5,1,8,1044,1585,-541
2,10,6,1,8,1058,1610,-552
2,10,7,1,8,1059,1571,-512
2,10,8,1,8,1031,1530,-499
2,10,9,1,8,1034,1556,-522
2,10,10,1,8,1055,1614,-559
2,10,11,1,8,1035,1604,-569
2,10,12,1,8,1036,1637,-601
2,10,13,1,8,1026,1659,-633
2,10,14,1,8,976,1628,-652
2,10,15,1,8,951,1617,-666
2,10,16,1,8,928,1562,-634
2,11,0,1,8,1333,1403,-70
2,11,1,1,8,1410,1484,-74
2,11,2,1,8,1488,1448,40
2,11,3,1,8,1592,1458,134
2,11,4,1,8,1647,1447,200
2,11,5,1,8,1585,1341,244
2,11,6,1,8,1610,1251,359
2,11,7,1,8,1571,1141,430
2,11,8,1,8,1530,1076,454
2,11,9,1,8,1556,1095,461
2,11,10,1,8,1614,1222,392
2,11,11,1,8,1604,1308,296
2,11,12,1,8,1637,1415,222
2,11,13,1,8,1659,1502,157
2,11,14,1,8,1628,1588,40
2,11,15,1,8,1617,1684,-67
2,11,16,1,8,1562,1656,-94
2,12,0,1,8,1403,1381,22
2,12,1,1,8,1484,1484,0
2,12,2,1,8,1448,1425,23
2,12,3,1,8,1458,1421,37
2,12,4,1,8,1447,1391,56
2,12,5,1,8,1341,1314,27
2,12,6,1,8,1251,1157,94
2,12,7,1,8,1141,1078,63
2,12,8,1,8,1076,1002,74
2,12,9,1,8,1095,1002,93
2,12,10,1,8,1222,1119,103
2,12,11,1,8,1308,1231,77
2,12,12,1,8,1415,1351,64
2,12,13,1,8,1502,1418,84
2,12,14,1,8,1588,1510,78
2,12,15,1,8,1684,1616,68
2,12,16,1,8,1656,1593,63
2,13,0,1,8,1381,1362,19
2,13,1,1,8,1484,1446,38
2,13,2,1,8,1425,1377,48
2,13,3,1,8,1421,1389,32
2,13,4,1,8,1391,1360,31
2,13,5,1,8,1314,1293,21
2,13,6,1,8,1157,1151,6
2,13,7,1,8,1078,1112,-34
2,13,8,1,8,1002,1036,-34
2,13,9,1,8,1002,1041,-39
2,13,10,1,8,1119,1121,-2
2,13,11,1,8,1231,1224,7
2,13,12,1,8,1351,1344,7
2,13,13,1,8,1418,1388,30
2,13,14,1,8,1510,1471,39
2,13,15,1,8,1616,1568,48
2,13,16,1,8,1593,1567,26
2,14,0,1,8,1362,1399,-37
2,14,1,1,8,1446,1491,-45
2,14,2,1,8,1377,1405,-28
2,14,3,1,8,1389,1416,-27
2,14,4,1,8,1360,1391,-31
2,14,5,1,8,1293,1289,4
2,14,6,1,8,1151,1131,20
2,14,7,1,8,1112,1053,59
2,14,8,1,8,1036,976,60
2,14,9,1,8,1041,993,48
2,14,10,1,8,1121,1081,40
2,14,11,1,8,1224,1210,14
2,14,12,1,8,1344,1339,5
2,14,13,1,8,1388,1383,5
2,14,14,1,8,1471,1489,-18
2,14,15,1,8,1568,1589,-21
2,14,16,1,8,1567,1570,-3
2,15,0,1,8,1399,1262,137
2,15,1,1,8,1491,1393,98
2,15,2,1,8,1405,1386,19
2,15,3,1,8,1416,1428,-12
2,15,4,1,8,1391,1403,-12
2,15,5,1,8,1289,1311,-22
2,15,6,1,8,1131,1174,-43
2,15,7,1,8,1053,1142,-89
2,15,8,1,8,976,1068,-92
2,15,9,1,8,993,1083,-90
2,15,10,1,8,1081,1146,-65
2,15,11,1,8,1210,1218,-8
2,15,12,1,8,1339,1341,-2
2,15,13,1,8,1383,1370,13
2,15,14,1,8,1489,1426,63
2,15,15,1,8,1589,1445,144
2,15,16,1,8,1570,1411,159
2,16,0,1,8,1262,1133,129
2,16,1,1,8,1393,1221,172
2,16,2,1,8,1386,1217,169
2,16,3,1,8,1428,1264,164
2,16,4,1,8,1403,1185,218
2,16,5,1,8,1311,1061,250
2,16,6,1,8,1174,953,221
2,16,7,1,8,1142,902,240
2,16,8,1,8,1068,811,257
2,16,9,1,8,1083,857,226
2,16,10,1,8,1146,947,199
2,16,11,1,8,1218,912,306
2,16,12,1,8,1341,1005,336
2,16,13,1,8,1370,1096,274
2,16,14,1,8,1426,1179,247
2,16,15,1,8,1445,1211,234
2,16,16,1,8,1411,1226,185
2,17,0,1,8,1133,1088,45
2,17,1,1,8,1221,1078,143
2,17,2,1,8,1217,1059,158
2,17,3,1,8,1264,1058,206
2,17,4,1,8,1185,958,227
2,17,5,1,8,1061,827,234
2,17,6,1,8,953,723,230
2,17,7,1,8,902,757,145
2,17,8,1,8,811,711,100
2,17,9,1,8,857,666,191
2,17,10,1,8,947,751,196
2,17,11,1,8,912,749,163
2,17,12,1,8,1005,790,215
2,17,13,1,8,1096,883,213
2,17,14,1,8,1179,972,207
2,17,15,1,8,1211,950,261
2,17,16,1,8,1226,989,237
2,18,0,1,8,1088,999,89
2,18,1,1,8,1078,996,82
2,18,2,1,8,1059,1029,30
2,18,3,1,8,1058,1083,-25
2,18,4,1,8,958,980,-22
2,18,5,1,8,827,1008,-181
2,18,6,1,8,723,1085,-362
2,18,7,1,8,757,1123,-366
2,18,8,1,8,711,1089,-378
2,18,9,1,8,666,1090,-424
2,18,10,1,8,751,1175,-424
2,18,11,1,8,749,1086,-337
2,18,12,1,8,790,1018,-228
2,18,13,1,8,883,1037,-154
2,18,14,1,8,972,959,13
2,18,15,1,8,950,923,27
2,18,16,1,8,989,1059,-70
2,19,0,1,8,999,956,43
2,19,1,1,8,996,1010,-14
2,19,2,1,8,1029,1066,-37
2,19,3,1,8,1083,1151,-68
2,19,4,1,8,980,1041,-61
2,19,5,1,8,1008,1096,-88
2,19,6,1,8,1085,1199,-114
2,19,7,1,8,1123,1210,-87
2,19,8,1,8,1089,1106,-17
2,19,9,1,8,1090,1000,90
2,19,10,1,8,1175,988,187
2,19,11,1,8,1086,883,203
2,19,12,1,8,1018,840,178
2,19,13,1,8,1037,851,186
2,19,14,1,8,959,750,209
2,19,15,1,8,923,721,202
2,19,16,1,8,1059,857,202
2,20,0,1,8,956,835,121
2,20,1,1,8,1010,777,233
2,20,2,1,8,1066,746,320
2,20,3,1,8,1151,683,468
2,20,4,1,8,1041,492,549
2,20,5,1,8,1096,518,578
2,20,6,1,8,1199,522,677
2,20,7,1,8,1210,488,722
2,20,8,1,8,1106,459,647
2,20,9,1,8,1000,357,643
2,20,10,1,8,988,386,602
2,20,11,1,8,883,415,468
2,20,12,1,8,840,455,385
2,20,13,1,8,851,468,383
2,20,14,1,8,750,521,229
2,20,15,1,8,721,593,128
2,20,16,1,8,857,711,146
2,21,0,1,8,835,584,251
2,21,1,1,8,777,638,139
2,21,2,1,8,746,613,133
2,21,3,1,8,683,607,76
2,21,4,1,8,492,548,-56
2,21,5,1,8,518,624,-106
2,21,6,1,8,522,670,-148
2,21,7,1,8,488,658,-170
2,21,8,1,8,459,661,-202
2,21,9,1,8,357,622,-265
2,21,10,1,8,386,643,-257
2,21,11,1,8,415,593,-178
2,21,12,1,8,455,590,-135
2,21,13,1,8,468,522,-54
2,21,14,1,8,521,493,28
2,21,15,1,8,593,514,79
2,21,16,1,8,711,472,239
2,22,0,1,8,584,565,19
2,22,1,1,8,638,580,58
2,22,2,1,8,613,609,4
2,22,3,1,8,607,610,-3
2,22,4,1,8,548,601,-53
2,22,5,1,8,624,664,-40
2,22,6,1,8,670,689,-19
2,22,7,1,8,658,733,-75
2,22,8,1,8,661,747,-86
2,22,9,1,8,622,728,-106
2,22,10,1,8,643,697,-54
2,22,11,1,8,593,684,-91
2,22,12,1,8,590,694,-104
2,22,13,1,8,522,616,-94
2,22,14,1,8,493,559,-66
2,22,15,1,8,514,541,-27
2,22,16,1,8,472,494,-22
2,0,0,2,8,1702,1782,-80
2,0,1,2,8,1698,1751,-53
2,0,2,2,8,1689,1701,-12
2,0,3,2,8,1692,1654,38
2,0,4,2,8,1693,1612,81
2,0,5,2,8,1675,1558,117
2,0,6,2,8,1663,1506,157
2,0,7,2,8,1666,1461,205
2,0,8,2,8,1665,1406,259
2,0,9,2,8,1666,1426,240
2,0,10,2,8,1666,1452,214
2,0,11,2,8,1674,1503,171
2,0,12,2,8,1679,1561,118
2,0,13,2,8,1673,1603,70
2,0,14,2,8,1680,1646,34
2,0,15,2,8,1694,1697,-3
2,0,16,2,8,1686,1736,-50
2,1,0,2,8,1743,1776,-33
2,1,1,2,8,1754,1676,78
2,1,2,2,8,1747,1560,187
2,1,3,2,8,1741,1450,291
2,1,4,2,8,1738,1338,400
2,1,5,2,8,1725,1206,519
2,1,6,2,8,1721,1079,642
2,1,7,2,8,1726,985,741
2,1,8,2,8,1719,909,810
2,1,9,2,8,1728,932,796
2,1,10,2,8,1725,986,739
2,1,11,2,8,1725,1095,630
2,1,12,2,8,1724,1231,493
2,1,13,2,8,1719,1347,372
2,1,14,2,8,1728,1453,275
2,1,15,2,8,1742,1565,177
2,1,16,2,8,1732,1671,61
2,2,0,2,8,1782,1695,87
2,2,1,2,8,1751,1590,161
2,2,2,2,8,1701,1468,233
2,2,3,2,8,1654,1349,305
2,2,4,2,8,1612,1225,387
2,2,5,2,8,1558,1083,475
2,2,6,2,8,1506,964,542
2,2,7,2,8,1461,913,548
2,2,8,2,8,1406,912,494
2,2,9,2,8,1426,903,523
2,2,10,2,8,1452,917,535
2,2,11,2,8,1503,989,514
2,2,12,2,8,1561,1109,452
2,2,13,2,8,1603,1231,372
2,2,14,2,8,1646,1350,296
2,2,15,2,8,1697,1469,228
2,2,16,2,8,1736,1573,163
2,3,0,2,8,1776,1553,223
2,3,1,2,8,1676,1457,219
2,3,2,2,8,1560,1348,212
2,3,3,2,8,1450,1255,195
2,3,4,2,8,1338,1181,157
2,3,5,2,8,1206,1103,103
2,3,6,2,8,1079,1046,33
2,3,7,2,8,985,1043,-58
2,3,8,2,8,909,1080,-171
2,3,9,2,8,932,1074,-142
2,3,10,2,8,986,1061,-75
2,3,11,2,8,1095,1077,18
2,3,12,2,8,1231,1137,94
2,3,13,2,8,1347,1216,131
2,3,14,2,8,1453,1308,145
2,3,15,2,8,1565,1409,156
2,3,16,2,8,1671,1498,173
2,4,0,2,8,1695,1414,281
2,4,1,2,8,1590,1328,262
2,4,2,2,8,1468,1244,224
2,4,3,2,8,1349,1211,138
2,4,4,2,8,1225,1241,-16
2,4,5,2,8,1083,1282,-199
2,4,6,2,8,964,1310,-346
2,4,7,2,8,913,1326,-413
2,4,8,2,8,912,1327,-415
2,4,9,2,8,903,1339,-436
2,4,10,2,8,917,1324,-407
2,4,11,2,8,989,1308,-319
2,4,12,2,8,1109,1304,-195
2,4,13,2,8,1231,1305,-74
2,4,14,2,8,1350,1329,21
2,4,15,2,8,1469,1390,79
2,4,16,2,8,1573,1466,107
2,5,0,2,8,1553,1557,-4
2,5,1,2,8,1457,1523,-66
2,5,2,2,8,1348,1488,-140
2,5,3,2,8,1255,1504,-249
2,5,4,2,8,1181,1613,-432
2,5,5,2,8,1103,1755,-652
2,5,6,2,8,1046,1848,-802
2,5,7,2,8,1043,1866,-823
2,5,8,2,8,1080,1874,-794
2,5,9,2,8,1074,1885,-811
2,5,10,2,8,1061,1869,-808
2,5,11,2,8,1077,1850,-773
2,5,12,2,8,1137,1784,-647
2,5,13,2,8,1216,1710,-494
2,5,14,2,8,1308,1678,-370
2,5,15,2,8,1409,1671,-262
2,5,16,2,8,1498,1693,-195
2,6,0,2,8,1414,1373,41
2,6,1,2,8,1328,1332,-4
2,6,2,2,8,1244,1298,-54
2,6,3,2,8,1211,1267,-56
2,6,4,2,8,1241,1319,-78
2,6,5,2,8,1282,1400,-118
2,6,6,2,8,1310,1425,-115
2,6,7,2,8,1326,1411,-85
2,6,8,2,8,1327,1414,-87
2,6,9,2,8,1339,1416,-77
2,6,10,2,8,1324,1437,-113
2,6,11,2,8,1308,1465,-157
2,6,12,2,8,1304,1432,-128
2,6,13,2,8,1305,1397,-92
2,6,14,2,8,1329,1411,-82
2,6,15,2,8,1390,1440,-50
2,6,16,2,8,1466,1483,-17
2,7,0,2,8,1557,1324,233
2,7,1,2,8,1523,1320,203
2,7,2,2,8,1488,1376,112
2,7,3,2,8,1504,1408,96
2,7,4,2,8,1613,1444,169
2,7,5,2,8,1755,1419,336
2,7,6,2,8,1848,1406,442
2,7,7,2,8,1866,1390,476
2,7,8,2,8,1874,1348,526
2,7,9,2,8,1885,1346,539
2,7,10,2,8,1869,1392,477
2,7,11,2,8,1850,1401,449
2,7,12,2,8,1784,1413,371
2,7,13,2,8,1710,1415,295
2,7,14,2,8,1678,1397,281
2,7,15,2,8,1671,1421,250
2,7,16,2,8,1693,1448,245
2,8,0,2,8,1373,2163,-790
2,8,1,2,8,1332,2278,-946
2,8,2,2,8,1298,2440,-1142
2,8,3,2,8,1267,2616,-1349
2,8,4,2,8,1319,2714,-1395
2,8,5,2,8,1400,2629,-1229
2,8,6,2,8,1425,2668,-1243
2,8,7,2,8,1411,2630,-1219
2,8,8,2,8,1414,2561,-1147
2,8,9,2,8,1416,2590,-1174
2,8,10,2,8,1437,2669,-1232
2,8,11,2,8,1465,2639,-1174
2,8,12,2,8,1432,2673,-1241
2,8,13,2,8,1397,2685,-1288
2,8,14,2,8,1411,2604,-1193
2,8,15,2,8,1440,2568,-1128
2,8,16,2,8,1483,2490,-1007
2,9,0,2,8,1324,2736,-1412
2,9,1,2,8,1320,2894,-1574
2,9,2,2,8,1376,2936,-1560
2,9,3,2,8,1408,3050,-1642
2,9,4,2,8,1444,3094,-1650
2,9,5,2,8,1419,2926,-1507
2,9,6,2,8,1406,2861,-1455
2,9,7,2,8,1390,2712,-1322
2,9,8,2,8,1348,2606,-1258
2,9,9,2,8,1346,2651,-1305
2,9,10,2,8,1392,2836,-1444
2,9,11,2,8,1401,2912,-1511
2,9,12,2,8,1413,3052,-1639
2,9,13,2,8,1415,3161,-1746
2,9,14,2,8,1397,3216,-1819
2,9,15,2,8,1421,3301,-1880
2,9,16,2,8,1448,3218,-1770
2,10,0,2,8,2163,2784,-621
2,10,1,2,8,2278,2968,-690
2,10,2,2,8,2440,2873,-433
2,10,3,2,8,2616,2879,-263
2,10,4,2,8,2714,2838,-124
2,10,5,2,8,2629,2655,-26
2,10,6,2,8,2668,2408,260
2,10,7,2,8,2630,2219,411
2,10,8,2,8,2561,2078,483
2,10,9,2,8,2590,2097,493
2,10,10,2,8,2669,2341,328
2,10,11,2,8,2639,2539,100
2,10,12,2,8,2673,2766,-93
2,10,13,2,8,2685,2920,-235
2,10,14,2,8,2604,3098,-494
2,10,15,2,8,2568,3300,-732
2,10,16,2,8,2490,3249,-759
2,11,0,2,8,2736,2743,-7
2,11,1,2,8,2894,2930,-36
2,11,2,2,8,2936,2802,134
2,11,3,2,8,3050,2810,240
2,11,4,2,8,3094,2751,343
2,11,5,2,8,2926,2607,319
2,11,6,2,8,2861,2308,553
2,11,7,2,8,2712,2190,522
2,11,8,2,8,2606,2038,568
2,11,9,2,8,2651,2043,608
2,11,10,2,8,2836,2240,596
2,11,11,2,8,2912,2455,457
2,11,12,2,8,3052,2695,357
2,11,13,2,8,3161,2806,355
2,11,14,2,8,3216,2981,235
2,11,15,2,8,3301,3184,117
2,11,16,2,8,3218,3160,58
2,12,0,2,8,2784,2761,23
2,12,1,2,8,2968,2937,31
2,12,2,2,8,2873,2782,91
2,12,3,2,8,2879,2805,74
2,12,4,2,8,2838,2751,87
2,12,5,2,8,2655,2582,73
2,12,6,2,8,2408,2282,126
2,12,7,2,8,2219,2165,54
2,12,8,2,8,2078,2012,66
2,12,9,2,8,2097,2034,63
2,12,10,2,8,2341,2202,139
2,12,11,2,8,2539,2434,105
2,12,12,2,8,2766,2683,83
2,12,13,2,8,2920,2771,149
2,12,14,2,8,3098,2960,138
2,12,15,2,8,3300,3157,143
2,12,16,2,8,3249,3137,112
2,13,0,2,8,2743,2661,82
2,13,1,2,8,2930,2884,46
2,13,2,2,8,2802,2791,11
2,13,3,2,8,2810,2844,-34
2,13,4,2,8,2751,2794,-43
2,13,5,2,8,2607,2600,7
2,13,6,2,8,2308,2305,3
2,13,7,2,8,2190,2195,-5
2,13,8,2,8,2038,2044,-6
2,13,9,2,8,2043,2076,-33
2,13,10,2,8,2240,2227,13
2,13,11,2,8,2455,2428,27
2,13,12,2,8,2695,2680,15
2,13,13,2,8,2806,2753,53
2,13,14,2,8,2981,2915,66
2,13,15,2,8,3184,3034,150
2,13,16,2,8,3160,2981,179
2,14,0,2,8,2761,2395,366
2,14,1,2,8,2937,2614,323
2,14,2,2,8,2782,2603,179
2,14,3,2,8,2805,2692,113
2,14,4,2,8,2751,2588,163
2,14,5,2,8,2582,2372,210
2,14,6,2,8,2282,2127,155
2,14,7,2,8,2165,2044,121
2,14,8,2,8,2012,1879,133
2,14,9,2,8,2034,1940,94
2,14,10,2,8,2202,2093,109
2,14,11,2,8,2434,2130,304
2,14,12,2,8,2683,2346,337
2,14,13,2,8,2771,2466,305
2,14,14,2,8,2960,2605,355
2,14,15,2,8,3157,2656,501
2,14,16,2,8,3137,2637,500
2,15,0,2,8,2661,2221,440
2,15,1,2,8,2884,2299,585
2,15,2,2,8,2791,2276,515
2,15,3,2,8,2844,2322,522
2,15,4,2,8,2794,2143,651
2,15,5,2,8,2600,1888,712
2,15,6,2,8,2305,1676,629
2,15,7,2,8,2195,1659,536
2,15,8,2,8,2044,1522,522
2,15,9,2,8,2076,1523,553
2,15,10,2,8,2227,1698,529
2,15,11,2,8,2428,1661,767
2,15,12,2,8,2680,1795,885
2,15,13,2,8,2753,1979,774
2,15,14,2,8,2915,2151,764
2,15,15,2,8,3034,2161,873
2,15,16,2,8,2981,2215,766
2,16,0,2,8,2395,2087,308
2,16,1,2,8,2614,2074,540
2,16,2,2,8,2603,2088,515
2,16,3,2,8,2692,2141,551
2,16,4,2,8,2588,1938,650
2,16,5,2,8,2372,1835,537
2,16,6,2,8,2127,1808,319
2,16,7,2,8,2044,1880,164
2,16,8,2,8,1879,1800,79
2,16,9,2,8,1940,1756,184
2,16,10,2,8,2093,1926,167
2,16,11,2,8,2130,1835,295
2,16,12,2,8,2346,1808,538
2,16,13,2,8,2466,1920,546
2,16,14,2,8,2605,1931,674
2,16,15,2,8,2656,1873,783
2,16,16,2,8,2637,2048,589
2,17,0,2,8,2221,1955,266
2,17,1,2,8,2299,2006,293
2,17,2,2,8,2276,2095,181
2,17,3,2,8,2322,2234,88
2,17,4,2,8,2143,2021,122
2,17,5,2,8,1888,2104,-216
2,17,6,2,8,1676,2284,-608
2,17,7,2,8,1659,2333,-674
2,17,8,2,8,1522,2195,-673
2,17,9,2,8,1523,2090,-567
2,17,10,2,8,1698,2163,-465
2,17,11,2,8,1661,1969,-308
2,17,12,2,8,1795,1858,-63
2,17,13,2,8,1979,1888,91
2,17,14,2,8,2151,1709,442
2,17,15,2,8,2161,1644,517
2,17,16,2,8,2215,1916,299
2,18,0,2,8,2087,1791,296
2,18,1,2,8,2074,1787,287
2,18,2,2,8,2088,1812,276
2,18,3,2,8,2141,1834,307
2,18,4,2,8,1938,1533,405
2,18,5,2,8,1835,1614,221
2,18,6,2,8,1808,1721,87
2,18,7,2,8,1880,1698,182
2,18,8,2,8,1800,1565,235
2,18,9,2,8,1756,1357,399
2,18,10,2,8,1926,1374,552
2,18,11,2,8,1835,1298,537
2,18,12,2,8,1808,1295,513
2,18,13,2,8,1920,1319,601
2,18,14,2,8,1931,1271,660
2,18,15,2,8,1873,1314,559
2,18,16,2,8,2048,1568,480
2,19,0,2,8,1955,1419,536
2,19,1,2,8,2006,1415,591
2,19,2,2,8,2095,1359,736
2,19,3,2,8,2234,1290,944
2,19,4,2,8,2021,1040,981
2,19,5,2,8,2104,1142,962
2,19,6,2,8,2284,1192,1092
2,19,7,2,8,2333,1146,1187
2,19,8,2,8,2195,1120,1075
2,19,9,2,8,2090,979,1111
2,19,10,2,8,2163,1029,1134
2,19,11,2,8,1969,1008,961
2,19,12,2,8,1858,1045,813
2,19,13,2,8,1888,990,898
2,19,14,2,8,1709,1014,695
2,19,15,2,8,1644,1107,537
2,19,16,2,8,1916,1183,733
2,20,0,2,8,1791,1149,642
2,20,1,2,8,1787,1218,569
2,20,2,2,8,1812,1222,590
2,20,3,2,8,1834,1217,617
2,20,4,2,8,1533,1149,384
2,20,5,2,8,1614,1288,326
2,20,6,2,8,1721,1359,362
2,20,7,2,8,1698,1391,307
2,20,8,2,8,1565,1408,157
2,20,9,2,8,1357,1350,7
2,20,10,2,8,1374,1340,34
2,20,11,2,8,1298,1277,21
2,20,12,2,8,1295,1284,11
2,20,13,2,8,1319,1138,181
2,20,14,2,8,1271,1052,219
2,20,15,2,8,1314,1055,259
2,20,16,2,8,1568,966,602
2,0,0,3,8,2586,2593,-7
2,0,1,3,8,2591,2448,143
2,0,2,3,8,2580,2278,302
2,0,3,3,8,2580,2115,465
2,0,4,3,8,2581,1949,632
2,0,5,3,8,2559,1757,802
2,0,6,3,8,2547,1586,961
2,0,7,3,8,2552,1488,1064
2,0,8,3,8,2544,1439,1105
2,0,9,3,8,2547,1448,1099
2,0,10,3,8,2543,1492,1051
2,0,11,3,8,2551,1615,936
2,0,12,3,8,2556,1793,763
2,0,13,3,8,2547,1960,587
2,0,14,3,8,2556,2120,436
2,0,15,3,8,2575,2285,290
2,0,16,3,8,2562,2433,129
2,1,0,3,8,2641,2431,210
2,1,1,3,8,2612,2275,337
2,1,2,3,8,2557,2098,459
2,1,3,3,8,2507,1939,568
2,1,4,3,8,2462,1795,667
2,1,5,3,8,2399,1635,764
2,1,6,3,8,2343,1503,840
2,1,7,3,8,2301,1453,848
2,1,8,3,8,2246,1462,784
2,1,9,3,8,2273,1461,812
2,1,10,3,8,2300,1472,828
2,1,11,3,8,2351,1546,805
2,1,12,3,8,2408,1684,724
2,1,13,3,8,2448,1834,614
2,1,14,3,8,2498,1991,507
2,1,15,3,8,2558,2158,400
2,1,16,3,8,2592,2309,283
2,2,0,3,8,2660,2231,429
2,2,1,3,8,2569,2100,469
2,2,2,3,8,2451,1962,489
2,2,3,3,8,2338,1876,462
2,2,4,3,8,2226,1852,374
2,2,5,3,8,2090,1833,257
2,2,6,3,8,1963,1817,146
2,2,7,3,8,1871,1829,42
2,2,8,3,8,1788,1857,-69
2,2,9,3,8,1813,1855,-42
2,2,10,3,8,1863,1830,33
2,2,11,3,8,1972,1828,144
2,2,12,3,8,2108,1866,242
2,2,13,3,8,2221,1918,303
2,2,14,3,8,2329,1996,333
2,2,15,3,8,2446,2110,336
2,2,16,3,8,2547,2228,319
2,3,0,3,8,2593,2293,300
2,3,1,3,8,2448,2208,240
2,3,2,3,8,2278,2118,160
2,3,3,3,8,2115,2094,21
2,3,4,3,8,1949,2183,-234
2,3,5,3,8,1757,2307,-550
2,3,6,3,8,1586,2387,-801
2,3,7,3,8,1488,2406,-918
2,3,8,3,8,1439,2424,-985
2,3,9,3,8,1448,2443,-995
2,3,10,3,8,1492,2424,-932
2,3,11,3,8,1615,2407,-792
2,3,12,3,8,1793,2359,-566
2,3,13,3,8,1960,2313,-353
2,3,14,3,8,2120,2319,-199
2,3,15,3,8,2285,2360,-75
2,3,16,3,8,2433,2429,4
2,4,0,3,8,2431,2051,380
2,4,1,3,8,2275,1975,300
2,4,2,3,8,2098,1912,186
2,4,3,3,8,1939,1888,51
2,4,4,3,8,1795,1990,-195
2,4,5,3,8,1635,2130,-495
2,4,6,3,8,1503,2196,-693
2,4,7,3,8,1453,2197,-744
2,4,8,3,8,1462,2191,-729
2,4,9,3,8,1461,2197,-736
2,4,10,3,8,1472,2206,-734
2,4,11,3,8,1546,2216,-670
2,4,12,3,8,1684,2161,-477
2,4,13,3,8,1834,2099,-265
2,4,14,3,8,1991,2099,-108
2,4,15,3,8,2158,2141,17
2,4,16,3,8,2309,2213,96
2,5,0,3,8,2231,2203,28
2,5,1,3,8,2100,2200,-100
2,5,2,3,8,1962,2250,-288
2,5,3,3,8,1876,2291,-415
2,5,4,3,8,1852,2386,-534
2,5,5,3,8,1833,2444,-611
2,5,6,3,8,1817,2483,-666
2,5,7,3,8,1829,2470,-641
2,5,8,3,8,1857,2445,-588
2,5,9,3,8,1855,2450,-595
2,5,10,3,8,1830,2492,-662
2,5,11,3,8,1828,2500,-672
2,5,12,3,8,1866,2468,-602
2,5,13,3,8,1918,2423,-505
2,5,14,3,8,1996,2387,-391
2,5,15,3,8,2110,2391,-281
2,5,16,3,8,2228,2411,-183
2,6,0,3,8,2293,2657,-364
2,6,1,3,8,2208,2730,-522
2,6,2,3,8,2118,2864,-746
2,6,3,3,8,2094,3000,-906
2,6,4,3,8,2183,3091,-908
2,6,5,3,8,2307,3004,-697
2,6,6,3,8,2387,3016,-629
2,6,7,3,8,2406,2961,-555
2,6,8,3,8,2424,2878,-454
2,6,9,3,8,2443,2902,-459
2,6,10,3,8,2424,3006,-582
2,6,11,3,8,2407,3005,-598
2,6,12,3,8,2359,3050,-691
2,6,13,3,8,2313,3074,-761
2,6,14,3,8,2319,3025,-706
2,6,15,3,8,2360,3038,-678
2,6,16,3,8,2429,3010,-581
2,7,0,3,8,2051,3566,-1515
2,7,1,3,8,1975,3762,-1787
2,7,2,3,8,1912,3888,-1976
2,7,3,3,8,1888,4074,-2186
2,7,4,3,8,1990,4161,-2171
2,7,5,3,8,2130,3970,-1840
2,7,6,3,8,2196,3919,-1723
2,7,7,3,8,2197,3771,-1574
2,7,8,3,8,2191,3637,-1446
2,7,9,3,8,2197,3685,-1488
2,7,10,3,8,2206,3891,-1685
2,7,11,3,8,2216,3947,-1731
2,7,12,3,8,2161,4088,-1927
2,7,13,3,8,2099,4187,-2088
2,7,14,3,8,2099,4192,-2093
2,7,15,3,8,2141,4252,-2111
2,7,16,3,8,2213,4146,-1933
2,8,0,3,8,2203,4117,-1914
2,8,1,3,8,2200,4378,-2178
2,8,2,3,8,2250,4361,-2111
2,8,3,3,8,2291,4471,-2180
2,8,4,3,8,2386,4485,-2099
2,8,5,3,8,2444,4240,-1796
2,8,6,3,8,2483,4018,-1535
2,8,7,3,8,2470,3790,-1320
2,8,8,3,8,2445,3608,-1163
2,8,9,3,8,2450,3653,-1203
2,8,10,3,8,2492,3955,-1463
2,8,11,3,8,2500,4143,-1643
2,8,12,3,8,2468,4403,-1935
2,8,13,3,8,2423,4579,-2156
2,8,14,3,8,2387,4726,-2339
2,8,15,3,8,2391,4917,-2526
2,8,16,3,8,2411,4811,-2400
2,9,0,3,8,2657,4146,-1489
2,9,1,3,8,2730,4414,-1684
2,9,2,3,8,2864,4250,-1386
2,9,3,3,8,3000,4268,-1268
2,9,4,3,8,3091,4198,-1107
2,9,5,3,8,3004,3948,-944
2,9,6,3,8,3016,3559,-543
2,9,7,3,8,2961,3331,-370
2,9,8,3,8,2878,3114,-236
2,9,9,3,8,2902,3138,-236
2,9,10,3,8,3006,3462,-456
2,9,11,3,8,3005,3763,-758
2,9,12,3,8,3050,4110,-1060
2,9,13,3,8,3074,4308,-1234
2,9,14,3,8,3025,4569,-1544
2,9,15,3,8,3038,4868,-1830
2,9,16,3,8,3010,4816,-1806
2,10,0,3,8,3566,4142,-576
2,10,1,3,8,3762,4421,-659
2,10,2,3,8,3888,4207,-319
2,10,3,3,8,4074,4226,-152
2,10,4,3,8,4161,4142,19
2,10,5,3,8,3970,3896,74
2,10,6,3,8,3919,3439,480
2,10,7,3,8,3771,3243,528
2,10,8,3,8,3637,3014,623
2,10,9,3,8,3685,3036,649
2,10,10,3,8,3891,3321,570
2,10,11,3,8,3947,3665,282
2,10,12,3,8,4088,4034,54
2,10,13,3,8,4187,4189,-2
2,10,14,3,8,4192,4470,-278
2,10,15,3,8,4252,4773,-521
2,10,16,3,8,4146,4730,-584
2,11,0,3,8,4117,4023,94
2,11,1,3,8,4378,4330,48
2,11,2,3,8,4361,4168,193
2,11,3,3,8,4471,4233,238
2,11,4,3,8,4485,4154,331
2,11,5,3,8,4240,3893,347
2,11,6,3,8,4018,3456,562
2,11,7,3,8,3790,3307,483
2,11,8,3,8,3608,3080,528
2,11,9,3,8,3653,3117,536
2,11,10,3,8,3955,3348,607
2,11,11,3,8,4143,3652,491
2,11,12,3,8,4403,4024,379
2,11,13,3,8,4579,4141,438
2,11,14,3,8,4726,4386,340
2,11,15,3,8,4917,4602,315
2,11,16,3,8,4811,4548,263
2,12,0,3,8,4146,3794,352
2,12,1,3,8,4414,4105,309
2,12,2,3,8,4250,4008,242
2,12,3,3,8,4268,4108,160
2,12,4,3,8,4198,3979,219
2,12,5,3,8,3948,3661,287
2,12,6,3,8,3559,3258,301
2,12,7,3,8,3331,3097,234
2,12,8,3,8,3114,2855,259
2,12,9,3,8,3138,2933,205
2,12,10,3,8,3462,3174,288
2,12,11,3,8,3763,3340,423
2,12,12,3,8,4110,3685,425
2,12,13,3,8,4308,3849,459
2,12,14,3,8,4569,4094,475
2,12,15,3,8,4868,4245,623
2,12,16,3,8,4816,4207,609
2,13,0,3,8,4142,3483,659
2,13,1,3,8,4421,3692,729
2,13,2,3,8,4207,3662,545
2,13,3,3,8,4226,3750,476
2,13,4,3,8,4142,3546,596
2,13,5,3,8,3896,3199,697
2,13,6,3,8,3439,2850,589
2,13,7,3,8,3243,2801,442
2,13,8,3,8,3014,2590,424
2,13,9,3,8,3036,2606,430
2,13,10,3,8,3321,2844,477
2,13,11,3,8,3665,2879,786
2,13,12,3,8,4034,3136,898
2,13,13,3,8,4189,3349,840
2,13,14,3,8,4470,3577,893
2,13,15,3,8,4773,3606,1167
2,13,16,3,8,4730,3626,1104
2,14,0,3,8,4023,3220,803
2,14,1,3,8,4330,3295,1035
2,14,2,3,8,4168,3305,863
2,14,3,3,8,4233,3405,828
2,14,4,3,8,4154,3123,1031
2,14,5,3,8,3893,2896,997
2,14,6,3,8,3456,2761,695
2,14,7,3,8,3307,2782,525
2,14,8,3,8,3080,2611,469
2,14,9,3,8,3117,2613,504
2,14,10,3,8,3348,2873,475
2,14,11,3,8,3652,2747,905
2,14,12,3,8,4024,2813,1211
2,14,13,3,8,4141,3016,1125
2,14,14,3,8,4386,3110,1276
2,14,15,3,8,4602,3084,1518
2,14,16,3,8,4548,3274,1274
2,15,0,3,8,3794,3043,751
2,15,1,3,8,4105,3084,1021
2,15,2,3,8,4008,3154,854
2,15,3,3,8,4108,3292,816
2,15,4,3,8,3979,2979,1000
2,15,5,3,8,3661,2931,730
2,15,6,3,8,3258,3007,251
2,15,7,3,8,3097,3090,7
2,15,8,3,8,2855,2906,-51
2,15,9,3,8,2933,2756,177
2,15,10,3,8,3174,2914,260
2,15,11,3,8,3340,2718,622
2,15,12,3,8,3685,2648,1037
2,15,13,3,8,3849,2771,1078
2,15,14,3,8,4094,2681,1413
2,15,15,3,8,4245,2594,1651
2,15,16,3,8,4207,2905,1302
2,16,0,3,8,3483,2790,693
2,16,1,3,8,3692,2783,909
2,16,2,3,8,3662,2841,821
2,16,3,3,8,3750,2917,833
2,16,4,3,8,3546,2513,1033
2,16,5,3,8,3199,2622,577
2,16,6,3,8,2850,2806,44
2,16,7,3,8,2801,2821,-20
2,16,8,3,8,2590,2654,-64
2,16,9,3,8,2606,2447,159
2,16,10,3,8,2844,2549,295
2,16,11,3,8,2879,2384,495
2,16,12,3,8,3136,2313,823
2,16,13,3,8,3349,2356,993
2,16,14,3,8,3577,2230,1347
2,16,15,3,8,3606,2237,1369
2,16,16,3,8,3626,2627,999
2,17,0,3,8,3220,2375,845
2,17,1,3,8,3295,2425,870
2,17,2,3,8,3305,2425,880
2,17,3,3,8,3405,2441,964
2,17,4,3,8,3123,2081,1042
2,17,5,3,8,2896,2238,658
2,17,6,3,8,2761,2391,370
2,17,7,3,8,2782,2356,426
2,17,8,3,8,2611,2226,385
2,17,9,3,8,2613,1979,634
2,17,10,3,8,2873,2017,856
2,17,11,3,8,2747,1891,856
2,17,12,3,8,2813,1885,928
2,17,13,3,8,3016,1841,1175
2,17,14,3,8,3110,1764,1346
2,17,15,3,8,3084,1828,1256
2,17,16,3,8,3274,2040,1234
2,18,0,3,8,3043,1984,1059
2,18,1,3,8,3084,1995,1089
2,18,2,3,8,3154,1968,1186
2,18,3,3,8,3292,1900,1392
2,18,4,3,8,2979,1641,1338
2,18,5,3,8,2931,1806,1125
2,18,6,3,8,3007,1881,1126
2,18,7,3,8,3090,1879,1211
2,18,8,3,8,2906,1867,1039
2,18,9,3,8,2756,1707,1049
2,18,10,3,8,2914,1726,1188
2,18,11,3,8,2718,1692,1026
2,18,12,3,8,2648,1739,909
2,18,13,3,8,2771,1606,1165
2,18,14,3,8,2681,1573,1108
2,18,15,3,8,2594,1648,946
2,18,16,3,8,2905,1677,1228
2,0,0,4,8,3484,3109,375
2,0,1,4,8,3449,2918,531
2,0,2,4,8,3390,2712,678
2,0,3,4,8,3346,2560,786
2,0,4,4,8,3305,2466,839
2,0,5,4,8,3233,2365,868
2,0,6,4,8,3169,2274,895
2,0,7,4,8,3127,2239,888
2,0,8,4,8,3071,2239,832
2,0,9,4,8,3092,2242,850
2,0,10,4,8,3118,2241,877
2,0,11,4,8,3177,2297,880
2,0,12,4,8,3240,2413,827
2,0,13,4,8,3276,2536,740
2,0,14,4,8,3326,2679,647
2,0,15,4,8,3391,2859,532
2,0,16,4,8,3422,3039,383
2,1,0,4,8,3519,3110,409
2,1,1,4,8,3430,2980,450
2,1,2,4,8,3307,2836,471
2,1,3,4,8,3191,2759,432
2,1,4,4,8,3076,2794,282
2,1,5,4,8,2931,2858,73
2,1,6,4,8,2800,2894,-94
2,1,7,4,8,2711,2909,-198
2,1,8,4,8,2628,2954,-326
2,1,9,4,8,2660,2959,-299
2,1,10,4,8,2711,2930,-219
2,1,11,4,8,2820,2927,-107
2,1,12,4,8,2955,2921,34
2,1,13,4,8,3066,2926,140
2,1,14,4,8,3181,2986,195
2,1,15,4,8,3307,3080,227
2,1,16,4,8,3403,3191,212
2,2,0,4,8,3477,2787,690
2,2,1,4,8,3341,2660,681
2,2,2,4,8,3169,2542,627
2,2,3,4,8,3003,2478,525
2,2,4,4,8,2837,2560,277
2,2,5,4,8,2641,2682,-41
2,2,6,4,8,2470,2735,-265
2,2,7,4,8,2374,2737,-363
2,2,8,4,8,2318,2741,-423
2,2,9,4,8,2329,2755,-426
2,2,10,4,8,2369,2761,-392
2,2,11,4,8,2492,2773,-281
2,2,12,4,8,2670,2736,-66
2,2,13,4,8,2834,2702,132
2,2,14,4,8,2996,2740,256
2,2,15,4,8,3166,2830,336
2,2,16,4,8,3309,2949,360
2,3,0,4,8,3329,2881,448
2,3,1,4,8,3133,2843,290
2,3,2,4,8,2908,2864,44
2,3,3,4,8,2705,2912,-207
2,3,4,4,8,2519,3057,-538
2,3,5,4,8,2309,3174,-865
2,3,6,4,8,2125,3254,-1129
2,3,7,4,8,2028,3256,-1228
2,3,8,4,8,1989,3222,-1233
2,3,9,4,8,2006,3231,-1225
2,3,10,4,8,2047,3261,-1214
2,3,11,4,8,2172,3251,-1079
2,3,12,4,8,2368,3197,-829
2,3,13,4,8,2563,3125,-562
2,3,14,4,8,2761,3075,-314
2,3,15,4,8,2974,3092,-118
2,3,16,4,8,3169,3141,28
2,4,0,4,8,3109,3536,-427
2,4,1,4,8,2918,3610,-692
2,4,2,4,8,2712,3738,-1026
2,4,3,4,8,2560,3883,-1323
2,4,4,4,8,2466,4033,-1567
2,4,5,4,8,2365,4029,-1664
2,4,6,4,8,2274,4093,-1819
2,4,7,4,8,2239,4041,-1802
2,4,8,4,8,2239,3975,-1736
2,4,9,4,8,2242,4006,-1764
2,4,10,4,8,2241,4106,-1865
2,4,11,4,8,2297,4104,-1807
2,4,12,4,8,2413,4105,-1692
2,4,13,4,8,2536,4082,-1546
2,4,14,4,8,2679,4015,-1336
2,4,15,4,8,2859,4008,-1149
2,4,16,4,8,3039,3973,-934
2,5,0,4,8,3110,4060,-950
2,5,1,4,8,2980,4214,-1234
2,5,2,4,8,2836,4312,-1476
2,5,3,4,8,2759,4458,-1699
2,5,4,4,8,2794,4538,-1744
2,5,5,4,8,2858,4345,-1487
2,5,6,4,8,2894,4267,-1373
2,5,7,4,8,2909,4102,-1193
2,5,8,4,8,2954,3954,-1000
2,5,9,4,8,2959,3997,-1038
2,5,10,4,8,2930,4228,-1298
2,5,11,4,8,2927,4313,-1386
2,5,12,4,8,2921,4465,-1544
2,5,13,4,8,2926,4576,-1650
2,5,14,4,8,2986,4613,-1627
2,5,15,4,8,3080,4722,-1642
2,5,16,4,8,3191,4666,-1475
2,6,0,4,8,2787,4947,-2160
2,6,1,4,8,2660,5246,-2586
2,6,2,4,8,2542,5313,-2771
2,6,3,4,8,2478,5495,-3017
2,6,4,4,8,2560,5552,-2992
2,6,5,4,8,2682,5284,-2602
2,6,6,4,8,2735,5076,-2341
2,6,7,4,8,2737,4849,-2112
2,6,8,4,8,2741,4639,-1898
2,6,9,4,8,2755,4687,-1932
2,6,10,4,8,2761,5010,-2249
2,6,11,4,8,2773,5178,-2405
2,6,12,4,8,2736,5439,-2703
2,6,13,4,8,2702,5605,-2903
2,6,14,4,8,2740,5702,-2962
2,6,15,4,8,2830,5868,-3038
2,6,16,4,8,2949,5739,-2790
2,7,0,4,8,2881,5479,-2598
2,7,1,4,8,2843,5824,-2981
2,7,2,4,8,2864,5738,-2874
2,7,3,4,8,2912,5860,-2948
2,7,4,4,8,3057,5845,-2788
2,7,5,4,8,3174,5533,-2359
2,7,6,4,8,3254,5169,-1915
2,7,7,4,8,3256,4902,-1646
2,7,8,4,8,3222,4644,-1422
2,7,9,4,8,3231,4694,-1463
2,7,10,4,8,3261,5076,-1815
2,7,11,4,8,3251,5367,-2116
2,7,12,4,8,3197,5747,-2550
2,7,13,4,8,3125,5967,-2842
2,7,14,4,8,3075,6197,-3122
2,7,15,4,8,3092,6485,-3393
2,7,16,4,8,3141,6378,-3237
2,8,0,4,8,3536,5545,-2009
2,8,1,4,8,3610,5905,-2295
2,8,2,4,8,3738,5655,-1917
2,8,3,4,8,3883,5684,-1801
2,8,4,4,8,4033,5589,-1556
2,8,5,4,8,4029,5237,-1208
2,8,6,4,8,4093,4690,-597
2,8,7,4,8,4041,4384,-343
2,8,8,4,8,3975,4090,-115
2,8,9,4,8,4006,4131,-125
2,8,10,4,8,4106,4543,-437
2,8,11,4,8,4104,4973,-869
2,8,12,4,8,4105,5449,-1344
2,8,13,4,8,4082,5691,-1609
2,8,14,4,8,4015,6058,-2043
2,8,15,4,8,4008,6457,-2449
2,8,16,4,8,3973,6386,-2413
2,9,0,4,8,4060,5404,-1344
2,9,1,4,8,4214,5814,-1600
2,9,2,4,8,4312,5593,-1281
2,9,3,4,8,4458,5654,-1196
2,9,4,4,8,4538,5545,-1007
2,9,5,4,8,4345,5207,-862
2,9,6,4,8,4267,4613,-346
2,9,7,4,8,4102,4385,-283
2,9,8,4,8,3954,4082,-128
2,9,9,4,8,3997,4119,-122
2,9,10,4,8,4228,4467,-239
2,9,11,4,8,4313,4883,-570
2,9,12,4,8,4465,5375,-910
2,9,13,4,8,4576,5559,-983
2,9,14,4,8,4613,5896,-1283
2,9,15,4,8,4722,6218,-1496
2,9,16,4,8,4666,6141,-1475
2,10,0,4,8,4947,5156,-209
2,10,1,4,8,5246,5551,-305
2,10,2,4,8,5313,5385,-72
2,10,3,4,8,5495,5497,-2
2,10,4,4,8,5552,5339,213
2,10,5,4,8,5284,4954,330
2,10,6,4,8,5076,4409,667
2,10,7,4,8,4849,4209,640
2,10,8,4,8,4639,3891,748
2,10,9,4,8,4687,3974,713
2,10,10,4,8,5010,4295,715
2,10,11,4,8,5178,4564,614
2,10,12,4,8,5439,5029,410
2,10,13,4,8,5605,5237,368
2,10,14,4,8,5702,5565,137
2,10,15,4,8,5868,5813,55
2,10,16,4,8,5739,5774,-35
2,11,0,4,8,5479,4882,597
2,11,1,4,8,5824,5183,641
2,11,2,4,8,5738,5067,671
2,11,3,4,8,5860,5166,694
2,11,4,4,8,5845,4937,908
2,11,5,4,8,5533,4488,1045
2,11,6,4,8,5169,3981,1188
2,11,7,4,8,4902,3854,1048
2,11,8,4,8,4644,3566,1078
2,11,9,4,8,4694,3599,1095
2,11,10,4,8,5076,3925,1151
2,11,11,4,8,5367,4089,1278
2,11,12,4,8,5747,4475,1272
2,11,13,4,8,5967,4732,1235
2,11,14,4,8,6197,5066,1131
2,11,15,4,8,6485,5195,1290
2,11,16,4,8,6378,5196,1182
2,12,0,4,8,5545,4482,1063
2,12,1,4,8,5905,4688,1217
2,12,2,4,8,5655,4691,964
2,12,3,4,8,5684,4833,851
2,12,4,4,8,5589,4526,1063
2,12,5,4,8,5237,4207,1030
2,12,6,4,8,4690,3935,755
2,12,7,4,8,4384,3924,460
2,12,8,4,8,4090,3679,411
2,12,9,4,8,4131,3696,435
2,12,10,4,8,4543,4019,524
2,12,11,4,8,4973,3965,1008
2,12,12,4,8,5449,4154,1295
2,12,13,4,8,5691,4386,1305
2,12,14,4,8,6058,4536,1522
2,12,15,4,8,6457,4529,1928
2,12,16,4,8,6386,4685,1701
2,13,0,4,8,5404,4176,1228
2,13,1,4,8,5814,4305,1509
2,13,2,4,8,5593,4371,1222
2,13,3,4,8,5654,4556,1098
2,13,4,4,8,5545,4164,1381
2,13,5,4,8,5207,3992,1215
2,13,6,4,8,4613,3960,653
2,13,7,4,8,4385,3992,393
2,13,8,4,8,4082,3717,365
2,13,9,4,8,4119,3613,506
2,13,10,4,8,4467,3861,606
2,13,11,4,8,4883,3630,1253
2,13,12,4,8,5375,3653,1722
2,13,13,4,8,5559,3867,1692
2,13,14,4,8,5896,3860,2036
2,13,15,4,8,6218,3805,2413
2,13,16,4,8,6141,4131,2010
2,14,0,4,8,5156,3878,1278
2,14,1,4,8,5551,3861,1690
2,14,2,4,8,5385,3900,1485
2,14,3,4,8,5497,3975,1522
2,14,4,4,8,5339,3471,1868
2,14,5,4,8,4954,3449,1505
2,14,6,4,8,4409,3529,880
2,14,7,4,8,4209,3578,631
2,14,8,4,8,3891,3365,526
2,14,9,4,8,3974,3113,861
2,14,10,4,8,4295,3300,995
2,14,11,4,8,4564,3133,1431
2,14,12,4,8,5029,3103,1926
2,14,13,4,8,5237,3239,1998
2,14,14,4,8,5565,3202,2363
2,14,15,4,8,5813,3187,2626
2,14,16,4,8,5774,3616,2158
2,15,0,4,8,4882,3374,1508
2,15,1,4,8,5183,3421,1762
2,15,2,4,8,5067,3454,1613
2,15,3,4,8,5166,3524,1642
2,15,4,4,8,4937,3061,1876
2,15,5,4,8,4488,3246,1242
2,15,6,4,8,3981,3476,505
2,15,7,4,8,3854,3479,375
2,15,8,4,8,3566,3315,251
2,15,9,4,8,3599,3069,530
2,15,10,4,8,3925,3192,733
2,15,11,4,8,4089,2977,1112
2,15,12,4,8,4475,2903,1572
2,15,13,4,8,4732,2878,1854
2,15,14,4,8,5066,2723,2343
2,15,15,4,8,5195,2751,2444
2,15,16,4,8,5196,3099,2097
2,16,0,4,8,4482,2940,1542
2,16,1,4,8,4688,3005,1683
2,16,2,4,8,4691,3034,1657
2,16,3,4,8,4833,3051,1782
2,16,4,4,8,4526,2682,1844
2,16,5,4,8,4207,2902,1305
2,16,6,4,8,3935,3080,855
2,16,7,4,8,3924,3089,835
2,16,8,4,8,3679,2973,706
2,16,9,4,8,3696,2707,989
2,16,10,4,8,4019,2714,1305
2,16,11,4,8,3965,2575,1390
2,16,12,4,8,4154,2579,1575
2,16,13,4,8,4386,2457,1929
2,16,14,4,8,4536,2323,2213
2,16,15,4,8,4529,2369,2160
2,16,16,4,8,4685,2534,2151
2,0,0,5,8,4362,3604,758
2,0,1,5,8,4267,3432,835
2,0,2,5,8,4140,3260,880
2,0,3,5,8,4030,3143,887
2,0,4,5,8,3919,3171,748
2,0,5,5,8,3765,3233,532
2,0,6,5,8,3626,3242,384
2,0,7,5,8,3537,3240,297
2,0,8,5,8,3453,3271,182
2,0,9,5,8,3479,3271,208
2,0,10,5,8,3529,3267,262
2,0,11,5,8,3646,3293,353
2,0,12,5,8,3787,3298,489
2,0,13,5,8,3894,3315,579
2,0,14,5,8,4009,3407,602
2,0,15,5,8,4140,3550,590
2,0,16,5,8,4233,3711,522
2,1,0,5,8,4336,3617,719
2,1,1,5,8,4202,3528,674
2,1,2,5,8,4025,3494,531
2,1,3,5,8,3856,3502,354
2,1,4,5,8,3687,3627,60
2,1,5,5,8,3482,3726,-244
2,1,6,5,8,3307,3793,-486
2,1,7,5,8,3214,3796,-582
2,1,8,5,8,3158,3772,-614
2,1,9,5,8,3176,3789,-613
2,1,10,5,8,3217,3816,-599
2,1,11,5,8,3340,3808,-468
2,1,12,5,8,3517,3772,-255
2,1,13,5,8,3679,3728,-49
2,1,14,5,8,3848,3716,132
2,1,15,5,8,4027,3781,246
2,1,16,5,8,4165,3877,288
2,2,0,5,8,4213,4214,-1
2,2,1,5,8,4026,4253,-227
2,2,2,5,8,3799,4352,-553
2,2,3,5,8,3593,4504,-911
2,2,4,5,8,3407,4704,-1297
2,2,5,5,8,3193,4759,-1566
2,2,6,5,8,3009,4864,-1855
2,2,7,5,8,2914,4827,-1913
2,2,8,5,8,2868,4752,-1884
2,2,9,5,8,2887,4787,-1900
2,2,10,5,8,2924,4875,-1951
2,2,11,5,8,3049,4855,-1806
2,2,12,5,8,3245,4834,-1589
2,2,13,5,8,3437,4784,-1347
2,2,14,5,8,3637,4703,-1066
2,2,15,5,8,3855,4709,-854
2,2,16,5,8,4045,4703,-658
2,3,0,5,8,4007,4939,-932
2,3,1,5,8,3776,5094,-1318
2,3,2,5,8,3522,5186,-1664
2,3,3,5,8,3326,5341,-2015
2,3,4,5,8,3190,5480,-2290
2,3,5,5,8,3039,5370,-2331
2,3,6,5,8,2896,5344,-2448
2,3,7,5,8,2814,5182,-2368
2,3,8,5,8,2766,5051,-2285
2,3,9,5,8,2787,5101,-2314
2,3,10,5,8,2816,5328,-2512
2,3,11,5,8,2923,5412,-2489
2,3,12,5,8,3097,5520,-2423
2,3,13,5,8,3265,5584,-2319
2,3,14,5,8,3449,5603,-2154
2,3,15,5,8,3675,5692,-2017
2,3,16,5,8,3899,5629,-1730
2,4,0,5,8,3988,5441,-1453
2,4,1,5,8,3798,5698,-1900
2,4,2,5,8,3586,5737,-2151
2,4,3,5,8,3443,5879,-2436
2,4,4,5,8,3408,5929,-2521
2,4,5,5,8,3390,5659,-2269
2,4,6,5,8,3351,5424,-2073
2,4,7,5,8,3319,5180,-1861
2,4,8,5,8,3336,4956,-1620
2,4,9,5,8,3346,4999,-1653
2,4,10,5,8,3341,5347,-2006
2,4,11,5,8,3396,5544,-2148
2,4,12,5,8,3468,5816,-2348
2,4,13,5,8,3544,5994,-2450
2,4,14,5,8,3669,6123,-2454
2,4,15,5,8,3829,6338,-2509
2,4,16,5,8,4002,6259,-2257
2,5,0,5,8,3604,6309,-2705
2,5,1,5,8,3432,6692,-3260
2,5,2,5,8,3260,6690,-3430
2,5,3,5,8,3143,6884,-3741
2,5,4,5,8,3171,6912,-3741
2,5,5,5,8,3233,6577,-3344
2,5,6,5,8,3242,6227,-2985
2,5,7,5,8,3240,5961,-2721
2,5,8,5,8,3271,5675,-2404
2,5,9,5,8,3271,5728,-2457
2,5,10,5,8,3267,6131,-2864
2,5,11,5,8,3293,6402,-3109
2,5,12,5,8,3298,6783,-3485
2,5,13,5,8,3315,6993,-3678
2,5,14,5,8,3407,7173,-3766
2,5,15,5,8,3550,7436,-3886
2,5,16,5,8,3711,7306,-3595
2,6,0,5,8,3617,6878,-3261
2,6,1,5,8,3528,7315,-3787
2,6,2,5,8,3494,7143,-3649
2,6,3,5,8,3502,7276,-3774
2,6,4,5,8,3627,7236,-3609
2,6,5,5,8,3726,6822,-3096
2,6,6,5,8,3793,6300,-2507
2,6,7,5,8,3796,5955,-2159
2,6,8,5,8,3772,5620,-1848
2,6,9,5,8,3789,5687,-1898
2,6,10,5,8,3816,6157,-2341
2,6,11,5,8,3808,6577,-2769
2,6,12,5,8,3772,7086,-3314
2,6,13,5,8,3728,7350,-3622
2,6,14,5,8,3716,7686,-3970
2,6,15,5,8,3781,8074,-4293
2,6,16,5,8,3877,7948,-4071
2,7,0,5,8,4214,6807,-2593
2,7,1,5,8,4253,7298,-3045
2,7,2,5,8,4352,7041,-2689
2,7,3,5,8,4504,7112,-2608
2,7,4,5,8,4704,6992,-2288
2,7,5,5,8,4759,6548,-1789
2,7,6,5,8,4864,5864,-1000
2,7,7,5,8,4827,5526,-699
2,7,8,5,8,4752,5158,-406
2,7,9,5,8,4787,5214,-427
2,7,10,5,8,4875,5689,-814
2,7,11,5,8,4855,6191,-1336
2,7,12,5,8,4834,6790,-1956
2,7,13,5,8,4784,7061,-2277
2,7,14,5,8,4703,7484,-2781
2,7,15,5,8,4709,7902,-3193
2,7,16,5,8,4703,7797,-3094
2,8,0,5,8,4939,6537,-1598
2,8,1,5,8,5094,7035,-1941
2,8,2,5,8,5186,6810,-1624
2,8,3,5,8,5341,6918,-1577
2,8,4,5,8,5480,6730,-1250
2,8,5,5,8,5370,6268,-898
2,8,6,5,8,5344,5566,-222
2,8,7,5,8,5182,5287,-105
2,8,8,5,8,5051,4893,158
2,8,9,5,8,5101,4976,125
2,8,10,5,8,5328,5414,-86
2,8,11,5,8,5412,5795,-383
2,8,12,5,8,5520,6380,-860
2,8,13,5,8,5584,6655,-1071
2,8,14,5,8,5603,7075,-1472
2,8,15,5,8,5692,7429,-1737
2,8,16,5,8,5629,7367,-1738
2,9,0,5,8,5441,6244,-803
2,9,1,5,8,5698,6629,-931
2,9,2,5,8,5737,6444,-707
2,9,3,5,8,5879,6555,-676
2,9,4,5,8,5929,6297,-368
2,9,5,5,8,5659,5781,-122
2,9,6,5,8,5424,5132,292
2,9,7,5,8,5180,4966,214
2,9,8,5,8,4956,4602,354
2,9,9,5,8,4999,4640,359
2,9,10,5,8,5347,5046,301
2,9,11,5,8,5544,5313,231
2,9,12,5,8,5816,5819,-3
2,9,13,5,8,5994,6120,-126
2,9,14,5,8,6123,6537,-414
2,9,15,5,8,6338,6763,-425
2,9,16,5,8,6259,6763,-504
2,10,0,5,8,6309,5881,428
2,10,1,5,8,6692,6179,513
2,10,2,5,8,6690,6096,594
2,10,3,5,8,6884,6249,635
2,10,4,5,8,6912,5917,995
2,10,5,5,8,6577,5496,1081
2,10,6,5,8,6227,5066,1161
2,10,7,5,8,5961,4977,984
2,10,8,5,8,5675,4655,1020
2,10,9,5,8,5728,4689,1039
2,10,10,5,8,6131,5100,1031
2,10,11,5,8,6402,5175,1227
2,10,12,5,8,6783,5493,1290
2,10,13,5,8,6993,5769,1224
2,10,14,5,8,7173,6025,1148
2,10,15,5,8,7436,6118,1318
2,10,16,5,8,7306,6255,1051
2,11,0,5,8,6878,5438,1440
2,11,1,5,8,7315,5698,1617
2,11,2,5,8,7143,5757,1386
2,11,3,5,8,7276,5984,1292
2,11,4,5,8,7236,5567,1669
2,11,5,5,8,6822,5303,1519
2,11,6,5,8,6300,5134,1166
2,11,7,5,8,5955,5134,821
2,11,8,5,8,5620,4785,835
2,11,9,5,8,5687,4696,991
2,11,10,5,8,6157,5007,1150
2,11,11,5,8,6577,4848,1729
2,11,12,5,8,7086,4994,2092
2,11,13,5,8,7350,5237,2113
2,11,14,5,8,7686,5286,2400
2,11,15,5,8,8074,5250,2824
2,11,16,5,8,7948,5542,2406
2,12,0,5,8,6807,5011,1796
2,12,1,5,8,7298,5082,2216
2,12,2,5,8,7041,5117,1924
2,12,3,5,8,7112,5239,1873
2,12,4,5,8,6992,4656,2336
2,12,5,5,8,6548,4510,2038
2,12,6,5,8,5864,4482,1382
2,12,7,5,8,5526,4480,1046
2,12,8,5,8,5158,4176,982
2,12,9,5,8,5214,3970,1244
2,12,10,5,8,5689,4247,1442
2,12,11,5,8,6191,4045,2146
2,12,12,5,8,6790,4108,2682
2,12,13,5,8,7061,4335,2726
2,12,14,5,8,7484,4381,3103
2,12,15,5,8,7902,4398,3504
2,12,16,5,8,7797,4842,2955
2,13,0,5,8,6537,4462,2075
2,13,1,5,8,7035,4499,2536
2,13,2,5,8,6810,4513,2297
2,13,3,5,8,6918,4582,2336
2,13,4,5,8,6730,4019,2711
2,13,5,5,8,6268,4073,2195
2,13,6,5,8,5566,4199,1367
2,13,7,5,8,5287,4236,1051
2,13,8,5,8,4893,4026,867
2,13,9,5,8,4976,3735,1241
2,13,10,5,8,5414,3943,1471
2,13,11,5,8,5795,3726,2069
2,13,12,5,8,6380,3693,2687
2,13,13,5,8,6655,3761,2894
2,13,14,5,8,7075,3695,3380
2,13,15,5,8,7429,3701,3728
2,13,16,5,8,7367,4088,3279
2,14,0,5,8,6244,3939,2305
2,14,1,5,8,6629,4001,2628
2,14,2,5,8,6444,4063,2381
2,14,3,5,8,6555,4134,2421
2,14,4,5,8,6297,3662,2635
2,14,5,5,8,5781,3910,1871
2,14,6,5,8,5132,4165,967
2,14,7,5,8,4966,4212,754
2,14,8,5,8,4602,4062,540
2,14,9,5,8,4640,3797,843
2,14,10,5,8,5046,3889,1157
2,14,11,5,8,5313,3661,1652
2,14,12,5,8,5819,3597,2222
2,14,13,5,8,6120,3494,2626
2,14,14,5,8,6537,3282,3255
2,14,15,5,8,6763,3292,3471
2,14,16,5,8,6763,3593,3170
2,0,0,6,8,5179,4950,229
2,0,1,6,8,5039,4938,101
2,0,2,6,8,4858,4982,-124
2,0,3,6,8,4695,5094,-399
2,0,4,6,8,4530,5274,-744
2,0,5,6,8,4316,5311,-995
2,0,6,6,8,4133,5403,-1270
2,0,7,6,8,4040,5367,-1327
2,0,8,6,8,3983,5302,-1319
2,0,9,6,8,3995,5345,-1350
2,0,10,6,8,4035,5430,-1395
2,0,11,6,8,4166,5412,-1246
2,0,12,6,8,4349,5409,-1060
2,0,13,6,8,4507,5387,-880
2,0,14,6,8,4676,5344,-668
2,0,15,6,8,4860,5398,-538
2,0,16,6,8,4995,5439,-444
2,1,0,6,8,5072,5617,-545
2,1,1,6,8,4887,5737,-850
2,1,2,6,8,4655,5800,-1145
2,1,3,6,8,4446,5962,-1516
2,1,4,6,8,4257,6151,-1894
2,1,5,6,8,4034,6100,-2066
2,1,6,6,8,3846,6115,-2269
2,1,7,6,8,3754,5968,-2214
2,1,8,6,8,3708,5828,-2120
2,1,9,6,8,3734,5882,-2148
2,1,10,6,8,3772,6097,-2325
2,1,11,6,8,3897,6163,-2266
2,1,12,6,8,4092,6249,-2157
2,1,13,6,8,4282,6286,-2004
2,1,14,6,8,4489,6291,-1802
2,1,15,6,8,4716,6393,-1677
2,1,16,6,8,4901,6359,-1458
2,2,0,6,8,4891,6320,-1429
2,2,1,6,8,4669,6578,-1909
2,2,2,6,8,4413,6611,-2198
2,2,3,6,8,4214,6762,-2548
2,2,4,6,8,4078,6871,-2793
2,2,5,6,8,3923,6684,-2761
2,2,6,6,8,3780,6501,-2721
2,2,7,6,8,3700,6260,-2560
2,2,8,6,8,3645,6053,-2408
2,2,9,6,8,3668,6103,-2435
2,2,10,6,8,3693,6447,-2754
2,2,11,6,8,3800,6643,-2843
2,2,12,6,8,3974,6871,-2897
2,2,13,6,8,4139,7002,-2863
2,2,14,6,8,4325,7113,-2788
2,2,15,6,8,4556,7308,-2752
2,2,16,6,8,4775,7222,-2447
2,3,0,6,8,4886,6803,-1917
2,3,1,6,8,4656,7144,-2488
2,3,2,6,8,4396,7114,-2718
2,3,3,6,8,4209,7268,-3059
2,3,4,6,8,4132,7289,-3157
2,3,5,6,8,4064,6952,-2888
2,3,6,6,8,3973,6575,-2602
2,3,7,6,8,3894,6292,-2398
2,3,8,6,8,3863,5992,-2129
2,3,9,6,8,3891,6040,-2149
2,3,10,6,8,3916,6468,-2552
2,3,11,6,8,4022,6768,-2746
2,3,12,6,8,4152,7160,-3008
2,3,13,6,8,4273,7382,-3109
2,3,14,6,8,4439,7594,-3155
2,3,15,6,8,4645,7906,-3261
2,3,16,6,8,4862,7826,-2964
2,4,0,6,8,4482,7708,-3226
2,4,1,6,8,4250,8183,-3933
2,4,2,6,8,4010,8095,-4085
2,4,3,6,8,3827,8300,-4473
2,4,4,6,8,3785,8303,-4518
2,4,5,6,8,3765,7866,-4101
2,4,6,6,8,3699,7358,-3659
2,4,7,6,8,3650,7014,-3364
2,4,8,6,8,3653,6651,-2998
2,4,9,6,8,3658,6721,-3063
2,4,10,6,8,3678,7212,-3534
2,4,11,6,8,3762,7612,-3850
2,4,12,6,8,3845,8122,-4277
2,4,13,6,8,3933,8376,-4443
2,4,14,6,8,4090,8662,-4572
2,4,15,6,8,4299,9025,-4726
2,4,16,6,8,4522,8876,-4354
2,5,0,6,8,4434,8140,-3706
2,5,1,6,8,4300,8708,-4408
2,5,2,6,8,4212,8529,-4317
2,5,3,6,8,4167,8704,-4537
2,5,4,6,8,4238,8639,-4401
2,5,5,6,8,4277,8133,-3856
2,5,6,6,8,4300,7474,-3174
2,5,7,6,8,4299,7097,-2798
2,5,8,6,8,4302,6688,-2386
2,5,9,6,8,4305,6770,-2465
2,5,10,6,8,4322,7303,-2981
2,5,11,6,8,4328,7795,-3467
2,5,12,6,8,4334,8427,-4093
2,5,13,6,8,4341,8720,-4379
2,5,14,6,8,4383,9112,-4729
2,5,15,6,8,4501,9519,-5018
2,5,16,6,8,4639,9359,-4720
2,6,0,6,8,4950,7940,-2990
2,6,1,6,8,4938,8519,-3581
2,6,2,6,8,4982,8258,-3276
2,6,3,6,8,5094,8376,-3282
2,6,4,6,8,5274,8177,-2903
2,6,5,6,8,5311,7609,-2298
2,6,6,6,8,5403,6817,-1414
2,6,7,6,8,5367,6428,-1061
2,6,8,6,8,5302,5969,-667
2,6,9,6,8,5345,6071,-726
2,6,10,6,8,5430,6636,-1206
2,6,11,6,8,5412,7103,-1691
2,6,12,6,8,5409,7795,-2386
2,6,13,6,8,5387,8157,-2770
2,6,14,6,8,5344,8663,-3319
2,6,15,6,8,5398,9113,-3715
2,6,16,6,8,5439,9023,-3584
2,7,0,6,8,5617,7625,-2008
2,7,1,6,8,5737,8113,-2376
2,7,2,6,8,5800,7869,-2069
2,7,3,6,8,5962,7976,-2014
2,7,4,6,8,6151,7688,-1537
2,7,5,6,8,6100,7095,-995
2,7,6,6,8,6115,6289,-174
2,7,7,6,8,5968,6044,-76
2,7,8,6,8,5828,5604,224
2,7,9,6,8,5882,5642,240
2,7,10,6,8,6097,6165,-68
2,7,11,6,8,6163,6544,-381
2,7,12,6,8,6249,7170,-921
2,7,13,6,8,6286,7538,-1252
2,7,14,6,8,6291,8047,-1756
2,7,15,6,8,6393,8379,-1986
2,7,16,6,8,6359,8356,-1997
2,8,0,6,8,6320,7243,-923
2,8,1,6,8,6578,7625,-1047
2,8,2,6,8,6611,7473,-862
2,8,3,6,8,6762,7638,-876
2,8,4,6,8,6871,7277,-406
2,8,5,6,8,6684,6789,-105
2,8,6,6,8,6501,6217,284
2,8,7,6,8,6260,6089,171
2,8,8,6,8,6053,5691,362
2,8,9,6,8,6103,5730,373
2,8,10,6,8,6447,6221,226
2,8,11,6,8,6643,6399,244
2,8,12,6,8,6871,6837,34
2,8,13,6,8,7002,7157,-155
2,8,14,6,8,7113,7496,-383
2,8,15,6,8,7308,7686,-378
2,8,16,6,8,7222,7822,-600
2,9,0,6,8,6803,6837,-34
2,9,1,6,8,7144,7189,-45
2,9,2,6,8,7114,7162,-48
2,9,3,6,8,7268,7400,-132
2,9,4,6,8,7289,6958,331
2,9,5,6,8,6952,6592,360
2,9,6,6,8,6575,6265,310
2,9,7,6,8,6292,6187,105
2,9,8,6,8,5992,5761,231
2,9,9,6,8,6040,5689,351
2,9,10,6,8,6468,6088,380
2,9,11,6,8,6768,6058,710
2,9,12,6,8,7160,6333,827
2,9,13,6,8,7382,6620,762
2,9,14,6,8,7594,6775,819
2,9,15,6,8,7906,6839,1067
2,9,16,6,8,7826,7112,714
2,10,0,6,8,7708,6273,1435
2,10,1,6,8,8183,6475,1708
2,10,2,6,8,8095,6503,1592
2,10,3,6,8,8300,6667,1633
2,10,4,6,8,8303,6059,2244
2,10,5,6,8,7866,5821,2045
2,10,6,6,8,7358,5656,1702
2,10,7,6,8,7014,5622,1392
2,10,8,6,8,6651,5244,1407
2,10,9,6,8,6721,5053,1668
2,10,10,6,8,7212,5393,1819
2,10,11,6,8,7612,5263,2349
2,10,12,6,8,8122,5449,2673
2,10,13,6,8,8376,5705,2671
2,10,14,6,8,8662,5807,2855
2,10,15,6,8,9025,5843,3182
2,10,16,6,8,8876,6253,2623
2,11,0,6,8,8140,5595,2545
2,11,1,6,8,8708,5720,2988
2,11,2,6,8,8529,5730,2799
2,11,3,6,8,8704,5846,2858
2,11,4,6,8,8639,5204,3435
2,11,5,6,8,8133,5134,2999
2,11,6,6,8,7474,5152,2322
2,11,7,6,8,7097,5138,1959
2,11,8,6,8,6688,4837,1851
2,11,9,6,8,6770,4592,2178
2,11,10,6,8,7303,4890,2413
2,11,11,6,8,7795,4638,3157
2,11,12,6,8,8427,4698,3729
2,11,13,6,8,8720,4857,3863
2,11,14,6,8,9112,4874,4238
2,11,15,6,8,9519,4912,4607
2,11,16,6,8,9359,5314,4045
2,12,0,6,8,7940,5027,2913
2,12,1,6,8,8519,5079,3440
2,12,2,6,8,8258,5122,3136
2,12,3,6,8,8376,5192,3184
2,12,4,6,8,8177,4620,3557
2,12,5,6,8,7609,4737,2872
2,12,6,6,8,6817,4888,1929
2,12,7,6,8,6428,4969,1459
2,12,8,6,8,5969,4773,1196
2,12,9,6,8,6071,4463,1608
2,12,10,6,8,6636,4640,1996
2,12,11,6,8,7103,4410,2693
2,12,12,6,8,7795,4387,3408
2,12,13,6,8,8157,4377,3780
2,12,14,6,8,8663,4254,4409
2,12,15,6,8,9113,4242,4871
2,12,16,6,8,9023,4582,4441
2,0,0,7,8,5915,6998,-1083
2,0,1,7,8,5724,7221,-1497
2,0,2,7,8,5488,7225,-1737
2,0,3,7,8,5285,7383,-2098
2,0,4,7,8,5100,7542,-2442
2,0,5,7,8,4868,7414,-2546
2,0,6,7,8,4672,7272,-2600
2,0,7,7,8,4580,7046,-2466
2,0,8,7,8,4533,6830,-2297
2,0,9,7,8,4553,6884,-2331
2,0,10,7,8,4590,7216,-2626
2,0,11,7,8,4723,7394,-2671
2,0,12,7,8,4924,7600,-2676
2,0,13,7,8,5110,7704,-2594
2,0,14,7,8,5317,7801,-2484
2,0,15,7,8,5549,8009,-2460
2,0,16,7,8,5731,7952,-2221
2,1,0,7,8,5750,7682,-1932
2,1,1,7,8,5530,8024,-2494
2,1,2,7,8,5269,7988,-2719
2,1,3,7,8,5067,8151,-3084
2,1,4,7,8,4928,8231,-3303
2,1,5,7,8,4764,7977,-3213
2,1,6,7,8,4617,7652,-3035
2,1,7,7,8,4540,7372,-2832
2,1,8,7,8,4485,7089,-2604
2,1,9,7,8,4515,7144,-2629
2,1,10,7,8,4541,7568,-3027
2,1,11,7,8,4648,7867,-3219
2,1,12,7,8,4821,8215,-3394
2,1,13,7,8,4984,8390,-3406
2,1,14,7,8,5177,8584,-3407
2,1,15,7,8,5417,8876,-3459
2,1,16,7,8,5631,8789,-3158
2,2,0,7,8,5770,8202,-2432
2,2,1,7,8,5549,8635,-3086
2,2,2,7,8,5287,8519,-3232
2,2,3,7,8,5097,8684,-3587
2,2,4,7,8,5020,8680,-3660
2,2,5,7,8,4948,8241,-3293
2,2,6,7,8,4857,7706,-2849
2,2,7,7,8,4780,7345,-2565
2,2,8,7,8,4742,6968,-2226
2,2,9,7,8,4772,7033,-2261
2,2,10,7,8,4793,7549,-2756
2,2,11,7,8,4899,7978,-3079
2,2,12,7,8,5029,8499,-3470
2,2,13,7,8,5147,8765,-3618
2,2,14,7,8,5315,9083,-3768
2,2,15,7,8,5526,9495,-3969
2,2,16,7,8,5738,9396,-3658
2,3,0,7,8,5380,8970,-3590
2,3,1,7,8,5108,9576,-4468
2,3,2,7,8,4820,9481,-4661
2,3,3,7,8,4593,9728,-5135
2,3,4,7,8,4509,9706,-5197
2,3,5,7,8,4439,9177,-4738
2,3,6,7,8,4321,8532,-4211
2,3,7,7,8,4225,8156,-3931
2,3,8,7,8,4180,7719,-3539
2,3,9,7,8,4203,7804,-3601
2,3,10,7,8,4253,8358,-4105
2,3,11,7,8,4388,8830,-4442
2,3,12,7,8,4529,9463,-4934
2,3,13,7,8,4662,9746,-5084
2,3,14,7,8,4860,10088,-5228
2,3,15,7,8,5115,10470,-5355
2,3,16,7,8,5382,10287,-4905
2,4,0,7,8,5312,9273,-3961
2,4,1,7,8,5118,9929,-4811
2,4,2,7,8,4962,9746,-4784
2,4,3,7,8,4851,9968,-5117
2,4,4,7,8,4852,9824,-4972
2,4,5,7,8,4809,9194,-4385
2,4,6,7,8,4757,8427,-3670
2,4,7,7,8,4709,7999,-3290
2,4,8,7,8,4684,7499,-2815
2,4,9,7,8,4692,7627,-2935
2,4,10,7,8,4733,8250,-3517
2,4,11,7,8,4797,8707,-3910
2,4,12,7,8,4881,9432,-4551
2,4,13,7,8,4959,9816,-4857
2,4,14,7,8,5066,10291,-5225
2,4,15,7,8,5250,10730,-5480
2,4,16,7,8,5450,10585,-5135
2,5,0,7,8,5767,9028,-3261
2,5,1,7,8,5710,9597,-3887
2,5,2,7,8,5700,9317,-3617
2,5,3,7,8,5759,9434,-3675
2,5,4,7,8,5885,9135,-3250
2,5,5,7,8,5862,8436,-2574
2,5,6,7,8,5910,7540,-1630
2,5,7,7,8,5870,7185,-1315
2,5,8,7,8,5832,6680,-848
2,5,9,7,8,5861,6737,-876
2,5,10,7,8,5936,7387,-1451
2,5,11,7,8,5932,7852,-1920
2,5,12,7,8,5971,8585,-2614
2,5,13,7,8,6000,9040,-3040
2,5,14,7,8,6011,9635,-3624
2,5,15,7,8,6118,10063,-3945
2,5,16,7,8,6201,10012,-3811
2,6,0,7,8,6353,8624,-2271
2,6,1,7,8,6422,9109,-2687
2,6,2,7,8,6430,8898,-2468
2,6,3,7,8,6552,9059,-2507
2,6,4,7,8,6721,8668,-1947
2,6,5,7,8,6652,8103,-1451
2,6,6,7,8,6654,7374,-720
2,6,7,7,8,6508,7167,-659
2,6,8,7,8,6378,6693,-315
2,6,9,7,8,6440,6732,-292
2,6,10,7,8,6652,7340,-688
2,6,11,7,8,6720,7630,-910
2,6,12,7,8,6824,8188,-1364
2,6,13,7,8,6889,8575,-1686
2,6,14,7,8,6932,9006,-2074
2,6,15,7,8,7082,9302,-2220
2,6,16,7,8,7095,9415,-2320
2,7,0,7,8,6998,8199,-1201
2,7,1,7,8,7221,8635,-1414
2,7,2,7,8,7225,8539,-1314
2,7,3,7,8,7383,8789,-1406
2,7,4,7,8,7542,8318,-776
2,7,5,7,8,7414,7885,-471
2,7,6,7,8,7272,7416,-144
2,7,7,7,8,7046,7299,-253
2,7,8,7,8,6830,6797,33
2,7,9,7,8,6884,6730,154
2,7,10,7,8,7216,7209,7
2,7,11,7,8,7394,7282,112
2,7,12,7,8,7600,7677,-77
2,7,13,7,8,7704,8008,-304
2,7,14,7,8,7801,8246,-445
2,7,15,7,8,8009,8407,-398
2,7,16,7,8,7952,8679,-727
2,8,0,7,8,7682,7672,10
2,8,1,7,8,8024,7966,58
2,8,2,7,8,7988,7908,80
2,8,3,7,8,8151,8083,68
2,8,4,7,8,8231,7450,781
2,8,5,7,8,7977,7110,867
2,8,6,7,8,7652,6787,865
2,8,7,7,8,7372,6675,697
2,8,8,7,8,7089,6220,869
2,8,9,7,8,7144,6046,1098
2,8,10,7,8,7568,6474,1094
2,8,11,7,8,7867,6473,1394
2,8,12,7,8,8215,6788,1427
2,8,13,7,8,8390,7088,1302
2,8,14,7,8,8584,7296,1288
2,8,15,7,8,8876,7432,1444
2,8,16,7,8,8789,7823,966
2,9,0,7,8,8202,6857,1345
2,9,1,7,8,8635,7113,1522
2,9,2,7,8,8519,7116,1403
2,9,3,7,8,8684,7274,1410
2,9,4,7,8,8680,6607,2073
2,9,5,7,8,8241,6445,1796
2,9,6,7,8,7706,6326,1380
2,9,7,7,8,7345,6280,1065
2,9,8,7,8,6968,5905,1063
2,9,9,7,8,7033,5675,1358
2,9,10,7,8,7549,6036,1513
2,9,11,7,8,7978,5856,2122
2,9,12,7,8,8499,6039,2460
2,9,13,7,8,8765,6227,2538
2,9,14,7,8,9083,6300,2783
2,9,15,7,8,9495,6357,3138
2,9,16,7,8,9396,6725,2671
2,10,0,7,8,8970,6160,2810
2,10,1,7,8,9576,6300,3276
2,10,2,7,8,9481,6339,3142
2,10,3,7,8,9728,6456,3272
2,10,4,7,8,9706,5805,3901
2,10,5,7,8,9177,5798,3379
2,10,6,7,8,8532,5841,2691
2,10,7,7,8,8156,5871,2285
2,10,8,7,8,7719,5584,2135
2,10,9,7,8,7804,5320,2484
2,10,10,7,8,8358,5587,2771
2,10,11,7,8,8830,5322,3508
2,10,12,7,8,9463,5392,4071
2,10,13,7,8,9746,5473,4273
2,10,14,7,8,10088,5433,4655
2,10,15,7,8,10470,5453,5017
2,10,16,7,8,10287,5808,4479
2,0,0,8,8,6593,9081,-2488
2,0,1,8,8,6367,9515,-3148
2,0,2,8,8,6102,9393,-3291
2,0,3,8,8,5906,9567,-3661
2,0,4,8,8,5771,9622,-3851
2,0,5,8,8,5598,9266,-3668
2,0,6,8,8,5443,8783,-3340
2,0,7,8,8,5366,8425,-3059
2,0,8,8,8,5310,8065,-2755
2,0,9,8,8,5334,8137,-2803
2,0,10,8,8,5359,8649,-3290
2,0,11,8,8,5474,9077,-3603
2,0,12,8,8,5653,9554,-3901
2,0,13,8,8,5812,9773,-3961
2,0,14,8,8,6005,10073,-4068
2,0,15,8,8,6250,10465,-4215
2,0,16,8,8,6461,10359,-3898
2,1,0,8,8,6629,9464,-2835
2,1,1,8,8,6410,10028,-3618
2,1,2,8,8,6143,9905,-3762
2,1,3,8,8,5950,10112,-4162
2,1,4,8,8,5870,10083,-4213
2,1,5,8,8,5789,9552,-3763
2,1,6,8,8,5694,8880,-3186
2,1,7,8,8,5620,8487,-2867
2,1,8,8,8,5582,8036,-2454
2,1,9,8,8,5619,8116,-2497
2,1,10,8,8,5641,8695,-3054
2,1,11,8,8,5747,9196,-3449
2,1,12,8,8,5876,9840,-3964
2,1,13,8,8,5992,10135,-4143
2,1,14,8,8,6167,10509,-4342
2,1,15,8,8,6387,10940,-4553
2,1,16,8,8,6594,10807,-4213
2,2,0,8,8,6264,10103,-3839
2,2,1,8,8,6001,10797,-4796
2,2,2,8,8,5711,10698,-4987
2,2,3,8,8,5481,10992,-5511
2,2,4,8,8,5397,10891,-5494
2,2,5,8,8,5323,10238,-4915
2,2,6,8,8,5205,9485,-4280
2,2,7,8,8,5111,9058,-3947
2,2,8,8,8,5059,8530,-3471
2,2,9,8,8,5084,8661,-3577
2,2,10,8,8,5130,9305,-4175
2,2,11,8,8,5265,9742,-4477
2,2,12,8,8,5406,10468,-5062
2,2,13,8,8,5536,10842,-5306
2,2,14,8,8,5736,11267,-5531
2,2,15,8,8,5996,11681,-5685
2,2,16,8,8,6258,11513,-5255
2,3,0,8,8,6210,10361,-4151
2,3,1,8,8,5976,11007,-5031
2,3,2,8,8,5772,10805,-5033
2,3,3,8,8,5617,11026,-5409
2,3,4,8,8,5576,10782,-5206
2,3,5,8,8,5483,10021,-4538
2,3,6,8,8,5379,9150,-3771
2,3,7,8,8,5284,8756,-3472
2,3,8,8,8,5211,8210,-2999
2,3,9,8,8,5237,8293,-3056
2,3,10,8,8,5308,9001,-3693
2,3,11,8,8,5423,9456,-4033
2,3,12,8,8,5565,10222,-4657
2,3,13,8,8,5688,10699,-5011
2,3,14,8,8,5836,11263,-5427
2,3,15,8,8,6066,11680,-5614
2,3,16,8,8,6310,11574,-5264
2,4,0,8,8,6645,10027,-3382
2,4,1,8,8,6528,10593,-4065
2,4,2,8,8,6450,10346,-3896
2,4,3,8,8,6443,10517,-4074
2,4,4,8,8,6499,10115,-3616
2,4,5,8,8,6394,9444,-3050
2,4,6,8,8,6367,8625,-2258
2,4,7,8,8,6280,8308,-2028
2,4,8,8,8,6214,7769,-1555
2,4,9,8,8,6248,7827,-1579
2,4,10,8,8,6347,8562,-2215
2,4,11,8,8,6401,8938,-2537
2,4,12,8,8,6518,9603,-3085
2,4,13,8,8,6618,10077,-3459
2,4,14,8,8,6694,10594,-3900
2,4,15,8,8,6867,10986,-4119
2,4,16,8,8,7012,11071,-4059
2,5,0,8,8,7170,9580,-2410
2,5,1,8,8,7194,10119,-2925
2,5,2,8,8,7148,9964,-2816
2,5,3,8,8,7217,10210,-2993
2,5,4,8,8,7332,9709,-2377
2,5,5,8,8,7203,9199,-1996
2,5,6,8,8,7161,8573,-1412
2,5,7,8,8,7011,8377,-1366
2,5,8,8,8,6908,7799,-891
2,5,9,8,8,6956,7732,-776
2,5,10,8,8,7158,8328,-1170
2,5,11,8,8,7240,8513,-1273
2,5,12,8,8,7386,9028,-1642
2,5,13,8,8,7502,9426,-1924
2,5,14,8,8,7599,9756,-2157
2,5,15,8,8,7802,10023,-2221
2,5,16,8,8,7857,10272,-2415
2,6,0,8,8,7734,9034,-1300
2,6,1,8,8,7906,9412,-1506
2,6,2,8,8,7855,9285,-1430
2,6,3,8,8,7973,9472,-1499
2,6,4,8,8,8112,8810,-698
2,6,5,8,8,7966,8403,-437
2,6,6,8,8,7811,7938,-127
2,6,7,8,8,7586,7787,-201
2,6,8,8,8,7380,7256,124
2,6,9,8,8,7442,7087,355
2,6,10,8,8,7771,7595,176
2,6,11,8,8,7951,7697,254
2,6,12,8,8,8175,8132,43
2,6,13,8,8,8307,8476,-169
2,6,14,8,8,8442,8767,-325
2,6,15,8,8,8698,9000,-302
2,6,16,8,8,8688,9390,-702
2,7,0,8,8,8360,8256,104
2,7,1,8,8,8667,8604,63
2,7,2,8,8,8602,8521,81
2,7,3,8,8,8772,8690,82
2,7,4,8,8,8902,7998,904
2,7,5,8,8,8707,7734,973
2,7,6,8,8,8423,7457,966
2,7,7,8,8,8158,7333,825
2,7,8,8,8,7866,6881,985
2,7,9,8,8,7925,6668,1257
2,7,10,8,8,8337,7117,1220
2,7,11,8,8,8618,7066,1552
2,7,12,8,8,8944,7378,1566
2,7,13,8,8,9092,7610,1482
2,7,14,8,8,9272,7789,1483
2,7,15,8,8,9577,7946,1631
2,7,16,8,8,9519,8295,1224
2,8,0,8,8,9081,7422,1659
2,8,1,8,8,9515,7693,1822
2,8,2,8,8,9393,7725,1668
2,8,3,8,8,9567,7884,1683
2,8,4,8,8,9622,7208,2414
2,8,5,8,8,9266,7109,2157
2,8,6,8,8,8783,7015,1768
2,8,7,8,8,8425,7013,1412
2,8,8,8,8,8065,6652,1413
2,8,9,8,8,8137,6403,1734
2,8,10,8,8,8649,6733,1916
2,8,11,8,8,9077,6540,2537
2,8,12,8,8,9554,6733,2821
2,8,13,8,8,9773,6843,2930
2,8,14,8,8,10073,6859,3214
2,8,15,8,8,10465,6898,3567
2,8,16,8,8,10359,7219,3140
2,0,0,9,8,7472,10597,-3125
2,0,1,9,8,7247,11249,-4002
2,0,2,9,8,6976,11122,-4146
2,0,3,9,8,6789,11376,-4587
2,0,4,9,8,6713,11268,-4555
2,0,5,9,8,6623,10613,-3990
2,0,6,9,8,6520,9833,-3313
2,0,7,9,8,6446,9389,-2943
2,0,8,9,8,6407,8847,-2440
2,0,9,9,8,6438,8973,-2535
2,0,10,9,8,6459,9642,-3183
2,0,11,9,8,6573,10108,-3535
2,0,12,9,8,6708,10845,-4137
2,0,13,9,8,6820,11231,-4411
2,0,14,9,8,6995,11688,-4693
2,0,15,9,8,7220,12151,-4931
2,0,16,9,8,7424,12033,-4609
2,1,0,9,8,7123,11191,-4068
2,1,1,9,8,6862,11875,-5013
2,1,2,9,8,6567,11757,-5190
2,1,3,9,8,6334,12050,-5716
2,1,4,9,8,6247,11849,-5602
2,1,5,9,8,6164,11065,-4901
2,1,6,9,8,6042,10208,-4166
2,1,7,9,8,5951,9815,-3864
2,1,8,9,8,5899,9241,-3342
2,1,9,9,8,5931,9327,-3396
2,1,10,9,8,5978,10056,-4078
2,1,11,9,8,6113,10491,-4378
2,1,12,9,8,6253,11258,-5005
2,1,13,9,8,6381,11725,-5344
2,1,14,9,8,6588,12239,-5651
2,1,15,9,8,6857,12631,-5774
2,1,16,9,8,7114,12502,-5388
2,2,0,9,8,7094,11360,-4266
2,2,1,9,8,6869,12003,-5134
2,2,2,9,8,6663,11834,-5171
2,2,3,9,8,6505,12109,-5604
2,2,4,9,8,6464,11762,-5298
2,2,5,9,8,6367,11029,-4662
2,2,6,9,8,6263,10235,-3972
2,2,7,9,8,6170,9879,-3709
2,2,8,9,8,6090,9299,-3209
2,2,9,9,8,6118,9383,-3265
2,2,10,9,8,6185,10176,-3991
2,2,11,9,8,6300,10542,-4242
2,2,12,9,8,6442,11240,-4798
2,2,13,9,8,6562,11736,-5174
2,2,14,9,8,6712,12222,-5510
2,2,15,9,8,6947,12603,-5656
2,2,16,9,8,7186,12633,-5447
2,3,0,9,8,7543,10983,-3440
2,3,1,9,8,7386,11603,-4217
2,3,2,9,8,7260,11412,-4152
2,3,3,9,8,7209,11668,-4459
2,3,4,9,8,7223,11156,-3933
2,3,5,9,8,7068,10540,-3472
2,3,6,9,8,6989,9824,-2835
2,3,7,9,8,6855,9518,-2663
2,3,8,9,8,6741,8875,-2134
2,3,9,9,8,6793,8827,-2034
2,3,10,9,8,6922,9550,-2628
2,3,11,9,8,7027,9821,-2794
2,3,12,9,8,7202,10443,-3241
2,3,13,9,8,7347,10928,-3581
2,3,14,9,8,7464,11344,-3880
2,3,15,9,8,7683,11707,-4024
2,3,16,9,8,7872,11928,-4056
2,4,0,9,8,8048,10415,-2367
2,4,1,9,8,8012,10896,-2884
2,4,2,9,8,7898,10710,-2812
2,4,3,9,8,7901,10893,-2992
2,4,4,9,8,7946,10201,-2255
2,4,5,9,8,7735,9717,-1982
2,4,6,9,8,7618,9095,-1477
2,4,7,9,8,7421,8865,-1444
2,4,8,9,8,7290,8258,-968
2,4,9,9,8,7343,8089,-746
2,4,10,9,8,7569,8714,-1145
2,4,11,9,8,7709,8928,-1219
2,4,12,9,8,7933,9483,-1550
2,4,13,9,8,8120,9894,-1774
2,4,14,9,8,8282,10277,-1995
2,4,15,9,8,8551,10616,-2065
2,4,16,9,8,8668,10983,-2315
2,5,0,9,8,8551,9618,-1067
2,5,1,9,8,8678,10050,-1372
2,5,2,9,8,8573,9898,-1325
2,5,3,9,8,8638,10079,-1441
2,5,4,9,8,8723,9358,-635
2,5,5,9,8,8517,9027,-510
2,5,6,9,8,8318,8608,-290
2,5,7,9,8,8089,8445,-356
2,5,8,9,8,7910,7917,-7
2,5,9,9,8,7958,7709,249
2,5,10,9,8,8277,8238,39
2,5,11,9,8,8471,8290,181
2,5,12,9,8,8737,8722,15
2,5,13,9,8,8920,8998,-78
2,5,14,9,8,9109,9260,-151
2,5,15,9,8,9418,9514,-96
2,5,16,9,8,9450,9862,-412
2,6,0,9,8,9096,8821,275
2,6,1,9,8,9352,9184,168
2,6,2,9,8,9232,9130,102
2,6,3,9,8,9362,9300,62
2,6,4,9,8,9472,8599,873
2,6,5,9,8,9259,8398,861
2,6,6,9,8,8962,8146,816
2,6,7,9,8,8698,8066,632
2,6,8,9,8,8416,7628,788
2,6,9,9,8,8483,7396,1087
2,6,10,9,8,8892,7814,1078
2,6,11,9,8,9175,7750,1425
2,6,12,9,8,9519,8072,1447
2,6,13,9,8,9695,8226,1469
2,6,14,9,8,9913,8348,1565
2,6,15,9,8,10266,8487,1779
2,6,16,9,8,10255,8789,1466
2,0,0,10,8,7966,12190,-4224
2,0,1,10,8,7699,12871,-5172
2,0,2,10,8,7400,12786,-5386
2,0,3,10,8,7173,13133,-5960
2,0,4,10,8,7090,12829,-5739
2,0,5,10,8,6998,12073,-5075
2,0,6,10,8,6868,11293,-4425
2,0,7,10,8,6777,10938,-4161
2,0,8,10,8,6724,10330,-3606
2,0,9,10,8,6750,10417,-3667
2,0,10,10,8,6796,11231,-4435
2,0,11,10,8,6939,11577,-4638
2,0,12,10,8,7085,12276,-5191
2,0,13,10,8,7209,12762,-5553
2,0,14,10,8,7416,13198,-5782
2,0,15,10,8,7690,13554,-5864
2,0,16,10,8,7944,13561,-5617
2,1,0,10,8,7953,12316,-4363
2,1,1,10,8,7730,13013,-5283
2,1,2,10,8,7519,12900,-5381
2,1,3,10,8,7358,13260,-5902
2,1,4,10,8,7314,12803,-5489
2,1,5,10,8,7208,12125,-4917
2,1,6,10,8,7100,11434,-4334
2,1,7,10,8,7010,11089,-4079
2,1,8,10,8,6930,10405,-3475
2,1,9,10,8,6965,10383,-3418
2,1,10,10,8,7033,11164,-4131
2,1,11,10,8,7148,11425,-4277
2,1,12,10,8,7289,12080,-4791
2,1,13,10,8,7407,12587,-5180
2,1,14,10,8,7564,12972,-5408
2,1,15,10,8,7808,13324,-5516
2,1,16,10,8,8042,13490,-5448
2,2,0,10,8,8427,11818,-3391
2,2,1,10,8,8279,12380,-4101
2,2,2,10,8,8151,12158,-4007
2,2,3,10,8,8097,12351,-4254
2,2,4,10,8,8111,11648,-3537
2,2,5,10,8,7952,11058,-3106
2,2,6,10,8,7873,10346,-2473
2,2,7,10,8,7741,10006,-2265
2,2,8,10,8,7620,9334,-1714
2,2,9,10,8,7674,9184,-1510
2,2,10,10,8,7799,9936,-2137
2,2,11,10,8,7904,10236,-2332
2,2,12,10,8,8079,10898,-2819
2,2,13,10,8,8221,11396,-3175
2,2,14,10,8,8340,11865,-3525
2,2,15,10,8,8564,12300,-3736
2,2,16,10,8,8748,12639,-3891
2,3,0,10,8,8946,10999,-2053
2,3,1,10,8,8870,11534,-2664
2,3,2,10,8,8708,11323,-2615
2,3,3,10,8,8667,11500,-2833
2,3,4,10,8,8670,10749,-2079
2,3,5,10,8,8409,10341,-1932
2,3,6,10,8,8240,9765,-1525
2,3,7,10,8,7996,9523,-1527
2,3,8,10,8,7817,8919,-1102
2,3,9,10,8,7888,8711,-823
2,3,10,10,8,8144,9357,-1213
2,3,11,10,8,8335,9521,-1186
2,3,12,10,8,8617,10073,-1456
2,3,13,10,8,8849,10416,-1567
2,3,14,10,8,9052,10770,-1718
2,3,15,10,8,9367,11130,-1763
2,3,16,10,8,9528,11455,-1927
2,4,0,10,8,9429,10183,-754
2,4,1,10,8,9496,10630,-1134
2,4,2,10,8,9323,10507,-1184
2,4,3,10,8,9322,10689,-1367
2,4,4,10,8,9337,9959,-622
2,4,5,10,8,9049,9691,-642
2,4,6,10,8,8775,9297,-522
2,4,7,10,8,8499,9178,-679
2,4,8,10,8,8292,8664,-372
2,4,9,10,8,8345,8437,-92
2,4,10,10,8,8688,8935,-247
2,4,11,10,8,8940,8974,-34
2,4,12,10,8,9284,9416,-132
2,4,13,10,8,9538,9614,-76
2,4,14,10,8,9792,9819,-27
2,4,15,10,8,10167,10055,112
2,4,16,10,8,10261,10356,-95
2,0,0,11,8,8796,13151,-4355
2,0,1,11,8,8567,13790,-5223
2,0,2,11,8,8352,13646,-5294
2,0,3,11,8,8197,13943,-5746
2,0,4,11,8,8157,13295,-5138
2,0,5,11,8,8042,12643,-4601
2,0,6,11,8,7926,11956,-4030
2,0,7,11,8,7836,11577,-3741
2,0,8,11,8,7755,10864,-3109
2,0,9,11,8,7784,10740,-2956
2,0,10,11,8,7851,11550,-3699
2,0,11,11,8,7974,11840,-3866
2,0,12,11,8,8121,12535,-4414
2,0,13,11,8,8235,13055,-4820
2,0,14,11,8,8392,13493,-5101
2,0,15,11,8,8641,13917,-5276
2,0,16,11,8,8872,14201,-5329
2,1,0,11,8,9286,12402,-3116
2,1,1,11,8,9140,13018,-3878
2,1,2,11,8,9007,12771,-3764
2,1,3,11,8,8950,12958,-4008
2,1,4,11,8,8961,12196,-3235
2,1,5,11,8,8793,11682,-2889
2,1,6,11,8,8710,11016,-2306
2,1,7,11,8,8581,10664,-2083
2,1,8,11,8,8460,9995,-1535
2,1,9,11,8,8521,9806,-1285
2,1,10,11,8,8647,10579,-1932
2,1,11,11,8,8752,10829,-2077
2,1,12,11,8,8926,11488,-2562
2,1,13,11,8,9066,11918,-2852
2,1,14,11,8,9192,12358,-3166
2,1,15,11,8,9425,12814,-3389
2,1,16,11,8,9604,13111,-3507
2,2,0,11,8,9830,11564,-1734
2,2,1,11,8,9763,12114,-2351
2,2,2,11,8,9599,11932,-2333
2,2,3,11,8,9555,12110,-2555
2,2,4,11,8,9558,11350,-1792
2,2,5,11,8,9293,11005,-1712
2,2,6,11,8,9124,10454,-1330
2,2,7,11,8,8882,10256,-1374
2,2,8,11,8,8696,9666,-970
2,2,9,11,8,8769,9439,-670
2,2,10,11,8,9021,10054,-1033
2,2,11,11,8,9212,10205,-993
2,2,12,11,8,9494,10767,-1273
2,2,13,11,8,9723,11032,-1309
2,2,14,11,8,9928,11329,-1401
2,2,15,11,8,10248,11671,-1423
2,2,16,11,8,10404,11949,-1545
2,0,0,12,8,10129,12967,-2838
2,0,1,12,8,9977,13598,-3621
2,0,2,12,8,9840,13380,-3540
2,0,3,12,8,9789,13568,-3779
2,0,4,12,8,9804,12797,-2993
2,0,5,12,8,9627,12346,-2719
2,0,6,12,8,9536,11705,-2169
2,0,7,12,8,9407,11397,-1990
2,0,8,12,8,9285,10742,-1457
2,0,9,12,8,9340,10534,-1194
2,0,10,12,8,9465,11276,-1811
2,0,11,12,8,9578,11513,-1935
2,0,12,12,8,9758,12182,-2424
2,0,13,12,8,9894,12534,-2640
2,0,14,12,8,10020,12917,-2897
2,0,15,12,8,10258,13355,-3097
2,0,16,12,8,10434,13605,-3171
2,0,0,1,9,947,967,-20
2,0,1,1,9,940,967,-27
2,0,2,1,9,935,960,-25
2,0,3,1,9,941,956,-15
2,0,4,1,9,945,953,-8
2,0,5,1,9,937,945,-8
2,0,6,1,9,930,942,-12
2,0,7,1,9,931,947,-16
2,0,8,1,9,923,955,-32
2,0,9,1,9,921,954,-33
2,0,10,1,9,928,952,-24
2,0,11,1,9,934,950,-16
2,0,12,1,9,930,948,-18
2,0,13,1,9,931,956,-25
2,0,14,1,9,937,966,-29
2,0,15,1,9,935,963,-28
2,1,0,1,9,967,999,-32
2,1,1,1,9,967,1006,-39
2,1,2,1,9,960,1000,-40
2,1,3,1,9,956,995,-39
2,1,4,1,9,953,994,-41
2,1,5,1,9,945,992,-47
2,1,6,1,9,942,994,-52
2,1,7,1,9,947,997,-50
2,1,8,1,9,955,996,-41
2,1,9,1,9,954,990,-36
2,1,10,1,9,952,986,-34
2,1,11,1,9,950,984,-34
2,1,12,1,9,948,980,-32
2,1,13,1,9,956,984,-28
2,1,14,1,9,966,991,-25
2,1,15,1,9,963,987,-24
2,2,0,1,9,999,970,29
2,2,1,1,9,1006,927,79
2,2,2,1,9,1000,876,124
2,2,3,1,9,995,829,166
2,2,4,1,9,994,786,208
2,2,5,1,9,992,737,255
2,2,6,1,9,994,687,307
2,2,7,1,9,997,642,355
2,2,8,1,9,996,617,379
2,2,9,1,9,990,644,346
2,2,10,1,9,986,692,294
2,2,11,1,9,984,747,237
2,2,12,1,9,980,791,189
2,2,13,1,9,984,833,151
2,2,14,1,9,991,881,110
2,2,15,1,9,987,927,60
2,3,0,1,9,970,932,38
2,3,1,1,9,927,869,58
2,3,2,1,9,876,798,78
2,3,3,1,9,829,729,100
2,3,4,1,9,786,658,128
2,3,5,1,9,737,577,160
2,3,6,1,9,687,504,183
2,3,7,1,9,642,458,184
2,3,8,1,9,617,441,176
2,3,9,1,9,644,462,182
2,3,10,1,9,692,517,175
2,3,11,1,9,747,592,155
2,3,12,1,9,791,662,129
2,3,13,1,9,833,728,105
2,3,14,1,9,881,796,85
2,3,15,1,9,927,859,68
2,4,0,1,9,932,886,46
2,4,1,1,9,869,840,29
2,4,2,1,9,798,785,13
2,4,3,1,9,729,730,-1
2,4,4,1,9,658,676,-18
2,4,5,1,9,577,616,-39
2,4,6,1,9,504,572,-68
2,4,7,1,9,458,569,-111
2,4,8,1,9,441,585,-144
2,4,9,1,9,462,574,-112
2,4,10,1,9,517,587,-70
2,4,11,1,9,592,627,-35
2,4,12,1,9,662,678,-16
2,4,13,1,9,728,732,-4
2,4,14,1,9,796,785,11
2,4,15,1,9,859,828,31
2,5,0,1,9,886,805,81
2,5,1,1,9,840,754,86
2,5,2,1,9,785,699,86
2,5,3,1,9,730,659,71
2,5,4,1,9,676,639,37
2,5,5,1,9,616,621,-5
2,5,6,1,9,572,607,-35
2,5,7,1,9,569,608,-39
2,5,8,1,9,585,627,-42
2,5,9,1,9,574,624,-50
2,5,10,1,9,587,626,-39
2,5,11,1,9,627,644,-17
2,5,12,1,9,678,672,6
2,5,13,1,9,732,710,22
2,5,14,1,9,785,757,28
2,5,15,1,9,828,804,24
2,6,0,1,9,805,773,32
2,6,1,1,9,754,739,15
2,6,2,1,9,699,711,-12
2,6,3,1,9,659,720,-61
2,6,4,1,9,639,770,-131
2,6,5,1,9,621,828,-207
2,6,6,1,9,607,868,-261
2,6,7,1,9,608,882,-274
2,6,8,1,9,627,876,-249
2,6,9,1,9,624,865,-241
2,6,10,1,9,626,848,-222
2,6,11,1,9,644,828,-184
2,6,12,1,9,672,801,-129
2,6,13,1,9,710,786,-76
2,6,14,1,9,757,798,-41
2,6,15,1,9,804,826,-22
2,7,0,1,9,773,1006,-233
2,7,1,1,9,739,1015,-276
2,7,2,1,9,711,1004,-293
2,7,3,1,9,720,1020,-300
2,7,4,1,9,770,1088,-318
2,7,5,1,9,828,1171,-343
2,7,6,1,9,868,1215,-347
2,7,7,1,9,882,1218,-336
2,7,8,1,9,876,1231,-355
2,7,9,1,9,865,1235,-370
2,7,10,1,9,848,1229,-381
2,7,11,1,9,828,1192,-364
2,7,12,1,9,801,1154,-353
2,7,13,1,9,786,1136,-350
2,7,14,1,9,798,1108,-310
2,7,15,1,9,826,1101,-275
2,8,0,1,9,1006,558,448
2,8,1,1,9,1015,493,522
2,8,2,1,9,1004,453,551
2,8,3,1,9,1020,420,600
2,8,4,1,9,1088,416,672
2,8,5,1,9,1171,403,768
2,8,6,1,9,1215,375,840
2,8,7,1,9,1218,384,834
2,8,8,1,9,1231,376,855
2,8,9,1,9,1235,378,857
2,8,10,1,9,1229,395,834
2,8,11,1,9,1192,413,779
2,8,12,1,9,1154,428,726
2,8,13,1,9,1136,449,687
2,8,14,1,9,1108,497,611
2,8,15,1,9,1101,573,528
2,9,0,1,9,558,972,-414
2,9,1,1,9,493,996,-503
2,9,2,1,9,453,1084,-631
2,9,3,1,9,420,1143,-723
2,9,4,1,9,416,1192,-776
2,9,5,1,9,403,1176,-773
2,9,6,1,9,375,1182,-807
2,9,7,1,9,384,1188,-804
2,9,8,1,9,376,1176,-800
2,9,9,1,9,378,1183,-805
2,9,10,1,9,395,1167,-772
2,9,11,1,9,413,1155,-742
2,9,12,1,9,428,1151,-723
2,9,13,1,9,449,1108,-659
2,9,14,1,9,497,1075,-578
2,9,15,1,9,573,1057,-484
2,10,0,1,9,972,1549,-577
2,10,1,1,9,996,1588,-592
2,10,2,1,9,1084,1682,-598
2,10,3,1,9,1143,1770,-627
2,10,4,1,9,1192,1838,-646
2,10,5,1,9,1176,1785,-609
2,10,6,1,9,1182,1794,-612
2,10,7,1,9,1188,1760,-572
2,10,8,1,9,1176,1772,-596
2,10,9,1,9,1183,1792,-609
2,10,10,1,9,1167,1798,-631
2,10,11,1,9,1155,1815,-660
2,10,12,1,9,1151,1850,-699
2,10,13,1,9,1108,1828,-720
2,10,14,1,9,1075,1801,-726
2,10,15,1,9,1057,1751,-694
2,11,0,1,9,1549,1635,-86
2,11,1,1,9,1588,1595,-7
2,11,2,1,9,1682,1562,120
2,11,3,1,9,1770,1573,197
2,11,4,1,9,1838,1578,260
2,11,5,1,9,1785,1452,333
2,11,6,1,9,1794,1354,440
2,11,7,1,9,1760,1300,460
2,11,8,1,9,1772,1327,445
2,11,9,1,9,1792,1333,459
2,11,10,1,9,1798,1422,376
2,11,11,1,9,1815,1530,285
2,11,12,1,9,1850,1633,217
2,11,13,1,9,1828,1699,129
2,11,14,1,9,1801,1787,14
2,11,15,1,9,1751,1815,-64
2,12,0,1,9,1635,1630,5
2,12,1,1,9,1595,1584,11
2,12,2,1,9,1562,1531,31
2,12,3,1,9,1573,1514,59
2,12,4,1,9,1578,1501,77
2,12,5,1,9,1452,1410,42
2,12,6,1,9,1354,1248,106
2,12,7,1,9,1300,1235,65
2,12,8,1,9,1327,1251,76
2,12,9,1,9,1333,1219,114
2,12,10,1,9,1422,1337,85
2,12,11,1,9,1530,1444,86
2,12,12,1,9,1633,1528,105
2,12,13,1,9,1699,1606,93
2,12,14,1,9,1787,1707,80
2,12,15,1,9,1815,1750,65
2,13,0,1,9,1630,1598,32
2,13,1,1,9,1584,1546,38
2,13,2,1,9,1531,1504,27
2,13,3,1,9,1514,1482,32
2,13,4,1,9,1501,1469,32
2,13,5,1,9,1410,1405,5
2,13,6,1,9,1248,1255,-7
2,13,7,1,9,1235,1267,-32
2,13,8,1,9,1251,1277,-26
2,13,9,1,9,1219,1221,-2
2,13,10,1,9,1337,1351,-14
2,13,11,1,9,1444,1437,7
2,13,12,1,9,1528,1497,31
2,13,13,1,9,1606,1583,23
2,13,14,1,9,1707,1672,35
2,13,15,1,9,1750,1722,28
2,14,0,1,9,1598,1637,-39
2,14,1,1,9,1546,1574,-28
2,14,2,1,9,1504,1523,-19
2,14,3,1,9,1482,1510,-28
2,14,4,1,9,1469,1496,-27
2,14,5,1,9,1405,1381,24
2,14,6,1,9,1255,1217,38
2,14,7,1,9,1267,1213,54
2,14,8,1,9,1277,1231,46
2,14,9,1,9,1221,1164,57
2,14,10,1,9,1351,1328,23
2,14,11,1,9,1437,1433,4
2,14,12,1,9,1497,1488,9
2,14,13,1,9,1583,1581,2
2,14,14,1,9,1672,1675,-3
2,14,15,1,9,1722,1730,-8
2,15,0,1,9,1637,1501,136
2,15,1,1,9,1574,1500,74
2,15,2,1,9,1523,1503,20
2,15,3,1,9,1510,1522,-12
2,15,4,1,9,1496,1530,-34
2,15,5,1,9,1381,1423,-42
2,15,6,1,9,1217,1272,-55
2,15,7,1,9,1213,1316,-103
2,15,8,1,9,1231,1322,-91
2,15,9,1,9,1164,1253,-89
2,15,10,1,9,1328,1335,-7
2,15,11,1,9,1433,1435,-2
2,15,12,1,9,1488,1497,-9
2,15,13,1,9,1581,1538,43
2,15,14,1,9,1675,1543,132
2,15,15,1,9,1730,1585,145
2,16,0,1,9,1501,1329,172
2,16,1,1,9,1500,1292,208
2,16,2,1,9,1503,1327,176
2,16,3,1,9,1522,1331,191
2,16,4,1,9,1530,1268,262
2,16,5,1,9,1423,1144,279
2,16,6,1,9,1272,1014,258
2,16,7,1,9,1316,1042,274
2,16,8,1,9,1322,1053,269
2,16,9,1,9,1253,1018,235
2,16,10,1,9,1335,1022,313
2,16,11,1,9,1435,1072,363
2,16,12,1,9,1497,1179,318
2,16,13,1,9,1538,1262,276
2,16,14,1,9,1543,1272,271
2,16,15,1,9,1585,1366,219
2,17,0,1,9,1329,1200,129
2,17,1,1,9,1292,1151,141
2,17,2,1,9,1327,1134,193
2,17,3,1,9,1331,1142,189
2,17,4,1,9,1268,1065,203
2,17,5,1,9,1144,902,242
2,17,6,1,9,1014,826,188
2,17,7,1,9,1042,839,203
2,17,8,1,9,1053,778,275
2,17,9,1,9,1018,824,194
2,17,10,1,9,1022,824,198
2,17,11,1,9,1072,874,198
2,17,12,1,9,1179,990,189
2,17,13,1,9,1262,1047,215
2,17,14,1,9,1272,1053,219
2,17,15,1,9,1366,1071,295
2,18,0,1,9,1200,1186,14
2,18,1,1,9,1151,1119,32
2,18,2,1,9,1134,1187,-53
2,18,3,1,9,1142,1214,-72
2,18,4,1,9,1065,1138,-73
2,18,5,1,9,902,1165,-263
2,18,6,1,9,826,1195,-369
2,18,7,1,9,839,1188,-349
2,18,8,1,9,778,1277,-499
2,18,9,1,9,824,1298,-474
2,18,10,1,9,824,1244,-420
2,18,11,1,9,874,1149,-275
2,18,12,1,9,990,1195,-205
2,18,13,1,9,1047,1116,-69
2,18,14,1,9,1053,1033,20
2,18,15,1,9,1071,1124,-53
2,19,0,1,9,1186,1200,-14
2,19,1,1,9,1119,1142,-23
2,19,2,1,9,1187,1219,-32
2,19,3,1,9,1214,1271,-57
2,19,4,1,9,1138,1193,-55
2,19,5,1,9,1165,1242,-77
2,19,6,1,9,1195,1283,-88
2,19,7,1,9,1188,1285,-97
2,19,8,1,9,1277,1244,33
2,19,9,1,9,1298,1120,178
2,19,10,1,9,1244,1036,208
2,19,11,1,9,1149,960,189
2,19,12,1,9,1195,1003,192
2,19,13,1,9,1116,896,220
2,19,14,1,9,1033,805,228
2,19,15,1,9,1124,932,192
2,20,0,1,9,1200,980,220
2,20,1,1,9,1142,818,324
2,20,2,1,9,1219,772,447
2,20,3,1,9,1271,727,544
2,20,4,1,9,1193,580,613
2,20,5,1,9,1242,554,688
2,20,6,1,9,1283,546,737
2,20,7,1,9,1285,543,742
2,20,8,1,9,1244,502,742
2,20,9,1,9,1120,427,693
2,20,10,1,9,1036,441,595
2,20,11,1,9,960,499,461
2,20,12,1,9,1003,556,447
2,20,13,1,9,896,557,339
2,20,14,1,9,805,617,188
2,20,15,1,9,932,766,166
2,21,0,1,9,980,735,245
2,21,1,1,9,818,687,131
2,21,2,1,9,772,683,89
2,21,3,1,9,727,668,59
2,21,4,1,9,580,664,-84
2,21,5,1,9,554,707,-153
2,21,6,1,9,546,703,-157
2,21,7,1,9,543,756,-213
2,21,8,1,9,502,773,-271
2,21,9,1,9,427,692,-265
2,21,10,1,9,441,663,-222
2,21,11,1,9,499,651,-152
2,21,12,1,9,556,638,-82
2,21,13,1,9,557,576,-19
2,21,14,1,9,617,547,70
2,21,15,1,9,766,570,196
2,22,0,1,9,735,691,44
2,22,1,1,9,687,678,9
2,22,2,1,9,683,664,19
2,22,3,1,9,668,670,-2
2,22,4,1,9,664,733,-69
2,22,5,1,9,707,754,-47
2,22,6,1,9,703,781,-78
2,22,7,1,9,756,827,-71
2,22,8,1,9,773,854,-81
2,22,9,1,9,692,795,-103
2,22,10,1,9,663,739,-76
2,22,11,1,9,651,754,-103
2,22,12,1,9,638,748,-110
2,22,13,1,9,576,649,-73
2,22,14,1,9,547,633,-86
2,22,15,1,9,570,588,-18
2,0,0,2,9,1914,1969,-55
2,0,1,2,9,1907,1933,-26
2,0,2,2,9,1895,1876,19
2,0,3,2,9,1897,1824,73
2,0,4,2,9,1898,1780,118
2,0,5,2,9,1882,1729,153
2,0,6,2,9,1872,1681,191
2,0,7,2,9,1878,1639,239
2,0,8,2,9,1878,1613,265
2,0,9,2,9,1875,1634,241
2,0,10,2,9,1880,1678,202
2,0,11,2,9,1884,1731,153
2,0,12,2,9,1878,1771,107
2,0,13,2,9,1887,1817,70
2,0,14,2,9,1903,1872,31
2,0,15,2,9,1898,1914,-16
2,1,0,2,9,1966,1902,64
2,1,1,2,9,1973,1796,177
2,1,2,2,9,1960,1674,286
2,1,3,2,9,1951,1558,393
2,1,4,2,9,1947,1444,503
2,1,5,2,9,1937,1314,623
2,1,6,2,9,1936,1191,745
2,1,7,2,9,1944,1100,844
2,1,8,2,9,1951,1058,893
2,1,9,2,9,1944,1106,838
2,1,10,2,9,1938,1209,729
2,1,11,2,9,1934,1339,595
2,1,12,2,9,1928,1453,475
2,1,13,2,9,1940,1561,379
2,1,14,2,9,1957,1677,280
2,1,15,2,9,1950,1786,164
2,2,0,2,9,1969,1818,151
2,2,1,2,9,1933,1709,224
2,2,2,2,9,1876,1583,293
2,2,3,2,9,1824,1459,365
2,2,4,2,9,1780,1334,446
2,2,5,2,9,1729,1193,536
2,2,6,2,9,1681,1076,605
2,2,7,2,9,1639,1027,612
2,2,8,2,9,1613,1026,587
2,2,9,2,9,1634,1036,598
2,2,10,2,9,1678,1104,574
2,2,11,2,9,1731,1219,512
2,2,12,2,9,1771,1340,431
2,2,13,2,9,1817,1460,357
2,2,14,2,9,1872,1581,291
2,2,15,2,9,1914,1687,227
2,3,0,2,9,1902,1691,211
2,3,1,2,9,1796,1594,202
2,3,2,2,9,1674,1484,190
2,3,3,2,9,1558,1389,169
2,3,4,2,9,1444,1315,129
2,3,5,2,9,1314,1237,77
2,3,6,2,9,1191,1179,12
2,3,7,2,9,1100,1177,-77
2,3,8,2,9,1058,1212,-154
2,3,9,2,9,1106,1198,-92
2,3,10,2,9,1209,1213,-4
2,3,11,2,9,1339,1271,68
2,3,12,2,9,1453,1350,103
2,3,13,2,9,1561,1442,119
2,3,14,2,9,1677,1542,135
2,3,15,2,9,1786,1632,154
2,4,0,2,9,1818,1578,240
2,4,1,2,9,1709,1493,216
2,4,2,2,9,1583,1410,173
2,4,3,2,9,1459,1379,80
2,4,4,2,9,1334,1409,-75
2,4,5,2,9,1193,1449,-256
2,4,6,2,9,1076,1475,-399
2,4,7,2,9,1027,1490,-463
2,4,8,2,9,1026,1503,-477
2,4,9,2,9,1036,1489,-453
2,4,10,2,9,1104,1474,-370
2,4,11,2,9,1219,1472,-253
2,4,12,2,9,1340,1473,-133
2,4,13,2,9,1460,1496,-36
2,4,14,2,9,1581,1555,26
2,4,15,2,9,1687,1630,57
2,5,0,2,9,1691,1779,-88
2,5,1,2,9,1594,1754,-160
2,5,2,2,9,1484,1715,-231
2,5,3,2,9,1389,1740,-351
2,5,4,2,9,1315,1858,-543
2,5,5,2,9,1237,1999,-762
2,5,6,2,9,1179,2083,-904
2,5,7,2,9,1177,2100,-923
2,5,8,2,9,1212,2107,-895
2,5,9,2,9,1198,2100,-902
2,5,10,2,9,1213,2077,-864
2,5,11,2,9,1271,2020,-749
2,5,12,2,9,1350,1955,-605
2,5,13,2,9,1442,1922,-480
2,5,14,2,9,1542,1906,-364
2,5,15,2,9,1632,1927,-295
2,6,0,2,9,1578,1564,14
2,6,1,2,9,1493,1508,-15
2,6,2,2,9,1410,1457,-47
2,6,3,2,9,1379,1440,-61
2,6,4,2,9,1409,1504,-95
2,6,5,2,9,1449,1574,-125
2,6,6,2,9,1475,1590,-115
2,6,7,2,9,1490,1602,-112
2,6,8,2,9,1503,1607,-104
2,6,9,2,9,1489,1613,-124
2,6,10,2,9,1474,1624,-150
2,6,11,2,9,1472,1605,-133
2,6,12,2,9,1473,1582,-109
2,6,13,2,9,1496,1585,-89
2,6,14,2,9,1555,1605,-50
2,6,15,2,9,1630,1674,-44
2,7,0,2,9,1779,1530,249
2,7,1,2,9,1754,1489,265
2,7,2,2,9,1715,1537,178
2,7,3,2,9,1740,1563,177
2,7,4,2,9,1858,1608,250
2,7,5,2,9,1999,1579,420
2,7,6,2,9,2083,1557,526
2,7,7,2,9,2100,1572,528
2,7,8,2,9,2107,1552,555
2,7,9,2,9,2100,1561,539
2,7,10,2,9,2077,1562,515
2,7,11,2,9,2020,1568,452
2,7,12,2,9,1955,1579,376
2,7,13,2,9,1922,1557,365
2,7,14,2,9,1906,1572,334
2,7,15,2,9,1927,1630,297
2,8,0,2,9,1564,2521,-957
2,8,1,2,9,1508,2584,-1076
2,8,2,2,9,1457,2766,-1309
2,8,3,2,9,1440,2913,-1473
2,8,4,2,9,1504,3030,-1526
2,8,5,2,9,1574,2961,-1387
2,8,6,2,9,1590,2976,-1386
2,8,7,2,9,1602,2948,-1346
2,8,8,2,9,1607,2948,-1341
2,8,9,2,9,1613,2975,-1362
2,8,10,2,9,1624,2965,-1341
2,8,11,2,9,1605,2970,-1365
2,8,12,2,9,1582,3001,-1419
2,8,13,2,9,1585,2936,-1351
2,8,14,2,9,1605,2876,-1271
2,8,15,2,9,1674,2808,-1134
2,9,0,2,9,1530,3184,-1654
2,9,1,2,9,1489,3183,-1694
2,9,2,2,9,1537,3244,-1707
2,9,3,2,9,1563,3343,-1780
2,9,4,2,9,1608,3416,-1808
2,9,5,2,9,1579,3237,-1658
2,9,6,2,9,1557,3148,-1591
2,9,7,2,9,1572,3060,-1488
2,9,8,2,9,1552,3099,-1547
2,9,9,2,9,1561,3125,-1564
2,9,10,2,9,1562,3220,-1658
2,9,11,2,9,1568,3345,-1777
2,9,12,2,9,1579,3483,-1904
2,9,13,2,9,1557,3527,-1970
2,9,14,2,9,1572,3588,-2016
2,9,15,2,9,1630,3566,-1936
2,10,0,2,9,2521,3265,-744
2,10,1,2,9,2584,3179,-595
2,10,2,2,9,2766,3093,-327
2,10,3,2,9,2913,3087,-174
2,10,4,2,9,3030,3079,-49
2,10,5,2,9,2961,2862,99
2,10,6,2,9,2976,2602,374
2,10,7,2,9,2948,2535,413
2,10,8,2,9,2948,2578,370
2,10,9,2,9,2975,2552,423
2,10,10,2,9,2965,2759,206
2,10,11,2,9,2970,2974,-4
2,10,12,2,9,3001,3161,-160
2,10,13,2,9,2936,3305,-369
2,10,14,2,9,2876,3494,-618
2,10,15,2,9,2808,3565,-757
2,11,0,2,9,3184,3228,-44
2,11,1,2,9,3183,3130,53
2,11,2,2,9,3244,3035,209
2,11,3,2,9,3343,2996,347
2,11,4,2,9,3416,2970,446
2,11,5,2,9,3237,2815,422
2,11,6,2,9,3148,2503,645
2,11,7,2,9,3060,2502,558
2,11,8,2,9,3099,2528,571
2,11,9,2,9,3125,2440,685
2,11,10,2,9,3220,2688,532
2,11,11,2,9,3345,2881,464
2,11,12,2,9,3483,3025,458
2,11,13,2,9,3527,3189,338
2,11,14,2,9,3588,3379,209
2,11,15,2,9,3566,3472,94
2,12,0,2,9,3265,3235,30
2,12,1,2,9,3179,3120,59
2,12,2,2,9,3093,3027,66
2,12,3,2,9,3087,2992,95
2,12,4,2,9,3079,2965,114
2,12,5,2,9,2862,2786,76
2,12,6,2,9,2602,2472,130
2,12,7,2,9,2535,2480,55
2,12,8,2,9,2578,2508,70
2,12,9,2,9,2552,2385,167
2,12,10,2,9,2759,2679,80
2,12,11,2,9,2974,2870,104
2,12,12,2,9,3161,2985,176
2,12,13,2,9,3305,3164,141
2,12,14,2,9,3494,3347,147
2,12,15,2,9,3565,3452,113
2,13,0,2,9,3228,3138,90
2,13,1,2,9,3130,3074,56
2,13,2,2,9,3035,3026,9
2,13,3,2,9,2996,3032,-36
2,13,4,2,9,2970,3026,-56
2,13,5,2,9,2815,2804,11
2,13,6,2,9,2503,2489,14
2,13,7,2,9,2502,2529,-27
2,13,8,2,9,2528,2553,-25
2,13,9,2,9,2440,2417,23
2,13,10,2,9,2688,2663,25
2,13,11,2,9,2881,2868,13
2,13,12,2,9,3025,2985,40
2,13,13,2,9,3189,3119,70
2,13,14,2,9,3379,3218,161
2,13,15,2,9,3472,3315,157
2,14,0,2,9,3235,2830,405
2,14,1,2,9,3120,2792,328
2,14,2,2,9,3027,2830,197
2,14,3,2,9,2992,2853,139
2,14,4,2,9,2965,2798,167
2,14,5,2,9,2786,2567,219
2,14,6,2,9,2472,2286,186
2,14,7,2,9,2480,2358,122
2,14,8,2,9,2508,2375,133
2,14,9,2,9,2385,2271,114
2,14,10,2,9,2679,2357,322
2,14,11,2,9,2870,2507,363
2,14,12,2,9,2985,2676,309
2,14,13,2,9,3164,2800,364
2,14,14,2,9,3347,2815,532
2,14,15,2,9,3452,2951,501
2,15,0,2,9,3138,2529,609
2,15,1,2,9,3074,2443,631
2,15,2,2,9,3026,2461,565
2,15,3,2,9,3032,2473,559
2,15,4,2,9,3026,2333,693
2,15,5,2,9,2804,2046,758
2,15,6,2,9,2489,1840,649
2,15,7,2,9,2529,1881,648
2,15,8,2,9,2553,1831,722
2,15,9,2,9,2417,1842,575
2,15,10,2,9,2663,1846,817
2,15,11,2,9,2868,1946,922
2,15,12,2,9,2985,2169,816
2,15,13,2,9,3119,2309,810
2,15,14,2,9,3218,2325,893
2,15,15,2,9,3315,2437,878
2,16,0,2,9,2830,2386,444
2,16,1,2,9,2792,2270,522
2,16,2,2,9,2830,2321,509
2,16,3,2,9,2853,2356,497
2,16,4,2,9,2798,2203,595
2,16,5,2,9,2567,2067,500
2,16,6,2,9,2286,2021,265
2,16,7,2,9,2358,2027,331
2,16,8,2,9,2375,2055,320
2,16,9,2,9,2271,2122,149
2,16,10,2,9,2357,2068,289
2,16,11,2,9,2507,2023,484
2,16,12,2,9,2676,2185,491
2,16,13,2,9,2800,2163,637
2,16,14,2,9,2815,2086,729
2,16,15,2,9,2951,2195,756
2,17,0,2,9,2529,2386,143
2,17,1,2,9,2443,2261,182
2,17,2,2,9,2461,2406,55
2,17,3,2,9,2473,2485,-12
2,17,4,2,9,2333,2331,2
2,17,5,2,9,2046,2407,-361
2,17,6,2,9,1840,2478,-638
2,17,7,2,9,1881,2473,-592
2,17,8,2,9,1831,2521,-690
2,17,9,2,9,1842,2418,-576
2,17,10,2,9,1846,2280,-434
2,17,11,2,9,1946,2109,-163
2,17,12,2,9,2169,2198,-29
2,17,13,2,9,2309,2012,297
2,17,14,2,9,2325,1838,487
2,17,15,2,9,2437,2056,381
2,18,0,2,9,2386,2180,206
2,18,1,2,9,2270,1960,310
2,18,2,2,9,2321,1991,330
2,18,3,2,9,2356,1998,358
2,18,4,2,9,2203,1773,430
2,18,5,2,9,2067,1796,271
2,18,6,2,9,2021,1829,192
2,18,7,2,9,2027,1828,199
2,18,8,2,9,2055,1746,309
2,18,9,2,9,2122,1547,575
2,18,10,2,9,2068,1477,591
2,18,11,2,9,2023,1459,564
2,18,12,2,9,2185,1559,626
2,18,13,2,9,2163,1453,710
2,18,14,2,9,2086,1422,664
2,18,15,2,9,2195,1698,497
2,19,0,2,9,2386,1715,671
2,19,1,2,9,2261,1505,756
2,19,2,2,9,2406,1455,951
2,19,3,2,9,2485,1395,1090
2,19,4,2,9,2331,1244,1087
2,19,5,2,9,2407,1261,1146
2,19,6,2,9,2478,1249,1229
2,19,7,2,9,2473,1299,1174
2,19,8,2,9,2521,1275,1246
2,19,9,2,9,2418,1119,1299
2,19,10,2,9,2280,1104,1176
2,19,11,2,9,2109,1150,959
2,19,12,2,9,2198,1194,1004
2,19,13,2,9,2012,1133,879
2,19,14,2,9,1838,1164,674
2,19,15,2,9,2056,1336,720
2,20,0,2,9,2180,1426,754
2,20,1,2,9,1960,1365,595
2,20,2,2,9,1991,1347,644
2,20,3,2,9,1998,1338,660
2,20,4,2,9,1773,1397,376
2,20,5,2,9,1796,1461,335
2,20,6,2,9,1829,1484,345
2,20,7,2,9,1828,1583,245
2,20,8,2,9,1746,1627,119
2,20,9,2,9,1547,1487,60
2,20,10,2,9,1477,1402,75
2,20,11,2,9,1459,1405,54
2,20,12,2,9,1559,1386,173
2,20,13,2,9,1453,1225,228
2,20,14,2,9,1422,1180,242
2,20,15,2,9,1698,1158,540
2,0,0,3,9,2913,2788,125
2,0,1,3,9,2913,2636,277
2,0,2,3,9,2895,2459,436
2,0,3,3,9,2892,2288,604
2,0,4,3,9,2892,2120,772
2,0,5,3,9,2874,1930,944
2,0,6,3,9,2866,1763,1103
2,0,7,3,9,2875,1669,1206
2,0,8,3,9,2874,1643,1231
2,0,9,3,9,2865,1680,1185
2,0,10,3,9,2866,1796,1070
2,0,11,3,9,2868,1966,902
2,0,12,3,9,2858,2131,727
2,0,13,3,9,2871,2293,578
2,0,14,3,9,2894,2462,432
2,0,15,3,9,2885,2614,271
2,1,0,3,9,2936,2623,313
2,1,1,3,9,2900,2463,437
2,1,2,3,9,2836,2282,554
2,1,3,3,9,2780,2118,662
2,1,4,3,9,2733,1973,760
2,1,5,3,9,2674,1814,860
2,1,6,3,9,2623,1683,940
2,1,7,3,9,2586,1635,951
2,1,8,3,9,2568,1653,915
2,1,9,3,9,2588,1660,928
2,1,10,3,9,2630,1730,900
2,1,11,3,9,2681,1863,818
2,1,12,3,9,2719,2012,707
2,1,13,3,9,2773,2170,603
2,1,14,3,9,2838,2338,500
2,1,15,3,9,2877,2491,386
2,2,0,3,9,2901,2464,437
2,2,1,3,9,2802,2333,469
2,2,2,3,9,2674,2195,479
2,2,3,3,9,2553,2109,444
2,2,4,3,9,2438,2085,353
2,2,5,3,9,2306,2065,241
2,2,6,3,9,2185,2047,138
2,2,7,3,9,2097,2059,38
2,2,8,3,9,2054,2088,-34
2,2,9,3,9,2096,2063,33
2,2,10,3,9,2195,2061,134
2,2,11,3,9,2323,2099,224
2,2,12,3,9,2433,2151,282
2,2,13,3,9,2545,2228,317
2,2,14,3,9,2668,2340,328
2,2,15,3,9,2773,2458,315
2,3,0,3,9,2788,2584,204
2,3,1,3,9,2636,2508,128
2,3,2,3,9,2459,2414,45
2,3,3,3,9,2288,2399,-111
2,3,4,3,9,2120,2497,-377
2,3,5,3,9,1930,2620,-690
2,3,6,3,9,1763,2690,-927
2,3,7,3,9,1669,2708,-1039
2,3,8,3,9,1643,2734,-1091
2,3,9,3,9,1680,2724,-1044
2,3,10,3,9,1796,2703,-907
2,3,11,3,9,1966,2664,-698
2,3,12,3,9,2131,2627,-496
2,3,13,3,9,2293,2632,-339
2,3,14,3,9,2462,2663,-201
2,3,15,3,9,2614,2731,-117
2,4,0,3,9,2623,2337,286
2,4,1,3,9,2463,2247,216
2,4,2,3,9,2282,2168,114
2,4,3,3,9,2118,2160,-42
2,4,4,3,9,1973,2274,-301
2,4,5,3,9,1814,2402,-588
2,4,6,3,9,1683,2458,-775
2,4,7,3,9,1635,2484,-849
2,4,8,3,9,1653,2483,-830
2,4,9,3,9,1660,2478,-818
2,4,10,3,9,1730,2472,-742
2,4,11,3,9,1863,2433,-570
2,4,12,3,9,2012,2383,-371
2,4,13,3,9,2170,2371,-201
2,4,14,3,9,2338,2403,-65
2,4,15,3,9,2491,2500,-9
2,5,0,3,9,2464,2536,-72
2,5,1,3,9,2333,2504,-171
2,5,2,3,9,2195,2541,-346
2,5,3,3,9,2109,2583,-474
2,5,4,3,9,2085,2696,-611
2,5,5,3,9,2065,2750,-685
2,5,6,3,9,2047,2772,-725
2,5,7,3,9,2059,2790,-731
2,5,8,3,9,2088,2783,-695
2,5,9,3,9,2063,2796,-733
2,5,10,3,9,2061,2791,-730
2,5,11,3,9,2099,2760,-661
2,5,12,3,9,2151,2733,-582
2,5,13,3,9,2228,2693,-465
2,5,14,3,9,2340,2680,-340
2,5,15,3,9,2458,2731,-273
2,6,0,3,9,2584,3079,-495
2,6,1,3,9,2508,3077,-569
2,6,2,3,9,2414,3219,-805
2,6,3,3,9,2399,3333,-934
2,6,4,3,9,2497,3446,-949
2,6,5,3,9,2620,3364,-744
2,6,6,3,9,2690,3351,-661
2,6,7,3,9,2708,3332,-624
2,6,8,3,9,2734,3324,-590
2,6,9,3,9,2724,3353,-629
2,6,10,3,9,2703,3360,-657
2,6,11,3,9,2664,3383,-719
2,6,12,3,9,2627,3429,-802
2,6,13,3,9,2632,3385,-753
2,6,14,3,9,2663,3373,-710
2,6,15,3,9,2731,3381,-650
2,7,0,3,9,2337,4156,-1819
2,7,1,3,9,2247,4179,-1932
2,7,2,3,9,2168,4328,-2160
2,7,3,3,9,2160,4486,-2326
2,7,4,3,9,2274,4608,-2334
2,7,5,3,9,2402,4413,-2011
2,7,6,3,9,2458,4330,-1872
2,7,7,3,9,2484,4248,-1764
2,7,8,3,9,2483,4275,-1792
2,7,9,3,9,2478,4308,-1830
2,7,10,3,9,2472,4387,-1915
2,7,11,3,9,2433,4500,-2067
2,7,12,3,9,2383,4634,-2251
2,7,13,3,9,2371,4635,-2264
2,7,14,3,9,2403,4663,-2260
2,7,15,3,9,2500,4623,-2123
2,8,0,3,9,2536,4814,-2278
2,8,1,3,9,2504,4767,-2263
2,8,2,3,9,2541,4775,-2234
2,8,3,3,9,2583,4857,-2274
2,8,4,3,9,2696,4917,-2221
2,8,5,3,9,2750,4647,-1897
2,8,6,3,9,2772,4396,-1624
2,8,7,3,9,2790,4295,-1505
2,8,8,3,9,2783,4350,-1567
2,8,9,3,9,2796,4344,-1548
2,8,10,3,9,2791,4557,-1766
2,8,11,3,9,2760,4789,-2029
2,8,12,3,9,2733,5011,-2278
2,8,13,3,9,2693,5133,-2440
2,8,14,3,9,2680,5295,-2615
2,8,15,3,9,2731,5316,-2585
2,9,0,3,9,3079,4863,-1784
2,9,1,3,9,3077,4725,-1648
2,9,2,3,9,3219,4597,-1378
2,9,3,3,9,3333,4569,-1236
2,9,4,3,9,3446,4548,-1102
2,9,5,3,9,3364,4267,-903
2,9,6,3,9,3351,3857,-506
2,9,7,3,9,3332,3802,-470
2,9,8,3,9,3324,3855,-531
2,9,9,3,9,3353,3773,-420
2,9,10,3,9,3360,4110,-750
2,9,11,3,9,3383,4411,-1028
2,9,12,3,9,3429,4658,-1229
2,9,13,3,9,3385,4888,-1503
2,9,14,3,9,3373,5166,-1793
2,9,15,3,9,3381,5287,-1906
2,10,0,3,9,4156,4865,-709
2,10,1,3,9,4179,4704,-525
2,10,2,3,9,4328,4558,-230
2,10,3,3,9,4486,4506,-20
2,10,4,3,9,4608,4466,142
2,10,5,3,9,4413,4196,217
2,10,6,3,9,4330,3720,610
2,10,7,3,9,4248,3715,533
2,10,8,3,9,4275,3759,516
2,10,9,3,9,4308,3604,704
2,10,10,3,9,4387,4016,371
2,10,11,3,9,4500,4314,186
2,10,12,3,9,4634,4513,121
2,10,13,3,9,4635,4770,-135
2,10,14,3,9,4663,5054,-391
2,10,15,3,9,4623,5202,-579
2,11,0,3,9,4814,4736,78
2,11,1,3,9,4767,4620,147
2,11,2,3,9,4775,4530,245
2,11,3,3,9,4857,4514,343
2,11,4,3,9,4917,4495,422
2,11,5,3,9,4647,4209,438
2,11,6,3,9,4396,3744,652
2,11,7,3,9,4295,3796,499
2,11,8,3,9,4350,3830,520
2,11,9,3,9,4344,3638,706
2,11,10,3,9,4557,4014,543
2,11,11,3,9,4789,4305,484
2,11,12,3,9,5011,4482,529
2,11,13,3,9,5133,4702,431
2,11,14,3,9,5295,4890,405
2,11,15,3,9,5316,5037,279
2,12,0,3,9,4863,4467,396
2,12,1,3,9,4725,4366,359
2,12,2,3,9,4597,4353,244
2,12,3,3,9,4569,4363,206
2,12,4,3,9,4548,4294,254
2,12,5,3,9,4267,3948,319
2,12,6,3,9,3857,3503,354
2,12,7,3,9,3802,3571,231
2,12,8,3,9,3855,3606,249
2,12,9,3,9,3773,3435,338
2,12,10,3,9,4110,3685,425
2,12,11,3,9,4411,3940,471
2,12,12,3,9,4658,4164,494
2,12,13,3,9,4888,4381,507
2,12,14,3,9,5166,4490,676
2,12,15,3,9,5287,4681,606
2,13,0,3,9,4865,4030,835
2,13,1,3,9,4704,3943,761
2,13,2,3,9,4558,3964,594
2,13,3,3,9,4506,3995,511
2,13,4,3,9,4466,3863,603
2,13,5,3,9,4196,3469,727
2,13,6,3,9,3720,3112,608
2,13,7,3,9,3715,3197,518
2,13,8,3,9,3759,3153,606
2,13,9,3,9,3604,3095,509
2,13,10,3,9,4016,3181,835
2,13,11,3,9,4314,3381,933
2,13,12,3,9,4513,3666,847
2,13,13,3,9,4770,3847,923
2,13,14,3,9,5054,3868,1186
2,13,15,3,9,5202,4022,1180
2,14,0,3,9,4736,3715,1021
2,14,1,3,9,4620,3562,1058
2,14,2,3,9,4530,3648,882
2,14,3,3,9,4514,3687,827
2,14,4,3,9,4495,3471,1024
2,14,5,3,9,4209,3211,998
2,14,6,3,9,3744,3035,709
2,14,7,3,9,3796,3069,727
2,14,8,3,9,3830,3108,722
2,14,9,3,9,3638,3140,498
2,14,10,3,9,4014,3090,924
2,14,11,3,9,4305,3095,1210
2,14,12,3,9,4482,3364,1118
2,14,13,3,9,4702,3425,1277
2,14,14,3,9,4890,3358,1532
2,14,15,3,9,5037,3561,1476
2,15,0,3,9,4467,3586,881
2,15,1,3,9,4366,3412,954
2,15,2,3,9,4353,3540,813
2,15,3,3,9,4363,3627,736
2,15,4,3,9,4294,3396,898
2,15,5,3,9,3948,3309,639
2,15,6,3,9,3503,3304,199
2,15,7,3,9,3571,3312,259
2,15,8,3,9,3606,3299,307
2,15,9,3,9,3435,3242,193
2,15,10,3,9,3685,3104,581
2,15,11,3,9,3940,2983,957
2,15,12,3,9,4164,3188,976
2,15,13,3,9,4381,3059,1322
2,15,14,3,9,4490,2891,1599
2,15,15,3,9,4681,3127,1554
2,16,0,3,9,4030,3366,664
2,16,1,3,9,3943,3079,864
2,16,2,3,9,3964,3178,786
2,16,3,3,9,3995,3212,783
2,16,4,3,9,3863,2911,952
2,16,5,3,9,3469,2961,508
2,16,6,3,9,3112,3024,88
2,16,7,3,9,3197,3016,181
2,16,8,3,9,3153,3023,130
2,16,9,3,9,3095,2845,250
2,16,10,3,9,3181,2721,460
2,16,11,3,9,3381,2608,773
2,16,12,3,9,3666,2754,912
2,16,13,3,9,3847,2569,1278
2,16,14,3,9,3868,2455,1413
2,16,15,3,9,4022,2822,1200
2,17,0,3,9,3715,2915,800
2,17,1,3,9,3562,2647,915
2,17,2,3,9,3648,2674,974
2,17,3,3,9,3687,2666,1021
2,17,4,3,9,3471,2437,1034
2,17,5,3,9,3211,2503,708
2,17,6,3,9,3035,2532,503
2,17,7,3,9,3069,2584,485
2,17,8,3,9,3108,2519,589
2,17,9,3,9,3140,2239,901
2,17,10,3,9,3090,2140,950
2,17,11,3,9,3095,2110,985
2,17,12,3,9,3364,2197,1167
2,17,13,3,9,3425,2029,1396
2,17,14,3,9,3358,1969,1389
2,17,15,3,9,3561,2268,1293
2,18,0,3,9,3586,2406,1180
2,18,1,3,9,3412,2183,1229
2,18,2,3,9,3540,2119,1421
2,18,3,3,9,3627,2065,1562
2,18,4,3,9,3396,1977,1419
2,18,5,3,9,3309,2015,1294
2,18,6,3,9,3304,2030,1274
2,18,7,3,9,3312,2126,1186
2,18,8,3,9,3299,2129,1170
2,18,9,3,9,3242,1914,1328
2,18,10,3,9,3104,1843,1261
2,18,11,3,9,2983,1904,1079
2,18,12,3,9,3188,1942,1246
2,18,13,3,9,3059,1782,1277
2,18,14,3,9,2891,1797,1094
2,18,15,3,9,3127,1924,1203
2,0,0,4,9,3883,3396,487
2,0,1,4,9,3840,3202,638
2,0,2,4,9,3771,2993,778
2,0,3,4,9,3721,2838,883
2,0,4,4,9,3678,2743,935
2,0,5,4,9,3611,2642,969
2,0,6,4,9,3553,2551,1002
2,0,7,4,9,3517,2517,1000
2,0,8,4,9,3491,2529,962
2,0,9,4,9,3509,2525,984
2,0,10,4,9,3558,2578,980
2,0,11,4,9,3615,2691,924
2,0,12,4,9,3649,2813,836
2,0,13,4,9,3704,2956,748
2,0,14,4,9,3775,3136,639
2,0,15,4,9,3812,3317,495
2,1,0,4,9,3868,3470,398
2,1,1,4,9,3769,3348,421
2,1,2,4,9,3634,3199,435
2,1,3,4,9,3509,3129,380
2,1,4,4,9,3391,3173,218
2,1,5,4,9,3251,3236,15
2,1,6,4,9,3127,3262,-135
2,1,7,4,9,3044,3277,-233
2,1,8,4,9,3009,3319,-310
2,1,9,4,9,3050,3298,-248
2,1,10,4,9,3147,3290,-143
2,1,11,4,9,3273,3291,-18
2,1,12,4,9,3381,3305,76
2,1,13,4,9,3501,3364,137
2,1,14,4,9,3634,3448,186
2,1,15,4,9,3736,3559,177
2,2,0,4,9,3787,3142,645
2,2,1,4,9,3642,3001,641
2,2,2,4,9,3459,2867,592
2,2,3,4,9,3283,2819,464
2,2,4,4,9,3114,2913,201
2,2,5,4,9,2922,3023,-101
2,2,6,4,9,2757,3065,-308
2,2,7,4,9,2666,3092,-426
2,2,8,4,9,2639,3110,-471
2,2,9,4,9,2670,3102,-432
2,2,10,4,9,2782,3098,-316
2,2,11,4,9,2950,3077,-127
2,2,12,4,9,3111,3055,56
2,2,13,4,9,3277,3081,196
2,2,14,4,9,3453,3160,293
2,2,15,4,9,3601,3304,297
2,3,0,4,9,3593,3309,284
2,3,1,4,9,3390,3243,147
2,3,2,4,9,3158,3252,-94
2,3,3,4,9,2947,3303,-356
2,3,4,4,9,2759,3466,-707
2,3,5,4,9,2551,3578,-1027
2,3,6,4,9,2370,3640,-1270
2,3,7,4,9,2277,3672,-1395
2,3,8,4,9,2270,3659,-1389
2,3,9,4,9,2304,3661,-1357
2,3,10,4,9,2422,3639,-1217
2,3,11,4,9,2610,3588,-978
2,3,12,4,9,2803,3534,-731
2,3,13,4,9,3003,3479,-476
2,3,14,4,9,3219,3478,-259
2,3,15,4,9,3418,3557,-139
2,4,0,4,9,3396,4085,-689
2,4,1,4,9,3202,4092,-890
2,4,2,4,9,2993,4223,-1230
2,4,3,4,9,2838,4353,-1515
2,4,4,4,9,2743,4534,-1791
2,4,5,4,9,2642,4535,-1893
2,4,6,4,9,2551,4566,-2015
2,4,7,4,9,2517,4550,-2033
2,4,8,4,9,2529,4555,-2026
2,4,9,4,9,2525,4588,-2063
2,4,10,4,9,2578,4589,-2011
2,4,11,4,9,2691,4575,-1884
2,4,12,4,9,2813,4583,-1770
2,4,13,4,9,2956,4521,-1565
2,4,14,4,9,3136,4481,-1345
2,4,15,4,9,3317,4482,-1165
2,5,0,4,9,3470,4714,-1244
2,5,1,4,9,3348,4672,-1324
2,5,2,4,9,3199,4781,-1582
2,5,3,4,9,3129,4906,-1777
2,5,4,4,9,3173,5024,-1851
2,5,5,4,9,3236,4816,-1580
2,5,6,4,9,3262,4705,-1443
2,5,7,4,9,3277,4632,-1355
2,5,8,4,9,3319,4651,-1332
2,5,9,4,9,3298,4686,-1388
2,5,10,4,9,3290,4782,-1492
2,5,11,4,9,3291,4913,-1622
2,5,12,4,9,3305,5062,-1757
2,5,13,4,9,3364,5084,-1720
2,5,14,4,9,3448,5160,-1712
2,5,15,4,9,3559,5196,-1637
2,6,0,4,9,3142,5786,-2644
2,6,1,4,9,3001,5763,-2762
2,6,2,4,9,2867,5859,-2992
2,6,3,4,9,2819,6000,-3181
2,6,4,4,9,2913,6109,-3196
2,6,5,4,9,3023,5823,-2800
2,6,6,4,9,3065,5578,-2513
2,6,7,4,9,3092,5483,-2391
2,6,8,4,9,3110,5526,-2416
2,6,9,4,9,3102,5527,-2425
2,6,10,4,9,3098,5724,-2626
2,6,11,4,9,3077,5944,-2867
2,6,12,4,9,3055,6162,-3107
2,6,13,4,9,3081,6241,-3160
2,6,14,4,9,3160,6370,-3210
2,6,15,4,9,3304,6373,-3069
2,7,0,4,9,3309,6412,-3103
2,7,1,4,9,3243,6313,-3070
2,7,2,4,9,3252,6279,-3027
2,7,3,4,9,3303,6339,-3036
2,7,4,4,9,3466,6386,-2920
2,7,5,4,9,3578,6052,-2474
2,7,6,4,9,3640,5651,-2011
2,7,7,4,9,3672,5562,-1890
2,7,8,4,9,3659,5627,-1968
2,7,9,4,9,3661,5565,-1904
2,7,10,4,9,3639,5908,-2269
2,7,11,4,9,3588,6226,-2638
2,7,12,4,9,3534,6508,-2974
2,7,13,4,9,3479,6716,-3237
2,7,14,4,9,3478,6967,-3489
2,7,15,4,9,3557,7038,-3481
2,8,0,4,9,4085,6500,-2415
2,8,1,4,9,4092,6299,-2207
2,8,2,4,9,4223,6120,-1897
2,8,3,4,9,4353,6079,-1726
2,8,4,4,9,4534,6044,-1510
2,8,5,4,9,4535,5648,-1113
2,8,6,4,9,4566,5074,-508
2,8,7,4,9,4550,5015,-465
2,8,8,4,9,4555,5086,-531
2,8,9,4,9,4588,4937,-349
2,8,10,4,9,4589,5438,-849
2,8,11,4,9,4575,5844,-1269
2,8,12,4,9,4583,6146,-1563
2,8,13,4,9,4521,6469,-1948
2,8,14,4,9,4481,6841,-2360
2,8,15,4,9,4482,7017,-2535
2,9,0,4,9,4714,6366,-1652
2,9,1,4,9,4672,6204,-1532
2,9,2,4,9,4781,6061,-1280
2,9,3,4,9,4906,6028,-1122
2,9,4,4,9,5024,5996,-972
2,9,5,4,9,4816,5619,-803
2,9,6,4,9,4705,4992,-287
2,9,7,4,9,4632,5031,-399
2,9,8,4,9,4651,5081,-430
2,9,9,4,9,4686,4857,-171
2,9,10,4,9,4782,5351,-569
2,9,11,4,9,4913,5749,-836
2,9,12,4,9,5062,6010,-948
2,9,13,4,9,5084,6308,-1224
2,9,14,4,9,5160,6597,-1437
2,9,15,4,9,5196,6787,-1591
2,10,0,4,9,5786,6065,-279
2,10,1,4,9,5763,5912,-149
2,10,2,4,9,5859,5857,2
2,10,3,4,9,6000,5845,155
2,10,4,4,9,6109,5763,346
2,10,5,4,9,5823,5353,470
2,10,6,4,9,5578,4758,820
2,10,7,4,9,5483,4838,645
2,10,8,4,9,5526,4883,643
2,10,9,4,9,5527,4656,871
2,10,10,4,9,5724,5036,688
2,10,11,4,9,5944,5377,567
2,10,12,4,9,6162,5661,501
2,10,13,4,9,6241,5964,277
2,10,14,4,9,6370,6162,208
2,10,15,4,9,6373,6403,-30
2,11,0,4,9,6412,5667,745
2,11,1,4,9,6313,5517,796
2,11,2,4,9,6279,5487,792
2,11,3,4,9,6339,5505,834
2,11,4,4,9,6386,5359,1027
2,11,5,4,9,6052,4850,1202
2,11,6,4,9,5651,4329,1322
2,11,7,4,9,5562,4410,1152
2,11,8,4,9,5627,4384,1243
2,11,9,4,9,5565,4259,1306
2,11,10,4,9,5908,4509,1399
2,11,11,4,9,6226,4814,1412
2,11,12,4,9,6508,5154,1354
2,11,13,4,9,6716,5428,1288
2,11,14,4,9,6967,5543,1424
2,11,15,4,9,7038,5752,1286
2,12,0,4,9,6500,5216,1284
2,12,1,4,9,6299,5062,1237
2,12,2,4,9,6120,5151,969
2,12,3,4,9,6079,5209,870
2,12,4,4,9,6044,5001,1043
2,12,5,4,9,5648,4634,1014
2,12,6,4,9,5074,4307,767
2,12,7,4,9,5015,4385,630
2,12,8,4,9,5086,4430,656
2,12,9,4,9,4937,4393,544
2,12,10,4,9,5438,4425,1013
2,12,11,4,9,5844,4530,1314
2,12,12,4,9,6146,4861,1285
2,12,13,4,9,6469,4963,1506
2,12,14,4,9,6841,4901,1940
2,12,15,4,9,7017,5146,1871
2,13,0,4,9,6366,4915,1451
2,13,1,4,9,6204,4704,1500
2,13,2,4,9,6061,4867,1194
2,13,3,4,9,6028,4958,1070
2,13,4,4,9,5996,4664,1332
2,13,5,4,9,5619,4453,1166
2,13,6,4,9,4992,4318,674
2,13,7,4,9,5031,4354,677
2,13,8,4,9,5081,4352,729
2,13,9,4,9,4857,4260,597
2,13,10,4,9,5351,4126,1225
2,13,11,4,9,5749,4055,1694
2,13,12,4,9,6010,4367,1643
2,13,13,4,9,6308,4321,1987
2,13,14,4,9,6597,4163,2434
2,13,15,4,9,6787,4493,2294
2,14,0,4,9,6065,4566,1499
2,14,1,4,9,5912,4230,1682
2,14,2,4,9,5857,4312,1545
2,14,3,4,9,5845,4354,1491
2,14,4,4,9,5763,3976,1787
2,14,5,4,9,5353,3863,1490
2,14,6,4,9,4758,3850,908
2,14,7,4,9,4838,3855,983
2,14,8,4,9,4883,3801,1082
2,14,9,4,9,4656,3669,987
2,14,10,4,9,5036,3545,1491
2,14,11,4,9,5377,3482,1895
2,14,12,4,9,5661,3744,1917
2,14,13,4,9,5964,3616,2348
2,14,14,4,9,6162,3508,2654
2,14,15,4,9,6403,3893,2510
2,15,0,4,9,5667,4101,1566
2,15,1,4,9,5517,3766,1751
2,15,2,4,9,5487,3861,1626
2,15,3,4,9,5505,3880,1625
2,15,4,4,9,5359,3575,1784
2,15,5,4,9,4850,3668,1182
2,15,6,4,9,4329,3727,602
2,15,7,4,9,4410,3772,638
2,15,8,4,9,4384,3796,588
2,15,9,4,9,4259,3537,722
2,15,10,4,9,4509,3384,1125
2,15,11,4,9,4814,3259,1555
2,15,12,4,9,5154,3392,1762
2,15,13,4,9,5428,3145,2283
2,15,14,4,9,5543,3002,2541
2,15,15,4,9,5752,3392,2360
2,16,0,4,9,5216,3606,1610
2,16,1,4,9,5062,3325,1737
2,16,2,4,9,5151,3338,1813
2,16,3,4,9,5209,3336,1873
2,16,4,4,9,5001,3170,1831
2,16,5,4,9,4634,3257,1377
2,16,6,4,9,4307,3313,994
2,16,7,4,9,4385,3411,974
2,16,8,4,9,4430,3373,1057
2,16,9,4,9,4393,3034,1359
2,16,10,4,9,4425,2879,1546
2,16,11,4,9,4530,2864,1666
2,16,12,4,9,4861,2945,1916
2,16,13,4,9,4963,2678,2285
2,16,14,4,9,4901,2602,2299
2,16,15,4,9,5146,2856,2290
2,0,0,5,9,4815,4028,787
2,0,1,5,9,4709,3841,868
2,0,2,5,9,4569,3652,917
2,0,3,5,9,4450,3549,901
2,0,4,5,9,4336,3589,747
2,0,5,5,9,4188,3639,549
2,0,6,5,9,4057,3637,420
2,0,7,5,9,3975,3661,314
2,0,8,5,9,3932,3695,237
2,0,9,5,9,3971,3676,295
2,0,10,5,9,4075,3685,390
2,0,11,5,9,4207,3704,503
2,0,12,5,9,4311,3733,578
2,0,13,5,9,4432,3813,619
2,0,14,5,9,4571,3945,626
2,0,15,5,9,4671,4132,539
2,1,0,5,9,4754,4114,640
2,1,1,5,9,4609,3997,612
2,1,2,5,9,4419,3951,468
2,1,3,5,9,4239,3962,277
2,1,4,5,9,4067,4105,-38
2,1,5,5,9,3867,4199,-332
2,1,6,5,9,3699,4247,-548
2,1,7,5,9,3613,4280,-667
2,1,8,5,9,3594,4286,-692
2,1,9,5,9,3624,4285,-661
2,1,10,5,9,3734,4265,-531
2,1,11,5,9,3900,4232,-332
2,1,12,5,9,4059,4206,-147
2,1,13,5,9,4233,4189,44
2,1,14,5,9,4419,4235,184
2,1,15,5,9,4564,4361,203
2,2,0,5,9,4592,4858,-266
2,2,1,5,9,4396,4831,-435
2,2,2,5,9,4158,4934,-776
2,2,3,5,9,3942,5073,-1131
2,2,4,5,9,3753,5304,-1551
2,2,5,5,9,3543,5363,-1820
2,2,6,5,9,3364,5434,-2070
2,2,7,5,9,3274,5432,-2158
2,2,8,5,9,3266,5431,-2165
2,2,9,5,9,3294,5453,-2159
2,2,10,5,9,3408,5437,-2029
2,2,11,5,9,3594,5403,-1809
2,2,12,5,9,3783,5384,-1601
2,2,13,5,9,3987,5307,-1320
2,2,14,5,9,4210,5279,-1069
2,2,15,5,9,4405,5308,-903
2,3,0,5,9,4366,5720,-1354
2,3,1,5,9,4129,5687,-1558
2,3,2,5,9,3869,5785,-1916
2,3,3,5,9,3667,5926,-2259
2,3,4,5,9,3529,6112,-2583
2,3,5,5,9,3379,5987,-2608
2,3,6,5,9,3238,5920,-2682
2,3,7,5,9,3159,5850,-2691
2,3,8,5,9,3146,5882,-2736
2,3,9,5,9,3169,5921,-2752
2,3,10,5,9,3270,6011,-2741
2,3,11,5,9,3438,6105,-2667
2,3,12,5,9,3604,6216,-2612
2,3,13,5,9,3789,6220,-2431
2,3,14,5,9,4017,6268,-2251
2,3,15,5,9,4244,6297,-2053
2,4,0,5,9,4402,6344,-1942
2,4,1,5,9,4217,6256,-2039
2,4,2,5,9,3997,6312,-2315
2,4,3,5,9,3858,6420,-2562
2,4,4,5,9,3831,6525,-2694
2,4,5,5,9,3813,6226,-2413
2,4,6,5,9,3766,5953,-2187
2,4,7,5,9,3735,5867,-2132
2,4,8,5,9,3760,5902,-2142
2,4,9,5,9,3760,5905,-2145
2,4,10,5,9,3807,6119,-2312
2,4,11,5,9,3883,6357,-2474
2,4,12,5,9,3967,6590,-2623
2,4,13,5,9,4092,6690,-2598
2,4,14,5,9,4244,6867,-2623
2,4,15,5,9,4418,6946,-2528
2,5,0,5,9,4028,7384,-3356
2,5,1,5,9,3841,7309,-3468
2,5,2,5,9,3652,7363,-3711
2,5,3,5,9,3549,7482,-3933
2,5,4,5,9,3589,7578,-3989
2,5,5,5,9,3639,7228,-3589
2,5,6,5,9,3637,6833,-3196
2,5,7,5,9,3661,6750,-3089
2,5,8,5,9,3695,6803,-3108
2,5,9,5,9,3676,6748,-3072
2,5,10,5,9,3685,7075,-3390
2,5,11,5,9,3704,7381,-3677
2,5,12,5,9,3733,7659,-3926
2,5,13,5,9,3813,7824,-4011
2,5,14,5,9,3945,8042,-4097
2,5,15,5,9,4132,8095,-3963
2,6,0,5,9,4114,8049,-3935
2,6,1,5,9,3997,7887,-3890
2,6,2,5,9,3951,7802,-3851
2,6,3,5,9,3962,7849,-3887
2,6,4,5,9,4105,7882,-3777
2,6,5,5,9,4199,7433,-3234
2,6,6,5,9,4247,6868,-2621
2,6,7,5,9,4280,6775,-2495
2,6,8,5,9,4286,6858,-2572
2,6,9,5,9,4285,6729,-2444
2,6,10,5,9,4265,7236,-2971
2,6,11,5,9,4232,7659,-3427
2,6,12,5,9,4206,7996,-3790
2,6,13,5,9,4189,8297,-4108
2,6,14,5,9,4235,8642,-4407
2,6,15,5,9,4361,8768,-4407
2,7,0,5,9,4858,8001,-3143
2,7,1,5,9,4831,7799,-2968
2,7,2,5,9,4934,7623,-2689
2,7,3,5,9,5073,7601,-2528
2,7,4,5,9,5304,7574,-2270
2,7,5,5,9,5363,7071,-1708
2,7,6,5,9,5434,6346,-912
2,7,7,5,9,5432,6331,-899
2,7,8,5,9,5431,6408,-977
2,7,9,5,9,5453,6190,-737
2,7,10,5,9,5437,6773,-1336
2,7,11,5,9,5403,7279,-1876
2,7,12,5,9,5384,7643,-2259
2,7,13,5,9,5307,8007,-2700
2,7,14,5,9,5279,8384,-3105
2,7,15,5,9,5308,8602,-3294
2,8,0,5,9,5720,7695,-1975
2,8,1,5,9,5687,7496,-1809
2,8,2,5,9,5785,7388,-1603
2,8,3,5,9,5926,7359,-1433
2,8,4,5,9,6112,7264,-1152
2,8,5,5,9,5987,6763,-776
2,8,6,5,9,5920,6006,-86
2,8,7,5,9,5850,6073,-223
2,8,8,5,9,5882,6134,-252
2,8,9,5,9,5921,5875,46
2,8,10,5,9,6011,6373,-362
2,8,11,5,9,6105,6821,-716
2,8,12,5,9,6216,7189,-973
2,8,13,5,9,6220,7570,-1350
2,8,14,5,9,6268,7869,-1601
2,8,15,5,9,6297,8153,-1856
2,9,0,5,9,6344,7265,-921
2,9,1,5,9,6256,7063,-807
2,9,2,5,9,6312,6991,-679
2,9,3,5,9,6420,6987,-567
2,9,4,5,9,6525,6828,-303
2,9,5,5,9,6226,6255,-29
2,9,6,5,9,5953,5584,369
2,9,7,5,9,5867,5677,190
2,9,8,5,9,5902,5661,241
2,9,9,5,9,5905,5480,425
2,9,10,5,9,6119,5860,259
2,9,11,5,9,6357,6251,106
2,9,12,5,9,6590,6651,-61
2,9,13,5,9,6690,7011,-321
2,9,14,5,9,6867,7215,-348
2,9,15,5,9,6946,7474,-528
2,10,0,5,9,7384,6853,531
2,10,1,5,9,7309,6636,673
2,10,2,5,9,7363,6674,689
2,10,3,5,9,7482,6719,763
2,10,4,5,9,7578,6497,1081
2,10,5,5,9,7228,6015,1213
2,10,6,5,9,6833,5524,1309
2,10,7,5,9,6750,5598,1152
2,10,8,5,9,6803,5661,1142
2,10,9,5,9,6748,5557,1191
2,10,10,5,9,7075,5753,1322
2,10,11,5,9,7381,5963,1418
2,10,12,5,9,7659,6349,1310
2,10,13,5,9,7824,6544,1280
2,10,14,5,9,8042,6576,1466
2,10,15,5,9,8095,6876,1219
2,11,0,5,9,8049,6416,1633
2,11,1,5,9,7887,6204,1683
2,11,2,5,9,7802,6370,1432
2,11,3,5,9,7849,6480,1369
2,11,4,5,9,7882,6194,1688
2,11,5,5,9,7433,5876,1557
2,11,6,5,9,6868,5590,1278
2,11,7,5,9,6775,5670,1105
2,11,8,5,9,6858,5674,1184
2,11,9,5,9,6729,5513,1216
2,11,10,5,9,7236,5461,1775
2,11,11,5,9,7659,5490,2169
2,11,12,5,9,7996,5864,2132
2,11,13,5,9,8297,5859,2438
2,11,14,5,9,8642,5706,2936
2,11,15,5,9,8768,6078,2690
2,12,0,5,9,8001,5895,2106
2,12,1,5,9,7799,5522,2277
2,12,2,5,9,7623,5639,1984
2,12,3,5,9,7601,5685,1916
2,12,4,5,9,7574,5244,2330
2,12,5,5,9,7071,5007,2064
2,12,6,5,9,6346,4864,1482
2,12,7,5,9,6331,4897,1434
2,12,8,5,9,6408,4854,1554
2,12,9,5,9,6190,4687,1503
2,12,10,5,9,6773,4567,2206
2,12,11,5,9,7279,4554,2725
2,12,12,5,9,7643,4923,2720
2,12,13,5,9,8007,4878,3129
2,12,14,5,9,8384,4780,3604
2,12,15,5,9,8602,5259,3343
2,13,0,5,9,7695,5301,2394
2,13,1,5,9,7496,4917,2579
2,13,2,5,9,7388,4995,2393
2,13,3,5,9,7359,5022,2337
2,13,4,5,9,7264,4640,2624
2,13,5,5,9,6763,4570,2193
2,13,6,5,9,6006,4553,1453
2,13,7,5,9,6073,4611,1462
2,13,8,5,9,6134,4574,1560
2,13,9,5,9,5875,4361,1514
2,13,10,5,9,6373,4208,2165
2,13,11,5,9,6821,4133,2688
2,13,12,5,9,7189,4382,2807
2,13,13,5,9,7570,4192,3378
2,13,14,5,9,7869,4055,3814
2,13,15,5,9,8153,4463,3690
2,14,0,5,9,7265,4792,2473
2,14,1,5,9,7063,4444,2619
2,14,2,5,9,6991,4525,2466
2,14,3,5,9,6987,4550,2437
2,14,4,5,9,6828,4308,2520
2,14,5,5,9,6255,4422,1833
2,14,6,5,9,5584,4508,1076
2,14,7,5,9,5677,4599,1078
2,14,8,5,9,5661,4650,1011
2,14,9,5,9,5480,4332,1148
2,14,10,5,9,5860,4123,1737
2,14,11,5,9,6251,4013,2238
2,14,12,5,9,6651,4140,2511
2,14,13,5,9,7011,3794,3217
2,14,14,5,9,7215,3635,3580
2,14,15,5,9,7474,3980,3494
2,0,0,6,9,5701,5663,38
2,0,1,6,9,5549,5585,-36
2,0,2,6,9,5354,5633,-279
2,0,3,6,9,5180,5732,-552
2,0,4,6,9,5012,5943,-931
2,0,5,6,9,4804,5984,-1180
2,0,6,6,9,4629,6041,-1412
2,0,7,6,9,4544,6040,-1496
2,0,8,6,9,4517,6058,-1541
2,0,9,6,9,4545,6077,-1532
2,0,10,6,9,4662,6063,-1401
2,0,11,6,9,4834,6047,-1213
2,0,12,6,9,4989,6056,-1067
2,0,13,6,9,5164,6017,-853
2,0,14,6,9,5356,6036,-680
2,0,15,6,9,5499,6112,-613
2,1,0,6,9,5559,6493,-934
2,1,1,6,9,5363,6426,-1063
2,1,2,6,9,5118,6496,-1378
2,1,3,6,9,4898,6646,-1748
2,1,4,6,9,4706,6882,-2176
2,1,5,6,9,4488,6815,-2327
2,1,6,6,9,4306,6788,-2482
2,1,7,6,9,4221,6732,-2511
2,1,8,6,9,4221,6758,-2537
2,1,9,6,9,4248,6786,-2538
2,1,10,6,9,4360,6859,-2499
2,1,11,6,9,4544,6933,-2389
2,1,12,6,9,4731,7017,-2286
2,1,13,6,9,4943,7006,-2063
2,1,14,6,9,5176,7066,-1890
2,1,15,6,9,5368,7123,-1755
2,2,0,6,9,5365,7350,-1985
2,2,1,6,9,5135,7271,-2136
2,2,2,6,9,4869,7316,-2447
2,2,3,6,9,4662,7440,-2778
2,2,4,6,9,4523,7613,-3090
2,2,5,6,9,4371,7397,-3026
2,2,6,6,9,4232,7168,-2936
2,2,7,6,9,4156,7085,-2929
2,2,8,6,9,4142,7133,-2991
2,2,9,6,9,4159,7140,-2981
2,2,10,6,9,4256,7348,-3092
2,2,11,6,9,4422,7549,-3127
2,2,12,6,9,4584,7744,-3160
2,2,13,6,9,4773,7826,-3053
2,2,14,6,9,5008,7975,-2967
2,2,15,6,9,5231,8047,-2816
2,3,0,6,9,5372,7942,-2570
2,3,1,6,9,5144,7802,-2658
2,3,2,6,9,4873,7816,-2943
2,3,3,6,9,4687,7902,-3215
2,3,4,6,9,4617,7994,-3377
2,3,5,6,9,4550,7631,-3081
2,3,6,6,9,4453,7208,-2755
2,3,7,6,9,4377,7134,-2757
2,3,8,6,9,4377,7179,-2802
2,3,9,6,9,4404,7126,-2722
2,3,10,6,9,4499,7470,-2971
2,3,11,6,9,4630,7794,-3164
2,3,12,6,9,4758,8087,-3329
2,3,13,6,9,4925,8273,-3348
2,3,14,6,9,5125,8539,-3414
2,3,15,6,9,5345,8668,-3323
2,4,0,6,9,4960,9021,-4061
2,4,1,6,9,4710,8883,-4173
2,4,2,6,9,4450,8886,-4436
2,4,3,6,9,4278,8992,-4714
2,4,4,6,9,4247,9074,-4827
2,4,5,6,9,4216,8609,-4393
2,4,6,6,9,4141,8050,-3909
2,4,7,6,9,4119,7963,-3844
2,4,8,6,9,4136,8034,-3898
2,4,9,6,9,4138,7912,-3774
2,4,10,6,9,4202,8403,-4201
2,4,11,6,9,4296,8814,-4518
2,4,12,6,9,4395,9147,-4752
2,4,13,6,9,4541,9405,-4864
2,4,14,6,9,4741,9717,-4976
2,4,15,6,9,4991,9825,-4834
2,5,0,6,9,5000,9550,-4550
2,5,1,6,9,4837,9387,-4550
2,5,2,6,9,4736,9305,-4569
2,5,3,6,9,4692,9371,-4679
2,5,4,6,9,4781,9412,-4631
2,5,5,6,9,4815,8856,-4041
2,5,6,6,9,4819,8140,-3321
2,5,7,6,9,4849,8091,-3242
2,5,8,6,9,4871,8180,-3309
2,5,9,6,9,4859,7982,-3123
2,5,10,6,9,4852,8571,-3719
2,5,11,6,9,4859,9094,-4235
2,5,12,6,9,4884,9493,-4609
2,5,13,6,9,4921,9835,-4914
2,5,14,6,9,5020,10185,-5165
2,5,15,6,9,5189,10353,-5164
2,6,0,6,9,5663,9330,-3667
2,6,1,6,9,5585,9091,-3506
2,6,2,6,9,5633,8950,-3317
2,6,3,6,9,5732,8932,-3200
2,6,4,6,9,5943,8842,-2899
2,6,5,6,9,5984,8215,-2231
2,6,6,6,9,6041,7360,-1319
2,6,7,6,9,6040,7373,-1333
2,6,8,6,9,6058,7461,-1403
2,6,9,6,9,6077,7208,-1131
2,6,10,6,9,6063,7795,-1732
2,6,11,6,9,6047,8351,-2304
2,6,12,6,9,6056,8822,-2766
2,6,13,6,9,6017,9269,-3252
2,6,14,6,9,6036,9656,-3620
2,6,15,6,9,6112,9968,-3856
2,7,0,6,9,6493,8895,-2402
2,7,1,6,9,6426,8647,-2221
2,7,2,6,9,6496,8522,-2026
2,7,3,6,9,6646,8501,-1855
2,7,4,6,9,6882,8329,-1447
2,7,5,6,9,6815,7665,-850
2,7,6,6,9,6788,6832,-44
2,7,7,6,9,6732,6912,-180
2,7,8,6,9,6758,6912,-154
2,7,9,6,9,6786,6699,87
2,7,10,6,9,6859,7197,-338
2,7,11,6,9,6933,7695,-762
2,7,12,6,9,7017,8179,-1162
2,7,13,6,9,7006,8617,-1611
2,7,14,6,9,7066,8922,-1856
2,7,15,6,9,7123,9224,-2101
2,8,0,6,9,7350,8451,-1101
2,8,1,6,9,7271,8182,-911
2,8,2,6,9,7316,8178,-862
2,8,3,6,9,7440,8201,-761
2,8,4,6,9,7613,7966,-353
2,8,5,6,9,7397,7420,-23
2,8,6,6,9,7168,6779,389
2,8,7,6,9,7085,6865,220
2,8,8,6,9,7133,6938,195
2,8,9,6,9,7140,6778,362
2,8,10,6,9,7348,7104,244
2,8,11,6,9,7549,7400,149
2,8,12,6,9,7744,7846,-102
2,8,13,6,9,7826,8127,-301
2,8,14,6,9,7975,8248,-273
2,8,15,6,9,8047,8598,-551
2,9,0,6,9,7942,8053,-111
2,9,1,6,9,7802,7778,24
2,9,2,6,9,7816,7893,-77
2,9,3,6,9,7902,7990,-88
2,9,4,6,9,7994,7690,304
2,9,5,6,9,7631,7257,374
2,9,6,6,9,7208,6807,401
2,9,7,6,9,7134,6883,251
2,9,8,6,9,7179,6905,274
2,9,9,6,9,7126,6677,449
2,9,10,6,9,7470,6789,681
2,9,11,6,9,7794,6923,871
2,9,12,6,9,8087,7352,735
2,9,13,6,9,8273,7440,833
2,9,14,6,9,8539,7381,1158
2,9,15,6,9,8668,7808,860
2,10,0,6,9,9021,7396,1625
2,10,1,6,9,8883,7022,1861
2,10,2,6,9,8886,7142,1744
2,10,3,6,9,8992,7207,1785
2,10,4,6,9,9074,6774,2300
2,10,5,6,9,8609,6430,2179
2,10,6,6,9,8050,6136,1914
2,10,7,6,9,7963,6213,1750
2,10,8,6,9,8034,6176,1858
2,10,9,6,9,7912,5940,1972
2,10,10,6,9,8403,5902,2501
2,10,11,6,9,8814,5989,2825
2,10,12,6,9,9147,6420,2727
2,10,13,6,9,9405,6416,2989
2,10,14,6,9,9717,6323,3394
2,10,15,6,9,9825,6844,2981
2,11,0,6,9,9550,6630,2920
2,11,1,6,9,9387,6209,3178
2,11,2,6,9,9305,6322,2983
2,11,3,6,9,9371,6353,3018
2,11,4,6,9,9412,5908,3504
2,11,5,6,9,8856,5714,3142
2,11,6,6,9,8140,5567,2573
2,11,7,6,9,8091,5653,2438
2,11,8,6,9,8180,5627,2553
2,11,9,6,9,7982,5379,2603
2,11,10,6,9,8571,5230,3341
2,11,11,6,9,9094,5205,3889
2,11,12,6,9,9493,5561,3932
2,11,13,6,9,9835,5454,4381
2,11,14,6,9,10185,5327,4858
2,11,15,6,9,10353,5829,4524
2,12,0,6,9,9330,5992,3338
2,12,1,6,9,9091,5595,3496
2,12,2,6,9,8950,5659,3291
2,12,3,6,9,8932,5692,3240
2,12,4,6,9,8842,5373,3469
2,12,5,6,9,8215,5324,2891
2,12,6,6,9,7360,5334,2026
2,12,7,6,9,7373,5438,1935
2,12,8,6,9,7461,5428,2033
2,12,9,6,9,7208,5156,2052
2,12,10,6,9,7795,4947,2848
2,12,11,6,9,8351,4887,3464
2,12,12,6,9,8822,5130,3692
2,12,13,6,9,9269,4841,4428
2,12,14,6,9,9656,4688,4968
2,12,15,6,9,9968,5051,4917
2,0,0,7,9,6506,8123,-1617
2,0,1,7,9,6303,8010,-1707
2,0,2,7,9,6053,8027,-1974
2,0,3,7,9,5839,8160,-2321
2,0,4,7,9,5651,8383,-2732
2,0,5,7,9,5425,8225,-2800
2,0,6,7,9,5236,8036,-2800
2,0,7,7,9,5152,7967,-2815
2,0,8,7,9,5144,8009,-2865
2,0,9,7,9,5169,8005,-2836
2,0,10,7,9,5288,8196,-2908
2,0,11,7,9,5478,8377,-2899
2,0,12,7,9,5661,8545,-2884
2,0,13,7,9,5874,8612,-2738
2,0,14,7,9,6113,8773,-2660
2,0,15,7,9,6303,8873,-2570
2,1,0,7,9,6332,8948,-2616
2,1,1,7,9,6102,8817,-2715
2,1,2,7,9,5829,8820,-2991
2,1,3,7,9,5618,8922,-3304
2,1,4,7,9,5476,9082,-3606
2,1,5,7,9,5316,8802,-3486
2,1,6,7,9,5174,8423,-3249
2,1,7,7,9,5103,8352,-3249
2,1,8,7,9,5097,8410,-3313
2,1,9,7,9,5113,8361,-3248
2,1,10,7,9,5208,8699,-3491
2,1,11,7,9,5372,8986,-3614
2,1,12,7,9,5532,9241,-3709
2,1,13,7,9,5729,9409,-3680
2,1,14,7,9,5974,9647,-3673
2,1,15,7,9,6194,9769,-3575
2,2,0,7,9,6371,9579,-3208
2,2,1,7,9,6150,9376,-3226
2,2,2,7,9,5873,9339,-3466
2,2,3,7,9,5682,9412,-3730
2,2,4,7,9,5611,9490,-3879
2,2,5,7,9,5542,9012,-3470
2,2,6,7,9,5447,8425,-2978
2,2,7,7,9,5374,8347,-2973
2,2,8,7,9,5373,8410,-3037
2,2,9,7,9,5394,8290,-2896
2,2,10,7,9,5485,8798,-3313
2,2,11,7,9,5614,9227,-3613
2,2,12,7,9,5738,9575,-3837
2,2,13,7,9,5909,9854,-3945
2,2,14,7,9,6116,10214,-4098
2,2,15,7,9,6332,10398,-4066
2,3,0,7,9,5930,10522,-4592
2,3,1,7,9,5637,10383,-4746
2,3,2,7,9,5326,10389,-5063
2,3,3,7,9,5107,10514,-5407
2,3,4,7,9,5033,10604,-5571
2,3,5,7,9,4953,10032,-5079
2,3,6,7,9,4828,9322,-4494
2,3,7,7,9,4761,9279,-4518
2,3,8,7,9,4753,9356,-4603
2,3,9,7,9,4782,9165,-4383
2,3,10,7,9,4894,9738,-4844
2,3,11,7,9,5043,10249,-5206
2,3,12,7,9,5186,10644,-5458
2,3,13,7,9,5374,10943,-5569
2,3,14,7,9,5622,11260,-5638
2,3,15,7,9,5918,11410,-5492
2,4,0,7,9,5932,10879,-4947
2,4,1,7,9,5706,10679,-4973
2,4,2,7,9,5534,10632,-5098
2,4,3,7,9,5421,10702,-5281
2,4,4,7,9,5439,10680,-5241
2,4,5,7,9,5392,10000,-4608
2,4,6,7,9,5323,9154,-3831
2,4,7,7,9,5307,9133,-3826
2,4,8,7,9,5312,9233,-3921
2,4,9,7,9,5321,9000,-3679
2,4,10,7,9,5369,9593,-4224
2,4,11,7,9,5451,10166,-4715
2,4,12,7,9,5546,10672,-5126
2,4,13,7,9,5649,11097,-5448
2,4,14,7,9,5816,11457,-5641
2,4,15,7,9,6048,11719,-5671
2,5,0,7,9,6549,10530,-3981
2,5,1,7,9,6425,10242,-3817
2,5,2,7,9,6418,10084,-3666
2,5,3,7,9,6462,10074,-3612
2,5,4,7,9,6619,9907,-3288
2,5,5,7,9,6600,9117,-2517
2,5,6,7,9,6613,8186,-1573
2,5,7,7,9,6609,8212,-1603
2,5,8,7,9,6643,8239,-1596
2,5,9,7,9,6651,8032,-1381
2,5,10,7,9,6650,8619,-1969
2,5,11,7,9,6674,9225,-2551
2,5,12,7,9,6734,9812,-3078
2,5,13,7,9,6749,10316,-3567
2,5,14,7,9,6821,10709,-3888
2,5,15,7,9,6940,11039,-4099
2,6,0,7,9,7298,10081,-2783
2,6,1,7,9,7180,9766,-2586
2,6,2,7,9,7195,9709,-2514
2,6,3,7,9,7305,9715,-2410
2,6,4,7,9,7521,9467,-1946
2,6,5,7,9,7436,8830,-1394
2,6,6,7,9,7395,8027,-632
2,6,7,7,9,7340,8100,-760
2,6,8,7,9,7385,8189,-804
2,6,9,7,9,7410,7997,-587
2,6,10,7,9,7485,8441,-956
2,6,11,7,9,7577,8844,-1267
2,6,12,7,9,7689,9374,-1685
2,6,13,7,9,7716,9733,-2017
2,6,14,7,9,7823,9955,-2132
2,6,15,7,9,7927,10348,-2421
2,7,0,7,9,8123,9651,-1528
2,7,1,7,9,8010,9324,-1314
2,7,2,7,9,8027,9397,-1370
2,7,3,7,9,8160,9472,-1312
2,7,4,7,9,8383,9159,-776
2,7,5,7,9,8225,8662,-437
2,7,6,7,9,8036,8062,-26
2,7,7,7,9,7967,8150,-183
2,7,8,7,9,8009,8182,-173
2,7,9,7,9,8005,7898,107
2,7,10,7,9,8196,8140,56
2,7,11,7,9,8377,8360,17
2,7,12,7,9,8545,8849,-304
2,7,13,7,9,8612,9023,-411
2,7,14,7,9,8773,9053,-280
2,7,15,7,9,8873,9530,-657
2,8,0,7,9,8948,9033,-85
2,8,1,7,9,8817,8596,221
2,8,2,7,9,8820,8665,155
2,8,3,7,9,8922,8717,205
2,8,4,7,9,9082,8270,812
2,8,5,7,9,8802,7811,991
2,8,6,7,9,8423,7353,1070
2,8,7,7,9,8352,7426,926
2,8,8,7,9,8410,7407,1003
2,8,9,7,9,8361,7104,1257
2,8,10,7,9,8699,7230,1469
2,8,11,7,9,8986,7422,1564
2,8,12,7,9,9241,7908,1333
2,8,13,7,9,9409,7997,1412
2,8,14,7,9,9647,7998,1649
2,8,15,7,9,9769,8574,1195
2,9,0,7,9,9579,8131,1448
2,9,1,7,9,9376,7709,1667
2,9,2,7,9,9339,7825,1514
2,9,3,7,9,9412,7875,1537
2,9,4,7,9,9490,7438,2052
2,9,5,7,9,9012,7137,1875
2,9,6,7,9,8425,6839,1586
2,9,7,7,9,8347,6969,1378
2,9,8,7,9,8410,6949,1461
2,9,9,7,9,8290,6632,1658
2,9,10,7,9,8798,6565,2233
2,9,11,7,9,9227,6640,2587
2,9,12,7,9,9575,7058,2517
2,9,13,7,9,9854,6992,2862
2,9,14,7,9,10214,6870,3344
2,9,15,7,9,10398,7414,2984
2,10,0,7,9,10522,7321,3201
2,10,1,7,9,10383,6887,3496
2,10,2,7,9,10389,6986,3403
2,10,3,7,9,10514,7023,3491
2,10,4,7,9,10604,6641,3963
2,10,5,7,9,10032,6468,3564
2,10,6,7,9,9322,6348,2974
2,10,7,7,9,9279,6480,2799
2,10,8,7,9,9356,6481,2875
2,10,9,7,9,9165,6174,2991
2,10,10,7,9,9738,5969,3769
2,10,11,7,9,10249,5959,4290
2,10,12,7,9,10644,6309,4335
2,10,13,7,9,10943,6103,4840
2,10,14,7,9,11260,5960,5300
2,10,15,7,9,11410,6417,4993
2,0,0,8,9,7279,10585,-3306
2,0,1,8,9,7042,10391,-3349
2,0,2,8,9,6764,10343,-3579
2,0,3,8,9,6559,10432,-3873
2,0,4,8,9,6421,10578,-4157
2,0,5,8,9,6253,10183,-3930
2,0,6,8,9,6104,9640,-3536
2,0,7,8,9,6034,9565,-3531
2,0,8,8,9,6020,9641,-3621
2,0,9,8,9,6034,9525,-3491
2,0,10,8,9,6136,10027,-3891
2,0,11,8,9,6306,10419,-4113
2,0,12,8,9,6462,10729,-4267
2,0,13,8,9,6660,10990,-4330
2,0,14,8,9,6911,11322,-4411
2,0,15,8,9,7129,11499,-4370
2,1,0,8,9,7338,11080,-3742
2,1,1,8,9,7117,10876,-3759
2,1,2,8,9,6833,10842,-4009
2,1,3,8,9,6638,10934,-4296
2,1,4,8,9,6564,11020,-4456
2,1,5,8,9,6487,10435,-3948
2,1,6,8,9,6389,9697,-3308
2,1,7,8,9,6321,9663,-3342
2,1,8,8,9,6328,9732,-3404
2,1,9,8,9,6348,9543,-3195
2,1,10,8,9,6437,10133,-3696
2,1,11,8,9,6564,10662,-4098
2,1,12,8,9,6686,11072,-4386
2,1,13,8,9,6865,11392,-4527
2,1,14,8,9,7082,11757,-4675
2,1,15,8,9,7295,11983,-4688
2,2,0,8,9,6929,11851,-4922
2,2,1,8,9,6643,11675,-5032
2,2,2,8,9,6326,11716,-5390
2,2,3,8,9,6102,11845,-5743
2,2,4,8,9,6027,11872,-5845
2,2,5,8,9,5945,11176,-5231
2,2,6,8,9,5822,10336,-4514
2,2,7,8,9,5758,10321,-4563
2,2,8,8,9,5749,10409,-4660
2,2,9,8,9,5772,10183,-4411
2,2,10,8,9,5880,10760,-4880
2,2,11,8,9,6027,11321,-5294
2,2,12,8,9,6166,11823,-5657
2,2,13,8,9,6358,12205,-5847
2,2,14,8,9,6613,12532,-5919
2,2,15,8,9,6905,12776,-5871
2,3,0,8,9,6902,12079,-5177
2,3,1,8,9,6633,11830,-5197
2,3,2,8,9,6410,11766,-5356
2,3,3,8,9,6250,11844,-5594
2,3,4,8,9,6225,11745,-5520
2,3,5,8,9,6129,10902,-4773
2,3,6,8,9,6010,9980,-3970
2,3,7,8,9,5949,9972,-4023
2,3,8,8,9,5929,10011,-4082
2,3,9,8,9,5965,9824,-3859
2,3,10,8,9,6061,10417,-4356
2,3,11,8,9,6198,11040,-4842
2,3,12,8,9,6337,11662,-5325
2,3,13,8,9,6482,12144,-5662
2,3,14,8,9,6697,12510,-5813
2,3,15,8,9,6975,12790,-5815
2,4,0,8,9,7481,11716,-4235
2,4,1,8,9,7294,11361,-4067
2,4,2,8,9,7216,11271,-4055
2,4,3,8,9,7191,11288,-4097
2,4,4,8,9,7277,11045,-3768
2,4,5,8,9,7177,10282,-3105
2,4,6,8,9,7117,9381,-2264
2,4,7,8,9,7067,9400,-2333
2,4,8,8,9,7084,9516,-2432
2,4,9,8,9,7113,9330,-2217
2,4,10,8,9,7167,9863,-2696
2,4,11,8,9,7266,10374,-3108
2,4,12,8,9,7396,11007,-3611
2,4,13,8,9,7477,11432,-3955
2,4,14,8,9,7617,11742,-4125
2,4,15,8,9,7799,12163,-4364
2,5,0,8,9,8184,11281,-3097
2,5,1,8,9,8020,10908,-2888
2,5,2,8,9,7980,10928,-2948
2,5,3,8,9,8035,10986,-2951
2,5,4,8,9,8197,10660,-2463
2,5,5,8,9,8052,10072,-2020
2,5,6,8,9,7967,9310,-1343
2,5,7,8,9,7909,9385,-1476
2,5,8,8,9,7970,9433,-1463
2,5,9,8,9,7984,9117,-1133
2,5,10,8,9,8072,9477,-1405
2,5,11,8,9,8204,9804,-1600
2,5,12,8,9,8367,10377,-2010
2,5,13,8,9,8448,10629,-2181
2,5,14,8,9,8608,10760,-2152
2,5,15,8,9,8755,11280,-2525
2,6,0,8,9,8928,10631,-1703
2,6,1,8,9,8764,10142,-1378
2,6,2,8,9,8726,10169,-1443
2,6,3,8,9,8819,10199,-1380
2,6,4,8,9,9022,9739,-717
2,6,5,8,9,8846,9216,-370
2,6,6,8,9,8643,8608,35
2,6,7,8,9,8575,8693,-118
2,6,8,8,9,8636,8684,-48
2,6,9,8,9,8629,8325,304
2,6,10,8,9,8822,8581,241
2,6,11,8,9,9021,8859,162
2,6,12,8,9,9217,9405,-188
2,6,13,8,9,9322,9580,-258
2,6,14,8,9,9530,9670,-140
2,6,15,8,9,9677,10296,-619
2,7,0,8,9,9721,9768,-47
2,7,1,8,9,9556,9283,273
2,7,2,8,9,9531,9348,183
2,7,3,8,9,9642,9385,257
2,7,4,8,9,9852,8934,918
2,7,5,8,9,9630,8518,1112
2,7,6,8,9,9291,8056,1235
2,7,7,8,9,9234,8182,1052
2,7,8,8,9,9286,8180,1106
2,7,9,8,9,9226,7796,1430
2,7,10,8,9,9547,7893,1654
2,7,11,8,9,9814,8073,1741
2,7,12,8,9,10042,8546,1496
2,7,13,8,9,10195,8573,1622
2,7,14,8,9,10445,8545,1900
2,7,15,8,9,10595,9144,1451
2,8,0,8,9,10585,8822,1763
2,8,1,8,9,10391,8387,2004
2,8,2,8,9,10343,8489,1854
2,8,3,8,9,10432,8545,1887
2,8,4,8,9,10578,8171,2407
2,8,5,8,9,10183,7891,2292
2,8,6,8,9,9640,7620,2020
2,8,7,8,9,9565,7796,1769
2,8,8,8,9,9641,7803,1838
2,8,9,8,9,9525,7427,2098
2,8,10,8,9,10027,7304,2723
2,8,11,8,9,10419,7394,3025
2,8,12,8,9,10729,7806,2923
2,8,13,8,9,10990,7641,3349
2,8,14,8,9,11322,7503,3819
2,8,15,8,9,11499,8002,3497
2,0,0,9,9,8285,12409,-4124
2,0,1,9,9,8057,12168,-4111
2,0,2,9,9,7768,12169,-4401
2,0,3,9,9,7579,12265,-4686
2,0,4,9,9,7509,12288,-4779
2,0,5,9,9,7424,11579,-4155
2,0,6,9,9,7319,10711,-3392
2,0,7,9,9,7252,10705,-3453
2,0,8,9,9,7251,10785,-3534
2,0,9,9,9,7269,10561,-3292
2,0,10,9,9,7365,11155,-3790
2,0,11,9,9,7498,11734,-4236
2,0,12,9,9,7616,12251,-4635
2,0,13,9,9,7796,12654,-4858
2,0,14,9,9,8019,13029,-5010
2,0,15,9,9,8230,13349,-5119
2,1,0,9,9,7896,13051,-5155
2,1,1,9,9,7610,12826,-5216
2,1,2,9,9,7286,12850,-5564
2,1,3,9,9,7058,12987,-5929
2,1,4,9,9,6980,12937,-5957
2,1,5,9,9,6890,12078,-5188
2,1,6,9,9,6764,11162,-4398
2,1,7,9,9,6705,11160,-4455
2,1,8,9,9,6704,11187,-4483
2,1,9,9,9,6726,11007,-4281
2,1,10,9,9,6832,11584,-4752
2,1,11,9,9,6977,12195,-5218
2,1,12,9,9,7114,12813,-5699
2,1,13,9,9,7314,13252,-5938
2,1,14,9,9,7579,13585,-6006
2,1,15,9,9,7868,13847,-5979
2,2,0,9,9,7901,13265,-5364
2,2,1,9,9,7639,12949,-5310
2,2,2,9,9,7410,12953,-5543
2,2,3,9,9,7245,13058,-5813
2,2,4,9,9,7219,12883,-5664
2,2,5,9,9,7121,12067,-4946
2,2,6,9,9,7004,11175,-4171
2,2,7,9,9,6946,11160,-4214
2,2,8,9,9,6925,11288,-4363
2,2,9,9,9,6955,11122,-4167
2,2,10,9,9,7047,11661,-4614
2,2,11,9,9,7182,12189,-5007
2,2,12,9,9,7317,12857,-5540
2,2,13,9,9,7466,13260,-5794
2,2,14,9,9,7688,13543,-5855
2,2,15,9,9,7962,13914,-5952
2,3,0,9,9,8451,12916,-4465
2,3,1,9,9,8221,12503,-4282
2,3,2,9,9,8092,12490,-4398
2,3,3,9,9,8020,12559,-4539
2,3,4,9,9,8063,12238,-4175
2,3,5,9,9,7914,11524,-3610
2,3,6,9,9,7804,10664,-2860
2,3,7,9,9,7709,10685,-2976
2,3,8,9,9,7701,10760,-3059
2,3,9,9,9,7757,10450,-2693
2,3,10,9,9,7859,10899,-3040
2,3,11,9,9,8013,11334,-3321
2,3,12,9,9,8187,12010,-3823
2,3,13,9,9,8310,12328,-4018
2,3,14,9,9,8498,12547,-4049
2,3,15,9,9,8726,13095,-4369
2,4,0,9,9,9116,12261,-3145
2,4,1,9,9,8889,11726,-2837
2,4,2,9,9,8778,11700,-2922
2,4,3,9,9,8764,11713,-2949
2,4,4,9,9,8855,11240,-2385
2,4,5,9,9,8629,10626,-1997
2,4,6,9,9,8471,9856,-1385
2,4,7,9,9,8367,9928,-1561
2,4,8,9,9,8411,9935,-1524
2,4,9,9,9,8446,9544,-1098
2,4,10,9,9,8589,9918,-1329
2,4,11,9,9,8796,10303,-1507
2,4,12,9,9,9029,10933,-1904
2,4,13,9,9,9176,11186,-2010
2,4,14,9,9,9404,11377,-1973
2,4,15,9,9,9614,12046,-2432
2,5,0,9,9,9814,11366,-1552
2,5,1,9,9,9604,10829,-1225
2,5,2,9,9,9511,10852,-1341
2,5,3,9,9,9549,10867,-1318
2,5,4,9,9,9698,10403,-705
2,5,5,9,9,9462,9923,-461
2,5,6,9,9,9215,9311,-96
2,5,7,9,9,9144,9449,-305
2,5,8,9,9,9221,9457,-236
2,5,9,9,9,9203,9017,186
2,5,10,9,9,9409,9244,165
2,5,11,9,9,9648,9510,138
2,5,12,9,9,9895,10043,-148
2,5,13,9,9,10054,10156,-102
2,5,14,9,9,10315,10217,98
2,5,15,9,9,10505,10866,-361
2,6,0,9,9,10526,10459,67
2,6,1,9,9,10310,9961,349
2,6,2,9,9,10230,10012,218
2,6,3,9,9,10301,10055,246
2,6,4,9,9,10491,9667,824
2,6,5,9,9,10251,9272,979
2,6,6,9,9,9898,8837,1061
2,6,7,9,9,9842,9009,833
2,6,8,9,9,9913,9034,879
2,6,9,9,9,9850,8591,1259
2,6,10,9,9,10173,8632,1541
2,6,11,9,9,10458,8827,1631
2,6,12,9,9,10714,9294,1420
2,6,13,9,9,10905,9222,1683
2,6,14,9,9,11202,9178,2024
2,6,15,9,9,11399,9732,1667
2,0,0,10,9,8843,14237,-5394
2,0,1,10,9,8550,13945,-5395
2,0,2,10,9,8221,14037,-5816
2,0,3,10,9,7999,14201,-6202
2,0,4,10,9,7925,14075,-6150
2,0,5,10,9,7827,13243,-5416
2,0,6,10,9,7694,12357,-4663
2,0,7,10,9,7636,12348,-4712
2,0,8,10,9,7627,12464,-4837
2,0,9,10,9,7647,12305,-4658
2,0,10,10,9,7760,12828,-5068
2,0,11,10,9,7911,13344,-5433
2,0,12,10,9,8044,14008,-5964
2,0,13,10,9,8245,14368,-6123
2,0,14,10,9,8516,14618,-6102
2,0,15,10,9,8803,14971,-6168
2,1,0,10,9,8868,14465,-5597
2,1,1,10,9,8606,14091,-5485
2,1,2,10,9,8370,14172,-5802
2,1,3,10,9,8201,14329,-6128
2,1,4,10,9,8172,14076,-5904
2,1,5,10,9,8066,13309,-5243
2,1,6,10,9,7946,12458,-4512
2,1,7,10,9,7893,12445,-4552
2,1,8,10,9,7880,12532,-4652
2,1,9,10,9,7909,12242,-4333
2,1,10,10,9,7999,12697,-4698
2,1,11,10,9,8132,13149,-5017
2,1,12,10,9,8265,13860,-5595
2,1,13,10,9,8422,14156,-5734
2,1,14,10,9,8654,14348,-5694
2,1,15,10,9,8925,14846,-5921
2,2,0,10,9,9450,13896,-4446
2,2,1,10,9,9227,13321,-4094
2,2,2,10,9,9092,13262,-4170
2,2,3,10,9,9015,13286,-4271
2,2,4,10,9,9057,12818,-3761
2,2,5,10,9,8906,12078,-3172
2,2,6,10,9,8798,11210,-2412
2,2,7,10,9,8706,11228,-2522
2,2,8,10,9,8697,11262,-2565
2,2,9,10,9,8747,10877,-2130
2,2,10,10,9,8845,11340,-2495
2,2,11,10,9,8997,11833,-2836
2,2,12,10,9,9167,12566,-3399
2,2,13,10,9,9294,12885,-3591
2,2,14,10,9,9489,13164,-3675
2,2,15,10,9,9713,13861,-4148
2,3,0,10,9,10086,12996,-2910
2,3,1,10,9,9816,12413,-2597
2,3,2,10,9,9654,12383,-2729
2,3,3,10,9,9593,12381,-2788
2,3,4,10,9,9641,11904,-2263
2,3,5,10,9,9366,11333,-1967
2,3,6,10,9,9158,10559,-1401
2,3,7,10,9,9009,10684,-1675
2,3,8,10,9,9028,10708,-1680
2,3,9,10,9,9090,10236,-1146
2,3,10,10,9,9281,10581,-1300
2,3,11,10,9,9543,10954,-1411
2,3,12,10,9,9820,11571,-1751
2,3,13,10,9,10009,11762,-1753
2,3,14,10,9,10285,11924,-1639
2,3,15,10,9,10541,12616,-2075
2,4,0,10,9,10746,12057,-1311
2,4,1,10,9,10473,11507,-1034
2,4,2,10,9,10309,11516,-1207
2,4,3,10,9,10278,11537,-1259
2,4,4,10,9,10356,11136,-780
2,4,5,10,9,10039,10677,-638
2,4,6,10,9,9719,10092,-373
2,4,7,10,9,9602,10276,-674
2,4,8,10,9,9662,10311,-649
2,4,9,10,9,9665,9812,-147
2,4,10,10,9,9926,9983,-57
2,4,11,10,9,10240,10264,-24
2,4,12,10,9,10557,10791,-234
2,4,13,10,9,10782,10805,-23
2,4,14,10,9,11111,10850,261
2,4,15,10,9,11364,11454,-90
2,0,0,11,9,9815,15445,-5630
2,0,1,11,9,9546,14909,-5363
2,0,2,11,9,9305,14944,-5639
2,0,3,11,9,9142,15056,-5914
2,0,4,11,9,9117,14656,-5539
2,0,5,11,9,9003,13863,-4860
2,0,6,11,9,8876,13004,-4128
2,0,7,11,9,8824,12988,-4164
2,0,8,11,9,8803,13034,-4231
2,0,9,11,9,8830,12669,-3839
2,0,10,11,9,8927,13138,-4211
2,0,11,11,9,9066,13648,-4582
2,0,12,11,9,9195,14416,-5221
2,0,13,11,9,9353,14713,-5360
2,0,14,11,9,9591,14965,-5374
2,0,15,11,9,9860,15612,-5752
2,1,0,11,9,10417,14631,-4214
2,1,1,11,9,10194,14008,-3814
2,1,2,11,9,10052,13945,-3893
2,1,3,11,9,9971,13954,-3983
2,1,4,11,9,10010,13482,-3472
2,1,5,11,9,9851,12785,-2934
2,1,6,11,9,9740,11913,-2173
2,1,7,11,9,9653,11984,-2331
2,1,8,11,9,9652,12035,-2383
2,1,9,11,9,9701,11569,-1868
2,1,10,11,9,9797,12003,-2206
2,1,11,11,9,9947,12484,-2537
2,1,12,11,9,10115,13204,-3089
2,1,13,11,9,10250,13461,-3211
2,1,14,11,9,10455,13711,-3256
2,1,15,11,9,10676,14431,-3755
2,2,0,11,9,11085,13687,-2602
2,2,1,11,9,10822,13091,-2269
2,2,2,11,9,10654,13047,-2393
2,2,3,11,9,10588,13051,-2463
2,2,4,11,9,10635,12637,-2002
2,2,5,11,9,10358,12087,-1729
2,2,6,11,9,10152,11340,-1188
2,2,7,11,9,10006,11511,-1505
2,2,8,11,9,10024,11562,-1538
2,2,9,11,9,10080,11031,-951
2,2,10,11,9,10267,11320,-1053
2,2,11,11,9,10527,11708,-1181
2,2,12,11,9,10800,12319,-1519
2,2,13,11,9,10993,12411,-1418
2,2,14,11,9,11276,12557,-1281
2,2,15,11,9,11528,13204,-1676
2,0,0,12,9,11364,15322,-3958
2,0,1,12,9,11134,14686,-3552
2,0,2,12,9,10987,14609,-3622
2,0,3,12,9,10912,14624,-3712
2,0,4,12,9,10955,14215,-3260
2,0,5,12,9,10788,13539,-2751
2,0,6,12,9,10670,12694,-2024
2,0,7,12,9,10584,12811,-2227
2,0,8,12,9,10575,12889,-2314
2,0,9,12,9,10622,12364,-1742
2,0,10,12,9,10725,12742,-2017
2,0,11,12,9,10881,13238,-2357
2,0,12,12,9,11045,13952,-2907
2,0,13,12,9,11181,14110,-2929
2,0,14,12,9,11392,14344,-2952
2,0,15,12,9,11611,15019,-3408
2,0,0,1,10,1050,1073,-23
2,0,1,1,10,1042,1071,-29
2,0,2,1,10,1037,1063,-26
2,0,3,1,10,1043,1059,-16
2,0,4,1,10,1048,1057,-9
2,0,5,1,10,1041,1050,-9
2,0,6,1,10,1035,1049,-14
2,0,7,1,10,1029,1062,-33
2,0,8,1,10,1025,1062,-37
2,0,9,1,10,1031,1058,-27
2,0,10,1,10,1036,1054,-18
2,0,11,1,10,1032,1051,-19
2,0,12,1,10,1033,1059,-26
2,0,13,1,10,1040,1070,-30
2,0,14,1,10,1039,1068,-29
2,1,0,1,10,1073,1112,-39
2,1,1,1,10,1071,1115,-44
2,1,2,1,10,1063,1107,-44
2,1,3,1,10,1059,1101,-42
2,1,4,1,10,1057,1102,-45
2,1,5,1,10,1050,1102,-52
2,1,6,1,10,1049,1105,-56
2,1,7,1,10,1062,1114,-52
2,1,8,1,10,1062,1105,-43
2,1,9,1,10,1058,1099,-41
2,1,10,1,10,1054,1093,-39
2,1,11,1,10,1051,1087,-36
2,1,12,1,10,1059,1090,-31
2,1,13,1,10,1070,1099,-29
2,1,14,1,10,1068,1097,-29
2,2,0,1,10,1112,1039,73
2,2,1,1,10,1115,993,122
2,2,2,1,10,1107,939,168
2,2,3,1,10,1101,891,210
2,2,4,1,10,1102,849,253
2,2,5,1,10,1102,802,300
2,2,6,1,10,1105,754,351
2,2,7,1,10,1114,732,382
2,2,8,1,10,1105,716,389
2,2,9,1,10,1099,761,338
2,2,10,1,10,1093,813,280
2,2,11,1,10,1087,854,233
2,2,12,1,10,1090,895,195
2,2,13,1,10,1099,944,155
2,2,14,1,10,1097,992,105
2,3,0,1,10,1039,983,56
2,3,1,1,10,993,917,76
2,3,2,1,10,939,843,96
2,3,3,1,10,891,773,118
2,3,4,1,10,849,703,146
2,3,5,1,10,802,624,178
2,3,6,1,10,754,552,202
2,3,7,1,10,732,517,215
2,3,8,1,10,716,516,200
2,3,9,1,10,761,568,193
2,3,10,1,10,813,640,173
2,3,11,1,10,854,707,147
2,3,12,1,10,895,772,123
2,3,13,1,10,944,841,103
2,3,14,1,10,992,906,86
2,4,0,1,10,983,954,29
2,4,1,1,10,917,907,10
2,4,2,1,10,843,850,-7
2,4,3,1,10,773,795,-22
2,4,4,1,10,703,741,-38
2,4,5,1,10,624,681,-57
2,4,6,1,10,552,638,-86
2,4,7,1,10,517,624,-107
2,4,8,1,10,516,643,-127
2,4,9,1,10,568,655,-87
2,4,10,1,10,640,694,-54
2,4,11,1,10,707,743,-36
2,4,12,1,10,772,797,-25
2,4,13,1,10,841,850,-9
2,4,14,1,10,906,893,13
2,5,0,1,10,954,874,80
2,5,1,1,10,907,823,84
2,5,2,1,10,850,768,82
2,5,3,1,10,795,728,67
2,5,4,1,10,741,708,33
2,5,5,1,10,681,689,-8
2,5,6,1,10,638,675,-37
2,5,7,1,10,624,685,-61
2,5,8,1,10,643,693,-50
2,5,9,1,10,655,695,-40
2,5,10,1,10,694,713,-19
2,5,11,1,10,743,741,2
2,5,12,1,10,797,779,18
2,5,13,1,10,850,826,24
2,5,14,1,10,893,872,21
2,6,0,1,10,874,869,5
2,6,1,1,10,823,836,-13
2,6,2,1,10,768,810,-42
2,6,3,1,10,728,819,-91
2,6,4,1,10,708,868,-160
2,6,5,1,10,689,925,-236
2,6,6,1,10,675,964,-289
2,6,7,1,10,685,981,-296
2,6,8,1,10,693,960,-267
2,6,9,1,10,695,944,-249
2,6,10,1,10,713,925,-212
2,6,11,1,10,741,900,-159
2,6,12,1,10,779,885,-106
2,6,13,1,10,826,896,-70
2,6,14,1,10,872,923,-51
2,7,0,1,10,869,1141,-272
2,7,1,1,10,836,1145,-309
2,7,2,1,10,810,1141,-331
2,7,3,1,10,819,1166,-347
2,7,4,1,10,868,1234,-366
2,7,5,1,10,925,1309,-384
2,7,6,1,10,964,1353,-389
2,7,7,1,10,981,1352,-371
2,7,8,1,10,960,1362,-402
2,7,9,1,10,944,1364,-420
2,7,10,1,10,925,1322,-397
2,7,11,1,10,900,1291,-391
2,7,12,1,10,885,1282,-397
2,7,13,1,10,896,1254,-358
2,7,14,1,10,923,1239,-316
2,8,0,1,10,1141,599,542
2,8,1,1,10,1145,522,623
2,8,2,1,10,1141,489,652
2,8,3,1,10,1166,459,707
2,8,4,1,10,1234,444,790
2,8,5,1,10,1309,430,879
2,8,6,1,10,1353,428,925
2,8,7,1,10,1352,443,909
2,8,8,1,10,1362,442,920
2,8,9,1,10,1364,436,928
2,8,10,1,10,1322,442,880
2,8,11,1,10,1291,464,827
2,8,12,1,10,1282,488,794
2,8,13,1,10,1254,525,729
2,8,14,1,10,1239,600,639
2,9,0,1,10,599,1100,-501
2,9,1,1,10,522,1128,-606
2,9,2,1,10,489,1203,-714
2,9,3,1,10,459,1268,-809
2,9,4,1,10,444,1324,-880
2,9,5,1,10,430,1300,-870
2,9,6,1,10,428,1311,-883
2,9,7,1,10,443,1333,-890
2,9,8,1,10,442,1325,-883
2,9,9,1,10,436,1295,-859
2,9,10,1,10,442,1287,-845
2,9,11,1,10,464,1270,-806
2,9,12,1,10,488,1233,-745
2,9,13,1,10,525,1207,-682
2,9,14,1,10,600,1181,-581
2,10,0,1,10,1100,1727,-627
2,10,1,1,10,1128,1782,-654
2,10,2,1,10,1203,1860,-657
2,10,3,1,10,1268,1961,-693
2,10,4,1,10,1324,2038,-714
2,10,5,1,10,1300,1969,-669
2,10,6,1,10,1311,1983,-672
2,10,7,1,10,1333,2002,-669
2,10,8,1,10,1325,2008,-683
2,10,9,1,10,1295,1976,-681
2,10,10,1,10,1287,2009,-722
2,10,11,1,10,1270,2028,-758
2,10,12,1,10,1233,2019,-786
2,10,13,1,10,1207,2001,-794
2,10,14,1,10,1181,1935,-754
2,11,0,1,10,1727,1746,-19
2,11,1,1,10,1782,1709,73
2,11,2,1,10,1860,1677,183
2,11,3,1,10,1961,1704,257
2,11,4,1,10,2038,1689,349
2,11,5,1,10,1969,1555,414
2,11,6,1,10,1983,1513,470
2,11,7,1,10,2002,1551,451
2,11,8,1,10,2008,1565,443
2,11,9,1,10,1976,1533,443
2,11,10,1,10,2009,1644,365
2,11,11,1,10,2028,1748,280
2,11,12,1,10,2019,1830,189
2,11,13,1,10,2001,1898,103
2,11,14,1,10,1935,1918,17
2,12,0,1,10,1746,1730,16
2,12,1,1,10,1709,1690,19
2,12,2,1,10,1677,1624,53
2,12,3,1,10,1704,1624,80
2,12,4,1,10,1689,1597,92
2,12,5,1,10,1555,1501,54
2,12,6,1,10,1513,1405,108
2,12,7,1,10,1551,1484,67
2,12,8,1,10,1565,1468,97
2,12,9,1,10,1533,1437,96
2,12,10,1,10,1644,1550,94
2,12,11,1,10,1748,1621,127
2,12,12,1,10,1830,1716,114
2,12,13,1,10,1898,1803,95
2,12,14,1,10,1918,1841,77
2,13,0,1,10,1730,1698,32
2,13,1,1,10,1690,1673,17
2,13,2,1,10,1624,1597,27
2,13,3,1,10,1624,1591,33
2,13,4,1,10,1597,1581,16
2,13,5,1,10,1501,1509,-8
2,13,6,1,10,1405,1410,-5
2,13,7,1,10,1484,1508,-24
2,13,8,1,10,1468,1457,11
2,13,9,1,10,1437,1451,-14
2,13,10,1,10,1550,1564,-14
2,13,11,1,10,1621,1590,31
2,13,12,1,10,1716,1692,24
2,13,13,1,10,1803,1784,19
2,13,14,1,10,1841,1826,15
2,14,0,1,10,1698,1720,-22
2,14,1,1,10,1673,1692,-19
2,14,2,1,10,1597,1617,-20
2,14,3,1,10,1591,1615,-24
2,14,4,1,10,1581,1588,-7
2,14,5,1,10,1509,1467,42
2,14,6,1,10,1410,1377,33
2,14,7,1,10,1508,1468,40
2,14,8,1,10,1457,1402,55
2,14,9,1,10,1451,1411,40
2,14,10,1,10,1564,1551,13
2,14,11,1,10,1590,1582,8
2,14,12,1,10,1692,1686,6
2,14,13,1,10,1784,1767,17
2,14,14,1,10,1826,1816,10
2,15,0,1,10,1720,1608,112
2,15,1,1,10,1692,1617,75
2,15,2,1,10,1617,1597,20
2,15,3,1,10,1615,1649,-34
2,15,4,1,10,1588,1642,-54
2,15,5,1,10,1467,1521,-54
2,15,6,1,10,1377,1446,-69
2,15,7,1,10,1468,1570,-102
2,15,8,1,10,1402,1492,-90
2,15,9,1,10,1411,1442,-31
2,15,10,1,10,1551,1552,-1
2,15,11,1,10,1582,1591,-9
2,15,12,1,10,1686,1665,21
2,15,13,1,10,1767,1655,112
2,15,14,1,10,1816,1683,133
2,16,0,1,10,1608,1400,208
2,16,1,1,10,1617,1402,215
2,16,2,1,10,1597,1394,203
2,16,3,1,10,1649,1414,235
2,16,4,1,10,1642,1351,291
2,16,5,1,10,1521,1205,316
2,16,6,1,10,1446,1154,292
2,16,7,1,10,1570,1284,286
2,16,8,1,10,1492,1214,278
2,16,9,1,10,1442,1093,349
2,16,10,1,10,1552,1182,370
2,16,11,1,10,1591,1246,345
2,16,12,1,10,1665,1345,320
2,16,13,1,10,1655,1355,300
2,16,14,1,10,1683,1427,256
2,17,0,1,10,1400,1273,127
2,17,1,1,10,1402,1226,176
2,17,2,1,10,1394,1218,176
2,17,3,1,10,1414,1249,165
2,17,4,1,10,1351,1140,211
2,17,5,1,10,1205,1005,200
2,17,6,1,10,1154,908,246
2,17,7,1,10,1284,906,378
2,17,8,1,10,1214,936,278
2,17,9,1,10,1093,897,196
2,17,10,1,10,1182,949,233
2,17,11,1,10,1246,1074,172
2,17,12,1,10,1345,1154,191
2,17,13,1,10,1355,1128,227
2,17,14,1,10,1427,1174,253
2,18,0,1,10,1273,1309,-36
2,18,1,1,10,1226,1277,-51
2,18,2,1,10,1218,1318,-100
2,18,3,1,10,1249,1372,-123
2,18,4,1,10,1140,1295,-155
2,18,5,1,10,1005,1275,-270
2,18,6,1,10,908,1260,-352
2,18,7,1,10,906,1376,-470
2,18,8,1,10,936,1485,-549
2,18,9,1,10,897,1367,-470
2,18,10,1,10,949,1307,-358
2,18,11,1,10,1074,1326,-252
2,18,12,1,10,1154,1274,-120
2,18,13,1,10,1128,1190,-62
2,18,14,1,10,1174,1234,-60
2,19,0,1,10,1309,1332,-23
2,19,1,1,10,1277,1295,-18
2,19,2,1,10,1318,1339,-21
2,19,3,1,10,1372,1423,-51
2,19,4,1,10,1295,1339,-44
2,19,5,1,10,1275,1326,-51
2,19,6,1,10,1260,1358,-98
2,19,7,1,10,1376,1423,-47
2,19,8,1,10,1485,1364,121
2,19,9,1,10,1367,1168,199
2,19,10,1,10,1307,1113,194
2,19,11,1,10,1326,1123,203
2,19,12,1,10,1274,1048,226
2,19,13,1,10,1190,951,239
2,19,14,1,10,1234,1016,218
2,20,0,1,10,1332,1021,311
2,20,1,1,10,1295,844,451
2,20,2,1,10,1339,816,523
2,20,3,1,10,1423,815,608
2,20,4,1,10,1339,616,723
2,20,5,1,10,1326,578,748
2,20,6,1,10,1358,601,757
2,20,7,1,10,1423,586,837
2,20,8,1,10,1364,572,792
2,20,9,1,10,1168,482,686
2,20,10,1,10,1113,525,588
2,20,11,1,10,1123,600,523
2,20,12,1,10,1048,645,403
2,20,13,1,10,951,653,298
2,20,14,1,10,1016,790,226
2,21,0,1,10,1021,784,237
2,21,1,1,10,844,757,87
2,21,2,1,10,816,744,72
2,21,3,1,10,815,784,31
2,21,4,1,10,616,747,-131
2,21,5,1,10,578,740,-162
2,21,6,1,10,601,801,-200
2,21,7,1,10,586,868,-282
2,21,8,1,10,572,843,-271
2,21,9,1,10,482,712,-230
2,21,10,1,10,525,721,-196
2,21,11,1,10,600,699,-99
2,21,12,1,10,645,692,-47
2,21,13,1,10,653,630,23
2,21,14,1,10,790,603,187
2,22,0,1,10,784,789,-5
2,22,1,1,10,757,733,24
2,22,2,1,10,744,724,20
2,22,3,1,10,784,802,-18
2,22,4,1,10,747,823,-76
2,22,5,1,10,740,846,-106
2,22,6,1,10,801,875,-74
2,22,7,1,10,868,934,-66
2,22,8,1,10,843,921,-78
2,22,9,1,10,712,837,-125
2,22,10,1,10,721,809,-88
2,22,11,1,10,699,808,-109
2,22,12,1,10,692,781,-89
2,22,13,1,10,630,723,-93
2,22,14,1,10,603,680,-77
2,0,0,2,10,2123,2151,-28
2,0,1,2,10,2113,2108,5
2,0,2,2,10,2100,2046,54
2,0,3,2,10,2102,1992,110
2,0,4,2,10,2105,1951,154
2,0,5,2,10,2091,1904,187
2,0,6,2,10,2084,1859,225
2,0,7,2,10,2091,1846,245
2,0,8,2,10,2087,1821,266
2,0,9,2,10,2089,1860,229
2,0,10,2,10,2090,1906,184
2,0,11,2,10,2083,1941,142
2,0,12,2,10,2092,1985,107
2,0,13,2,10,2110,2043,67
2,0,14,2,10,2107,2089,18
2,1,0,2,10,2185,2022,163
2,1,1,2,10,2186,1910,276
2,1,2,2,10,2170,1782,388
2,1,3,2,10,2160,1664,496
2,1,4,2,10,2159,1552,607
2,1,5,2,10,2152,1426,726
2,1,6,2,10,2154,1306,848
2,1,7,2,10,2176,1249,927
2,1,8,2,10,2167,1232,935
2,1,9,2,10,2157,1329,828
2,1,10,2,10,2147,1453,694
2,1,11,2,10,2138,1561,577
2,1,12,2,10,2149,1667,482
2,1,13,2,10,2169,1785,384
2,1,14,2,10,2165,1898,267
2,2,0,2,10,2151,1937,214
2,2,1,2,10,2108,1824,284
2,2,2,2,10,2046,1693,353
2,2,3,2,10,1992,1568,424
2,2,4,2,10,1951,1444,507
2,2,5,2,10,1904,1305,599
2,2,6,2,10,1859,1190,669
2,2,7,2,10,1846,1141,705
2,2,8,2,10,1821,1159,662
2,2,9,2,10,1860,1223,637
2,2,10,2,10,1906,1334,572
2,2,11,2,10,1941,1450,491
2,2,12,2,10,1985,1569,416
2,2,13,2,10,2043,1691,352
2,2,14,2,10,2089,1799,290
2,3,0,2,10,2022,1828,194
2,3,1,2,10,1910,1730,180
2,3,2,2,10,1782,1618,164
2,3,3,2,10,1664,1523,141
2,3,4,2,10,1552,1449,103
2,3,5,2,10,1426,1370,56
2,3,6,2,10,1306,1313,-7
2,3,7,2,10,1249,1309,-60
2,3,8,2,10,1232,1336,-104
2,3,9,2,10,1329,1350,-21
2,3,10,2,10,1453,1407,46
2,3,11,2,10,1561,1484,77
2,3,12,2,10,1667,1576,91
2,3,13,2,10,1785,1676,109
2,3,14,2,10,1898,1765,133
2,4,0,2,10,1937,1743,194
2,4,1,2,10,1824,1659,165
2,4,2,2,10,1693,1578,115
2,4,3,2,10,1568,1547,21
2,4,4,2,10,1444,1576,-132
2,4,5,2,10,1305,1614,-309
2,4,6,2,10,1190,1639,-449
2,4,7,2,10,1141,1666,-525
2,4,8,2,10,1159,1653,-494
2,4,9,2,10,1223,1639,-416
2,4,10,2,10,1334,1638,-304
2,4,11,2,10,1450,1641,-191
2,4,12,2,10,1569,1664,-95
2,4,13,2,10,1691,1722,-31
2,4,14,2,10,1799,1795,4
2,5,0,2,10,1828,2010,-182
2,5,1,2,10,1730,1981,-251
2,5,2,2,10,1618,1951,-333
2,5,3,2,10,1523,1985,-462
2,5,4,2,10,1449,2102,-653
2,5,5,2,10,1370,2234,-864
2,5,6,2,10,1313,2317,-1004
2,5,7,2,10,1309,2333,-1024
2,5,8,2,10,1336,2322,-986
2,5,9,2,10,1350,2308,-958
2,5,10,2,10,1407,2247,-840
2,5,11,2,10,1484,2191,-707
2,5,12,2,10,1576,2167,-591
2,5,13,2,10,1676,2150,-474
2,5,14,2,10,1765,2162,-397
2,6,0,2,10,1743,1740,3
2,6,1,2,10,1659,1667,-8
2,6,2,2,10,1578,1630,-52
2,6,3,2,10,1547,1625,-78
2,6,4,2,10,1576,1678,-102
2,6,5,2,10,1614,1739,-125
2,6,6,2,10,1639,1781,-142
2,6,7,2,10,1666,1795,-129
2,6,8,2,10,1653,1804,-151
2,6,9,2,10,1639,1800,-161
2,6,10,2,10,1638,1764,-126
2,6,11,2,10,1641,1755,-114
2,6,12,2,10,1664,1770,-106
2,6,13,2,10,1722,1779,-57
2,6,14,2,10,1795,1839,-44
2,7,0,2,10,2010,1699,311
2,7,1,2,10,1981,1650,331
2,7,2,2,10,1951,1692,259
2,7,3,2,10,1985,1727,258
2,7,4,2,10,2102,1768,334
2,7,5,2,10,2234,1730,504
2,7,6,2,10,2317,1739,578
2,7,7,2,10,2333,1776,557
2,7,8,2,10,2322,1767,555
2,7,9,2,10,2308,1731,577
2,7,10,2,10,2247,1729,518
2,7,11,2,10,2191,1734,457
2,7,12,2,10,2167,1721,446
2,7,13,2,10,2150,1732,418
2,7,14,2,10,2162,1781,381
2,8,0,2,10,1740,2827,-1087
2,8,1,2,10,1667,2910,-1243
2,8,2,2,10,1630,3063,-1433
2,8,3,2,10,1625,3229,-1604
2,8,4,2,10,1678,3362,-1684
2,8,5,2,10,1739,3269,-1530
2,8,6,2,10,1781,3294,-1513
2,8,7,2,10,1795,3335,-1540
2,8,8,2,10,1804,3333,-1529
2,8,9,2,10,1800,3271,-1471
2,8,10,2,10,1764,3296,-1532
2,8,11,2,10,1755,3298,-1543
2,8,12,2,10,1770,3252,-1482
2,8,13,2,10,1779,3208,-1429
2,8,14,2,10,1839,3116,-1277
2,9,0,2,10,1699,3473,-1774
2,9,1,2,10,1650,3491,-1841
2,9,2,2,10,1692,3537,-1845
2,9,3,2,10,1727,3665,-1938
2,9,4,2,10,1768,3727,-1959
2,9,5,2,10,1730,3524,-1794
2,9,6,2,10,1739,3496,-1757
2,9,7,2,10,1776,3553,-1777
2,9,8,2,10,1767,3573,-1806
2,9,9,2,10,1731,3509,-1778
2,9,10,2,10,1729,3653,-1924
2,9,11,2,10,1734,3776,-2042
2,9,12,2,10,1721,3849,-2128
2,9,13,2,10,1732,3899,-2167
2,9,14,2,10,1781,3853,-2072
2,10,0,2,10,2827,3476,-649
2,10,1,2,10,2910,3399,-489
2,10,2,2,10,3063,3301,-238
2,10,3,2,10,3229,3328,-99
2,10,4,2,10,3362,3286,76
2,10,5,2,10,3269,3056,213
2,10,6,2,10,3294,2918,376
2,10,7,2,10,3335,3035,300
2,10,8,2,10,3333,3033,300
2,10,9,2,10,3271,2970,301
2,10,10,2,10,3296,3194,102
2,10,11,2,10,3298,3369,-71
2,10,12,2,10,3252,3546,-294
2,10,13,2,10,3208,3701,-493
2,10,14,2,10,3116,3759,-643
2,11,0,2,10,3473,3428,45
2,11,1,2,10,3491,3363,128
2,11,2,2,10,3537,3221,316
2,11,3,2,10,3665,3215,450
2,11,4,2,10,3727,3178,549
2,11,5,2,10,3524,3010,514
2,11,6,2,10,3496,2815,681
2,11,7,2,10,3553,2992,561
2,11,8,2,10,3573,2925,648
2,11,9,2,10,3509,2888,621
2,11,10,2,10,3653,3114,539
2,11,11,2,10,3776,3211,565
2,11,12,2,10,3849,3408,441
2,11,13,2,10,3899,3587,312
2,11,14,2,10,3853,3667,186
2,12,0,2,10,3476,3418,58
2,12,1,2,10,3399,3365,34
2,12,2,2,10,3301,3214,87
2,12,3,2,10,3328,3206,122
2,12,4,2,10,3286,3169,117
2,12,5,2,10,3056,2976,80
2,12,6,2,10,2918,2787,131
2,12,7,2,10,3035,2976,59
2,12,8,2,10,3033,2859,174
2,12,9,2,10,2970,2862,108
2,12,10,2,10,3194,3115,79
2,12,11,2,10,3369,3172,197
2,12,12,2,10,3546,3378,168
2,12,13,2,10,3701,3551,150
2,12,14,2,10,3759,3642,117
2,13,0,2,10,3428,3328,100
2,13,1,2,10,3363,3309,54
2,13,2,2,10,3221,3214,7
2,13,3,2,10,3215,3264,-49
2,13,4,2,10,3178,3230,-52
2,13,5,2,10,3010,2988,22
2,13,6,2,10,2815,2823,-8
2,13,7,2,10,2992,3038,-46
2,13,8,2,10,2925,2894,31
2,13,9,2,10,2888,2853,35
2,13,10,2,10,3114,3103,11
2,13,11,2,10,3211,3173,38
2,13,12,2,10,3408,3351,57
2,13,13,2,10,3587,3422,165
2,13,14,2,10,3667,3499,168
2,14,0,2,10,3418,3008,410
2,14,1,2,10,3365,3019,346
2,14,2,2,10,3214,2991,223
2,14,3,2,10,3206,3063,143
2,14,4,2,10,3169,2993,176
2,14,5,2,10,2976,2726,250
2,14,6,2,10,2787,2600,187
2,14,7,2,10,2976,2854,122
2,14,8,2,10,2859,2706,153
2,14,9,2,10,2862,2535,327
2,14,10,2,10,3115,2734,381
2,14,11,2,10,3172,2837,335
2,14,12,2,10,3378,3010,368
2,14,13,2,10,3551,3010,541
2,14,14,2,10,3642,3110,532
2,15,0,2,10,3328,2673,655
2,15,1,2,10,3309,2628,681
2,15,2,2,10,3214,2612,602
2,15,3,2,10,3264,2663,601
2,15,4,2,10,3230,2491,739
2,15,5,2,10,2988,2210,778
2,15,6,2,10,2823,2062,761
2,15,7,2,10,3038,2190,848
2,15,8,2,10,2894,2150,744
2,15,9,2,10,2853,1990,863
2,15,10,2,10,3103,2131,972
2,15,11,2,10,3173,2320,853
2,15,12,2,10,3351,2499,852
2,15,13,2,10,3422,2483,939
2,15,14,2,10,3499,2601,898
2,16,0,2,10,3008,2582,426
2,16,1,2,10,3019,2503,516
2,16,2,2,10,2991,2536,455
2,16,3,2,10,3063,2621,442
2,16,4,2,10,2993,2435,558
2,16,5,2,10,2726,2280,446
2,16,6,2,10,2600,2168,432
2,16,7,2,10,2854,2282,572
2,16,8,2,10,2706,2421,285
2,16,9,2,10,2535,2264,271
2,16,10,2,10,2734,2256,478
2,16,11,2,10,2837,2400,437
2,16,12,2,10,3010,2428,582
2,16,13,2,10,3010,2318,692
2,16,14,2,10,3110,2408,702
2,17,0,2,10,2673,2641,32
2,17,1,2,10,2628,2572,56
2,17,2,2,10,2612,2657,-45
2,17,3,2,10,2663,2795,-132
2,17,4,2,10,2491,2634,-143
2,17,5,2,10,2210,2601,-391
2,17,6,2,10,2062,2618,-556
2,17,7,2,10,2190,2799,-609
2,17,8,2,10,2150,2849,-699
2,17,9,2,10,1990,2535,-545
2,17,10,2,10,2131,2420,-289
2,17,11,2,10,2320,2449,-129
2,17,12,2,10,2499,2322,177
2,17,13,2,10,2483,2141,342
2,17,14,2,10,2601,2250,351
2,18,0,2,10,2582,2353,229
2,18,1,2,10,2503,2139,364
2,18,2,2,10,2536,2155,381
2,18,3,2,10,2621,2238,383
2,18,4,2,10,2435,1955,480
2,18,5,2,10,2280,1904,376
2,18,6,2,10,2168,1959,209
2,18,7,2,10,2282,2009,273
2,18,8,2,10,2421,1936,485
2,18,9,2,10,2264,1650,614
2,18,10,2,10,2256,1638,618
2,18,11,2,10,2400,1723,677
2,18,12,2,10,2428,1693,735
2,18,13,2,10,2318,1604,714
2,18,14,2,10,2408,1806,602
2,19,0,2,10,2641,1805,836
2,19,1,2,10,2572,1601,971
2,19,2,2,10,2657,1560,1097
2,19,3,2,10,2795,1599,1196
2,19,4,2,10,2634,1363,1271
2,19,5,2,10,2601,1318,1283
2,19,6,2,10,2618,1402,1216
2,19,7,2,10,2799,1454,1345
2,19,8,2,10,2849,1415,1434
2,19,9,2,10,2535,1194,1341
2,19,10,2,10,2420,1246,1174
2,19,11,2,10,2449,1299,1150
2,19,12,2,10,2322,1337,985
2,19,13,2,10,2141,1283,858
2,19,14,2,10,2250,1393,857
2,20,0,2,10,2353,1573,780
2,20,1,2,10,2139,1490,649
2,20,2,2,10,2155,1468,687
2,20,3,2,10,2238,1586,652
2,20,4,2,10,1955,1570,385
2,20,5,2,10,1904,1586,318
2,20,6,2,10,1959,1676,283
2,20,7,2,10,2009,1802,207
2,20,8,2,10,1936,1764,172
2,20,9,2,10,1650,1549,101
2,20,10,2,10,1638,1530,108
2,20,11,2,10,1723,1507,216
2,20,12,2,10,1693,1473,220
2,20,13,2,10,1604,1353,251
2,20,14,2,10,1806,1283,523
2,0,0,3,10,3235,2976,259
2,0,1,3,10,3228,2817,411
2,0,2,3,10,3207,2632,575
2,0,3,3,10,3203,2459,744
2,0,4,3,10,3207,2293,914
2,0,5,3,10,3193,2107,1086
2,0,6,3,10,3189,1944,1245
2,0,7,3,10,3205,1873,1332
2,0,8,3,10,3192,1875,1317
2,0,9,3,10,3188,1984,1204
2,0,10,3,10,3183,2147,1036
2,0,11,3,10,3170,2304,866
2,0,12,3,10,3182,2464,718
2,0,13,3,10,3209,2635,574
2,0,14,3,10,3204,2791,413
2,1,0,3,10,3224,2811,413
2,1,1,3,10,3179,2647,532
2,1,2,3,10,3109,2461,648
2,1,3,3,10,3051,2296,755
2,1,4,3,10,3008,2152,856
2,1,5,3,10,2954,1994,960
2,1,6,3,10,2908,1865,1043
2,1,7,3,10,2908,1826,1082
2,1,8,3,10,2883,1852,1031
2,1,9,3,10,2918,1918,1000
2,1,10,3,10,2960,2047,913
2,1,11,3,10,2992,2191,801
2,1,12,3,10,3044,2348,696
2,1,13,3,10,3113,2517,596
2,1,14,3,10,3157,2671,486
2,2,0,3,10,3134,2697,437
2,2,1,3,10,3025,2566,459
2,2,2,3,10,2889,2428,461
2,2,3,3,10,2765,2342,423
2,2,4,3,10,2654,2317,337
2,2,5,3,10,2528,2295,233
2,2,6,3,10,2411,2277,134
2,2,7,3,10,2363,2290,73
2,2,8,3,10,2337,2296,41
2,2,9,3,10,2428,2294,134
2,2,10,3,10,2546,2332,214
2,2,11,3,10,2648,2384,264
2,2,12,3,10,2757,2461,296
2,2,13,3,10,2884,2572,312
2,2,14,3,10,2995,2688,307
2,3,0,3,10,2976,2884,92
2,3,1,3,10,2817,2804,13
2,3,2,3,10,2632,2719,-87
2,3,3,3,10,2459,2713,-254
2,3,4,3,10,2293,2810,-517
2,3,5,3,10,2107,2923,-816
2,3,6,3,10,1944,2992,-1048
2,3,7,3,10,1873,3018,-1145
2,3,8,3,10,1875,3015,-1140
2,3,9,3,10,1984,3003,-1019
2,3,10,3,10,2147,2960,-813
2,3,11,3,10,2304,2932,-628
2,3,12,3,10,2464,2946,-482
2,3,13,3,10,2635,2976,-341
2,3,14,3,10,2791,3034,-243
2,4,0,3,10,2811,2609,202
2,4,1,3,10,2647,2503,144
2,4,2,3,10,2461,2440,21
2,4,3,3,10,2296,2444,-148
2,4,4,3,10,2152,2546,-394
2,4,5,3,10,1994,2664,-670
2,4,6,3,10,1865,2745,-880
2,4,7,3,10,1826,2776,-950
2,4,8,3,10,1852,2764,-912
2,4,9,3,10,1918,2744,-826
2,4,10,3,10,2047,2689,-642
2,4,11,3,10,2191,2655,-464
2,4,12,3,10,2348,2655,-307
2,4,13,3,10,2517,2675,-158
2,4,14,3,10,2671,2762,-91
2,5,0,3,10,2697,2840,-143
2,5,1,3,10,2566,2795,-229
2,5,2,3,10,2428,2833,-405
2,5,3,3,10,2342,2893,-551
2,5,4,3,10,2317,3002,-685
2,5,5,3,10,2295,3039,-744
2,5,6,3,10,2277,3092,-815
2,5,7,3,10,2290,3128,-838
2,5,8,3,10,2296,3129,-833
2,5,9,3,10,2294,3095,-801
2,5,10,3,10,2332,3051,-719
2,5,11,3,10,2384,3025,-641
2,5,12,3,10,2461,3003,-542
2,5,13,3,10,2572,2986,-414
2,5,14,3,10,2688,3020,-332
2,6,0,3,10,2884,3426,-542
2,6,1,3,10,2804,3432,-628
2,6,2,3,10,2719,3552,-833
2,6,3,3,10,2713,3688,-975
2,6,4,3,10,2810,3806,-996
2,6,5,3,10,2923,3699,-776
2,6,6,3,10,2992,3722,-730
2,6,7,3,10,3018,3778,-760
2,6,8,3,10,3015,3775,-760
2,6,9,3,10,3003,3707,-704
2,6,10,3,10,2960,3738,-778
2,6,11,3,10,2932,3762,-830
2,6,12,3,10,2946,3740,-794
2,6,13,3,10,2976,3733,-757
2,6,14,3,10,3034,3716,-682
2,7,0,3,10,2609,4573,-1964
2,7,1,3,10,2503,4619,-2116
2,7,2,3,10,2440,4740,-2300
2,7,3,3,10,2444,4933,-2489
2,7,4,3,10,2546,5051,-2505
2,7,5,3,10,2664,4824,-2160
2,7,6,3,10,2745,4807,-2062
2,7,7,3,10,2776,4886,-2110
2,7,8,3,10,2764,4898,-2134
2,7,9,3,10,2744,4804,-2060
2,7,10,3,10,2689,4940,-2251
2,7,11,3,10,2655,5046,-2391
2,7,12,3,10,2655,5082,-2427
2,7,13,3,10,2675,5106,-2431
2,7,14,3,10,2762,5034,-2272
2,8,0,3,10,2840,5203,-2363
2,8,1,3,10,2795,5181,-2386
2,8,2,3,10,2833,5161,-2328
2,8,3,3,10,2893,5289,-2396
2,8,4,3,10,3002,5324,-2322
2,8,5,3,10,3039,5025,-1986
2,8,6,3,10,3092,4901,-1809
2,8,7,3,10,3128,5037,-1909
2,8,8,3,10,3129,5041,-1912
2,8,9,3,10,3095,4946,-1851
2,8,10,3,10,3051,5203,-2152
2,8,11,3,10,3025,5397,-2372
2,8,12,3,10,3003,5565,-2562
2,8,13,3,10,2986,5702,-2716
2,8,14,3,10,3020,5694,-2674
2,9,0,3,10,3426,5174,-1748
2,9,1,3,10,3432,5072,-1640
2,9,2,3,10,3552,4898,-1346
2,9,3,3,10,3688,4919,-1231
2,9,4,3,10,3806,4867,-1061
2,9,5,3,10,3699,4565,-866
2,9,6,3,10,3722,4328,-606
2,9,7,3,10,3778,4543,-765
2,9,8,3,10,3775,4490,-715
2,9,9,3,10,3707,4421,-714
2,9,10,3,10,3738,4758,-1020
2,9,11,3,10,3762,4959,-1197
2,9,12,3,10,3740,5238,-1498
2,9,13,3,10,3733,5485,-1752
2,9,14,3,10,3716,5585,-1869
2,10,0,3,10,4573,5148,-575
2,10,1,3,10,4619,5055,-436
2,10,2,3,10,4740,4838,-98
2,10,3,3,10,4933,4830,103
2,10,4,3,10,5051,4766,285
2,10,5,3,10,4824,4477,347
2,10,6,3,10,4807,4192,615
2,10,7,3,10,4886,4460,426
2,10,8,3,10,4898,4327,571
2,10,9,3,10,4804,4299,505
2,10,10,3,10,4940,4665,275
2,10,11,3,10,5046,4793,253
2,10,12,3,10,5082,5094,-12
2,10,13,3,10,5106,5354,-248
2,10,14,3,10,5034,5483,-449
2,11,0,3,10,5203,5026,177
2,11,1,3,10,5181,4982,199
2,11,2,3,10,5161,4811,350
2,11,3,3,10,5289,4855,434
2,11,4,3,10,5324,4811,513
2,11,5,3,10,5025,4497,528
2,11,6,3,10,4901,4233,668
2,11,7,3,10,5037,4546,491
2,11,8,3,10,5041,4351,690
2,11,9,3,10,4946,4304,642
2,11,10,3,10,5203,4667,536
2,11,11,3,10,5397,4763,634
2,11,12,3,10,5565,5043,522
2,11,13,3,10,5702,5206,496
2,11,14,3,10,5694,5325,369
2,12,0,3,10,5174,4728,446
2,12,1,3,10,5072,4711,361
2,12,2,3,10,4898,4608,290
2,12,3,3,10,4919,4678,241
2,12,4,3,10,4867,4581,286
2,12,5,3,10,4565,4193,372
2,12,6,3,10,4328,3977,351
2,12,7,3,10,4543,4322,221
2,12,8,3,10,4490,4108,382
2,12,9,3,10,4421,3946,475
2,12,10,3,10,4758,4285,473
2,12,11,3,10,4959,4419,540
2,12,12,3,10,5238,4696,542
2,12,13,3,10,5485,4777,708
2,12,14,3,10,5585,4926,659
2,13,0,3,10,5148,4281,867
2,13,1,3,10,5055,4245,810
2,13,2,3,10,4838,4209,629
2,13,3,3,10,4830,4312,518
2,13,4,3,10,4766,4133,633
2,13,5,3,10,4477,3731,746
2,13,6,3,10,4192,3508,684
2,13,7,3,10,4460,3760,700
2,13,8,3,10,4327,3642,685
2,13,9,3,10,4299,3432,867
2,13,10,3,10,4665,3683,982
2,13,11,3,10,4793,3911,882
2,13,12,3,10,5094,4164,930
2,13,13,3,10,5354,4138,1216
2,13,14,3,10,5483,4284,1199
2,14,0,3,10,5026,3982,1044
2,14,1,3,10,4982,3905,1077
2,14,2,3,10,4811,3930,881
2,14,3,3,10,4855,4035,820
2,14,4,3,10,4811,3786,1025
2,14,5,3,10,4497,3485,1012
2,14,6,3,10,4233,3322,911
2,14,7,3,10,4546,3566,980
2,14,8,3,10,4351,3635,716
2,14,9,3,10,4304,3357,947
2,14,10,3,10,4667,3438,1229
2,14,11,3,10,4763,3646,1117
2,14,12,3,10,5043,3773,1270
2,14,13,3,10,5206,3673,1533
2,14,14,3,10,5325,3835,1490
2,15,0,3,10,4728,3914,814
2,15,1,3,10,4711,3798,913
2,15,2,3,10,4608,3875,733
2,15,3,3,10,4678,4044,634
2,15,4,3,10,4581,3774,807
2,15,5,3,10,4193,3606,587
2,15,6,3,10,3977,3526,451
2,15,7,3,10,4322,3705,617
2,15,8,3,10,4108,3785,323
2,15,9,3,10,3946,3432,514
2,15,10,3,10,4285,3369,916
2,15,11,3,10,4419,3523,896
2,15,12,3,10,4696,3476,1220
2,15,13,3,10,4777,3269,1508
2,15,14,3,10,4926,3424,1502
2,16,0,3,10,4281,3662,619
2,16,1,3,10,4245,3416,829
2,16,2,3,10,4209,3473,736
2,16,3,3,10,4312,3610,702
2,16,4,3,10,4133,3250,883
2,16,5,3,10,3731,3179,552
2,16,6,3,10,3508,3219,289
2,16,7,3,10,3760,3385,375
2,16,8,3,10,3642,3421,221
2,16,9,3,10,3432,3017,415
2,16,10,3,10,3683,2945,738
2,16,11,3,10,3911,3049,862
2,16,12,3,10,4164,2967,1197
2,16,13,3,10,4138,2794,1344
2,16,14,3,10,4284,3040,1244
2,17,0,3,10,3982,3137,845
2,17,1,3,10,3905,2896,1009
2,17,2,3,10,3930,2899,1031
2,17,3,3,10,4035,3022,1013
2,17,4,3,10,3786,2702,1084
2,17,5,3,10,3485,2644,841
2,17,6,3,10,3322,2760,562
2,17,7,3,10,3566,2877,689
2,17,8,3,10,3635,2779,856
2,17,9,3,10,3357,2362,995
2,17,10,3,10,3438,2359,1079
2,17,11,3,10,3646,2422,1224
2,17,12,3,10,3773,2385,1388
2,17,13,3,10,3673,2234,1439
2,17,14,3,10,3835,2409,1426
2,18,0,3,10,3914,2594,1320
2,18,1,3,10,3798,2334,1464
2,18,2,3,10,3875,2284,1591
2,18,3,3,10,4044,2401,1643
2,18,4,3,10,3774,2186,1588
2,18,5,3,10,3606,2164,1442
2,18,6,3,10,3526,2277,1249
2,18,7,3,10,3705,2388,1317
2,18,8,3,10,3785,2336,1449
2,18,9,3,10,3432,2031,1401
2,18,10,3,10,3369,2055,1314
2,18,11,3,10,3523,2107,1416
2,18,12,3,10,3476,2118,1358
2,18,13,3,10,3269,2006,1263
2,18,14,3,10,3424,2073,1351
2,0,0,4,10,4274,3680,594
2,0,1,4,10,4221,3483,738
2,0,2,4,10,4146,3271,875
2,0,3,4,10,4094,3115,979
2,0,4,4,10,4056,3020,1036
2,0,5,4,10,3995,2919,1076
2,0,6,4,10,3943,2829,1114
2,0,7,4,10,3937,2807,1130
2,0,8,4,10,3908,2812,1096
2,0,9,4,10,3949,2862,1087
2,0,10,4,10,3996,2972,1024
2,0,11,4,10,4024,3091,933
2,0,12,4,10,4077,3233,844
2,0,13,4,10,4153,3413,740
2,0,14,4,10,4196,3594,602
2,1,0,4,10,4207,3838,369
2,1,1,4,10,4096,3711,385
2,1,2,4,10,3952,3569,383
2,1,3,4,10,3824,3508,316
2,1,4,4,10,3711,3551,160
2,1,5,4,10,3578,3604,-26
2,1,6,4,10,3460,3630,-170
2,1,7,4,10,3425,3642,-217
2,1,8,4,10,3399,3658,-259
2,1,9,4,10,3486,3658,-172
2,1,10,4,10,3600,3654,-54
2,1,11,4,10,3699,3675,24
2,1,12,4,10,3816,3743,73
2,1,13,4,10,3954,3826,128
2,1,14,4,10,4063,3927,136
2,2,0,4,10,4088,3483,605
2,2,1,4,10,3932,3326,606
2,2,2,4,10,3739,3208,531
2,2,3,4,10,3560,3172,388
2,2,4,4,10,3395,3254,141
2,2,5,4,10,3209,3353,-144
2,2,6,4,10,3049,3420,-371
2,2,7,4,10,2987,3461,-474
2,2,8,4,10,2980,3457,-477
2,2,9,4,10,3083,3439,-356
2,2,10,4,10,3240,3402,-162
2,2,11,4,10,3391,3396,-5
2,2,12,4,10,3554,3434,120
2,2,13,4,10,3734,3501,233
2,2,14,4,10,3888,3634,254
2,3,0,4,10,3850,3709,141
2,3,1,4,10,3640,3631,9
2,3,2,4,10,3400,3643,-243
2,3,3,4,10,3187,3712,-525
2,3,4,4,10,3001,3870,-869
2,3,5,4,10,2796,3964,-1168
2,3,6,4,10,2619,4056,-1437
2,3,7,4,10,2558,4109,-1551
2,3,8,4,10,2568,4089,-1521
2,3,9,4,10,2679,4039,-1360
2,3,10,4,10,2860,3976,-1116
2,3,11,4,10,3045,3925,-880
2,3,12,4,10,3243,3888,-645
2,3,13,4,10,3461,3882,-421
2,3,14,4,10,3663,3943,-280
2,4,0,4,10,3680,4567,-887
2,4,1,4,10,3483,4577,-1094
2,4,2,4,10,3271,4693,-1422
2,4,3,4,10,3115,4854,-1739
2,4,4,4,10,3020,5040,-2020
2,4,5,4,10,2919,5008,-2089
2,4,6,4,10,2829,5075,-2246
2,4,7,4,10,2807,5130,-2323
2,4,8,4,10,2812,5137,-2325
2,4,9,4,10,2862,5071,-2209
2,4,10,4,10,2972,5060,-2088
2,4,11,4,10,3091,5053,-1962
2,4,12,4,10,3233,5022,-1789
2,4,13,4,10,3413,4987,-1574
2,4,14,4,10,3594,4955,-1361
2,5,0,4,10,3838,5172,-1334
2,5,1,4,10,3711,5141,-1430
2,5,2,4,10,3569,5229,-1660
2,5,3,4,10,3508,5392,-1884
2,5,4,4,10,3551,5495,-1944
2,5,5,4,10,3604,5254,-1650
2,5,6,4,10,3630,5235,-1605
2,5,7,4,10,3642,5329,-1687
2,5,8,4,10,3658,5340,-1682
2,5,9,4,10,3658,5240,-1582
2,5,10,4,10,3654,5382,-1728
2,5,11,4,10,3675,5510,-1835
2,5,12,4,10,3743,5570,-1827
2,5,13,4,10,3826,5631,-1805
2,5,14,4,10,3927,5634,-1707
2,6,0,4,10,3483,6303,-2820
2,6,1,4,10,3326,6309,-2983
2,6,2,4,10,3208,6364,-3156
2,6,3,4,10,3172,6557,-3385
2,6,4,4,10,3254,6648,-3394
2,6,5,4,10,3353,6325,-2972
2,6,6,4,10,3420,6212,-2792
2,6,7,4,10,3461,6370,-2909
2,6,8,4,10,3457,6366,-2909
2,6,9,4,10,3439,6241,-2802
2,6,10,4,10,3402,6490,-3088
2,6,11,4,10,3396,6667,-3271
2,6,12,4,10,3434,6798,-3364
2,6,13,4,10,3501,6909,-3408
2,6,14,4,10,3634,6875,-3241
2,7,0,4,10,3709,6901,-3192
2,7,1,4,10,3631,6854,-3223
2,7,2,4,10,3643,6758,-3115
2,7,3,4,10,3712,6880,-3168
2,7,4,4,10,3870,6905,-3035
2,7,5,4,10,3964,6534,-2570
2,7,6,4,10,4056,6311,-2255
2,7,7,4,10,4109,6545,-2436
2,7,8,4,10,4089,6498,-2409
2,7,9,4,10,4039,6397,-2358
2,7,10,4,10,3976,6767,-2791
2,7,11,4,10,3925,6987,-3062
2,7,12,4,10,3888,7257,-3369
2,7,13,4,10,3882,7486,-3604
2,7,14,4,10,3943,7520,-3577
2,8,0,4,10,4567,6894,-2327
2,8,1,4,10,4577,6764,-2187
2,8,2,4,10,4693,6515,-1822
2,8,3,4,10,4854,6534,-1680
2,8,4,4,10,5040,6455,-1415
2,8,5,4,10,5008,6032,-1024
2,8,6,4,10,5075,5705,-630
2,8,7,4,10,5130,6011,-881
2,8,8,4,10,5137,5892,-755
2,8,9,4,10,5071,5832,-761
2,8,10,4,10,5060,6309,-1249
2,8,11,4,10,5053,6541,-1488
2,8,12,4,10,5022,6924,-1902
2,8,13,4,10,4987,7252,-2265
2,8,14,4,10,4955,7401,-2446
2,9,0,4,10,5172,6756,-1584
2,9,1,4,10,5141,6672,-1531
2,9,2,4,10,5229,6435,-1206
2,9,3,4,10,5392,6479,-1087
2,9,4,4,10,5495,6408,-913
2,9,5,4,10,5254,5998,-744
2,9,6,4,10,5235,5638,-403
2,9,7,4,10,5329,6030,-701
2,9,8,4,10,5340,5819,-479
2,9,9,4,10,5240,5741,-501
2,9,10,4,10,5382,6217,-835
2,9,11,4,10,5510,6384,-874
2,9,12,4,10,5570,6759,-1189
2,9,13,4,10,5631,7009,-1378
2,9,14,4,10,5634,7166,-1532
2,10,0,4,10,6303,6426,-123
2,10,1,4,10,6309,6384,-75
2,10,2,4,10,6364,6205,159
2,10,3,4,10,6557,6269,288
2,10,4,4,10,6648,6162,486
2,10,5,4,10,6325,5702,623
2,10,6,4,10,6212,5387,825
2,10,7,4,10,6370,5830,540
2,10,8,4,10,6366,5565,801
2,10,9,4,10,6241,5397,844
2,10,10,4,10,6490,5849,641
2,10,11,4,10,6667,6009,658
2,10,12,4,10,6798,6388,410
2,10,13,4,10,6909,6561,348
2,10,14,4,10,6875,6752,123
2,11,0,4,10,6901,6001,900
2,11,1,4,10,6854,5937,917
2,11,2,4,10,6758,5826,932
2,11,3,4,10,6880,5927,953
2,11,4,4,10,6905,5721,1184
2,11,5,4,10,6534,5198,1336
2,11,6,4,10,6311,4885,1426
2,11,7,4,10,6545,5228,1317
2,11,8,4,10,6498,5044,1454
2,11,9,4,10,6397,4843,1554
2,11,10,4,10,6767,5234,1533
2,11,11,4,10,6987,5493,1494
2,11,12,4,10,7257,5850,1407
2,11,13,4,10,7486,5905,1581
2,11,14,4,10,7520,6100,1420
2,12,0,4,10,6894,5590,1304
2,12,1,4,10,6764,5522,1242
2,12,2,4,10,6515,5527,988
2,12,3,4,10,6534,5684,850
2,12,4,4,10,6455,5428,1027
2,12,5,4,10,6032,5006,1026
2,12,6,4,10,5705,4768,937
2,12,7,4,10,6011,5136,875
2,12,8,4,10,5892,5127,765
2,12,9,4,10,5832,4799,1033
2,12,10,4,10,6309,4990,1319
2,12,11,4,10,6541,5237,1304
2,12,12,4,10,6924,5438,1486
2,12,13,4,10,7252,5328,1924
2,12,14,4,10,7401,5518,1883
2,13,0,4,10,6756,5314,1442
2,13,1,4,10,6672,5200,1472
2,13,2,4,10,6435,5269,1166
2,13,3,4,10,6479,5458,1021
2,13,4,4,10,6408,5125,1283
2,13,5,4,10,5998,4811,1187
2,13,6,4,10,5638,4680,958
2,13,7,4,10,6030,4989,1041
2,13,8,4,10,5819,4999,820
2,13,9,4,10,5741,4525,1216
2,13,10,4,10,6217,4551,1666
2,13,11,4,10,6384,4769,1615
2,13,12,4,10,6759,4821,1938
2,13,13,4,10,7009,4624,2385
2,13,14,4,10,7166,4851,2315
2,14,0,4,10,6426,4935,1491
2,14,1,4,10,6384,4642,1742
2,14,2,4,10,6205,4691,1514
2,14,3,4,10,6269,4859,1410
2,14,4,4,10,6162,4390,1772
2,14,5,4,10,5702,4184,1518
2,14,6,4,10,5387,4127,1260
2,14,7,4,10,5830,4291,1539
2,14,8,4,10,5565,4357,1208
2,14,9,4,10,5397,3914,1483
2,14,10,4,10,5849,3894,1955
2,14,11,4,10,6009,4123,1886
2,14,12,4,10,6388,4121,2267
2,14,13,4,10,6561,3922,2639
2,14,14,4,10,6752,4214,2538
2,15,0,4,10,6001,4446,1555
2,15,1,4,10,5937,4173,1764
2,15,2,4,10,5826,4217,1609
2,15,3,4,10,5927,4394,1533
2,15,4,4,10,5721,3997,1724
2,15,5,4,10,5198,3919,1279
2,15,6,4,10,4885,4020,865
2,15,7,4,10,5228,4253,975
2,15,8,4,10,5044,4264,780
2,15,9,4,10,4843,3729,1114
2,15,10,4,10,5234,3666,1568
2,15,11,4,10,5493,3748,1745
2,15,12,4,10,5850,3659,2191
2,15,13,4,10,5905,3424,2481
2,15,14,4,10,6100,3643,2457
2,16,0,4,10,5590,3926,1664
2,16,1,4,10,5522,3629,1893
2,16,2,4,10,5527,3623,1904
2,16,3,4,10,5684,3824,1860
2,16,4,4,10,5428,3525,1903
2,16,5,4,10,5006,3490,1516
2,16,6,4,10,4768,3635,1133
2,16,7,4,10,5136,3811,1325
2,16,8,4,10,5127,3700,1427
2,16,9,4,10,4799,3199,1600
2,16,10,4,10,4990,3168,1822
2,16,11,4,10,5237,3230,2007
2,16,12,4,10,5438,3166,2272
2,16,13,4,10,5328,2957,2371
2,16,14,4,10,5518,3089,2429
2,0,0,5,10,5257,4437,820
2,0,1,5,10,5138,4233,905
2,0,2,5,10,4989,4058,931
2,0,3,5,10,4867,3967,900
2,0,4,5,10,4759,3995,764
2,0,5,5,10,4619,4034,585
2,0,6,5,10,4495,4058,437
2,0,7,5,10,4454,4085,369
2,0,8,5,10,4424,4100,324
2,0,9,5,10,4517,4094,423
2,0,10,5,10,4636,4096,540
2,0,11,5,10,4731,4139,592
2,0,12,5,10,4849,4231,618
2,0,13,5,10,4994,4351,643
2,0,14,5,10,5102,4527,575
2,1,0,5,10,5161,4583,578
2,1,1,5,10,5003,4454,549
2,1,2,5,10,4802,4411,391
2,1,3,5,10,4619,4440,179
2,1,4,5,10,4452,4578,-126
2,1,5,5,10,4259,4653,-394
2,1,6,5,10,4098,4731,-633
2,1,7,5,10,4049,4794,-745
2,1,8,5,10,4042,4782,-740
2,1,9,5,10,4141,4734,-593
2,1,10,5,10,4294,4689,-395
2,1,11,5,10,4442,4666,-224
2,1,12,5,10,4613,4667,-54
2,1,13,5,10,4804,4708,96
2,1,14,5,10,4956,4815,141
2,2,0,5,10,4962,5436,-474
2,2,1,5,10,4755,5413,-658
2,2,2,5,10,4507,5503,-996
2,2,3,5,10,4288,5673,-1385
2,2,4,5,10,4103,5908,-1805
2,2,5,5,10,3898,5933,-2035
2,2,6,5,10,3724,6039,-2315
2,2,7,5,10,3672,6111,-2439
2,2,8,5,10,3673,6097,-2424
2,2,9,5,10,3778,6015,-2237
2,2,10,5,10,3953,5985,-2032
2,2,11,5,10,4132,5953,-1821
2,2,12,5,10,4333,5907,-1574
2,2,13,5,10,4560,5883,-1323
2,2,14,5,10,4760,5878,-1118
2,3,0,5,10,4719,6313,-1594
2,3,1,5,10,4476,6286,-1810
2,3,2,5,10,4210,6370,-2160
2,3,3,5,10,4006,6558,-2552
2,3,4,5,10,3869,6729,-2860
2,3,5,5,10,3721,6563,-2842
2,3,6,5,10,3583,6588,-3005
2,3,7,5,10,3539,6681,-3142
2,3,8,5,10,3528,6702,-3174
2,3,9,5,10,3623,6604,-2981
2,3,10,5,10,3785,6704,-2919
2,3,11,5,10,3945,6801,-2856
2,3,12,5,10,4128,6852,-2724
2,3,13,5,10,4357,6885,-2528
2,3,14,5,10,4586,6873,-2287
2,4,0,5,10,4821,6902,-2081
2,4,1,5,10,4628,6831,-2203
2,4,2,5,10,4412,6853,-2441
2,4,3,5,10,4281,7016,-2735
2,4,4,5,10,4254,7092,-2838
2,4,5,5,10,4228,6755,-2527
2,4,6,5,10,4182,6640,-2458
2,4,7,5,10,4159,6813,-2654
2,4,8,5,10,4174,6808,-2634
2,4,9,5,10,4226,6677,-2451
2,4,10,5,10,4294,6932,-2638
2,4,11,5,10,4382,7131,-2749
2,4,12,5,10,4515,7286,-2771
2,4,13,5,10,4667,7434,-2767
2,4,14,5,10,4833,7475,-2642
2,5,0,5,10,4437,8001,-3564
2,5,1,5,10,4233,7982,-3749
2,5,2,5,10,4058,7961,-3903
2,5,3,5,10,3967,8148,-4181
2,5,4,5,10,3995,8229,-4234
2,5,5,5,10,4034,7834,-3800
2,5,6,5,10,4058,7622,-3564
2,5,7,5,10,4085,7878,-3793
2,5,8,5,10,4100,7823,-3723
2,5,9,5,10,4094,7692,-3598
2,5,10,5,10,4096,8054,-3958
2,5,11,5,10,4139,8257,-4118
2,5,12,5,10,4231,8490,-4259
2,5,13,5,10,4351,8693,-4342
2,5,14,5,10,4527,8701,-4174
2,6,0,5,10,4583,8621,-4038
2,6,1,5,10,4454,8546,-4092
2,6,2,5,10,4411,8375,-3964
2,6,3,5,10,4440,8495,-4055
2,6,4,5,10,4578,8493,-3915
2,6,5,5,10,4653,8001,-3348
2,6,6,5,10,4731,7688,-2957
2,6,7,5,10,4794,8013,-3219
2,6,8,5,10,4782,7900,-3118
2,6,9,5,10,4734,7808,-3074
2,6,10,5,10,4689,8318,-3629
2,6,11,5,10,4666,8569,-3903
2,6,12,5,10,4667,8943,-4276
2,6,13,5,10,4708,9253,-4545
2,6,14,5,10,4815,9336,-4521
2,7,0,5,10,5436,8502,-3066
2,7,1,5,10,5413,8381,-2968
2,7,2,5,10,5503,8112,-2609
2,7,3,5,10,5673,8183,-2510
2,7,4,5,10,5908,8097,-2189
2,7,5,5,10,5933,7553,-1620
2,7,6,5,10,6039,7151,-1112
2,7,7,5,10,6111,7581,-1470
2,7,8,5,10,6097,7384,-1287
2,7,9,5,10,6015,7274,-1259
2,7,10,5,10,5985,7861,-1876
2,7,11,5,10,5953,8132,-2179
2,7,12,5,10,5907,8589,-2682
2,7,13,5,10,5883,8907,-3024
2,7,14,5,10,5878,9084,-3206
2,8,0,5,10,6313,8156,-1843
2,8,1,5,10,6286,8074,-1788
2,8,2,5,10,6370,7829,-1459
2,8,3,5,10,6558,7893,-1335
2,8,4,5,10,6729,7759,-1030
2,8,5,5,10,6563,7203,-640
2,8,6,5,10,6588,6792,-204
2,8,7,5,10,6681,7314,-633
2,8,8,5,10,6702,7033,-331
2,8,9,5,10,6604,6834,-230
2,8,10,5,10,6704,7399,-695
2,8,11,5,10,6801,7630,-829
2,8,12,5,10,6852,8104,-1252
2,8,13,5,10,6885,8364,-1479
2,8,14,5,10,6873,8593,-1720
2,9,0,5,10,6902,7699,-797
2,9,1,5,10,6831,7610,-779
2,9,2,5,10,6853,7423,-570
2,9,3,5,10,7016,7518,-502
2,9,4,5,10,7092,7302,-210
2,9,5,5,10,6755,6707,48
2,9,6,5,10,6640,6295,345
2,9,7,5,10,6813,6736,77
2,9,8,5,10,6808,6501,307
2,9,9,5,10,6677,6294,383
2,9,10,5,10,6932,6798,134
2,9,11,5,10,7131,7083,48
2,9,12,5,10,7286,7542,-256
2,9,13,5,10,7434,7689,-255
2,9,14,5,10,7475,7926,-451
2,10,0,5,10,8001,7310,691
2,10,1,5,10,7982,7214,768
2,10,2,5,10,7961,7144,817
2,10,3,5,10,8148,7299,849
2,10,4,5,10,8229,7016,1213
2,10,5,5,10,7834,6473,1361
2,10,6,5,10,7622,6145,1477
2,10,7,5,10,7878,6604,1274
2,10,8,5,10,7823,6529,1294
2,10,9,5,10,7692,6210,1482
2,10,10,5,10,8054,6541,1513
2,10,11,5,10,8257,6819,1438
2,10,12,5,10,8490,7124,1366
2,10,13,5,10,8693,7095,1598
2,10,14,5,10,8701,7334,1367
2,11,0,5,10,8621,6922,1699
2,11,1,5,10,8546,6817,1729
2,11,2,5,10,8375,6866,1509
2,11,3,5,10,8495,7107,1388
2,11,4,5,10,8493,6767,1726
2,11,5,5,10,8001,6332,1669
2,11,6,5,10,7688,6126,1562
2,11,7,5,10,8013,6559,1454
2,11,8,5,10,7900,6491,1409
2,11,9,5,10,7808,5967,1841
2,11,10,5,10,8318,6103,2215
2,11,11,5,10,8569,6360,2209
2,11,12,5,10,8943,6486,2457
2,11,13,5,10,9253,6279,2974
2,11,14,5,10,9336,6534,2802
2,12,0,5,10,8502,6335,2167
2,12,1,5,10,8381,6044,2337
2,12,2,5,10,8112,6085,2027
2,12,3,5,10,8183,6273,1910
2,12,4,5,10,8097,5741,2356
2,12,5,5,10,7553,5389,2164
2,12,6,5,10,7151,5281,1870
2,12,7,5,10,7581,5575,2006
2,12,8,5,10,7384,5571,1813
2,12,9,5,10,7274,5007,2267
2,12,10,5,10,7861,5076,2785
2,12,11,5,10,8132,5369,2763
2,12,12,5,10,8589,5466,3123
2,12,13,5,10,8907,5277,3630
2,12,14,5,10,9084,5641,3443
2,13,0,5,10,8156,5719,2437
2,13,1,5,10,8074,5399,2675
2,13,2,5,10,7829,5435,2394
2,13,3,5,10,7893,5643,2250
2,13,4,5,10,7759,5137,2622
2,13,5,5,10,7203,4924,2279
2,13,6,5,10,6792,4928,1864
2,13,7,5,10,7314,5159,2155
2,13,8,5,10,7033,5200,1833
2,13,9,5,10,6834,4626,2208
2,13,10,5,10,7399,4615,2784
2,13,11,5,10,7630,4822,2808
2,13,12,5,10,8104,4813,3291
2,13,13,5,10,8364,4552,3812
2,13,14,5,10,8593,4817,3776
2,14,0,5,10,7699,5235,2464
2,14,1,5,10,7610,4906,2704
2,14,2,5,10,7423,4941,2482
2,14,3,5,10,7518,5196,2322
2,14,4,5,10,7302,4820,2482
2,14,5,5,10,6707,4765,1942
2,14,6,5,10,6295,4895,1400
2,14,7,5,10,6736,5187,1549
2,14,8,5,10,6501,5185,1316
2,14,9,5,10,6294,4566,1728
2,14,10,5,10,6798,4475,2323
2,14,11,5,10,7083,4556,2527
2,14,12,5,10,7542,4440,3102
2,14,13,5,10,7689,4147,3542
2,14,14,5,10,7926,4323,3603
2,0,0,6,10,6211,6310,-99
2,0,1,6,10,6045,6236,-191
2,0,2,6,10,5839,6271,-432
2,0,3,6,10,5662,6401,-739
2,0,4,6,10,5500,6616,-1116
2,0,5,6,10,5300,6622,-1322
2,0,6,6,10,5133,6714,-1581
2,0,7,6,10,5078,6796,-1718
2,0,8,6,10,5067,6790,-1723
2,0,9,6,10,5172,6710,-1538
2,0,10,6,10,5330,6698,-1368
2,0,11,6,10,5474,6694,-1220
2,0,12,6,10,5646,6686,-1040
2,0,13,6,10,5844,6709,-865
2,0,14,6,10,5995,6750,-755
2,1,0,6,10,6035,7182,-1147
2,1,1,6,10,5826,7122,-1296
2,1,2,6,10,5570,7180,-1610
2,1,3,6,10,5347,7377,-2030
2,1,4,6,10,5160,7597,-2437
2,1,5,6,10,4948,7488,-2540
2,1,6,6,10,4773,7552,-2779
2,1,7,6,10,4734,7662,-2928
2,1,8,6,10,4735,7662,-2927
2,1,9,6,10,4836,7548,-2712
2,1,10,6,10,5007,7629,-2622
2,1,11,6,10,5183,7701,-2518
2,1,12,6,10,5392,7737,-2345
2,1,13,6,10,5630,7781,-2151
2,1,14,6,10,5828,7796,-1968
2,2,0,6,10,5831,8043,-2212
2,2,1,6,10,5591,7976,-2385
2,2,2,6,10,5317,7994,-2677
2,2,3,6,10,5107,8182,-3075
2,2,4,6,10,4971,8326,-3355
2,2,5,6,10,4823,8064,-3241
2,2,6,6,10,4688,7993,-3305
2,2,7,6,10,4653,8165,-3512
2,2,8,6,10,4633,8170,-3537
2,2,9,6,10,4722,8041,-3319
2,2,10,6,10,4878,8254,-3376
2,2,11,6,10,5032,8422,-3390
2,2,12,6,10,5218,8568,-3350
2,2,13,6,10,5456,8688,-3232
2,2,14,6,10,5683,8714,-3031
2,3,0,6,10,5860,8600,-2740
2,3,1,6,10,5621,8504,-2883
2,3,2,6,10,5351,8450,-3099
2,3,3,6,10,5172,8607,-3435
2,3,4,6,10,5103,8673,-3570
2,3,5,6,10,5030,8264,-3234
2,3,6,6,10,4936,8050,-3114
2,3,7,6,10,4891,8321,-3430
2,3,8,6,10,4890,8265,-3375
2,3,9,6,10,4987,8128,-3141
2,3,10,6,10,5107,8496,-3389
2,3,11,6,10,5236,8721,-3485
2,3,12,6,10,5410,8978,-3568
2,3,13,6,10,5611,9218,-3607
2,3,14,6,10,5825,9301,-3476
2,4,0,6,10,5420,9721,-4301
2,4,1,6,10,5150,9674,-4524
2,4,2,6,10,4901,9578,-4677
2,4,3,6,10,4740,9763,-5023
2,4,4,6,10,4698,9817,-5119
2,4,5,6,10,4658,9301,-4643
2,4,6,6,10,4610,8999,-4389
2,4,7,6,10,4602,9346,-4744
2,4,8,6,10,4616,9225,-4609
2,4,9,6,10,4662,9103,-4441
2,4,10,6,10,4736,9605,-4869
2,4,11,6,10,4846,9839,-4993
2,4,12,6,10,5003,10176,-5173
2,4,13,6,10,5192,10460,-5268
2,4,14,6,10,5433,10517,-5084
2,5,0,6,10,5537,10229,-4692
2,5,1,6,10,5361,10163,-4802
2,5,2,6,10,5261,9972,-4711
2,5,3,6,10,5235,10144,-4909
2,5,4,6,10,5319,10135,-4816
2,5,5,6,10,5334,9522,-4188
2,5,6,6,10,5369,9134,-3765
2,5,7,6,10,5418,9583,-4165
2,5,8,6,10,5425,9392,-3967
2,5,9,6,10,5389,9250,-3861
2,5,10,6,10,5383,9870,-4487
2,5,11,6,10,5409,10160,-4751
2,5,12,6,10,5464,10608,-5144
2,5,13,6,10,5558,10908,-5350
2,5,14,6,10,5708,11019,-5311
2,6,0,6,10,6310,9902,-3592
2,6,1,6,10,6236,9783,-3547
2,6,2,6,10,6271,9506,-3235
2,6,3,6,10,6401,9597,-3196
2,6,4,6,10,6616,9448,-2832
2,6,5,6,10,6622,8758,-2136
2,6,6,6,10,6714,8305,-1591
2,6,7,6,10,6796,8865,-2069
2,6,8,6,10,6790,8598,-1808
2,6,9,6,10,6710,8367,-1657
2,6,10,6,10,6698,9043,-2345
2,6,11,6,10,6694,9378,-2684
2,6,12,6,10,6686,9934,-3248
2,6,13,6,10,6709,10262,-3553
2,6,14,6,10,6750,10511,-3761
2,7,0,6,10,7182,9429,-2247
2,7,1,6,10,7122,9300,-2178
2,7,2,6,10,7180,9047,-1867
2,7,3,6,10,7377,9142,-1765
2,7,4,6,10,7597,8899,-1302
2,7,5,6,10,7488,8208,-720
2,7,6,6,10,7552,7700,-148
2,7,7,6,10,7662,8220,-558
2,7,8,6,10,7662,7969,-307
2,7,9,6,10,7548,7731,-183
2,7,10,6,10,7629,8348,-719
2,7,11,6,10,7701,8704,-1003
2,7,12,6,10,7737,9258,-1521
2,7,13,6,10,7781,9492,-1711
2,7,14,6,10,7796,9767,-1971
2,8,0,6,10,8043,9008,-965
2,8,1,6,10,7976,8887,-911
2,8,2,6,10,7994,8741,-747
2,8,3,6,10,8182,8890,-708
2,8,4,6,10,8326,8597,-271
2,8,5,6,10,8064,7982,82
2,8,6,6,10,7993,7555,438
2,8,7,6,10,8165,8112,53
2,8,8,6,10,8170,7986,184
2,8,9,6,10,8041,7661,380
2,8,10,6,10,8254,8105,149
2,8,11,6,10,8422,8409,13
2,8,12,6,10,8568,8816,-248
2,8,13,6,10,8688,8879,-191
2,8,14,6,10,8714,9160,-446
2,9,0,6,10,8600,8642,-42
2,9,1,6,10,8504,8509,-5
2,9,2,6,10,8450,8483,-33
2,9,3,6,10,8607,8722,-115
2,9,4,6,10,8673,8355,318
2,9,5,6,10,8264,7799,465
2,9,6,6,10,8050,7503,547
2,9,7,6,10,8321,8027,294
2,9,8,6,10,8265,7893,372
2,9,9,6,10,8128,7378,750
2,9,10,6,10,8496,7654,842
2,9,11,6,10,8721,7942,779
2,9,12,6,10,8978,8172,806
2,9,13,6,10,9218,8046,1172
2,9,14,6,10,9301,8350,951
2,10,0,6,10,9721,7943,1778
2,10,1,6,10,9674,7661,2013
2,10,2,6,10,9578,7682,1896
2,10,3,6,10,9763,7922,1841
2,10,4,6,10,9817,7383,2434
2,10,5,6,10,9301,6910,2391
2,10,6,6,10,8999,6727,2272
2,10,7,6,10,9346,7145,2201
2,10,8,6,10,9225,7063,2162
2,10,9,6,10,9103,6449,2654
2,10,10,6,10,9605,6628,2977
2,10,11,6,10,9839,6960,2879
2,10,12,6,10,10176,7131,3045
2,10,13,6,10,10460,6932,3528
2,10,14,6,10,10517,7324,3193
2,11,0,6,10,10229,7119,3110
2,11,1,6,10,10163,6801,3362
2,11,2,6,10,9972,6829,3143
2,11,3,6,10,10144,7057,3087
2,11,4,6,10,10135,6488,3647
2,11,5,6,10,9522,6129,3393
2,11,6,6,10,9134,6082,3052
2,11,7,6,10,9583,6443,3140
2,11,8,6,10,9392,6414,2978
2,11,9,6,10,9250,5719,3531
2,11,10,6,10,9870,5797,4073
2,11,11,6,10,10160,6068,4092
2,11,12,6,10,10608,6158,4450
2,11,13,6,10,10908,5907,5001
2,11,14,6,10,11019,6244,4775
2,12,0,6,10,9902,6508,3394
2,12,1,6,10,9783,6132,3651
2,12,2,6,10,9506,6159,3347
2,12,3,6,10,9597,6445,3152
2,12,4,6,10,9448,5960,3488
2,12,5,6,10,8758,5770,2988
2,12,6,6,10,8305,5803,2502
2,12,7,6,10,8865,6093,2772
2,12,8,6,10,8598,6121,2477
2,12,9,6,10,8367,5463,2904
2,12,10,6,10,9043,5424,3619
2,12,11,6,10,9378,5630,3748
2,12,12,6,10,9934,5594,4340
2,12,13,6,10,10262,5275,4987
2,12,14,6,10,10511,5497,5014
2,0,0,7,10,7085,8912,-1827
2,0,1,7,10,6868,8812,-1944
2,0,2,7,10,6607,8804,-2197
2,0,3,7,10,6390,9001,-2611
2,0,4,7,10,6208,9194,-2986
2,0,5,7,10,5989,8989,-3000
2,0,6,7,10,5808,8957,-3149
2,0,7,7,10,5763,9146,-3383
2,0,8,7,10,5760,9130,-3370
2,0,9,7,10,5867,8985,-3118
2,0,10,7,10,6043,9179,-3136
2,0,11,7,10,6215,9322,-3107
2,0,12,7,10,6425,9453,-3028
2,0,13,7,10,6670,9584,-2914
2,0,14,7,10,6867,9637,-2770
2,1,0,7,10,6904,9741,-2837
2,1,1,7,10,6662,9649,-2987
2,1,2,7,10,6380,9591,-3211
2,1,3,7,10,6166,9773,-3607
2,1,4,7,10,6028,9907,-3879
2,1,5,7,10,5873,9573,-3700
2,1,6,7,10,5737,9403,-3666
2,1,7,7,10,5715,9673,-3958
2,1,8,7,10,5695,9627,-3932
2,1,9,7,10,5780,9492,-3712
2,1,10,7,10,5932,9818,-3886
2,1,11,7,10,6083,10012,-3929
2,1,12,7,10,6277,10260,-3983
2,1,13,7,10,6526,10472,-3946
2,1,14,7,10,6751,10540,-3789
2,2,0,7,10,6972,10320,-3348
2,2,1,7,10,6736,10196,-3460
2,2,2,7,10,6458,10067,-3609
2,2,3,7,10,6273,10222,-3949
2,2,4,7,10,6205,10261,-4056
2,2,5,7,10,6132,9731,-3599
2,2,6,7,10,6041,9427,-3386
2,2,7,7,10,6005,9789,-3784
2,2,8,7,10,5995,9667,-3672
2,2,9,7,10,6086,9539,-3453
2,2,10,7,10,6200,10047,-3847
2,2,11,7,10,6323,10303,-3980
2,2,12,7,10,6500,10664,-4164
2,2,13,7,10,6710,10985,-4275
2,2,14,7,10,6922,11117,-4195
2,3,0,7,10,6459,11329,-4870
2,3,1,7,10,6143,11291,-5148
2,3,2,7,10,5840,11175,-5335
2,3,3,7,10,5631,11412,-5781
2,3,4,7,10,5547,11459,-5912
2,3,5,7,10,5460,10822,-5362
2,3,6,7,10,5364,10445,-5081
2,3,7,7,10,5334,10916,-5582
2,3,8,7,10,5332,10717,-5385
2,3,9,7,10,5423,10545,-5122
2,3,10,7,10,5549,11157,-5608
2,3,11,7,10,5700,11430,-5730
2,3,12,7,10,5898,11841,-5943
2,3,13,7,10,6136,12115,-5979
2,3,14,7,10,6425,12200,-5775
2,4,0,7,10,6520,11629,-5109
2,4,1,7,10,6278,11565,-5287
2,4,2,7,10,6104,11366,-5262
2,4,3,7,10,6008,11558,-5550
2,4,4,7,10,6022,11486,-5464
2,4,5,7,10,5958,10727,-4769
2,4,6,7,10,5921,10288,-4367
2,4,7,7,10,5935,10867,-4932
2,4,8,7,10,5941,10606,-4665
2,4,9,7,10,5957,10343,-4386
2,4,10,7,10,6023,11052,-5029
2,4,11,7,10,6116,11406,-5290
2,4,12,7,10,6236,11953,-5717
2,4,13,7,10,6399,12263,-5864
2,4,14,7,10,6614,12446,-5832
2,5,0,7,10,7264,11175,-3911
2,5,1,7,10,7143,11009,-3866
2,5,2,7,10,7121,10724,-3603
2,5,3,7,10,7196,10846,-3650
2,5,4,7,10,7357,10588,-3231
2,5,5,7,10,7303,9763,-2460
2,5,6,7,10,7352,9213,-1861
2,5,7,7,10,7420,9771,-2351
2,5,8,7,10,7433,9534,-2101
2,5,9,7,10,7365,9264,-1899
2,5,10,7,10,7392,9992,-2600
2,5,11,7,10,7437,10452,-3015
2,5,12,7,10,7483,11088,-3605
2,5,13,7,10,7559,11390,-3831
2,5,14,7,10,7643,11685,-4042
2,6,0,7,10,8056,10738,-2682
2,6,1,7,10,7945,10577,-2632
2,6,2,7,10,7948,10365,-2417
2,6,3,7,10,8105,10514,-2409
2,6,4,7,10,8305,10194,-1889
2,6,5,7,10,8177,9483,-1306
2,6,6,7,10,8227,8960,-733
2,6,7,7,10,8347,9596,-1249
2,6,8,7,10,8355,9454,-1099
2,6,9,7,10,8243,9098,-855
2,6,10,7,10,8342,9655,-1313
2,6,11,7,10,8442,10030,-1588
2,6,12,7,10,8516,10532,-2016
2,6,13,7,10,8607,10682,-2075
2,6,14,7,10,8668,11001,-2333
2,7,0,7,10,8912,10340,-1428
2,7,1,7,10,8812,10182,-1370
2,7,2,7,10,8804,10080,-1276
2,7,3,7,10,9001,10313,-1312
2,7,4,7,10,9194,9936,-742
2,7,5,7,10,8989,9308,-319
2,7,6,7,10,8957,8913,44
2,7,7,7,10,9146,9535,-389
2,7,8,7,10,9130,9350,-220
2,7,9,7,10,8985,8829,156
2,7,10,7,10,9179,9218,-39
2,7,11,7,10,9322,9532,-210
2,7,12,7,10,9453,9864,-411
2,7,13,7,10,9584,9830,-246
2,7,14,7,10,9637,10176,-539
2,8,0,7,10,9741,9663,78
2,8,1,7,10,9649,9353,296
2,8,2,7,10,9591,9299,292
2,8,3,7,10,9773,9537,236
2,8,4,7,10,9907,8971,936
2,8,5,7,10,9573,8377,1196
2,8,6,7,10,9403,8104,1299
2,8,7,7,10,9673,8613,1060
2,8,8,7,10,9627,8465,1162
2,8,9,7,10,9492,7860,1632
2,8,10,7,10,9818,8179,1639
2,8,11,7,10,10012,8542,1470
2,8,12,7,10,10260,8817,1443
2,8,13,7,10,10472,8699,1773
2,8,14,7,10,10540,9140,1400
2,9,0,7,10,10320,8727,1593
2,9,1,7,10,10196,8418,1778
2,9,2,7,10,10067,8426,1641
2,9,3,7,10,10222,8706,1516
2,9,4,7,10,10261,8130,2131
2,9,5,7,10,9731,7650,2081
2,9,6,7,10,9427,7528,1899
2,9,7,7,10,9789,8013,1776
2,9,8,7,10,9667,7906,1761
2,9,9,7,10,9539,7161,2378
2,9,10,7,10,10047,7349,2698
2,9,11,7,10,10303,7659,2644
2,9,12,7,10,10664,7823,2841
2,9,13,7,10,10985,7562,3423
2,9,14,7,10,11117,7927,3190
2,10,0,7,10,11329,7908,3421
2,10,1,7,10,11291,7534,3757
2,10,2,7,10,11175,7553,3622
2,10,3,7,10,11412,7859,3553
2,10,4,7,10,11459,7311,4148
2,10,5,7,10,10822,6975,3847
2,10,6,7,10,10445,6957,3488
2,10,7,7,10,10916,7377,3539
2,10,8,7,10,10717,7335,3382
2,10,9,7,10,10545,6556,3989
2,10,10,7,10,11157,6606,4551
2,10,11,7,10,11430,6876,4554
2,10,12,7,10,11841,6939,4902
2,10,13,7,10,12115,6630,5485
2,10,14,7,10,12200,6924,5276
2,0,0,8,10,7954,11461,-3507
2,0,1,8,10,7704,11341,-3637
2,0,2,8,10,7417,11208,-3791
2,0,3,8,10,7209,11388,-4179
2,0,4,8,10,7076,11495,-4419
2,0,5,8,10,6914,11040,-4126
2,0,6,8,10,6772,10780,-4008
2,0,7,8,10,6744,11141,-4397
2,0,8,8,10,6720,11029,-4309
2,0,9,8,10,6811,10903,-4092
2,0,10,8,10,6968,11369,-4401
2,0,11,8,10,7115,11594,-4479
2,0,12,8,10,7310,11946,-4636
2,0,13,8,10,7566,12239,-4673
2,0,14,8,10,7790,12356,-4566
2,1,0,8,10,8045,11928,-3883
2,1,1,8,10,7807,11813,-4006
2,1,2,8,10,7521,11664,-4143
2,1,3,8,10,7332,11871,-4539
2,1,4,8,10,7262,11903,-4641
2,1,5,8,10,7182,11252,-4070
2,1,6,8,10,7090,10873,-3783
2,1,7,8,10,7067,11359,-4292
2,1,8,8,10,7057,11159,-4102
2,1,9,8,10,7144,10981,-3837
2,1,10,8,10,7254,11599,-4345
2,1,11,8,10,7374,11894,-4520
2,1,12,8,10,7559,12329,-4770
2,1,13,8,10,7780,12640,-4860
2,1,14,8,10,7990,12800,-4810
2,2,0,8,10,7571,12729,-5158
2,2,1,8,10,7258,12693,-5435
2,2,2,8,10,6947,12569,-5622
2,2,3,8,10,6732,12826,-6094
2,2,4,8,10,6649,12810,-6161
2,2,5,8,10,6562,12027,-5465
2,2,6,8,10,6469,11599,-5130
2,2,7,8,10,6448,12200,-5752
2,2,8,8,10,6437,11931,-5494
2,2,9,8,10,6522,11638,-5116
2,2,10,8,10,6642,12339,-5697
2,2,11,8,10,6787,12676,-5889
2,2,12,8,10,6988,13186,-6198
2,2,13,8,10,7235,13470,-6235
2,2,14,8,10,7522,13627,-6105
2,3,0,8,10,7559,12902,-5343
2,3,1,8,10,7271,12791,-5520
2,3,2,8,10,7043,12584,-5541
2,3,3,8,10,6899,12807,-5908
2,3,4,8,10,6871,12626,-5755
2,3,5,8,10,6760,11732,-4972
2,3,6,8,10,6675,11196,-4521
2,3,7,8,10,6667,11773,-5106
2,3,8,8,10,6657,11542,-4885
2,3,9,8,10,6718,11240,-4522
2,3,10,8,10,6836,12001,-5165
2,3,11,8,10,6970,12480,-5510
2,3,12,8,10,7131,13107,-5976
2,3,13,8,10,7343,13391,-6048
2,3,14,8,10,7606,13620,-6014
2,4,0,8,10,8247,12484,-4237
2,4,1,8,10,8060,12286,-4226
2,4,2,8,10,7964,12042,-4078
2,4,3,8,10,7969,12218,-4249
2,4,4,8,10,8060,11883,-3823
2,4,5,8,10,7927,11038,-3111
2,4,6,8,10,7904,10473,-2569
2,4,7,8,10,7937,11147,-3210
2,4,8,8,10,7949,11019,-3070
2,4,9,8,10,7933,10631,-2698
2,4,10,8,10,8032,11299,-3267
2,4,11,8,10,8144,11778,-3634
2,4,12,8,10,8255,12362,-4107
2,4,13,8,10,8400,12580,-4180
2,4,14,8,10,8549,12919,-4370
2,5,0,8,10,9010,12070,-3060
2,5,1,8,10,8852,11872,-3020
2,5,2,8,10,8798,11704,-2906
2,5,3,8,10,8900,11937,-3037
2,5,4,8,10,9046,11533,-2487
2,5,5,8,10,8858,10809,-1951
2,5,6,8,10,8865,10318,-1453
2,5,7,8,10,8971,11019,-2048
2,5,8,8,10,8998,10818,-1820
2,5,9,8,10,8898,10266,-1368
2,5,10,8,10,9036,10768,-1732
2,5,11,8,10,9185,11153,-1968
2,5,12,8,10,9313,11580,-2267
2,5,13,8,10,9457,11633,-2176
2,5,14,8,10,9561,12017,-2456
2,6,0,8,10,9786,11361,-1575
2,6,1,8,10,9635,11026,-1391
2,6,2,8,10,9572,10896,-1324
2,6,3,8,10,9729,11128,-1399
2,6,4,8,10,9902,10552,-650
2,6,5,8,10,9678,9886,-208
2,6,6,8,10,9632,9514,118
2,6,7,8,10,9831,10121,-290
2,6,8,8,10,9823,9922,-99
2,6,9,8,10,9680,9311,369
2,6,10,8,10,9892,9743,149
2,6,11,8,10,10063,10132,-69
2,6,12,8,10,10232,10509,-277
2,6,13,8,10,10410,10483,-73
2,6,14,8,10,10509,10966,-457
2,7,0,8,10,10610,10447,163
2,7,1,8,10,10485,10110,375
2,7,2,8,10,10401,10043,358
2,7,3,8,10,10592,10321,271
2,7,4,8,10,10775,9718,1057
2,7,5,8,10,10498,9117,1381
2,7,6,8,10,10367,8905,1462
2,7,7,8,10,10654,9481,1173
2,7,8,8,10,10587,9308,1279
2,7,9,8,10,10436,8572,1864
2,7,10,8,10,10743,8900,1843
2,7,11,8,10,10912,9241,1671
2,7,12,8,10,11145,9509,1636
2,7,13,8,10,11368,9329,2039
2,7,14,8,10,11463,9743,1720
2,8,0,8,10,11461,9516,1945
2,8,1,8,10,11341,9151,2190
2,8,2,8,10,11208,9150,2058
2,8,3,8,10,11388,9508,1880
2,8,4,8,10,11495,8953,2542
2,8,5,8,10,11040,8496,2544
2,8,6,8,10,10780,8403,2377
2,8,7,8,10,11141,8947,2194
2,8,8,8,10,11029,8827,2202
2,8,9,8,10,10903,7998,2905
2,8,10,8,10,11369,8158,3211
2,8,11,8,10,11594,8467,3127
2,8,12,8,10,11946,8604,3342
2,8,13,8,10,12239,8285,3954
2,8,14,8,10,12356,8607,3749
2,0,0,9,10,9095,13328,-4233
2,0,1,9,10,8849,13215,-4366
2,0,2,9,10,8558,13058,-4500
2,0,3,9,10,8375,13285,-4910
2,0,4,9,10,8310,13254,-4944
2,0,5,9,10,8223,12457,-4234
2,0,6,9,10,8125,12027,-3902
2,0,7,9,10,8096,12643,-4547
2,0,8,9,10,8082,12373,-4291
2,0,9,9,10,8175,12074,-3899
2,0,10,9,10,8290,12781,-4491
2,0,11,9,10,8406,13140,-4734
2,0,12,9,10,8592,13674,-5082
2,0,13,9,10,8820,13995,-5175
2,0,14,9,10,9029,14227,-5198
2,1,0,9,10,8644,14002,-5358
2,1,1,9,10,8329,13919,-5590
2,1,2,9,10,8010,13787,-5777
2,1,3,9,10,7791,14075,-6284
2,1,4,9,10,7706,13950,-6244
2,1,5,9,10,7612,13032,-5420
2,1,6,9,10,7518,12507,-4989
2,1,7,9,10,7510,13106,-5596
2,1,8,9,10,7499,12867,-5368
2,1,9,9,10,7580,12535,-4955
2,1,10,9,10,7696,13288,-5592
2,1,11,9,10,7838,13750,-5912
2,1,12,9,10,8047,14340,-6293
2,1,13,9,10,8305,14598,-6293
2,1,14,9,10,8590,14801,-6211
2,2,0,9,10,8671,14211,-5540
2,2,1,9,10,8386,14068,-5682
2,2,2,9,10,8150,13902,-5752
2,2,3,9,10,8000,14179,-6179
2,2,4,9,10,7973,13921,-5948
2,2,5,9,10,7862,13007,-5145
2,2,6,9,10,7780,12456,-4676
2,2,7,9,10,7781,13149,-5368
2,2,8,9,10,7762,13027,-5265
2,2,9,9,10,7817,12607,-4790
2,2,10,9,10,7929,13308,-5379
2,2,11,9,10,8057,13806,-5749
2,2,12,9,10,8221,14381,-6160
2,2,13,9,10,8442,14581,-6139
2,2,14,9,10,8703,14854,-6151
2,3,0,9,10,9286,13816,-4530
2,3,1,9,10,9053,13581,-4528
2,3,2,9,10,8903,13381,-4478
2,3,3,9,10,8860,13641,-4781
2,3,4,9,10,8909,13222,-4313
2,3,5,9,10,8729,12364,-3635
2,3,6,9,10,8658,11831,-3173
2,3,7,9,10,8669,12570,-3901
2,3,8,9,10,8665,12383,-3718
2,3,9,9,10,8694,11799,-3105
2,3,10,9,10,8845,12412,-3567
2,3,11,9,10,8998,12901,-3903
2,3,12,9,10,9150,13410,-4260
2,3,13,9,10,9344,13531,-4187
2,3,14,9,10,9541,13935,-4394
2,4,0,9,10,9993,13091,-3098
2,4,1,9,10,9769,12716,-2947
2,4,2,9,10,9641,12520,-2879
2,4,3,9,10,9673,12752,-3079
2,4,4,9,10,9749,12149,-2400
2,4,5,9,10,9482,11387,-1905
2,4,6,9,10,9417,10919,-1502
2,4,7,9,10,9488,11605,-2117
2,4,8,9,10,9514,11390,-1876
2,4,9,9,10,9466,10748,-1282
2,4,10,9,10,9676,11293,-1617
2,4,11,9,10,9892,11753,-1861
2,4,12,9,10,10085,12225,-2140
2,4,13,9,10,10298,12286,-1988
2,4,14,9,10,10467,12807,-2340
2,5,0,9,10,10740,12145,-1405
2,5,1,9,10,10542,11783,-1241
2,5,2,9,10,10422,11640,-1218
2,5,3,9,10,10524,11912,-1388
2,5,4,9,10,10643,11299,-656
2,5,5,9,10,10359,10626,-267
2,5,6,9,10,10270,10315,-45
2,5,7,9,10,10455,10989,-534
2,5,8,9,10,10466,10765,-299
2,5,9,9,10,10335,10023,312
2,5,10,9,10,10586,10464,122
2,5,11,9,10,10806,10831,-25
2,5,12,9,10,11029,11201,-172
2,5,13,9,10,11260,11113,147
2,5,14,9,10,11402,11569,-167
2,6,0,9,10,11484,11236,248
2,6,1,9,10,11308,10843,465
2,6,2,9,10,11169,10767,402
2,6,3,9,10,11320,11123,197
2,6,4,9,10,11483,10541,942
2,6,5,9,10,11187,9963,1224
2,6,6,9,10,11042,9780,1262
2,6,7,9,10,11339,10415,924
2,6,8,9,10,11280,10229,1051
2,6,9,9,10,11131,9409,1722
2,6,10,9,10,11456,9709,1747
2,6,11,9,10,11653,10049,1604
2,6,12,9,10,11924,10290,1634
2,6,13,9,10,12194,10052,2142
2,6,14,9,10,12335,10423,1912
2,0,0,10,10,9694,15311,-5617
2,0,1,10,10,9371,15196,-5825
2,0,2,10,10,9047,15105,-6058
2,0,3,10,10,8834,15447,-6613
2,0,4,10,10,8754,15245,-6491
2,0,5,10,10,8653,14307,-5654
2,0,6,10,10,8553,13767,-5214
2,0,7,10,10,8539,14482,-5943
2,0,8,10,10,8524,14352,-5828
2,0,9,10,10,8611,13902,-5291
2,0,10,10,10,8732,14595,-5863
2,0,11,10,10,8870,15076,-6206
2,0,12,10,10,9080,15614,-6534
2,0,13,10,10,9345,15788,-6443
2,0,14,10,10,9629,16035,-6406
2,1,0,10,10,9744,15543,-5799
2,1,1,10,10,9457,15363,-5906
2,1,2,10,10,9213,15241,-6028
2,1,3,10,10,9059,15602,-6543
2,1,4,10,10,9030,15260,-6230
2,1,5,10,10,8912,14333,-5421
2,1,6,10,10,8829,13814,-4985
2,1,7,10,10,8843,14572,-5729
2,1,8,10,10,8824,14391,-5567
2,1,9,10,10,8875,13775,-4900
2,1,10,10,10,8983,14421,-5438
2,1,11,10,10,9108,14929,-5821
2,1,12,10,10,9280,15429,-6149
2,1,13,10,10,9512,15532,-6020
2,1,14,10,10,9771,15870,-6099
2,2,0,10,10,10398,14837,-4439
2,2,1,10,10,10168,14425,-4257
2,2,2,10,10,10010,14197,-4187
2,2,3,10,10,9961,14456,-4495
2,2,4,10,10,10011,13838,-3827
2,2,5,10,10,9831,12942,-3111
2,2,6,10,10,9763,12432,-2669
2,2,7,10,10,9783,13156,-3373
2,2,8,10,10,9770,12955,-3185
2,2,9,10,10,9793,12281,-2488
2,2,10,10,10,9938,12937,-2999
2,2,11,10,10,10085,13501,-3416
2,2,12,10,10,10240,14055,-3815
2,2,13,10,10,10443,14184,-3741
2,2,14,10,10,10638,14725,-4087
2,3,0,10,10,11032,13875,-2843
2,3,1,10,10,10762,13473,-2711
2,3,2,10,10,10580,13264,-2684
2,3,3,10,10,10564,13536,-2972
2,3,4,10,10,10598,12896,-2298
2,3,5,10,10,10284,12127,-1843
2,3,6,10,10,10171,11720,-1549
2,3,7,10,10,10220,12473,-2253
2,3,8,10,10,10230,12233,-2003
2,3,9,10,10,10227,11460,-1233
2,3,10,10,10,10489,12014,-1525
2,3,11,10,10,10746,12452,-1706
2,3,12,10,10,10980,12917,-1937
2,3,13,10,10,11242,12916,-1674
2,3,14,10,10,11459,13410,-1951
2,4,0,10,10,11723,12934,-1211
2,4,1,10,10,11459,12516,-1057
2,4,2,10,10,11265,12364,-1099
2,4,3,10,10,11297,12714,-1417
2,4,4,10,10,11346,12122,-776
2,4,5,10,10,10983,11472,-489
2,4,6,10,10,10822,11190,-368
2,4,7,10,10,10972,11923,-951
2,4,8,10,10,10982,11686,-704
2,4,9,10,10,10903,10860,43
2,4,10,10,10,11226,11273,-47
2,4,11,10,10,11513,11639,-126
2,4,12,10,10,11801,11982,-181
2,4,13,10,10,12101,11836,265
2,4,14,10,10,12308,12249,59
2,0,0,11,10,10794,16564,-5770
2,0,1,11,10,10499,16207,-5708
2,0,2,11,10,10250,16057,-5807
2,0,3,11,10,10102,16417,-6315
2,0,4,11,10,10078,15876,-5798
2,0,5,11,10,9953,14911,-4958
2,0,6,11,10,9864,14415,-4551
2,0,7,11,10,9872,15158,-5286
2,0,8,11,10,9849,14963,-5114
2,0,9,11,10,9906,14257,-4351
2,0,10,11,10,10019,14946,-4927
2,0,11,11,10,10140,15529,-5389
2,0,12,11,10,10313,16074,-5761
2,0,13,11,10,10552,16185,-5633
2,0,14,11,10,10810,16660,-5850
2,1,0,11,10,11471,15621,-4150
2,1,1,11,10,11239,15182,-3943
2,1,2,11,10,11073,14941,-3868
2,1,3,11,10,11020,15240,-4220
2,1,4,11,10,11068,14585,-3517
2,1,5,11,10,10881,13682,-2801
2,1,6,11,10,10812,13233,-2421
2,1,7,11,10,10845,14024,-3179
2,1,8,11,10,10832,13798,-2966
2,1,9,11,10,10851,12993,-2142
2,1,10,11,10,10992,13658,-2666
2,1,11,11,10,11136,14200,-3064
2,1,12,11,10,11299,14747,-3448
2,1,13,11,10,11513,14814,-3301
2,1,14,11,10,11706,15328,-3622
2,2,0,11,10,12144,14664,-2520
2,2,1,11,10,11877,14206,-2329
2,2,2,11,10,11687,13988,-2301
2,2,3,11,10,11665,14338,-2673
2,2,4,11,10,11700,13719,-2019
2,2,5,11,10,11386,12973,-1587
2,2,6,11,10,11276,12595,-1319
2,2,7,11,10,11334,13407,-2073
2,2,8,11,10,11335,13154,-1819
2,2,9,11,10,11326,12297,-971
2,2,10,11,10,11582,12823,-1241
2,2,11,11,10,11833,13260,-1427
2,2,12,11,10,12070,13698,-1628
2,2,13,11,10,12341,13639,-1298
2,2,14,11,10,12556,14090,-1534
2,0,0,12,10,12521,16410,-3889
2,0,1,12,10,12281,15915,-3634
2,0,2,12,10,12110,15665,-3555
2,0,3,12,10,12063,16042,-3979
2,0,4,12,10,12116,15408,-3292
2,0,5,12,10,11922,14528,-2606
2,0,6,12,10,11847,14108,-2261
2,0,7,12,10,11874,14958,-3084
2,0,8,12,10,11857,14719,-2862
2,0,9,12,10,11882,13830,-1948
2,0,10,12,10,12028,14467,-2439
2,0,11,12,10,12168,15008,-2840
2,0,12,12,10,12332,15528,-3196
2,0,13,12,10,12553,15537,-2984
2,0,14,12,10,12745,16008,-3263
2,0,0,1,11,1152,1177,-25
2,0,1,1,11,1144,1174,-30
2,0,2,1,11,1139,1166,-27
2,0,3,1,11,1146,1163,-17
2,0,4,1,11,1152,1162,-10
2,0,5,1,11,1146,1157,-11
2,0,6,1,11,1133,1164,-31
2,0,7,1,11,1131,1169,-38
2,0,8,1,11,1135,1166,-31
2,0,9,1,11,1139,1160,-21
2,0,10,1,11,1134,1155,-21
2,0,11,1,11,1135,1162,-27
2,0,12,1,11,1142,1173,-31
2,0,13,1,11,1142,1172,-30
2,1,0,1,11,1177,1221,-44
2,1,1,1,11,1174,1222,-48
2,1,2,1,11,1166,1213,-47
2,1,3,1,11,1163,1209,-46
2,1,4,1,11,1162,1212,-50
2,1,5,1,11,1157,1213,-56
2,1,6,1,11,1164,1222,-58
2,1,7,1,11,1169,1223,-54
2,1,8,1,11,1166,1214,-48
2,1,9,1,11,1160,1206,-46
2,1,10,1,11,1155,1196,-41
2,1,11,1,11,1162,1197,-35
2,1,12,1,11,1173,1205,-32
2,1,13,1,11,1172,1205,-33
2,2,0,1,11,1221,1105,116
2,2,1,1,11,1222,1056,166
2,2,2,1,11,1213,1001,212
2,2,3,1,11,1209,954,255
2,2,4,1,11,1212,914,298
2,2,5,1,11,1213,869,344
2,2,6,1,11,1222,844,378
2,2,7,1,11,1223,831,392
2,2,8,1,11,1214,833,381
2,2,9,1,11,1206,882,324
2,2,10,1,11,1196,920,276
2,2,11,1,11,1197,958,239
2,2,12,1,11,1205,1006,199
2,2,13,1,11,1205,1055,150
2,3,0,1,11,1105,1031,74
2,3,1,1,11,1056,962,94
2,3,2,1,11,1001,887,114
2,3,3,1,11,954,818,136
2,3,4,1,11,914,750,164
2,3,5,1,11,869,672,197
2,3,6,1,11,844,611,233
2,3,7,1,11,831,592,239
2,3,8,1,11,833,622,211
2,3,9,1,11,882,691,191
2,3,10,1,11,920,755,165
2,3,11,1,11,958,817,141
2,3,12,1,11,1006,885,121
2,3,13,1,11,1055,951,104
2,4,0,1,11,1031,1021,10
2,4,1,1,11,962,972,-10
2,4,2,1,11,887,915,-28
2,4,3,1,11,818,860,-42
2,4,4,1,11,750,806,-56
2,4,5,1,11,672,747,-75
2,4,6,1,11,611,693,-82
2,4,7,1,11,592,682,-90
2,4,8,1,11,622,724,-102
2,4,9,1,11,691,762,-71
2,4,10,1,11,755,810,-55
2,4,11,1,11,817,862,-45
2,4,12,1,11,885,915,-30
2,4,13,1,11,951,958,-7
2,5,0,1,11,1021,943,78
2,5,1,1,11,972,892,80
2,5,2,1,11,915,837,78
2,5,3,1,11,860,797,63
2,5,4,1,11,806,776,30
2,5,5,1,11,747,757,-10
2,5,6,1,11,693,752,-59
2,5,7,1,11,682,751,-69
2,5,8,1,11,724,764,-40
2,5,9,1,11,762,782,-20
2,5,10,1,11,810,810,0
2,5,11,1,11,862,848,14
2,5,12,1,11,915,895,20
2,5,13,1,11,958,941,17
2,6,0,1,11,943,966,-23
2,6,1,1,11,892,935,-43
2,6,2,1,11,837,909,-72
2,6,3,1,11,797,917,-120
2,6,4,1,11,776,965,-189
2,6,5,1,11,757,1021,-264
2,6,6,1,11,752,1063,-311
2,6,7,1,11,751,1065,-314
2,6,8,1,11,764,1039,-275
2,6,9,1,11,782,1021,-239
2,6,10,1,11,810,997,-187
2,6,11,1,11,848,984,-136
2,6,12,1,11,895,995,-100
2,6,13,1,11,941,1021,-80
2,7,0,1,11,966,1271,-305
2,7,1,1,11,935,1282,-347
2,7,2,1,11,909,1287,-378
2,7,3,1,11,917,1312,-395
2,7,4,1,11,965,1372,-407
2,7,5,1,11,1021,1447,-426
2,7,6,1,11,1063,1487,-424
2,7,7,1,11,1065,1483,-418
2,7,8,1,11,1039,1491,-452
2,7,9,1,11,1021,1457,-436
2,7,10,1,11,997,1421,-424
2,7,11,1,11,984,1419,-435
2,7,12,1,11,995,1400,-405
2,7,13,1,11,1021,1385,-364
2,8,0,1,11,1271,628,643
2,8,1,1,11,1282,558,724
2,8,2,1,11,1287,528,759
2,8,3,1,11,1312,487,825
2,8,4,1,11,1372,471,901
2,8,5,1,11,1447,483,964
2,8,6,1,11,1487,487,1000
2,8,7,1,11,1483,509,974
2,8,8,1,11,1491,500,991
2,8,9,1,11,1457,483,974
2,8,10,1,11,1421,493,928
2,8,11,1,11,1419,524,895
2,8,12,1,11,1400,564,836
2,8,13,1,11,1385,628,757
2,9,0,1,11,628,1232,-604
2,9,1,1,11,558,1247,-689
2,9,2,1,11,528,1328,-800
2,9,3,1,11,487,1400,-913
2,9,4,1,11,471,1448,-977
2,9,5,1,11,483,1429,-946
2,9,6,1,11,487,1456,-969
2,9,7,1,11,509,1482,-973
2,9,8,1,11,500,1437,-937
2,9,9,1,11,483,1415,-932
2,9,10,1,11,493,1402,-909
2,9,11,1,11,524,1352,-828
2,9,12,1,11,564,1332,-768
2,9,13,1,11,628,1313,-685
2,10,0,1,11,1232,1921,-689
2,10,1,1,11,1247,1960,-713
2,10,2,1,11,1328,2051,-723
2,10,3,1,11,1400,2161,-761
2,10,4,1,11,1448,2222,-774
2,10,5,1,11,1429,2158,-729
2,10,6,1,11,1456,2225,-769
2,10,7,1,11,1482,2238,-756
2,10,8,1,11,1437,2192,-755
2,10,9,1,11,1415,2187,-772
2,10,10,1,11,1402,2222,-820
2,10,11,1,11,1352,2197,-845
2,10,12,1,11,1332,2192,-860
2,10,13,1,11,1313,2135,-822
2,11,0,1,11,1921,1860,61
2,11,1,1,11,1960,1824,136
2,11,2,1,11,2051,1808,243
2,11,3,1,11,2161,1815,346
2,11,4,1,11,2222,1792,430
2,11,5,1,11,2158,1714,444
2,11,6,1,11,2225,1764,461
2,11,7,1,11,2238,1789,449
2,11,8,1,11,2192,1765,427
2,11,9,1,11,2187,1755,432
2,11,10,1,11,2222,1862,360
2,11,11,1,11,2197,1945,252
2,11,12,1,11,2192,2029,163
2,11,13,1,11,2135,2029,106
2,12,0,1,11,1860,1836,24
2,12,1,1,11,1824,1783,41
2,12,2,1,11,1808,1734,74
2,12,3,1,11,1815,1720,95
2,12,4,1,11,1792,1688,104
2,12,5,1,11,1714,1658,56
2,12,6,1,11,1764,1654,110
2,12,7,1,11,1789,1701,88
2,12,8,1,11,1765,1686,79
2,12,9,1,11,1755,1650,105
2,12,10,1,11,1862,1727,135
2,12,11,1,11,1945,1809,136
2,12,12,1,11,2029,1913,116
2,12,13,1,11,2029,1937,92
2,13,0,1,11,1836,1825,11
2,13,1,1,11,1783,1766,17
2,13,2,1,11,1734,1706,28
2,13,3,1,11,1720,1703,17
2,13,4,1,11,1688,1685,3
2,13,5,1,11,1658,1664,-6
2,13,6,1,11,1654,1651,3
2,13,7,1,11,1701,1688,13
2,13,8,1,11,1686,1687,-1
2,13,9,1,11,1650,1664,-14
2,13,10,1,11,1727,1717,10
2,13,11,1,11,1809,1785,24
2,13,12,1,11,1913,1893,20
2,13,13,1,11,1937,1938,-1
2,14,0,1,11,1825,1838,-13
2,14,1,1,11,1766,1786,-20
2,14,2,1,11,1706,1722,-16
2,14,3,1,11,1703,1707,-4
2,14,4,1,11,1685,1674,11
2,14,5,1,11,1664,1627,37
2,14,6,1,11,1651,1632,19
2,14,7,1,11,1688,1639,49
2,14,8,1,11,1687,1649,38
2,14,9,1,11,1664,1634,30
2,14,10,1,11,1717,1700,17
2,14,11,1,11,1785,1780,5
2,14,12,1,11,1893,1872,21
2,14,13,1,11,1938,1908,30
2,15,0,1,11,1838,1725,113
2,15,1,1,11,1786,1711,75
2,15,2,1,11,1722,1724,-2
2,15,3,1,11,1707,1761,-54
2,15,4,1,11,1674,1740,-66
2,15,5,1,11,1627,1695,-68
2,15,6,1,11,1632,1700,-68
2,15,7,1,11,1639,1740,-101
2,15,8,1,11,1649,1681,-32
2,15,9,1,11,1634,1659,-25
2,15,10,1,11,1700,1708,-8
2,15,11,1,11,1780,1759,21
2,15,12,1,11,1872,1782,90
2,15,13,1,11,1908,1795,113
2,16,0,1,11,1725,1510,215
2,16,1,1,11,1711,1469,242
2,16,2,1,11,1724,1477,247
2,16,3,1,11,1761,1497,264
2,16,4,1,11,1740,1412,328
2,16,5,1,11,1695,1345,350
2,16,6,1,11,1700,1396,304
2,16,7,1,11,1740,1445,295
2,16,8,1,11,1681,1289,392
2,16,9,1,11,1659,1253,406
2,16,10,1,11,1708,1356,352
2,16,11,1,11,1759,1412,347
2,16,12,1,11,1782,1438,344
2,16,13,1,11,1795,1510,285
2,17,0,1,11,1510,1348,162
2,17,1,1,11,1469,1310,159
2,17,2,1,11,1477,1325,152
2,17,3,1,11,1497,1324,173
2,17,4,1,11,1412,1243,169
2,17,5,1,11,1345,1087,258
2,17,6,1,11,1396,975,421
2,17,7,1,11,1445,1064,381
2,17,8,1,11,1289,1009,280
2,17,9,1,11,1253,1022,231
2,17,10,1,11,1356,1149,207
2,17,11,1,11,1412,1238,174
2,17,12,1,11,1438,1235,203
2,17,13,1,11,1510,1249,261
2,18,0,1,11,1348,1467,-119
2,18,1,1,11,1310,1408,-98
2,18,2,1,11,1325,1476,-151
2,18,3,1,11,1324,1529,-205
2,18,4,1,11,1243,1405,-162
2,18,5,1,11,1087,1340,-253
2,18,6,1,11,975,1448,-473
2,18,7,1,11,1064,1584,-520
2,18,8,1,11,1009,1554,-545
2,18,9,1,11,1022,1430,-408
2,18,10,1,11,1149,1484,-335
2,18,11,1,11,1238,1405,-167
2,18,12,1,11,1235,1348,-113
2,18,13,1,11,1249,1391,-142
2,19,0,1,11,1467,1485,-18
2,19,1,1,11,1408,1415,-7
2,19,2,1,11,1476,1491,-15
2,19,3,1,11,1529,1569,-40
2,19,4,1,11,1405,1423,-18
2,19,5,1,11,1340,1401,-61
2,19,6,1,11,1448,1496,-48
2,19,7,1,11,1584,1543,41
2,19,8,1,11,1554,1412,142
2,19,9,1,11,1430,1245,185
2,19,10,1,11,1484,1276,208
2,19,11,1,11,1405,1168,237
2,19,12,1,11,1348,1103,245
2,19,13,1,11,1391,1162,229
2,20,0,1,11,1485,1047,438
2,20,1,1,11,1415,888,527
2,20,2,1,11,1491,904,587
2,20,3,1,11,1569,851,718
2,20,4,1,11,1423,640,783
2,20,5,1,11,1401,633,768
2,20,6,1,11,1496,644,852
2,20,7,1,11,1543,656,887
2,20,8,1,11,1412,627,785
2,20,9,1,11,1245,566,679
2,20,10,1,11,1276,626,650
2,20,11,1,11,1168,689,479
2,20,12,1,11,1103,741,362
2,20,13,1,11,1162,826,336
2,21,0,1,11,1047,854,193
2,21,1,1,11,888,818,70
2,21,2,1,11,904,860,44
2,21,3,1,11,851,867,-16
2,21,4,1,11,640,780,-140
2,21,5,1,11,633,838,-205
2,21,6,1,11,644,913,-269
2,21,7,1,11,656,938,-282
2,21,8,1,11,627,863,-236
2,21,9,1,11,566,770,-204
2,21,10,1,11,626,769,-143
2,21,11,1,11,689,753,-64
2,21,12,1,11,741,746,-5
2,21,13,1,11,826,686,140
2,22,0,1,11,854,844,10
2,22,1,1,11,818,793,25
2,22,2,1,11,860,856,4
2,22,3,1,11,867,892,-25
2,22,4,1,11,780,915,-135
2,22,5,1,11,838,940,-102
2,22,6,1,11,913,982,-69
2,22,7,1,11,938,1001,-63
2,22,8,1,11,863,963,-100
2,22,9,1,11,770,907,-137
2,22,10,1,11,769,863,-94
2,22,11,1,11,753,841,-88
2,22,12,1,11,746,855,-109
2,22,13,1,11,686,770,-84
2,0,0,2,11,2329,2326,3
2,0,1,2,11,2318,2278,40
2,0,2,2,11,2305,2214,91
2,0,3,2,11,2309,2163,146
2,0,4,2,11,2314,2126,188
2,0,5,2,11,2303,2082,221
2,0,6,2,11,2297,2066,231
2,0,7,2,11,2300,2054,246
2,0,8,2,11,2301,2047,254
2,0,9,2,11,2299,2088,211
2,0,10,2,11,2289,2116,173
2,0,11,2,11,2297,2155,142
2,0,12,2,11,2315,2211,104
2,0,13,2,11,2314,2260,54
2,1,0,2,11,2398,2136,262
2,1,1,2,11,2396,2018,378
2,1,2,2,11,2379,1888,491
2,1,3,2,11,2372,1772,600
2,1,4,2,11,2374,1664,710
2,1,5,2,11,2370,1541,829
2,1,6,2,11,2386,1455,931
2,1,7,2,11,2392,1423,969
2,1,8,2,11,2380,1455,925
2,1,9,2,11,2366,1573,793
2,1,10,2,11,2351,1675,676
2,1,11,2,11,2359,1775,584
2,1,12,2,11,2378,1891,487
2,1,13,2,11,2377,2006,371
2,2,0,2,11,2326,2052,274
2,2,1,2,11,2278,1934,344
2,2,2,2,11,2214,1802,412
2,2,3,2,11,2163,1678,485
2,2,4,2,11,2126,1556,570
2,2,5,2,11,2082,1419,663
2,2,6,2,11,2066,1304,762
2,2,7,2,11,2054,1274,780
2,2,8,2,11,2047,1346,701
2,2,9,2,11,2088,1453,635
2,2,10,2,11,2116,1565,551
2,2,11,2,11,2155,1679,476
2,2,12,2,11,2211,1800,411
2,2,13,2,11,2260,1909,351
2,3,0,2,11,2136,1964,172
2,3,1,2,11,2018,1864,154
2,3,2,2,11,1888,1752,136
2,3,3,2,11,1772,1657,115
2,3,4,2,11,1664,1582,82
2,3,5,2,11,1541,1504,37
2,3,6,2,11,1455,1445,10
2,3,7,2,11,1423,1433,-10
2,3,8,2,11,1455,1488,-33
2,3,9,2,11,1573,1544,29
2,3,10,2,11,1675,1620,55
2,3,11,2,11,1775,1710,65
2,3,12,2,11,1891,1810,81
2,3,13,2,11,2006,1899,107
2,4,0,2,11,2052,1909,143
2,4,1,2,11,1934,1827,107
2,4,2,2,11,1802,1746,56
2,4,3,2,11,1678,1714,-36
2,4,4,2,11,1556,1741,-185
2,4,5,2,11,1419,1778,-359
2,4,6,2,11,1304,1815,-511
2,4,7,2,11,1274,1816,-542
2,4,8,2,11,1346,1803,-457
2,4,9,2,11,1453,1803,-350
2,4,10,2,11,1565,1807,-242
2,4,11,2,11,1679,1832,-153
2,4,12,2,11,1800,1890,-90
2,4,13,2,11,1909,1962,-53
2,5,0,2,11,1964,2237,-273
2,5,1,2,11,1864,2217,-353
2,5,2,2,11,1752,2196,-444
2,5,3,2,11,1657,2229,-572
2,5,4,2,11,1582,2337,-755
2,5,5,2,11,1504,2468,-964
2,5,6,2,11,1445,2550,-1105
2,5,7,2,11,1433,2548,-1115
2,5,8,2,11,1488,2530,-1042
2,5,9,2,11,1544,2478,-934
2,5,10,2,11,1620,2418,-798
2,5,11,2,11,1710,2403,-693
2,5,12,2,11,1810,2395,-585
2,5,13,2,11,1899,2406,-507
2,6,0,2,11,1909,1899,10
2,6,1,2,11,1827,1840,-13
2,6,2,2,11,1746,1815,-69
2,6,3,2,11,1714,1799,-85
2,6,4,2,11,1741,1843,-102
2,6,5,2,11,1778,1930,-152
2,6,6,2,11,1815,1974,-159
2,6,7,2,11,1816,1992,-176
2,6,8,2,11,1803,1991,-188
2,6,9,2,11,1803,1940,-137
2,6,10,2,11,1807,1914,-107
2,6,11,2,11,1832,1943,-111
2,6,12,2,11,1890,1964,-74
2,6,13,2,11,1962,2013,-51
2,7,0,2,11,2237,1860,377
2,7,1,2,11,2217,1805,412
2,7,2,2,11,2196,1856,340
2,7,3,2,11,2229,1887,342
2,7,4,2,11,2337,1919,418
2,7,5,2,11,2468,1912,556
2,7,6,2,11,2550,1943,607
2,7,7,2,11,2548,1991,557
2,7,8,2,11,2530,1937,593
2,7,9,2,11,2478,1898,580
2,7,10,2,11,2418,1895,523
2,7,11,2,11,2403,1876,527
2,7,12,2,11,2395,1896,499
2,7,13,2,11,2406,1941,465
2,8,0,2,11,1899,3153,-1254
2,8,1,2,11,1840,3207,-1367
2,8,2,2,11,1815,3379,-1564
2,8,3,2,11,1799,3561,-1762
2,8,4,2,11,1843,3670,-1827
2,8,5,2,11,1930,3587,-1657
2,8,6,2,11,1974,3681,-1707
2,8,7,2,11,1992,3720,-1728
2,8,8,2,11,1991,3629,-1638
2,8,9,2,11,1940,3602,-1662
2,8,10,2,11,1914,3624,-1710
2,8,11,2,11,1943,3549,-1606
2,8,12,2,11,1964,3524,-1560
2,8,13,2,11,2013,3448,-1435
2,9,0,2,11,1860,3781,-1921
2,9,1,2,11,1805,3784,-1979
2,9,2,2,11,1856,3859,-2003
2,9,3,2,11,1887,3976,-2089
2,9,4,2,11,1919,4014,-2095
2,9,5,2,11,1912,3872,-1960
2,9,6,2,11,1943,3989,-2046
2,9,7,2,11,1991,4027,-2036
2,9,8,2,11,1937,3957,-2020
2,9,9,2,11,1898,3942,-2044
2,9,10,2,11,1895,4084,-2189
2,9,11,2,11,1876,4142,-2266
2,9,12,2,11,1896,4221,-2325
2,9,13,2,11,1941,4164,-2223
2,10,0,2,11,3153,3696,-543
2,10,1,2,11,3207,3607,-400
2,10,2,2,11,3379,3542,-163
2,10,3,2,11,3561,3535,26
2,10,4,2,11,3670,3480,190
2,10,5,2,11,3587,3372,215
2,10,6,2,11,3681,3418,263
2,10,7,2,11,3720,3490,230
2,10,8,2,11,3629,3451,178
2,10,9,2,11,3602,3405,197
2,10,10,2,11,3624,3589,35
2,10,11,2,11,3549,3754,-205
2,10,12,2,11,3524,3942,-418
2,10,13,2,11,3448,3966,-518
2,11,0,2,11,3781,3661,120
2,11,1,2,11,3784,3549,235
2,11,2,2,11,3859,3440,419
2,11,3,2,11,3976,3423,553
2,11,4,2,11,4014,3373,641
2,11,5,2,11,3872,3322,550
2,11,6,2,11,3989,3305,684
2,11,7,2,11,4027,3389,638
2,11,8,2,11,3957,3373,584
2,11,9,2,11,3942,3314,628
2,11,10,2,11,4084,3444,640
2,11,11,2,11,4142,3594,548
2,11,12,2,11,4221,3806,415
2,11,13,2,11,4164,3875,289
2,12,0,2,11,3696,3663,33
2,12,1,2,11,3607,3552,55
2,12,2,2,11,3542,3428,114
2,12,3,2,11,3535,3410,125
2,12,4,2,11,3480,3359,121
2,12,5,2,11,3372,3291,81
2,12,6,2,11,3418,3283,135
2,12,7,2,11,3490,3327,163
2,12,8,2,11,3451,3336,115
2,12,9,2,11,3405,3298,107
2,12,10,2,11,3589,3417,172
2,12,11,2,11,3754,3565,189
2,12,12,2,11,3942,3765,177
2,12,13,2,11,3966,3846,120
2,13,0,2,11,3661,3563,98
2,13,1,2,11,3549,3497,52
2,13,2,2,11,3440,3446,-6
2,13,3,2,11,3423,3468,-45
2,13,4,2,11,3373,3414,-41
2,13,5,2,11,3322,3322,0
2,13,6,2,11,3305,3332,-27
2,13,7,2,11,3389,3379,10
2,13,8,2,11,3373,3330,43
2,13,9,2,11,3314,3293,21
2,13,10,2,11,3444,3408,36
2,13,11,2,11,3594,3539,55
2,13,12,2,11,3806,3654,152
2,13,13,2,11,3875,3703,172
2,14,0,2,11,3663,3235,428
2,14,1,2,11,3552,3180,372
2,14,2,2,11,3428,3201,227
2,14,3,2,11,3410,3258,152
2,14,4,2,11,3359,3152,207
2,14,5,2,11,3291,3040,251
2,14,6,2,11,3283,3096,187
2,14,7,2,11,3327,3185,142
2,14,8,2,11,3336,2970,366
2,14,9,2,11,3298,2912,386
2,14,10,2,11,3417,3064,353
2,14,11,2,11,3565,3171,394
2,14,12,2,11,3765,3220,545
2,14,13,2,11,3846,3305,541
2,15,0,2,11,3563,2858,705
2,15,1,2,11,3497,2779,718
2,15,2,2,11,3446,2802,644
2,15,3,2,11,3468,2821,647
2,15,4,2,11,3414,2655,759
2,15,5,2,11,3322,2432,890
2,15,6,2,11,3332,2371,961
2,15,7,2,11,3379,2509,870
2,15,8,2,11,3330,2298,1032
2,15,9,2,11,3293,2275,1018
2,15,10,2,11,3408,2505,903
2,15,11,2,11,3539,2650,889
2,15,12,2,11,3654,2673,981
2,15,13,2,11,3703,2759,944
2,16,0,2,11,3235,2815,420
2,16,1,2,11,3180,2718,462
2,16,2,2,11,3201,2801,400
2,16,3,2,11,3258,2853,405
2,16,4,2,11,3152,2648,504
2,16,5,2,11,3040,2427,613
2,16,6,2,11,3096,2423,673
2,16,7,2,11,3185,2648,537
2,16,8,2,11,2970,2563,407
2,16,9,2,11,2912,2452,460
2,16,10,2,11,3064,2633,431
2,16,11,2,11,3171,2643,528
2,16,12,2,11,3220,2583,637
2,16,13,2,11,3305,2640,665
2,17,0,2,11,2858,2952,-94
2,17,1,2,11,2779,2823,-44
2,17,2,2,11,2802,2967,-165
2,17,3,2,11,2821,3098,-277
2,17,4,2,11,2655,2828,-173
2,17,5,2,11,2432,2741,-309
2,17,6,2,11,2371,2944,-573
2,17,7,2,11,2509,3127,-618
2,17,8,2,11,2298,2966,-668
2,17,9,2,11,2275,2675,-400
2,17,10,2,11,2505,2760,-255
2,17,11,2,11,2650,2573,77
2,17,12,2,11,2673,2451,222
2,17,13,2,11,2759,2553,206
2,18,0,2,11,2815,2532,283
2,18,1,2,11,2718,2303,415
2,18,2,2,11,2801,2395,406
2,18,3,2,11,2853,2420,433
2,18,4,2,11,2648,2063,585
2,18,5,2,11,2427,2034,393
2,18,6,2,11,2423,2140,283
2,18,7,2,11,2648,2199,449
2,18,8,2,11,2563,2039,524
2,18,9,2,11,2452,1811,641
2,18,10,2,11,2633,1902,731
2,18,11,2,11,2643,1857,786
2,18,12,2,11,2583,1844,739
2,18,13,2,11,2640,1988,652
2,19,0,2,11,2952,1901,1051
2,19,1,2,11,2823,1706,1117
2,19,2,2,11,2967,1764,1203
2,19,3,2,11,3098,1718,1380
2,19,4,2,11,2828,1420,1408
2,19,5,2,11,2741,1471,1270
2,19,6,2,11,2944,1557,1387
2,19,7,2,11,3127,1594,1533
2,19,8,2,11,2966,1490,1476
2,19,9,2,11,2675,1336,1339
2,19,10,2,11,2760,1395,1365
2,19,11,2,11,2573,1442,1131
2,19,12,2,11,2451,1487,964
2,19,13,2,11,2553,1512,1041
2,20,0,2,11,2532,1698,834
2,20,1,2,11,2303,1611,692
2,20,2,2,11,2395,1716,679
2,20,3,2,11,2420,1759,661
2,20,4,2,11,2063,1695,368
2,20,5,2,11,2034,1778,256
2,20,6,2,11,2140,1895,245
2,20,7,2,11,2199,1939,260
2,20,8,2,11,2039,1826,213
2,20,9,2,11,1811,1677,134
2,20,10,2,11,1902,1632,270
2,20,11,2,11,1857,1594,263
2,20,12,2,11,1844,1601,243
2,20,13,2,11,1988,1456,532
2,0,0,3,11,3550,3157,393
2,0,1,3,11,3540,2990,550
2,0,2,3,11,3518,2803,715
2,0,3,3,11,3518,2632,886
2,0,4,3,11,3526,2470,1056
2,0,5,3,11,3516,2288,1228
2,0,6,3,11,3519,2148,1371
2,0,7,3,11,3523,2105,1418
2,0,8,3,11,3515,2179,1336
2,0,9,3,11,3505,2335,1170
2,0,10,3,11,3485,2485,1000
2,0,11,3,11,3494,2637,857
2,0,12,3,11,3520,2806,714
2,0,13,3,11,3519,2964,555
2,1,0,3,11,3503,2995,508
2,1,1,3,11,3452,2826,626
2,1,2,3,11,3380,2639,741
2,1,3,3,11,3326,2475,851
2,1,4,3,11,3288,2332,956
2,1,5,3,11,3239,2176,1063
2,1,6,3,11,3230,2056,1174
2,1,7,3,11,3223,2025,1198
2,1,8,3,11,3213,2110,1103
2,1,9,3,11,3248,2235,1013
2,1,10,3,11,3271,2375,896
2,1,11,3,11,3317,2527,790
2,1,12,3,11,3384,2695,689
2,1,13,3,11,3432,2850,582
2,2,0,3,11,3357,2930,427
2,2,1,3,11,3240,2799,441
2,2,2,3,11,3101,2661,440
2,2,3,3,11,2981,2574,407
2,2,4,3,11,2876,2547,329
2,2,5,3,11,2754,2525,229
2,2,6,3,11,2677,2508,169
2,2,7,3,11,2646,2498,148
2,2,8,3,11,2669,2527,142
2,2,9,3,11,2779,2565,214
2,2,10,3,11,2871,2617,254
2,2,11,3,11,2972,2694,278
2,2,12,3,11,3096,2805,291
2,2,13,3,11,3211,2920,291
2,3,0,3,11,3157,3180,-23
2,3,1,3,11,2990,3109,-119
2,3,2,3,11,2803,3033,-230
2,3,3,3,11,2632,3026,-394
2,3,4,3,11,2470,3113,-643
2,3,5,3,11,2288,3225,-937
2,3,6,3,11,2148,3302,-1154
2,3,7,3,11,2105,3299,-1194
2,3,8,3,11,2179,3294,-1115
2,3,9,3,11,2335,3260,-925
2,3,10,3,11,2485,3228,-743
2,3,11,3,11,2637,3251,-614
2,3,12,3,11,2806,3290,-484
2,3,13,3,11,2964,3347,-383
2,4,0,3,11,2995,2865,130
2,4,1,3,11,2826,2775,51
2,4,2,3,11,2639,2724,-85
2,4,3,3,11,2475,2716,-241
2,4,4,3,11,2332,2808,-476
2,4,5,3,11,2176,2951,-775
2,4,6,3,11,2056,3037,-981
2,4,7,3,11,2025,3057,-1032
2,4,8,3,11,2110,3030,-920
2,4,9,3,11,2235,2961,-726
2,4,10,3,11,2375,2911,-536
2,4,11,3,11,2527,2927,-400
2,4,12,3,11,2695,2959,-264
2,4,13,3,11,2850,3034,-184
2,5,0,3,11,2930,3131,-201
2,5,1,3,11,2799,3087,-288
2,5,2,3,11,2661,3143,-482
2,5,3,3,11,2574,3199,-625
2,5,4,3,11,2547,3291,-744
2,5,5,3,11,2525,3359,-834
2,5,6,3,11,2508,3430,-922
2,5,7,3,11,2498,3474,-976
2,5,8,3,11,2527,3428,-901
2,5,9,3,11,2565,3355,-790
2,5,10,3,11,2617,3316,-699
2,5,11,3,11,2694,3295,-601
2,5,12,3,11,2805,3296,-491
2,5,13,3,11,2920,3326,-406
2,6,0,3,11,3180,3781,-601
2,6,1,3,11,3109,3765,-656
2,6,2,3,11,3033,3907,-874
2,6,3,3,11,3026,4048,-1022
2,6,4,3,11,3113,4141,-1028
2,6,5,3,11,3225,4070,-845
2,6,6,3,11,3302,4168,-866
2,6,7,3,11,3299,4229,-930
2,6,8,3,11,3294,4129,-835
2,6,9,3,11,3260,4085,-825
2,6,10,3,11,3228,4117,-889
2,6,11,3,11,3251,4073,-822
2,6,12,3,11,3290,4088,-798
2,6,13,3,11,3347,4076,-729
2,7,0,3,11,2865,5013,-2148
2,7,1,3,11,2775,5031,-2256
2,7,2,3,11,2724,5187,-2463
2,7,3,3,11,2716,5376,-2660
2,7,4,3,11,2808,5462,-2654
2,7,5,3,11,2951,5301,-2350
2,7,6,3,11,3037,5445,-2408
2,7,7,3,11,3057,5509,-2452
2,7,8,3,11,3030,5394,-2364
2,7,9,3,11,2961,5357,-2396
2,7,10,3,11,2911,5486,-2575
2,7,11,3,11,2927,5494,-2567
2,7,12,3,11,2959,5553,-2594
2,7,13,3,11,3034,5477,-2443
2,8,0,3,11,3131,5617,-2486
2,8,1,3,11,3087,5567,-2480
2,8,2,3,11,3143,5593,-2450
2,8,3,3,11,3199,5696,-2497
2,8,4,3,11,3291,5702,-2411
2,8,5,3,11,3359,5530,-2171
2,8,6,3,11,3430,5643,-2213
2,8,7,3,11,3474,5728,-2254
2,8,8,3,11,3428,5643,-2215
2,8,9,3,11,3355,5592,-2237
2,8,10,3,11,3316,5811,-2495
2,8,11,3,11,3295,5951,-2656
2,8,12,3,11,3296,6134,-2838
2,8,13,3,11,3326,6101,-2775
2,9,0,3,11,3781,5521,-1740
2,9,1,3,11,3765,5373,-1608
2,9,2,3,11,3907,5248,-1341
2,9,3,3,11,4048,5238,-1190
2,9,4,3,11,4141,5165,-1024
2,9,5,3,11,4070,5036,-966
2,9,6,3,11,4168,5069,-901
2,9,7,3,11,4229,5178,-949
2,9,8,3,11,4129,5138,-1009
2,9,9,3,11,4085,5069,-984
2,9,10,3,11,4117,5306,-1189
2,9,11,3,11,4073,5539,-1466
2,9,12,3,11,4088,5835,-1747
2,9,13,3,11,4076,5904,-1828
2,10,0,3,11,5013,5499,-486
2,10,1,3,11,5031,5335,-304
2,10,2,3,11,5187,5162,25
2,10,3,3,11,5376,5130,246
2,10,4,3,11,5462,5047,415
2,10,5,3,11,5301,4949,352
2,10,6,3,11,5445,4937,508
2,10,7,3,11,5509,5028,481
2,10,8,3,11,5394,5022,372
2,10,9,3,11,5357,4948,409
2,10,10,3,11,5486,5144,342
2,10,11,3,11,5494,5374,120
2,10,12,3,11,5553,5678,-125
2,10,13,3,11,5477,5783,-306
2,11,0,3,11,5617,5388,229
2,11,1,3,11,5567,5263,304
2,11,2,3,11,5593,5152,441
2,11,3,3,11,5696,5171,525
2,11,4,3,11,5702,5099,603
2,11,5,3,11,5530,4986,544
2,11,6,3,11,5643,4983,660
2,11,7,3,11,5728,5067,661
2,11,8,3,11,5643,5017,626
2,11,9,3,11,5592,4957,635
2,11,10,3,11,5811,5125,686
2,11,11,3,11,5951,5324,627
2,11,12,3,11,6134,5547,587
2,11,13,3,11,6101,5641,460
2,12,0,3,11,5521,5073,448
2,12,1,3,11,5373,4966,407
2,12,2,3,11,5248,4923,325
2,12,3,3,11,5238,4965,273
2,12,4,3,11,5165,4826,339
2,12,5,3,11,5036,4667,369
2,12,6,3,11,5069,4728,341
2,12,7,3,11,5178,4824,354
2,12,8,3,11,5138,4619,519
2,12,9,3,11,5069,4546,523
2,12,10,3,11,5306,4764,542
2,12,11,3,11,5539,4951,588
2,12,12,3,11,5835,5092,743
2,12,13,3,11,5904,5213,691
2,13,0,3,11,5499,4583,916
2,13,1,3,11,5335,4490,845
2,13,2,3,11,5162,4526,636
2,13,3,3,11,5130,4582,548
2,13,4,3,11,5047,4395,652
2,13,5,3,11,4949,4127,822
2,13,6,3,11,4937,4071,866
2,13,7,3,11,5028,4249,779
2,13,8,3,11,5022,3979,1043
2,13,9,3,11,4948,3934,1014
2,13,10,3,11,5144,4213,931
2,13,11,3,11,5374,4409,965
2,13,12,3,11,5678,4455,1223
2,13,13,3,11,5783,4554,1229
2,14,0,3,11,5388,4325,1063
2,14,1,3,11,5263,4187,1076
2,14,2,3,11,5152,4278,874
2,14,3,3,11,5171,4350,821
2,14,4,3,11,5099,4060,1039
2,14,5,3,11,4986,3772,1214
2,14,6,3,11,4983,3819,1164
2,14,7,3,11,5067,4093,974
2,14,8,3,11,5017,3852,1165
2,14,9,3,11,4957,3705,1252
2,14,10,3,11,5125,3989,1136
2,14,11,3,11,5324,4055,1269
2,14,12,3,11,5547,4021,1526
2,14,13,3,11,5641,4150,1491
2,15,0,3,11,5073,4300,773
2,15,1,3,11,4966,4133,833
2,15,2,3,11,4923,4292,631
2,15,3,3,11,4965,4422,543
2,15,4,3,11,4826,4071,755
2,15,5,3,11,4667,3828,839
2,15,6,3,11,4728,3919,809
2,15,7,3,11,4824,4191,633
2,15,8,3,11,4619,3975,644
2,15,9,3,11,4546,3697,849
2,15,10,3,11,4764,3909,855
2,15,11,3,11,4951,3811,1140
2,15,12,3,11,5092,3686,1406
2,15,13,3,11,5213,3802,1411
2,16,0,3,11,4583,3999,584
2,16,1,3,11,4490,3711,779
2,16,2,3,11,4526,3871,655
2,16,3,3,11,4582,3949,633
2,16,4,3,11,4395,3468,927
2,16,5,3,11,4127,3374,753
2,16,6,3,11,4071,3588,483
2,16,7,3,11,4249,3783,466
2,16,8,3,11,3979,3593,386
2,16,9,3,11,3934,3241,693
2,16,10,3,11,4213,3386,827
2,16,11,3,11,4409,3262,1147
2,16,12,3,11,4455,3192,1263
2,16,13,3,11,4554,3379,1175
2,17,0,3,11,4325,3386,939
2,17,1,3,11,4187,3121,1066
2,17,2,3,11,4278,3255,1023
2,17,3,3,11,4350,3287,1063
2,17,4,3,11,4060,2843,1217
2,17,5,3,11,3772,2872,900
2,17,6,3,11,3819,3053,766
2,17,7,3,11,4093,3137,956
2,17,8,3,11,3852,2902,950
2,17,9,3,11,3705,2581,1124
2,17,10,3,11,3989,2671,1318
2,17,11,3,11,4055,2610,1445
2,17,12,3,11,4021,2590,1431
2,17,13,3,11,4150,2674,1476
2,18,0,3,11,4300,2745,1555
2,18,1,3,11,4133,2499,1634
2,18,2,3,11,4292,2620,1672
2,18,3,3,11,4422,2610,1812
2,18,4,3,11,4071,2335,1736
2,18,5,3,11,3828,2411,1417
2,18,6,3,11,3919,2539,1380
2,18,7,3,11,4191,2595,1596
2,18,8,3,11,3975,2453,1522
2,18,9,3,11,3697,2243,1454
2,18,10,3,11,3909,2258,1651
2,18,11,3,11,3811,2283,1528
2,18,12,3,11,3686,2342,1344
2,18,13,3,11,3802,2282,1520
2,0,0,4,11,4655,3961,694
2,0,1,4,11,4596,3761,835
2,0,2,4,11,4519,3548,971
2,0,3,4,11,4472,3392,1080
2,0,4,4,11,4440,3297,1143
2,0,5,4,11,4385,3197,1188
2,0,6,4,11,4363,3119,1244
2,0,7,4,11,4354,3090,1264
2,0,8,4,11,4348,3149,1199
2,0,9,4,11,4387,3256,1131
2,0,10,4,11,4405,3372,1033
2,0,11,4,11,4452,3511,941
2,0,12,4,11,4526,3690,836
2,0,13,4,11,4574,3871,703
2,1,0,4,11,4534,4201,333
2,1,1,4,11,4414,4081,333
2,1,2,4,11,4267,3948,319
2,1,3,4,11,4144,3886,258
2,1,4,4,11,4038,3919,119
2,1,5,4,11,3911,3972,-61
2,1,6,4,11,3841,3995,-154
2,1,7,4,11,3815,3981,-166
2,1,8,4,11,3835,4018,-183
2,1,9,4,11,3939,4022,-83
2,1,10,4,11,4026,4038,-12
2,1,11,4,11,4134,4113,21
2,1,12,4,11,4269,4205,64
2,1,13,4,11,4383,4305,78
2,2,0,4,11,4378,3808,570
2,2,1,4,11,4212,3667,545
2,2,2,4,11,4016,3561,455
2,2,3,4,11,3841,3513,328
2,2,4,4,11,3682,3584,98
2,2,5,4,11,3501,3708,-207
2,2,6,4,11,3370,3789,-419
2,2,7,4,11,3328,3808,-480
2,2,8,4,11,3393,3794,-401
2,2,9,4,11,3541,3743,-202
2,2,10,4,11,3681,3721,-40
2,2,11,4,11,3834,3775,59
2,2,12,4,11,4011,3854,157
2,2,13,4,11,4169,3975,194
2,3,0,4,11,4100,4097,3
2,3,1,4,11,3882,4022,-140
2,3,2,4,11,3640,4052,-412
2,3,3,4,11,3429,4116,-687
2,3,4,4,11,3246,4256,-1010
2,3,5,4,11,3045,4380,-1335
2,3,6,4,11,2900,4493,-1593
2,3,7,4,11,2856,4539,-1683
2,3,8,4,11,2943,4467,-1524
2,3,9,4,11,3117,4376,-1259
2,3,10,4,11,3295,4313,-1018
2,3,11,4,11,3485,4279,-794
2,3,12,4,11,3701,4291,-590
2,3,13,4,11,3905,4347,-442
2,4,0,4,11,3961,5052,-1091
2,4,1,4,11,3761,5047,-1286
2,4,2,4,11,3548,5194,-1646
2,4,3,4,11,3392,5360,-1968
2,4,4,4,11,3297,5513,-2216
2,4,5,4,11,3197,5517,-2320
2,4,6,4,11,3119,5655,-2536
2,4,7,4,11,3090,5712,-2622
2,4,8,4,11,3149,5620,-2471
2,4,9,4,11,3256,5542,-2286
2,4,10,4,11,3372,5538,-2166
2,4,11,4,11,3511,5492,-1981
2,4,12,4,11,3690,5488,-1798
2,4,13,4,11,3871,5461,-1590
2,5,0,4,11,4201,5641,-1440
2,5,1,4,11,4081,5589,-1508
2,5,2,4,11,3948,5715,-1767
2,5,3,4,11,3886,5863,-1977
2,5,4,4,11,3919,5933,-2014
2,5,5,4,11,3972,5784,-1812
2,5,6,4,11,3995,5932,-1937
2,5,7,4,11,3981,6018,-2037
2,5,8,4,11,4018,5894,-1876
2,5,9,4,11,4022,5840,-1818
2,5,10,4,11,4038,5979,-1941
2,5,11,4,11,4113,6018,-1905
2,5,12,4,11,4205,6117,-1912
2,5,13,4,11,4305,6105,-1800
2,6,0,4,11,3808,6849,-3041
2,6,1,4,11,3667,6814,-3147
2,6,2,4,11,3561,6921,-3360
2,6,3,4,11,3513,7096,-3583
2,6,4,4,11,3584,7150,-3566
2,6,5,4,11,3708,6959,-3251
2,6,6,4,11,3789,7099,-3310
2,6,7,4,11,3808,7210,-3402
2,6,8,4,11,3794,7080,-3286
2,6,9,4,11,3743,7007,-3264
2,6,10,4,11,3721,7213,-3492
2,6,11,4,11,3775,7303,-3528
2,6,12,4,11,3854,7466,-3612
2,6,13,4,11,3975,7414,-3439
2,7,0,4,11,4097,7442,-3345
2,7,1,4,11,4022,7333,-3311
2,7,2,4,11,4052,7299,-3247
2,7,3,4,11,4116,7399,-3283
2,7,4,4,11,4256,7387,-3131
2,7,5,4,11,4380,7194,-2814
2,7,6,4,11,4493,7294,-2801
2,7,7,4,11,4539,7416,-2877
2,7,8,4,11,4467,7330,-2863
2,7,9,4,11,4376,7256,-2880
2,7,10,4,11,4313,7528,-3215
2,7,11,4,11,4279,7736,-3457
2,7,12,4,11,4291,8027,-3736
2,7,13,4,11,4347,8039,-3692
2,8,0,4,11,5052,7359,-2307
2,8,1,4,11,5047,7159,-2112
2,8,2,4,11,5194,6970,-1776
2,8,3,4,11,5360,6945,-1585
2,8,4,4,11,5513,6839,-1326
2,8,5,4,11,5517,6663,-1146
2,8,6,4,11,5655,6701,-1046
2,8,7,4,11,5712,6817,-1105
2,8,8,4,11,5620,6787,-1167
2,8,9,4,11,5542,6703,-1161
2,8,10,4,11,5538,7006,-1468
2,8,11,4,11,5492,7319,-1827
2,8,12,4,11,5488,7707,-2219
2,8,13,4,11,5461,7812,-2351
2,9,0,4,11,5641,7224,-1583
2,9,1,4,11,5589,7046,-1457
2,9,2,4,11,5715,6886,-1171
2,9,3,4,11,5863,6891,-1028
2,9,4,4,11,5933,6787,-854
2,9,5,4,11,5784,6644,-860
2,9,6,4,11,5932,6637,-705
2,9,7,4,11,6018,6768,-750
2,9,8,4,11,5894,6703,-809
2,9,9,4,11,5840,6607,-767
2,9,10,4,11,5979,6852,-873
2,9,11,4,11,6018,7133,-1115
2,9,12,4,11,6117,7460,-1343
2,9,13,4,11,6105,7578,-1473
2,10,0,4,11,6849,6898,-49
2,10,1,4,11,6814,6732,82
2,10,2,4,11,6921,6629,292
2,10,3,4,11,7096,6668,428
2,10,4,4,11,7150,6511,639
2,10,5,4,11,6959,6331,628
2,10,6,4,11,7099,6379,720
2,10,7,4,11,7210,6512,698
2,10,8,4,11,7080,6306,774
2,10,9,4,11,7007,6210,797
2,10,10,4,11,7213,6481,732
2,10,11,4,11,7303,6736,567
2,10,12,4,11,7466,6985,481
2,10,13,4,11,7414,7151,263
2,11,0,4,11,7442,6421,1021
2,11,1,4,11,7333,6276,1057
2,11,2,4,11,7299,6248,1051
2,11,3,4,11,7399,6289,1110
2,11,4,4,11,7387,6069,1318
2,11,5,4,11,7194,5754,1440
2,11,6,4,11,7294,5703,1591
2,11,7,4,11,7416,5888,1528
2,11,8,4,11,7330,5628,1702
2,11,9,4,11,7256,5568,1688
2,11,10,4,11,7528,5913,1615
2,11,11,4,11,7736,6189,1547
2,11,12,4,11,8027,6327,1700
2,11,13,4,11,8039,6462,1577
2,12,0,4,11,7359,6050,1309
2,12,1,4,11,7159,5898,1261
2,12,2,4,11,6970,6002,968
2,12,3,4,11,6945,6111,834
2,12,4,4,11,6839,5800,1039
2,12,5,4,11,6663,5467,1196
2,12,6,4,11,6701,5519,1182
2,12,7,4,11,6817,5833,984
2,12,8,4,11,6787,5533,1254
2,12,9,4,11,6703,5364,1339
2,12,10,4,11,7006,5697,1309
2,12,11,4,11,7319,5814,1505
2,12,12,4,11,7707,5803,1904
2,12,13,4,11,7812,5945,1867
2,13,0,4,11,7224,5810,1414
2,13,1,4,11,7046,5602,1444
2,13,2,4,11,6886,5769,1117
2,13,3,4,11,6891,5919,972
2,13,4,4,11,6787,5483,1304
2,13,5,4,11,6644,5173,1471
2,13,6,4,11,6637,5315,1322
2,13,7,4,11,6768,5636,1132
2,13,8,4,11,6703,5264,1439
2,13,9,4,11,6607,4950,1657
2,13,10,4,11,6852,5265,1587
2,13,11,4,11,7133,5223,1910
2,13,12,4,11,7460,5124,2336
2,13,13,4,11,7578,5312,2266
2,14,0,4,11,6898,5347,1551
2,14,1,4,11,6732,5021,1711
2,14,2,4,11,6629,5196,1433
2,14,3,4,11,6668,5273,1395
2,14,4,4,11,6511,4711,1800
2,14,5,4,11,6331,4461,1870
2,14,6,4,11,6379,4563,1816
2,14,7,4,11,6512,4847,1665
2,14,8,4,11,6306,4602,1704
2,14,9,4,11,6210,4263,1947
2,14,10,4,11,6481,4535,1946
2,14,11,4,11,6736,4500,2236
2,14,12,4,11,6985,4427,2558
2,14,13,4,11,7151,4628,2523
2,15,0,4,11,6421,4853,1568
2,15,1,4,11,6276,4529,1747
2,15,2,4,11,6248,4731,1517
2,15,3,4,11,6289,4816,1473
2,15,4,4,11,6069,4248,1821
2,15,5,4,11,5754,4212,1542
2,15,6,4,11,5703,4501,1202
2,15,7,4,11,5888,4721,1167
2,15,8,4,11,5628,4456,1172
2,15,9,4,11,5568,4011,1557
2,15,10,4,11,5913,4155,1758
2,15,11,4,11,6189,4015,2174
2,15,12,4,11,6327,3938,2389
2,15,13,4,11,6462,4065,2397
2,16,0,4,11,6050,4230,1820
2,16,1,4,11,5898,3914,1984
2,16,2,4,11,6002,4111,1891
2,16,3,4,11,6111,4179,1932
2,16,4,4,11,5800,3758,2042
2,16,5,4,11,5467,3812,1655
2,16,6,4,11,5519,4035,1484
2,16,7,4,11,5833,4138,1695
2,16,8,4,11,5533,3865,1668
2,16,9,4,11,5364,3488,1876
2,16,10,4,11,5697,3534,2163
2,16,11,4,11,5814,3451,2363
2,16,12,4,11,5803,3445,2358
2,16,13,4,11,5945,3444,2501
2,0,0,5,11,5686,4829,857
2,0,1,5,11,5558,4639,919
2,0,2,5,11,5406,4476,930
2,0,3,5,11,5290,4373,917
2,0,4,5,11,5190,4390,800
2,0,5,5,11,5057,4455,602
2,0,6,5,11,4974,4482,492
2,0,7,5,11,4946,4490,456
2,0,8,5,11,4970,4518,452
2,0,9,5,11,5078,4505,573
2,0,10,5,11,5160,4531,629
2,0,11,5,11,5269,4637,632
2,0,12,5,11,5411,4769,642
2,0,13,5,11,5525,4933,592
2,1,0,5,11,5555,5040,515
2,1,1,5,11,5386,4914,472
2,1,2,5,11,5182,4889,293
2,1,3,5,11,5004,4913,91
2,1,4,5,11,4844,5032,-188
2,1,5,5,11,4658,5137,-479
2,1,6,5,11,4534,5245,-711
2,1,7,5,11,4497,5290,-793
2,1,8,5,11,4559,5231,-672
2,1,9,5,11,4701,5158,-457
2,1,10,5,11,4836,5123,-287
2,1,11,5,11,4996,5127,-131
2,1,12,5,11,5184,5186,-2
2,1,13,5,11,5341,5288,53
2,2,0,5,11,5321,6018,-697
2,2,1,5,11,5104,5982,-878
2,2,2,5,11,4853,6103,-1250
2,2,3,5,11,4638,6277,-1639
2,2,4,5,11,4458,6478,-2020
2,2,5,5,11,4258,6538,-2280
2,2,6,5,11,4122,6718,-2596
2,2,7,5,11,4079,6777,-2698
2,2,8,5,11,4157,6659,-2502
2,2,9,5,11,4323,6563,-2240
2,2,10,5,11,4491,6535,-2044
2,2,11,5,11,4682,6476,-1794
2,2,12,5,11,4906,6483,-1577
2,2,13,5,11,5110,6482,-1372
2,3,0,5,11,5066,6912,-1846
2,3,1,5,11,4817,6871,-2054
2,3,2,5,11,4549,7002,-2453
2,3,3,5,11,4346,7175,-2829
2,3,4,5,11,4211,7305,-3094
2,3,5,5,11,4066,7231,-3165
2,3,6,5,11,3963,7419,-3456
2,3,7,5,11,3921,7501,-3580
2,3,8,5,11,3982,7385,-3403
2,3,9,5,11,4138,7297,-3159
2,3,10,5,11,4292,7400,-3108
2,3,11,5,11,4469,7437,-2968
2,3,12,5,11,4696,7517,-2821
2,3,13,5,11,4926,7490,-2564
2,4,0,5,11,5232,7477,-2245
2,4,1,5,11,5043,7372,-2329
2,4,2,5,11,4835,7449,-2614
2,4,3,5,11,4704,7583,-2879
2,4,4,5,11,4669,7621,-2952
2,4,5,5,11,4644,7442,-2798
2,4,6,5,11,4606,7586,-2980
2,4,7,5,11,4573,7719,-3146
2,4,8,5,11,4640,7580,-2940
2,4,9,5,11,4713,7490,-2777
2,4,10,5,11,4793,7706,-2913
2,4,11,5,11,4930,7827,-2897
2,4,12,5,11,5090,8030,-2940
2,4,13,5,11,5256,8042,-2786
2,5,0,5,11,4829,8674,-3845
2,5,1,5,11,4639,8580,-3941
2,5,2,5,11,4476,8627,-4151
2,5,3,5,11,4373,8799,-4426
2,5,4,5,11,4390,8835,-4445
2,5,5,5,11,4455,8623,-4168
2,5,6,5,11,4482,8750,-4268
2,5,7,5,11,4490,8898,-4408
2,5,8,5,11,4518,8767,-4249
2,5,9,5,11,4505,8671,-4166
2,5,10,5,11,4531,8930,-4399
2,5,11,5,11,4637,9088,-4451
2,5,12,5,11,4769,9359,-4590
2,5,13,5,11,4933,9352,-4419
2,6,0,5,11,5040,9280,-4240
2,6,1,5,11,4914,9119,-4205
2,6,2,5,11,4889,9021,-4132
2,6,3,5,11,4913,9106,-4193
2,6,4,5,11,5032,9061,-4029
2,6,5,5,11,5137,8821,-3684
2,6,6,5,11,5245,8926,-3681
2,6,7,5,11,5290,9055,-3765
2,6,8,5,11,5231,8979,-3748
2,6,9,5,11,5158,8890,-3732
2,6,10,5,11,5123,9228,-4105
2,6,11,5,11,5127,9516,-4389
2,6,12,5,11,5186,9899,-4713
2,6,13,5,11,5288,9947,-4659
2,7,0,5,11,6018,9084,-3066
2,7,1,5,11,5982,8870,-2888
2,7,2,5,11,6103,8694,-2591
2,7,3,5,11,6277,8706,-2429
2,7,4,5,11,6478,8579,-2101
2,7,5,5,11,6538,8358,-1820
2,7,6,5,11,6718,8401,-1683
2,7,7,5,11,6777,8557,-1780
2,7,8,5,11,6659,8468,-1809
2,7,9,5,11,6563,8362,-1799
2,7,10,5,11,6535,8714,-2179
2,7,11,5,11,6476,9078,-2602
2,7,12,5,11,6483,9489,-3006
2,7,13,5,11,6482,9607,-3125
2,8,0,5,11,6912,8734,-1822
2,8,1,5,11,6871,8515,-1644
2,8,2,5,11,7002,8363,-1361
2,8,3,5,11,7175,8388,-1213
2,8,4,5,11,7305,8199,-894
2,8,5,5,11,7231,7989,-758
2,8,6,5,11,7419,8033,-614
2,8,7,5,11,7501,8213,-712
2,8,8,5,11,7385,7992,-607
2,8,9,5,11,7297,7860,-563
2,8,10,5,11,7400,8208,-808
2,8,11,5,11,7437,8545,-1108
2,8,12,5,11,7517,8898,-1381
2,8,13,5,11,7490,9088,-1598
2,9,0,5,11,7477,8246,-769
2,9,1,5,11,7372,8042,-670
2,9,2,5,11,7449,7954,-505
2,9,3,5,11,7583,7992,-409
2,9,4,5,11,7621,7754,-133
2,9,5,5,11,7442,7418,24
2,9,6,5,11,7586,7354,232
2,9,7,5,11,7719,7576,143
2,9,8,5,11,7580,7315,265
2,9,9,5,11,7490,7232,258
2,9,10,5,11,7706,7630,76
2,9,11,5,11,7827,7974,-147
2,9,12,5,11,8030,8220,-190
2,9,13,5,11,8042,8400,-358
2,10,0,5,11,8674,7888,786
2,10,1,5,11,8580,7684,896
2,10,2,5,11,8627,7724,903
2,10,3,5,11,8799,7818,981
2,10,4,5,11,8835,7474,1361
2,10,5,5,11,8623,7094,1529
2,10,6,5,11,8750,7151,1599
2,10,7,5,11,8898,7472,1426
2,10,8,5,11,8767,7182,1585
2,10,9,5,11,8671,6998,1673
2,10,10,5,11,8930,7397,1533
2,10,11,5,11,9088,7594,1494
2,10,12,5,11,9359,7675,1684
2,10,13,5,11,9352,7853,1499
2,11,0,5,11,9280,7535,1745
2,11,1,5,11,9119,7313,1806
2,11,2,5,11,9021,7493,1528
2,11,3,5,11,9106,7680,1426
2,11,4,5,11,9061,7223,1838
2,11,5,5,11,8821,6868,1953
2,11,6,5,11,8926,7015,1911
2,11,7,5,11,9055,7376,1679
2,11,8,5,11,8979,6945,2034
2,11,9,5,11,8890,6609,2281
2,11,10,5,11,9228,6973,2255
2,11,11,5,11,9516,6982,2534
2,11,12,5,11,9899,6906,2993
2,11,13,5,11,9947,7107,2840
2,12,0,5,11,9084,6857,2227
2,12,1,5,11,8870,6490,2380
2,12,2,5,11,8694,6673,2021
2,12,3,5,11,8706,6770,1936
2,12,4,5,11,8579,6123,2456
2,12,5,5,11,8358,5806,2552
2,12,6,5,11,8401,5959,2442
2,12,7,5,11,8557,6292,2265
2,12,8,5,11,8468,5891,2577
2,12,9,5,11,8362,5516,2846
2,12,10,5,11,8714,5891,2823
2,12,11,5,11,9078,5912,3166
2,12,12,5,11,9489,5865,3624
2,12,13,5,11,9607,6138,3469
2,13,0,5,11,8734,6201,2533
2,13,1,5,11,8515,5839,2676
2,13,2,5,11,8363,6056,2307
2,13,3,5,11,8388,6140,2248
2,13,4,5,11,8199,5491,2708
2,13,5,5,11,7989,5299,2690
2,13,6,5,11,8033,5476,2557
2,13,7,5,11,8213,5785,2428
2,13,8,5,11,7992,5465,2527
2,13,9,5,11,7860,5033,2827
2,13,10,5,11,8208,5304,2904
2,13,11,5,11,8545,5253,3292
2,13,12,5,11,8898,5173,3725
2,13,13,5,11,9088,5314,3774
2,14,0,5,11,8246,5697,2549
2,14,1,5,11,8042,5322,2720
2,14,2,5,11,7954,5587,2367
2,14,3,5,11,7992,5708,2284
2,14,4,5,11,7754,5163,2591
2,14,5,5,11,7418,5152,2266
2,14,6,5,11,7354,5483,1871
2,14,7,5,11,7576,5722,1854
2,14,8,5,11,7315,5419,1896
2,14,9,5,11,7232,4918,2314
2,14,10,5,11,7630,5018,2612
2,14,11,5,11,7974,4856,3118
2,14,12,5,11,8220,4793,3427
2,14,13,5,11,8400,4835,3565
2,0,0,6,11,6707,6961,-254
2,0,1,6,11,6530,6874,-344
2,0,2,6,11,6321,6940,-619
2,0,3,6,11,6150,7074,-924
2,0,4,6,11,5996,7254,-1258
2,0,5,6,11,5804,7295,-1491
2,0,6,6,11,5667,7470,-1803
2,0,7,6,11,5628,7528,-1900
2,0,8,6,11,5694,7423,-1729
2,0,9,6,11,5840,7345,-1505
2,0,10,6,11,5970,7345,-1375
2,0,11,6,11,6131,7324,-1193
2,0,12,6,11,6326,7378,-1052
2,0,13,6,11,6483,7423,-940
2,1,0,6,11,6498,7878,-1380
2,1,1,6,11,6278,7806,-1528
2,1,2,6,11,6019,7911,-1892
2,1,3,6,11,5801,8092,-2291
2,1,4,6,11,5620,8270,-2650
2,1,5,6,11,5415,8252,-2837
2,1,6,6,11,5286,8482,-3196
2,1,7,6,11,5248,8566,-3318
2,1,8,6,11,5323,8424,-3101
2,1,9,6,11,5483,8318,-2835
2,1,10,6,11,5646,8397,-2751
2,1,11,6,11,5844,8421,-2577
2,1,12,6,11,6079,8512,-2433
2,1,13,6,11,6282,8511,-2229
2,2,0,6,11,6287,8748,-2461
2,2,1,6,11,6039,8654,-2615
2,2,2,6,11,5762,8736,-2974
2,2,3,6,11,5555,8895,-3340
2,2,4,6,11,5423,8993,-3570
2,2,5,6,11,5279,8889,-3610
2,2,6,6,11,5185,9073,-3888
2,2,7,6,11,5144,9202,-4058
2,2,8,6,11,5196,9071,-3875
2,2,9,6,11,5344,8947,-3603
2,2,10,6,11,5488,9127,-3639
2,2,11,6,11,5666,9246,-3580
2,2,12,6,11,5901,9430,-3529
2,2,13,6,11,6131,9427,-3296
2,3,0,6,11,6337,9302,-2965
2,3,1,6,11,6099,9138,-3039
2,3,2,6,11,5836,9155,-3319
2,3,3,6,11,5658,9286,-3628
2,3,4,6,11,5583,9306,-3723
2,3,5,6,11,5513,9106,-3593
2,3,6,6,11,5450,9237,-3787
2,3,7,6,11,5404,9407,-4003
2,3,8,6,11,5473,9267,-3794
2,3,9,6,11,5595,9154,-3559
2,3,10,6,11,5713,9423,-3710
2,3,11,6,11,5888,9612,-3724
2,3,12,6,11,6096,9923,-3827
2,3,13,6,11,6311,9980,-3669
2,4,0,6,11,5860,10512,-4652
2,4,1,6,11,5601,10366,-4765
2,4,2,6,11,5363,10349,-4986
2,4,3,6,11,5191,10506,-5315
2,4,4,6,11,5140,10509,-5369
2,4,5,6,11,5127,10250,-5123
2,4,6,6,11,5093,10382,-5289
2,4,7,6,11,5082,10537,-5455
2,4,8,6,11,5140,10416,-5276
2,4,9,6,11,5196,10305,-5109
2,4,10,6,11,5286,10630,-5344
2,4,11,6,11,5454,10868,-5414
2,4,12,6,11,5654,11231,-5577
2,4,13,6,11,5884,11260,-5376
2,5,0,6,11,6061,11005,-4944
2,5,1,6,11,5886,10830,-4944
2,5,2,6,11,5804,10745,-4941
2,5,3,6,11,5773,10867,-5094
2,5,4,6,11,5838,10801,-4963
2,5,5,6,11,5884,10516,-4632
2,5,6,6,11,5938,10626,-4688
2,5,7,6,11,5972,10795,-4823
2,5,8,6,11,5955,10660,-4705
2,5,9,6,11,5920,10549,-4629
2,5,10,6,11,5933,10936,-5003
2,5,11,6,11,5989,11275,-5286
2,5,12,6,11,6101,11681,-5580
2,5,13,6,11,6246,11742,-5496
2,6,0,6,11,6961,10594,-3633
2,6,1,6,11,6874,10339,-3465
2,6,2,6,11,6940,10171,-3231
2,6,3,6,11,7074,10203,-3129
2,6,4,6,11,7254,9991,-2737
2,6,5,6,11,7295,9703,-2408
2,6,6,6,11,7470,9797,-2327
2,6,7,6,11,7528,10002,-2474
2,6,8,6,11,7423,9757,-2334
2,6,9,6,11,7345,9615,-2270
2,6,10,6,11,7345,10070,-2725
2,6,11,6,11,7324,10490,-3166
2,6,12,6,11,7378,10927,-3549
2,6,13,6,11,7423,11117,-3694
2,7,0,6,11,7878,10082,-2204
2,7,1,6,11,7806,9825,-2019
2,7,2,6,11,7911,9688,-1777
2,7,3,6,11,8092,9712,-1620
2,7,4,6,11,8270,9442,-1172
2,7,5,6,11,8252,9076,-824
2,7,6,6,11,8482,9008,-526
2,7,7,6,11,8566,9277,-711
2,7,8,6,11,8424,9001,-577
2,7,9,6,11,8318,8882,-564
2,7,10,6,11,8397,9357,-960
2,7,11,6,11,8421,9783,-1362
2,7,12,6,11,8512,10133,-1621
2,7,13,6,11,8511,10337,-1826
2,8,0,6,11,8748,9713,-965
2,8,1,6,11,8654,9450,-796
2,8,2,6,11,8736,9430,-694
2,8,3,6,11,8895,9521,-626
2,8,4,6,11,8993,9159,-166
2,8,5,6,11,8889,8758,131
2,8,6,6,11,9073,8802,271
2,8,7,6,11,9202,9160,42
2,8,8,6,11,9071,8869,202
2,8,9,6,11,8947,8662,285
2,8,10,6,11,9127,9114,13
2,8,11,6,11,9246,9379,-133
2,8,12,6,11,9430,9568,-138
2,8,13,6,11,9427,9791,-364
2,9,0,6,11,9302,9373,-71
2,9,1,6,11,9138,9099,39
2,9,2,6,11,9155,9215,-60
2,9,3,6,11,9286,9387,-101
2,9,4,6,11,9306,8897,409
2,9,5,6,11,9106,8495,611
2,9,6,6,11,9237,8647,590
2,9,7,6,11,9407,9015,392
2,9,8,6,11,9267,8594,673
2,9,9,6,11,9154,8243,911
2,9,10,6,11,9423,8673,750
2,9,11,6,11,9612,8762,850
2,9,12,6,11,9923,8778,1145
2,9,13,6,11,9980,9015,965
2,10,0,6,11,10512,8582,1930
2,10,1,6,11,10366,8201,2165
2,10,2,6,11,10349,8397,1952
2,10,3,6,11,10506,8531,1975
2,10,4,6,11,10509,7863,2646
2,10,5,6,11,10250,7501,2749
2,10,6,6,11,10382,7659,2723
2,10,7,6,11,10537,8032,2505
2,10,8,6,11,10416,7572,2844
2,10,9,6,11,10305,7175,3130
2,10,10,6,11,10630,7599,3031
2,10,11,6,11,10868,7671,3197
2,10,12,6,11,11231,7647,3584
2,10,13,6,11,11260,7933,3327
2,11,0,6,11,11005,7711,3294
2,11,1,6,11,10830,7308,3522
2,11,2,6,11,10745,7533,3212
2,11,3,6,11,10867,7637,3230
2,11,4,6,11,10801,6903,3898
2,11,5,6,11,10516,6644,3872
2,11,6,6,11,10626,6872,3754
2,11,7,6,11,10795,7230,3565
2,11,8,6,11,10660,6754,3906
2,11,9,6,11,10549,6286,4263
2,11,10,6,11,10936,6660,4276
2,11,11,6,11,11275,6665,4610
2,11,12,6,11,11681,6611,5070
2,11,13,6,11,11742,6824,4918
2,12,0,6,11,10594,7045,3549
2,12,1,6,11,10339,6632,3707
2,12,2,6,11,10171,6912,3259
2,12,3,6,11,10203,7032,3171
2,12,4,6,11,9991,6406,3585
2,12,5,6,11,9703,6239,3464
2,12,6,6,11,9797,6458,3339
2,12,7,6,11,10002,6786,3216
2,12,8,6,11,9757,6428,3329
2,12,9,6,11,9615,5940,3675
2,12,10,6,11,10070,6167,3903
2,12,11,6,11,10490,6094,4396
2,12,12,6,11,10927,6028,4899
2,12,13,6,11,11117,6084,5033
2,0,0,7,11,7650,9714,-2064
2,0,1,7,11,7422,9589,-2167
2,0,2,7,11,7158,9645,-2487
2,0,3,7,11,6947,9812,-2865
2,0,4,7,11,6772,9958,-3186
2,0,5,7,11,6561,9910,-3349
2,0,6,7,11,6419,10136,-3717
2,0,7,7,11,6379,10267,-3888
2,0,8,7,11,6458,10110,-3652
2,0,9,7,11,6622,9968,-3346
2,0,10,7,11,6780,10124,-3344
2,0,11,7,11,6979,10230,-3251
2,0,12,7,11,7221,10425,-3204
2,0,13,7,11,7424,10448,-3024
2,1,0,7,11,7464,10573,-3109
2,1,1,7,11,7213,10420,-3207
2,1,2,7,11,6928,10442,-3514
2,1,3,7,11,6718,10598,-3880
2,1,4,7,11,6585,10678,-4093
2,1,5,7,11,6436,10553,-4117
2,1,6,7,11,6349,10724,-4375
2,1,7,7,11,6313,10890,-4577
2,1,8,7,11,6362,10758,-4396
2,1,9,7,11,6504,10611,-4107
2,1,10,7,11,6643,10844,-4201
2,1,11,7,11,6828,11031,-4203
2,1,12,7,11,7074,11323,-4249
2,1,13,7,11,7303,11365,-4062
2,2,0,7,11,7558,11140,-3582
2,2,1,7,11,7321,10924,-3603
2,2,2,7,11,7049,10877,-3828
2,2,3,7,11,6867,10993,-4126
2,2,4,7,11,6795,10980,-4185
2,2,5,7,11,6726,10733,-4007
2,2,6,7,11,6672,10869,-4197
2,2,7,7,11,6627,11046,-4419
2,2,8,7,11,6687,10916,-4229
2,2,9,7,11,6801,10788,-3987
2,2,10,7,11,6909,11123,-4214
2,2,11,7,11,7085,11392,-4307
2,2,12,7,11,7301,11795,-4494
2,2,13,7,11,7516,11888,-4372
2,3,0,7,11,6965,12237,-5272
2,3,1,7,11,6657,12077,-5420
2,3,2,7,11,6364,12073,-5709
2,3,3,7,11,6145,12267,-6122
2,3,4,7,11,6054,12249,-6195
2,3,5,7,11,5996,11945,-5949
2,3,6,7,11,5937,12082,-6145
2,3,7,7,11,5913,12277,-6364
2,3,8,7,11,5973,12097,-6124
2,3,9,7,11,6078,11964,-5886
2,3,10,7,11,6206,12338,-6132
2,3,11,7,11,6412,12627,-6215
2,3,12,7,11,6660,13013,-6353
2,3,13,7,11,6939,13055,-6116
2,4,0,7,11,7092,12515,-5423
2,4,1,7,11,6848,12299,-5451
2,4,2,7,11,6691,12222,-5531
2,4,3,7,11,6591,12364,-5773
2,4,4,7,11,6588,12213,-5625
2,4,5,7,11,6556,11861,-5305
2,4,6,7,11,6549,12022,-5473
2,4,7,7,11,6564,12240,-5676
2,4,8,7,11,6577,11949,-5372
2,4,9,7,11,6611,11802,-5191
2,4,10,7,11,6688,12292,-5604
2,4,11,7,11,6806,12687,-5881
2,4,12,7,11,6986,13119,-6133
2,4,13,7,11,7197,13252,-6055
2,5,0,7,11,7982,11942,-3960
2,5,1,7,11,7846,11649,-3803
2,5,2,7,11,7855,11496,-3641
2,5,3,7,11,7934,11527,-3593
2,5,4,7,11,8060,11234,-3174
2,5,5,7,11,8042,10790,-2748
2,5,6,7,11,8163,10772,-2609
2,5,7,7,11,8210,11066,-2856
2,5,8,7,11,8147,10766,-2619
2,5,9,7,11,8107,10637,-2530
2,5,10,7,11,8155,11219,-3064
2,5,11,7,11,8186,11728,-3542
2,5,12,7,11,8293,12162,-3869
2,5,13,7,11,8381,12366,-3985
2,6,0,7,11,8821,11549,-2728
2,6,1,7,11,8698,11233,-2535
2,6,2,7,11,8748,11164,-2416
2,6,3,7,11,8889,11241,-2352
2,6,4,7,11,9046,10847,-1801
2,6,5,7,11,9009,10416,-1407
2,6,6,7,11,9234,10456,-1222
2,6,7,7,11,9317,10861,-1544
2,6,8,7,11,9188,10555,-1367
2,6,9,7,11,9100,10312,-1212
2,6,10,7,11,9207,10841,-1634
2,6,11,7,11,9269,11188,-1919
2,6,12,7,11,9407,11481,-2074
2,6,13,7,11,9452,11728,-2276
2,7,0,7,11,9714,11198,-1484
2,7,1,7,11,9589,10865,-1276
2,7,2,7,11,9645,10921,-1276
2,7,3,7,11,9812,11090,-1278
2,7,4,7,11,9958,10582,-624
2,7,5,7,11,9910,10159,-249
2,7,6,7,11,10136,10298,-162
2,7,7,7,11,10267,10703,-436
2,7,8,7,11,10110,10281,-171
2,7,9,7,11,9968,9907,61
2,7,10,7,11,10124,10390,-266
2,7,11,7,11,10230,10547,-317
2,7,12,7,11,10425,10671,-246
2,7,13,7,11,10448,10953,-505
2,8,0,7,11,10573,10420,153
2,8,1,7,11,10420,9987,433
2,8,2,7,11,10442,10119,323
2,8,3,7,11,10598,10238,360
2,8,4,7,11,10678,9537,1141
2,8,5,7,11,10553,9128,1425
2,8,6,7,11,10724,9291,1433
2,8,7,7,11,10890,9671,1219
2,8,8,7,11,10758,9221,1537
2,8,9,7,11,10611,8809,1802
2,8,10,7,11,10844,9299,1545
2,8,11,7,11,11031,9451,1580
2,8,12,7,11,11323,9519,1804
2,8,13,7,11,11365,9841,1524
2,9,0,7,11,11140,9436,1704
2,9,1,7,11,10924,9019,1905
2,9,2,7,11,10877,9257,1620
2,9,3,7,11,10993,9398,1595
2,9,4,7,11,10980,8643,2337
2,9,5,7,11,10733,8339,2394
2,9,6,7,11,10869,8572,2297
2,9,7,7,11,11046,8970,2076
2,9,8,7,11,10916,8435,2481
2,9,9,7,11,10788,7945,2843
2,9,10,7,11,11123,8368,2755
2,9,11,7,11,11392,8424,2968
2,9,12,7,11,11795,8393,3402
2,9,13,7,11,11888,8619,3269
2,10,0,7,11,12237,8555,3682
2,10,1,7,11,12077,8101,3976
2,10,2,7,11,12073,8389,3684
2,10,3,7,11,12267,8529,3738
2,10,4,7,11,12249,7818,4431
2,10,5,7,11,11945,7584,4361
2,10,6,7,11,12082,7854,4228
2,10,7,7,11,12277,8231,4046
2,10,8,7,11,12097,7717,4380
2,10,9,7,11,11964,7193,4771
2,10,10,7,11,12338,7523,4815
2,10,11,7,11,12627,7506,5121
2,10,12,7,11,13013,7466,5547
2,10,13,7,11,13055,7594,5461
2,0,0,8,11,8616,12411,-3795
2,0,1,8,11,8357,12206,-3849
2,0,2,8,11,8067,12164,-4097
2,0,3,8,11,7864,12305,-4441
2,0,4,8,11,7737,12352,-4615
2,0,5,8,11,7582,12180,-4598
2,0,6,8,11,7482,12356,-4874
2,0,7,8,11,7444,12529,-5085
2,0,8,8,11,7497,12407,-4910
2,0,9,8,11,7643,12245,-4602
2,0,10,8,11,7777,12544,-4767
2,0,11,8,11,7963,12811,-4848
2,0,12,8,11,8216,13195,-4979
2,0,13,8,11,8445,13273,-4828
2,1,0,8,11,8735,12865,-4130
2,1,1,8,11,8495,12635,-4140
2,1,2,8,11,8215,12601,-4386
2,1,3,8,11,8030,12754,-4724
2,1,4,8,11,7957,12720,-4763
2,1,5,8,11,7883,12428,-4545
2,1,6,8,11,7836,12569,-4733
2,1,7,8,11,7796,12786,-4990
2,1,8,8,11,7853,12597,-4744
2,1,9,8,11,7961,12447,-4486
2,1,10,8,11,8064,12831,-4767
2,1,11,8,11,8247,13151,-4904
2,1,12,8,11,8474,13577,-5103
2,1,13,8,11,8688,13683,-4995
2,2,0,8,11,8186,13747,-5561
2,2,1,8,11,7879,13546,-5667
2,2,2,8,11,7577,13550,-5973
2,2,3,8,11,7354,13764,-6410
2,2,4,8,11,7266,13661,-6395
2,2,5,8,11,7209,13290,-6081
2,2,6,8,11,7159,13478,-6319
2,2,7,8,11,7136,13722,-6586
2,2,8,8,11,7187,13386,-6199
2,2,9,8,11,7284,13217,-5933
2,2,10,8,11,7402,13694,-6292
2,2,11,8,11,7609,14039,-6430
2,2,12,8,11,7865,14451,-6586
2,2,13,8,11,8144,14565,-6421
2,3,0,8,11,8197,13863,-5666
2,3,1,8,11,7904,13609,-5705
2,3,2,8,11,7692,13547,-5855
2,3,3,8,11,7545,13688,-6143
2,3,4,8,11,7502,13456,-5954
2,3,5,8,11,7425,12948,-5523
2,3,6,8,11,7393,12997,-5604
2,3,7,8,11,7395,13304,-5909
2,3,8,8,11,7410,12958,-5548
2,3,9,8,11,7493,12824,-5331
2,3,10,8,11,7608,13441,-5833
2,3,11,8,11,7764,13925,-6161
2,3,12,8,11,7992,14354,-6362
2,3,13,8,11,8252,14501,-6249
2,4,0,8,11,9013,13409,-4396
2,4,1,8,11,8808,13057,-4249
2,4,2,8,11,8742,12972,-4230
2,4,3,8,11,8752,13056,-4304
2,4,4,8,11,8810,12639,-3829
2,4,5,8,11,8714,12130,-3416
2,4,6,8,11,8774,12220,-3446
2,4,7,8,11,8802,12650,-3848
2,4,8,8,11,8769,12320,-3551
2,4,9,8,11,8798,12067,-3269
2,4,10,8,11,8910,12703,-3793
2,4,11,8,11,9003,13133,-4130
2,4,12,8,11,9178,13510,-4332
2,4,13,8,11,9332,13757,-4425
2,5,0,8,11,9842,13034,-3192
2,5,1,8,11,9670,12648,-2978
2,5,2,8,11,9663,12655,-2992
2,5,3,8,11,9749,12810,-3061
2,5,4,8,11,9852,12270,-2418
2,5,5,8,11,9756,11817,-2061
2,5,6,8,11,9927,11952,-2025
2,5,7,8,11,9999,12404,-2405
2,5,8,8,11,9912,11967,-2055
2,5,9,8,11,9862,11557,-1695
2,5,10,8,11,10017,12117,-2100
2,5,11,8,11,10131,12356,-2225
2,5,12,8,11,10322,12584,-2262
2,5,13,8,11,10410,12890,-2480
2,6,0,8,11,10657,12245,-1588
2,6,1,8,11,10481,11753,-1272
2,6,2,8,11,10482,11825,-1343
2,6,3,8,11,10609,11941,-1332
2,6,4,8,11,10734,11222,-488
2,6,5,8,11,10667,10792,-125
2,6,6,8,11,10888,10942,-54
2,6,7,8,11,11018,11359,-341
2,6,8,8,11,10874,10908,-34
2,6,9,8,11,10750,10473,277
2,6,10,8,11,10934,11016,-82
2,6,11,8,11,11078,11236,-158
2,6,12,8,11,11320,11412,-92
2,6,13,8,11,11389,11779,-390
2,7,0,8,11,11539,11274,265
2,7,1,8,11,11355,10805,550
2,7,2,8,11,11351,10979,372
2,7,3,8,11,11515,11105,410
2,7,4,8,11,11643,10317,1326
2,7,5,8,11,11574,9966,1608
2,7,6,8,11,11787,10204,1583
2,7,7,8,11,11955,10609,1346
2,7,8,8,11,11797,10084,1713
2,7,9,8,11,11632,9579,2053
2,7,10,8,11,11841,10068,1773
2,7,11,8,11,12015,10204,1811
2,7,12,8,11,12318,10265,2053
2,7,13,8,11,12386,10527,1859
2,8,0,8,11,12411,10280,2131
2,8,1,8,11,12206,9812,2394
2,8,2,8,11,12164,10113,2051
2,8,3,8,11,12305,10290,2015
2,8,4,8,11,12352,9558,2794
2,8,5,8,11,12180,9279,2901
2,8,6,8,11,12356,9554,2802
2,8,7,8,11,12529,9971,2558
2,8,8,8,11,12407,9398,3009
2,8,9,8,11,12245,8852,3393
2,8,10,8,11,12544,9231,3313
2,8,11,8,11,12811,9265,3546
2,8,12,8,11,13195,9248,3947
2,8,13,8,11,13273,9389,3884
2,0,0,9,11,9887,14375,-4488
2,0,1,9,11,9639,14104,-4465
2,0,2,9,11,9354,14078,-4724
2,0,3,9,11,9176,14251,-5075
2,0,4,9,11,9109,14132,-5023
2,0,5,9,11,9029,13773,-4744
2,0,6,9,11,8969,13965,-4996
2,0,7,9,11,8927,14231,-5304
2,0,8,9,11,8988,13886,-4898
2,0,9,9,11,9100,13700,-4600
2,0,10,9,11,9198,14187,-4989
2,0,11,9,11,9382,14563,-5181
2,0,12,9,11,9616,15015,-5399
2,0,13,9,11,9830,15193,-5363
2,1,0,9,11,9363,15095,-5732
2,1,1,9,11,9053,14856,-5803
2,1,2,9,11,8743,14875,-6132
2,1,3,9,11,8517,15088,-6571
2,1,4,9,11,8428,14904,-6476
2,1,5,9,11,8366,14377,-6011
2,1,6,9,11,8323,14453,-6130
2,1,7,9,11,8305,14786,-6481
2,1,8,9,11,8353,14395,-6042
2,1,9,9,11,8444,14239,-5795
2,1,10,9,11,8557,14843,-6286
2,1,11,9,11,8771,15277,-6506
2,1,12,9,11,9038,15686,-6648
2,1,13,9,11,9316,15814,-6498
2,2,0,9,11,9418,15330,-5912
2,2,1,9,11,9126,15017,-5891
2,2,2,9,11,8905,15023,-6118
2,2,3,9,11,8754,15217,-6463
2,2,4,9,11,8714,14861,-6147
2,2,5,9,11,8638,14288,-5650
2,2,6,9,11,8615,14445,-5830
2,2,7,9,11,8618,14888,-6270
2,2,8,9,11,8624,14512,-5888
2,2,9,9,11,8699,14254,-5555
2,2,10,9,11,8804,14925,-6121
2,2,11,9,11,8961,15330,-6369
2,2,12,9,11,9197,15702,-6505
2,2,13,9,11,9457,15892,-6435
2,3,0,9,11,10118,14894,-4776
2,3,1,9,11,9864,14472,-4608
2,3,2,9,11,9743,14463,-4720
2,3,3,9,11,9706,14625,-4919
2,3,4,9,11,9724,14062,-4338
2,3,5,9,11,9583,13531,-3948
2,3,6,9,11,9618,13716,-4098
2,3,7,9,11,9633,14193,-4560
2,3,8,9,11,9602,13732,-4130
2,3,9,9,11,9680,13312,-3632
2,3,10,9,11,9830,13979,-4149
2,3,11,9,11,9961,14301,-4340
2,3,12,9,11,10184,14613,-4429
2,3,13,9,11,10387,14919,-4532
2,4,0,9,11,10873,14081,-3208
2,4,1,9,11,10632,13536,-2904
2,4,2,9,11,10550,13559,-3009
2,4,3,9,11,10567,13661,-3094
2,4,4,9,11,10602,12910,-2308
2,4,5,9,11,10428,12450,-2022
2,4,6,9,11,10538,12596,-2058
2,4,7,9,11,10591,13060,-2469
2,4,8,9,11,10534,12594,-2060
2,4,9,9,11,10553,12123,-1570
2,4,10,9,11,10772,12743,-1971
2,4,11,9,11,10948,13045,-2097
2,4,12,9,11,11207,13325,-2118
2,4,13,9,11,11361,13716,-2355
2,5,0,9,11,11678,13099,-1421
2,5,1,9,11,11453,12571,-1118
2,5,2,9,11,11397,12685,-1288
2,5,3,9,11,11469,12808,-1339
2,5,4,9,11,11540,12002,-462
2,5,5,9,11,11414,11630,-216
2,5,6,9,11,11581,11855,-274
2,5,7,9,11,11700,12297,-597
2,5,8,9,11,11598,11771,-173
2,5,9,9,11,11512,11243,269
2,5,10,9,11,11744,11785,-41
2,5,11,9,11,11940,11989,-49
2,5,12,9,11,12235,12158,77
2,5,13,9,11,12347,12465,-118
2,6,0,9,11,12482,12118,364
2,6,1,9,11,12247,11598,649
2,6,2,9,11,12188,11835,353
2,6,3,9,11,12312,11997,315
2,6,4,9,11,12419,11232,1187
2,6,5,9,11,12331,10906,1425
2,6,6,9,11,12539,11186,1353
2,6,7,9,11,12706,11610,1096
2,6,8,9,11,12561,11047,1514
2,6,9,9,11,12414,10486,1928
2,6,10,9,11,12651,10931,1720
2,6,11,9,11,12863,11045,1818
2,6,12,9,11,13213,11120,2093
2,6,13,9,11,13327,11297,2030
2,0,0,10,11,10515,16562,-6047
2,0,1,10,11,10197,16264,-6067
2,0,2,10,11,9882,16351,-6469
2,0,3,10,11,9663,16617,-6954
2,0,4,10,11,9580,16309,-6729
2,0,5,10,11,9512,15717,-6205
2,0,6,10,11,9456,15901,-6445
2,0,7,10,11,9436,16370,-6934
2,0,8,10,11,9488,15949,-6461
2,0,9,10,11,9583,15669,-6086
2,0,10,10,11,9691,16327,-6636
2,0,11,10,11,9906,16682,-6776
2,0,12,10,11,10180,17034,-6854
2,0,13,10,11,10458,17205,-6747
2,1,0,10,11,10595,16815,-6220
2,1,1,10,11,10300,16432,-6132
2,1,2,10,11,10071,16514,-6443
2,1,3,10,11,9917,16786,-6869
2,1,4,10,11,9876,16284,-6408
2,1,5,10,11,9795,15689,-5894
2,1,6,10,11,9779,15941,-6162
2,1,7,10,11,9787,16431,-6644
2,1,8,10,11,9790,15924,-6134
2,1,9,10,11,9859,15499,-5640
2,1,10,10,11,9959,16201,-6242
2,1,11,10,11,10123,16498,-6375
2,1,12,10,11,10370,16805,-6435
2,1,13,10,11,10629,17054,-6425
2,2,0,10,11,11339,15941,-4602
2,2,1,10,11,11086,15360,-4274
2,2,2,10,11,10956,15367,-4411
2,2,3,10,11,10915,15476,-4561
2,2,4,10,11,10936,14702,-3766
2,2,5,10,11,10796,14164,-3368
2,2,6,10,11,10840,14360,-3520
2,2,7,10,11,10856,14849,-3993
2,2,8,10,11,10816,14359,-3543
2,2,9,10,11,10886,13878,-2992
2,2,10,10,11,11026,14605,-3579
2,2,11,10,11,11158,14990,-3832
2,2,12,10,11,11389,15354,-3965
2,2,13,10,11,11592,15745,-4153
2,3,0,10,11,11978,14935,-2957
2,3,1,10,11,11688,14354,-2666
2,3,2,10,11,11551,14419,-2868
2,3,3,10,11,11521,14528,-3007
2,3,4,10,11,11516,13690,-2174
2,3,5,10,11,11297,13288,-1991
2,3,6,10,11,11382,13509,-2127
2,3,7,10,11,11422,13998,-2576
2,3,8,10,11,11367,13457,-2090
2,3,9,10,11,11435,12893,-1458
2,3,10,10,11,11692,13512,-1820
2,3,11,10,11,11906,13798,-1892
2,3,12,10,11,12213,14071,-1858
2,3,13,10,11,12416,14402,-1986
2,4,0,10,11,12709,13943,-1234
2,4,1,10,11,12415,13364,-949
2,4,2,10,11,12284,13541,-1257
2,4,3,10,11,12287,13700,-1413
2,4,4,10,11,12290,12917,-627
2,4,5,10,11,12086,12570,-484
2,4,6,10,11,12192,12837,-645
2,4,7,10,11,12292,13298,-1006
2,4,8,10,11,12220,12734,-514
2,4,9,10,11,12203,12150,53
2,4,10,10,11,12499,12648,-149
2,4,11,10,11,12757,12830,-73
2,4,12,10,11,13120,13013,107
2,4,13,10,11,13298,13235,63
2,0,0,11,11,11747,17862,-6115
2,0,1,11,11,11444,17320,-5876
2,0,2,11,11,11210,17418,-6208
2,0,3,11,11,11063,17637,-6574
2,0,4,11,11,11028,16924,-5896
2,0,5,11,11,10941,16322,-5381
2,0,6,11,11,10912,16585,-5673
2,0,7,11,11,10918,17087,-6169
2,0,8,11,11,10925,16551,-5626
2,0,9,11,11,10998,16065,-5067
2,0,10,11,11,11093,16827,-5734
2,0,11,11,11,11258,17187,-5929
2,0,12,11,11,11512,17546,-6034
2,0,13,11,11,11771,17880,-6109
2,1,0,11,11,12516,16795,-4279
2,1,1,11,11,12260,16178,-3918
2,1,2,11,11,12122,16227,-4105
2,1,3,11,11,12078,16343,-4265
2,1,4,11,11,12098,15482,-3384
2,1,5,11,11,11953,15002,-3049
2,1,6,11,11,12004,15273,-3269
2,1,7,11,11,12025,15787,-3762
2,1,8,11,11,11982,15222,-3240
2,1,9,11,11,12046,14648,-2602
2,1,10,11,11,12181,15374,-3193
2,1,11,11,11,12320,15743,-3423
2,1,12,11,11,12562,16100,-3538
2,1,13,11,11,12764,16431,-3667
2,2,0,11,11,13199,15779,-2580
2,2,1,11,11,12910,15147,-2237
2,2,2,11,11,12764,15275,-2511
2,2,3,11,11,12730,15420,-2690
2,2,4,11,11,12728,14605,-1877
2,2,5,11,11,12510,14228,-1718
2,2,6,11,11,12604,14491,-1887
2,2,7,11,11,12645,14999,-2354
2,2,8,11,11,12581,14420,-1839
2,2,9,11,11,12641,13800,-1159
2,2,10,11,11,12888,14375,-1487
2,2,11,11,11,13103,14639,-1536
2,2,12,11,11,13418,14926,-1508
2,2,13,11,11,13621,15172,-1551
2,0,0,12,11,13668,17639,-3971
2,0,1,12,11,13404,16971,-3567
2,0,2,12,11,13261,17083,-3822
2,0,3,12,11,13224,17235,-4011
2,0,4,12,11,13250,16397,-3147
2,0,5,12,11,13099,15942,-2843
2,0,6,12,11,13137,16255,-3118
2,0,7,12,11,13156,16788,-3632
2,0,8,12,11,13117,16185,-3068
2,0,9,12,11,13185,15555,-2370
2,0,10,12,11,13315,16237,-2922
2,0,11,12,11,13455,16584,-3129
2,0,12,12,11,13704,16955,-3251
2,0,13,12,11,13906,17201,-3295
2,0,0,1,12,1254,1280,-26
2,0,1,1,12,1246,1277,-31
2,0,2,1,12,1242,1270,-28
2,0,3,1,12,1250,1268,-18
2,0,4,1,12,1257,1269,-12
2,0,5,1,12,1244,1272,-28
2,0,6,1,12,1235,1271,-36
2,0,7,1,12,1241,1273,-32
2,0,8,1,12,1243,1268,-25
2,0,9,1,12,1237,1261,-24
2,0,10,1,12,1237,1266,-29
2,0,11,1,12,1244,1276,-32
2,0,12,1,12,1244,1275,-31
2,1,0,1,12,1280,1328,-48
2,1,1,1,12,1277,1328,-51
2,1,2,1,12,1270,1321,-51
2,1,3,1,12,1268,1319,-51
2,1,4,1,12,1269,1323,-54
2,1,5,1,12,1272,1330,-58
2,1,6,1,12,1271,1331,-60
2,1,7,1,12,1273,1332,-59
2,1,8,1,12,1268,1321,-53
2,1,9,1,12,1261,1309,-48
2,1,10,1,12,1266,1306,-40
2,1,11,1,12,1276,1312,-36
2,1,12,1,12,1275,1311,-36
2,2,0,1,12,1328,1168,160
2,2,1,1,12,1328,1118,210
2,2,2,1,12,1321,1064,257
2,2,3,1,12,1319,1019,300
2,2,4,1,12,1323,981,342
2,2,5,1,12,1330,959,371
2,2,6,1,12,1331,943,388
2,2,7,1,12,1332,948,384
2,2,8,1,12,1321,954,367
2,2,9,1,12,1309,989,320
2,2,10,1,12,1306,1024,282
2,2,11,1,12,1312,1069,243
2,2,12,1,12,1311,1117,194
2,3,0,1,12,1168,1076,92
2,3,1,1,12,1118,1006,112
2,3,2,1,12,1064,932,132
2,3,3,1,12,1019,865,154
2,3,4,1,12,981,798,183
2,3,5,1,12,959,731,228
2,3,6,1,12,943,686,257
2,3,7,1,12,948,698,250
2,3,8,1,12,954,745,209
2,3,9,1,12,989,806,183
2,3,10,1,12,1024,865,159
2,3,11,1,12,1069,930,139
2,3,12,1,12,1117,995,122
2,4,0,1,12,1076,1086,-10
2,4,1,1,12,1006,1037,-31
2,4,2,1,12,932,980,-48
2,4,3,1,12,865,925,-60
2,4,4,1,12,798,872,-74
2,4,5,1,12,731,802,-71
2,4,6,1,12,686,751,-65
2,4,7,1,12,698,763,-65
2,4,8,1,12,745,831,-86
2,4,9,1,12,806,878,-72
2,4,10,1,12,865,929,-64
2,4,11,1,12,930,980,-50
2,4,12,1,12,995,1023,-28
2,5,0,1,12,1086,1012,74
2,5,1,1,12,1037,961,76
2,5,2,1,12,980,906,74
2,5,3,1,12,925,865,60
2,5,4,1,12,872,844,28
2,5,5,1,12,802,834,-32
2,5,6,1,12,751,818,-67
2,5,7,1,12,763,822,-59
2,5,8,1,12,831,851,-20
2,5,9,1,12,878,879,-1
2,5,10,1,12,929,917,12
2,5,11,1,12,980,964,16
2,5,12,1,12,1023,1010,13
2,6,0,1,12,1012,1065,-53
2,6,1,1,12,961,1034,-73
2,6,2,1,12,906,1007,-101
2,6,3,1,12,865,1014,-149
2,6,4,1,12,844,1061,-217
2,6,5,1,12,834,1120,-286
2,6,6,1,12,818,1147,-329
2,6,7,1,12,822,1144,-322
2,6,8,1,12,851,1116,-265
2,6,9,1,12,879,1093,-214
2,6,10,1,12,917,1081,-164
2,6,11,1,12,964,1094,-130
2,6,12,1,12,1010,1120,-110
2,7,0,1,12,1065,1408,-343
2,7,1,1,12,1034,1428,-394
2,7,2,1,12,1007,1433,-426
2,7,3,1,12,1014,1450,-436
2,7,4,1,12,1061,1510,-449
2,7,5,1,12,1120,1581,-461
2,7,6,1,12,1147,1618,-471
2,7,7,1,12,1144,1612,-468
2,7,8,1,12,1116,1584,-468
2,7,9,1,12,1093,1556,-463
2,7,10,1,12,1081,1549,-468
2,7,11,1,12,1094,1537,-443
2,7,12,1,12,1120,1531,-411
2,8,0,1,12,1408,664,744
2,8,1,1,12,1428,597,831
2,8,2,1,12,1433,556,877
2,8,3,1,12,1450,514,936
2,8,4,1,12,1510,524,986
2,8,5,1,12,1581,542,1039
2,8,6,1,12,1618,553,1065
2,8,7,1,12,1612,567,1045
2,8,8,1,12,1584,547,1037
2,8,9,1,12,1556,534,1022
2,8,10,1,12,1549,553,996
2,8,11,1,12,1537,600,937
2,8,12,1,12,1531,667,864
2,9,0,1,12,664,1351,-687
2,9,1,1,12,597,1372,-775
2,9,2,1,12,556,1460,-904
2,9,3,1,12,514,1524,-1010
2,9,4,1,12,524,1577,-1053
2,9,5,1,12,542,1574,-1032
2,9,6,1,12,553,1605,-1052
2,9,7,1,12,567,1594,-1027
2,9,8,1,12,547,1557,-1010
2,9,9,1,12,534,1530,-996
2,9,10,1,12,553,1484,-931
2,9,11,1,12,600,1451,-851
2,9,12,1,12,667,1438,-771
2,10,0,1,12,1351,2099,-748
2,10,1,1,12,1372,2151,-779
2,10,2,1,12,1460,2251,-791
2,10,3,1,12,1524,2345,-821
2,10,4,1,12,1577,2411,-834
2,10,5,1,12,1574,2400,-826
2,10,6,1,12,1605,2461,-856
2,10,7,1,12,1594,2422,-828
2,10,8,1,12,1557,2403,-846
2,10,9,1,12,1530,2400,-870
2,10,10,1,12,1484,2391,-907
2,10,11,1,12,1451,2370,-919
2,10,12,1,12,1438,2326,-888
2,11,0,1,12,2099,1975,124
2,11,1,1,12,2151,1955,196
2,11,2,1,12,2251,1919,332
2,11,3,1,12,2345,1918,427
2,11,4,1,12,2411,1951,460
2,11,5,1,12,2400,1965,435
2,11,6,1,12,2461,2002,459
2,11,7,1,12,2422,1989,433
2,11,8,1,12,2403,1987,416
2,11,9,1,12,2400,1973,427
2,11,10,1,12,2391,2059,332
2,11,11,1,12,2370,2144,226
2,11,12,1,12,2326,2160,166
2,12,0,1,12,1975,1929,46
2,12,1,1,12,1955,1893,62
2,12,2,1,12,1919,1830,89
2,12,3,1,12,1918,1811,107
2,12,4,1,12,1951,1845,106
2,12,5,1,12,1965,1907,58
2,12,6,1,12,2002,1871,131
2,12,7,1,12,1989,1919,70
2,12,8,1,12,1987,1899,88
2,12,9,1,12,1973,1827,146
2,12,10,1,12,2059,1915,144
2,12,11,1,12,2144,2006,138
2,12,12,1,12,2160,2047,113
2,13,0,1,12,1929,1918,11
2,13,1,1,12,1893,1875,18
2,13,2,1,12,1830,1818,12
2,13,3,1,12,1811,1807,4
2,13,4,1,12,1845,1840,5
2,13,5,1,12,1907,1905,2
2,13,6,1,12,1871,1831,40
2,13,7,1,12,1919,1918,1
2,13,8,1,12,1899,1900,-1
2,13,9,1,12,1827,1817,10
2,13,10,1,12,1915,1912,3
2,13,11,1,12,2006,1986,20
2,13,12,1,12,2047,2047,0
2,14,0,1,12,1918,1932,-14
2,14,1,1,12,1875,1891,-16
2,14,2,1,12,1818,1814,4
2,14,3,1,12,1807,1793,14
2,14,4,1,12,1840,1834,6
2,14,5,1,12,1905,1882,23
2,14,6,1,12,1831,1803,28
2,14,7,1,12,1918,1886,32
2,14,8,1,12,1900,1872,28
2,14,9,1,12,1817,1783,34
2,14,10,1,12,1912,1898,14
2,14,11,1,12,1986,1966,20
2,14,12,1,12,2047,2013,34
2,15,0,1,12,1932,1819,113
2,15,1,1,12,1891,1838,53
2,15,2,1,12,1814,1836,-22
2,15,3,1,12,1793,1859,-66
2,15,4,1,12,1834,1914,-80
2,15,5,1,12,1882,1949,-67
2,15,6,1,12,1803,1870,-67
2,15,7,1,12,1886,1929,-43
2,15,8,1,12,1872,1898,-26
2,15,9,1,12,1783,1815,-32
2,15,10,1,12,1898,1876,22
2,15,11,1,12,1966,1876,90
2,15,12,1,12,2013,1922,91
2,16,0,1,12,1819,1577,242
2,16,1,1,12,1838,1552,286
2,16,2,1,12,1836,1560,276
2,16,3,1,12,1859,1558,301
2,16,4,1,12,1914,1552,362
2,16,5,1,12,1949,1587,362
2,16,6,1,12,1870,1557,313
2,16,7,1,12,1929,1520,409
2,16,8,1,12,1898,1449,449
2,16,9,1,12,1815,1427,388
2,16,10,1,12,1876,1522,354
2,16,11,1,12,1876,1505,371
2,16,12,1,12,1922,1593,329
2,17,0,1,12,1577,1432,145
2,17,1,1,12,1552,1417,135
2,17,2,1,12,1560,1400,160
2,17,3,1,12,1558,1427,131
2,17,4,1,12,1552,1325,227
2,17,5,1,12,1587,1154,433
2,17,6,1,12,1557,1133,424
2,17,7,1,12,1520,1137,383
2,17,8,1,12,1449,1134,315
2,17,9,1,12,1427,1222,205
2,17,10,1,12,1522,1313,209
2,17,11,1,12,1505,1319,186
2,17,12,1,12,1593,1356,237
2,18,0,1,12,1432,1598,-166
2,18,1,1,12,1417,1566,-149
2,18,2,1,12,1400,1633,-233
2,18,3,1,12,1427,1639,-212
2,18,4,1,12,1325,1470,-145
2,18,5,1,12,1154,1528,-374
2,18,6,1,12,1133,1656,-523
2,18,7,1,12,1137,1653,-516
2,18,8,1,12,1134,1617,-483
2,18,9,1,12,1222,1607,-385
2,18,10,1,12,1313,1563,-250
2,18,11,1,12,1319,1479,-160
2,18,12,1,12,1356,1549,-193
2,19,0,1,12,1598,1605,-7
2,19,1,1,12,1566,1567,-1
2,19,2,1,12,1633,1637,-4
2,19,3,1,12,1639,1653,-14
2,19,4,1,12,1470,1498,-28
2,19,5,1,12,1528,1539,-11
2,19,6,1,12,1656,1616,40
2,19,7,1,12,1653,1591,62
2,19,8,1,12,1617,1489,128
2,19,9,1,12,1607,1408,199
2,19,10,1,12,1563,1321,242
2,19,11,1,12,1479,1223,256
2,19,12,1,12,1549,1314,235
2,20,0,1,12,1605,1091,514
2,20,1,1,12,1567,976,591
2,20,2,1,12,1637,940,697
2,20,3,1,12,1653,875,778
2,20,4,1,12,1498,695,803
2,20,5,1,12,1539,676,863
2,20,6,1,12,1616,714,902
2,20,7,1,12,1591,711,880
2,20,8,1,12,1489,711,778
2,20,9,1,12,1408,667,741
2,20,10,1,12,1321,715,606
2,20,11,1,12,1223,785,438
2,20,12,1,12,1314,914,400
2,21,0,1,12,1091,915,176
2,21,1,1,12,976,934,42
2,21,2,1,12,940,943,-3
2,21,3,1,12,875,900,-25
2,21,4,1,12,695,878,-183
2,21,5,1,12,676,950,-274
2,21,6,1,12,714,983,-269
2,21,7,1,12,711,958,-247
2,21,8,1,12,711,921,-210
2,21,9,1,12,667,818,-151
2,21,10,1,12,715,823,-108
2,21,11,1,12,785,807,-22
2,21,12,1,12,914,802,112
2,22,0,1,12,915,904,11
2,22,1,1,12,934,925,9
2,22,2,1,12,943,946,-3
2,22,3,1,12,900,984,-84
2,22,4,1,12,878,1009,-131
2,22,5,1,12,950,1047,-97
2,22,6,1,12,983,1049,-66
2,22,7,1,12,958,1043,-85
2,22,8,1,12,921,1033,-112
2,22,9,1,12,818,961,-143
2,22,10,1,12,823,896,-73
2,22,11,1,12,807,915,-108
2,22,12,1,12,802,902,-100
2,0,0,2,12,2534,2496,38
2,0,1,2,12,2523,2446,77
2,0,2,2,12,2512,2385,127
2,0,3,2,12,2518,2338,180
2,0,4,2,12,2526,2304,222
2,0,5,2,12,2516,2289,227
2,0,6,2,12,2506,2274,232
2,0,7,2,12,2514,2280,234
2,0,8,2,12,2511,2275,236
2,0,9,2,12,2498,2298,200
2,0,10,2,12,2503,2330,173
2,0,11,2,12,2520,2381,139
2,0,12,2,12,2519,2428,91
2,1,0,2,12,2608,2244,364
2,1,1,2,12,2605,2124,481
2,1,2,2,12,2591,1996,595
2,1,3,2,12,2587,1884,703
2,1,4,2,12,2592,1779,813
2,1,5,2,12,2602,1690,912
2,1,6,2,12,2602,1629,973
2,1,7,2,12,2605,1646,959
2,1,8,2,12,2589,1699,890
2,1,9,2,12,2570,1795,775
2,1,10,2,12,2572,1889,683
2,1,11,2,12,2588,1999,589
2,1,12,2,12,2586,2112,474
2,2,0,2,12,2496,2162,334
2,2,1,2,12,2446,2043,403
2,2,2,2,12,2385,1912,473
2,2,3,2,12,2338,1790,548
2,2,4,2,12,2304,1670,634
2,2,5,2,12,2289,1533,756
2,2,6,2,12,2274,1437,837
2,2,7,2,12,2280,1461,819
2,2,8,2,12,2275,1576,699
2,2,9,2,12,2298,1684,614
2,2,10,2,12,2330,1794,536
2,2,11,2,12,2381,1910,471
2,2,12,2,12,2428,2018,410
2,3,0,2,12,2244,2098,146
2,3,1,2,12,2124,1998,126
2,3,2,2,12,1996,1886,110
2,3,3,2,12,1884,1790,94
2,3,4,2,12,1779,1716,63
2,3,5,2,12,1690,1636,54
2,3,6,2,12,1629,1569,60
2,3,7,2,12,1646,1585,61
2,3,8,2,12,1699,1682,17
2,3,9,2,12,1795,1757,38
2,3,10,2,12,1889,1846,43
2,3,11,2,12,1999,1944,55
2,3,12,2,12,2112,2033,79
2,4,0,2,12,2162,2077,85
2,4,1,2,12,2043,1995,48
2,4,2,2,12,1912,1913,-1
2,4,3,2,12,1790,1879,-89
2,4,4,2,12,1670,1905,-235
2,4,5,2,12,1533,1954,-421
2,4,6,2,12,1437,1965,-528
2,4,7,2,12,1461,1966,-505
2,4,8,2,12,1576,1967,-391
2,4,9,2,12,1684,1972,-288
2,4,10,2,12,1794,1998,-204
2,4,11,2,12,1910,2058,-148
2,4,12,2,12,2018,2130,-112
2,5,0,2,12,2098,2473,-375
2,5,1,2,12,1998,2462,-464
2,5,2,2,12,1886,2440,-554
2,5,3,2,12,1790,2464,-674
2,5,4,2,12,1716,2571,-855
2,5,5,2,12,1636,2701,-1065
2,5,6,2,12,1569,2765,-1196
2,5,7,2,12,1585,2756,-1171
2,5,8,2,12,1682,2700,-1018
2,5,9,2,12,1757,2649,-892
2,5,10,2,12,1846,2630,-784
2,5,11,2,12,1944,2631,-687
2,5,12,2,12,2033,2651,-618
2,6,0,2,12,2077,2072,5
2,6,1,2,12,1995,2025,-30
2,6,2,2,12,1913,1989,-76
2,6,3,2,12,1879,1964,-85
2,6,4,2,12,1905,2034,-129
2,6,5,2,12,1954,2123,-169
2,6,6,2,12,1965,2171,-206
2,6,7,2,12,1966,2179,-213
2,6,8,2,12,1967,2131,-164
2,6,9,2,12,1972,2090,-118
2,6,10,2,12,1998,2102,-104
2,6,11,2,12,2058,2137,-79
2,6,12,2,12,2130,2198,-68
2,7,0,2,12,2473,2015,458
2,7,1,2,12,2462,1969,493
2,7,2,2,12,2440,2016,424
2,7,3,2,12,2464,2038,426
2,7,4,2,12,2571,2101,470
2,7,5,2,12,2701,2116,585
2,7,6,2,12,2765,2158,607
2,7,7,2,12,2756,2161,595
2,7,8,2,12,2700,2104,596
2,7,9,2,12,2649,2064,585
2,7,10,2,12,2630,2037,593
2,7,11,2,12,2631,2051,580
2,7,12,2,12,2651,2105,546
2,8,0,2,12,2072,3450,-1378
2,8,1,2,12,2025,3523,-1498
2,8,2,2,12,1989,3711,-1722
2,8,3,2,12,1964,3869,-1905
2,8,4,2,12,2034,3988,-1954
2,8,5,2,12,2123,3974,-1851
2,8,6,2,12,2171,4066,-1895
2,8,7,2,12,2179,4016,-1837
2,8,8,2,12,2131,3960,-1829
2,8,9,2,12,2090,3930,-1840
2,8,10,2,12,2102,3875,-1773
2,8,11,2,12,2137,3821,-1684
2,8,12,2,12,2198,3764,-1566
2,9,0,2,12,2015,4074,-2059
2,9,1,2,12,1969,4106,-2137
2,9,2,2,12,2016,4170,-2154
2,9,3,2,12,2038,4263,-2225
2,9,4,2,12,2101,4362,-2261
2,9,5,2,12,2116,4365,-2249
2,9,6,2,12,2158,4463,-2305
2,9,7,2,12,2161,4411,-2250
2,9,8,2,12,2104,4390,-2286
2,9,9,2,12,2064,4373,-2309
2,9,10,2,12,2037,4450,-2413
2,9,11,2,12,2051,4514,-2463
2,9,12,2,12,2105,4486,-2381
2,10,0,2,12,3450,3904,-454
2,10,1,2,12,3523,3848,-325
2,10,2,2,12,3711,3749,-38
2,10,3,2,12,3869,3729,140
2,10,4,2,12,3988,3796,192
2,10,5,2,12,3974,3872,102
2,10,6,2,12,4066,3873,193
2,10,7,2,12,4016,3908,108
2,10,8,2,12,3960,3886,74
2,10,9,2,12,3930,3800,130
2,10,10,2,12,3875,3974,-99
2,10,11,2,12,3821,4150,-329
2,10,12,2,12,3764,4207,-443
2,11,0,2,12,4074,3847,227
2,11,1,2,12,4106,3768,338
2,11,2,2,12,4170,3648,522
2,11,3,2,12,4263,3618,645
2,11,4,2,12,4362,3685,677
2,11,5,2,12,4365,3812,553
2,11,6,2,12,4463,3702,761
2,11,7,2,12,4411,3837,574
2,11,8,2,12,4390,3799,591
2,11,9,2,12,4373,3644,729
2,11,10,2,12,4450,3827,623
2,11,11,2,12,4514,3992,522
2,11,12,2,12,4486,4094,392
2,12,0,2,12,3904,3850,54
2,12,1,2,12,3848,3766,82
2,12,2,2,12,3749,3632,117
2,12,3,2,12,3729,3600,129
2,12,4,2,12,3796,3674,122
2,12,5,2,12,3872,3787,85
2,12,6,2,12,3873,3634,239
2,12,7,2,12,3908,3804,104
2,12,8,2,12,3886,3772,114
2,12,9,2,12,3800,3600,200
2,12,10,2,12,3974,3810,164
2,12,11,2,12,4150,3952,198
2,12,12,2,12,4207,4060,147
2,13,0,2,12,3847,3751,96
2,13,1,2,12,3768,3729,39
2,13,2,2,12,3648,3650,-2
2,13,3,2,12,3618,3652,-34
2,13,4,2,12,3685,3748,-63
2,13,5,2,12,3812,3831,-19
2,13,6,2,12,3702,3673,29
2,13,7,2,12,3837,3815,22
2,13,8,2,12,3799,3770,29
2,13,9,2,12,3644,3598,46
2,13,10,2,12,3827,3774,53
2,13,11,2,12,3992,3842,150
2,13,12,2,12,4094,3935,159
2,14,0,2,12,3850,3396,454
2,14,1,2,12,3766,3390,376
2,14,2,2,12,3632,3396,236
2,14,3,2,12,3600,3417,183
2,14,4,2,12,3674,3466,208
2,14,5,2,12,3787,3536,251
2,14,6,2,12,3634,3427,207
2,14,7,2,12,3804,3449,355
2,14,8,2,12,3772,3347,425
2,14,9,2,12,3600,3242,358
2,14,10,2,12,3810,3398,412
2,14,11,2,12,3952,3381,571
2,14,12,2,12,4060,3515,545
2,15,0,2,12,3751,3009,742
2,15,1,2,12,3729,2969,760
2,15,2,2,12,3650,2960,690
2,15,3,2,12,3652,2985,667
2,15,4,2,12,3748,2877,871
2,15,5,2,12,3831,2741,1090
2,15,6,2,12,3673,2690,983
2,15,7,2,12,3815,2657,1158
2,15,8,2,12,3770,2583,1187
2,15,9,2,12,3598,2649,949
2,15,10,2,12,3774,2835,939
2,15,11,2,12,3842,2824,1018
2,15,12,2,12,3935,2949,986
2,16,0,2,12,3396,3030,366
2,16,1,2,12,3390,2983,407
2,16,2,2,12,3396,3033,363
2,16,3,2,12,3417,3066,351
2,16,4,2,12,3466,2795,671
2,16,5,2,12,3536,2682,854
2,16,6,2,12,3427,2789,638
2,16,7,2,12,3449,2790,659
2,16,8,2,12,3347,2751,596
2,16,9,2,12,3242,2829,413
2,16,10,2,12,3398,2876,522
2,16,11,2,12,3381,2798,583
2,16,12,2,12,3515,2905,610
2,17,0,2,12,3009,3203,-194
2,17,1,2,12,2969,3133,-164
2,17,2,2,12,2960,3270,-310
2,17,3,2,12,2985,3292,-307
2,17,4,2,12,2877,2968,-91
2,17,5,2,12,2741,3067,-326
2,17,6,2,12,2690,3272,-582
2,17,7,2,12,2657,3244,-587
2,17,8,2,12,2583,3106,-523
2,17,9,2,12,2649,3015,-366
2,17,10,2,12,2835,2884,-49
2,17,11,2,12,2824,2702,122
2,17,12,2,12,2949,2863,86
2,18,0,2,12,3030,2696,334
2,18,1,2,12,2983,2543,440
2,18,2,2,12,3033,2577,456
2,18,3,2,12,3066,2528,538
2,18,4,2,12,2795,2193,602
2,18,5,2,12,2682,2215,467
2,18,6,2,12,2789,2330,459
2,18,7,2,12,2790,2302,488
2,18,8,2,12,2751,2200,551
2,18,9,2,12,2829,2075,754
2,18,10,2,12,2876,2036,840
2,18,11,2,12,2798,2008,790
2,18,12,2,12,2905,2228,677
2,19,0,2,12,3203,2006,1197
2,19,1,2,12,3133,1910,1223
2,19,2,2,12,3270,1883,1387
2,19,3,2,12,3292,1775,1517
2,19,4,2,12,2968,1573,1395
2,19,5,2,12,3067,1626,1441
2,19,6,2,12,3272,1697,1575
2,19,7,2,12,3244,1669,1575
2,19,8,2,12,3106,1632,1474
2,19,9,2,12,3015,1485,1530
2,19,10,2,12,2884,1538,1346
2,19,11,2,12,2702,1592,1110
2,19,12,2,12,2863,1716,1147
2,20,0,2,12,2696,1819,877
2,20,1,2,12,2543,1859,684
2,20,2,2,12,2577,1889,688
2,20,3,2,12,2528,1884,644
2,20,4,2,12,2193,1887,306
2,20,5,2,12,2215,1997,218
2,20,6,2,12,2330,2032,298
2,20,7,2,12,2302,2001,301
2,20,8,2,12,2200,1954,246
2,20,9,2,12,2075,1779,296
2,20,10,2,12,2036,1719,317
2,20,11,2,12,2008,1722,286
2,20,12,2,12,2228,1704,524
2,0,0,3,12,3862,3330,532
2,0,1,3,12,3851,3161,690
2,0,2,3,12,3833,2976,857
2,0,3,3,12,3837,2809,1028
2,0,4,3,12,3849,2651,1198
2,0,5,3,12,3846,2492,1354
2,0,6,3,12,3837,2380,1457
2,0,7,3,12,3846,2409,1437
2,0,8,3,12,3832,2530,1302
2,0,9,3,12,3807,2673,1134
2,0,10,3,12,3809,2818,991
2,0,11,3,12,3832,2979,853
2,0,12,3,12,3830,3135,695
2,1,0,3,12,3776,3174,602
2,1,1,3,12,3723,3004,719
2,1,2,3,12,3655,2818,837
2,1,3,3,12,3606,2655,951
2,1,4,3,12,3573,2514,1059
2,1,5,3,12,3561,2367,1194
2,1,6,3,12,3545,2255,1290
2,1,7,3,12,3553,2283,1270
2,1,8,3,12,3543,2427,1116
2,1,9,3,12,3559,2563,996
2,1,10,3,12,3596,2711,885
2,1,11,3,12,3657,2874,783
2,1,12,3,12,3703,3028,675
2,2,0,3,12,3572,3163,409
2,2,1,3,12,3452,3032,420
2,2,2,3,12,3317,2893,424
2,2,3,3,12,3203,2804,399
2,2,4,3,12,3102,2777,325
2,2,5,3,12,3020,2756,264
2,2,6,3,12,2960,2716,244
2,2,7,3,12,2978,2729,249
2,2,8,3,12,3020,2798,222
2,2,9,3,12,3104,2850,254
2,2,10,3,12,3195,2927,268
2,2,11,3,12,3311,3038,273
2,2,12,3,12,3423,3153,270
2,3,0,3,12,3330,3485,-155
2,3,1,3,12,3161,3423,-262
2,3,2,3,12,2976,3346,-370
2,3,3,3,12,2809,3329,-520
2,3,4,3,12,2651,3415,-764
2,3,5,3,12,2492,3535,-1043
2,3,6,3,12,2380,3583,-1203
2,3,7,3,12,2409,3578,-1169
2,3,8,3,12,2530,3551,-1021
2,3,9,3,12,2673,3528,-855
2,3,10,3,12,2818,3547,-729
2,3,11,3,12,2979,3595,-616
2,3,12,3,12,3135,3661,-526
2,4,0,3,12,3174,3137,37
2,4,1,3,12,3004,3059,-55
2,4,2,3,12,2818,2996,-178
2,4,3,3,12,2655,2978,-323
2,4,4,3,12,2514,3095,-581
2,4,5,3,12,2367,3243,-876
2,4,6,3,12,2255,3318,-1063
2,4,7,3,12,2283,3323,-1040
2,4,8,3,12,2427,3247,-820
2,4,9,3,12,2563,3183,-620
2,4,10,3,12,2711,3183,-472
2,4,11,3,12,2874,3231,-357
2,4,12,3,12,3028,3318,-290
2,5,0,3,12,3163,3423,-260
2,5,1,3,12,3032,3397,-365
2,5,2,3,12,2893,3449,-556
2,5,3,3,12,2804,3488,-684
2,5,4,3,12,2777,3611,-834
2,5,5,3,12,2756,3697,-941
2,5,6,3,12,2716,3776,-1060
2,5,7,3,12,2729,3773,-1044
2,5,8,3,12,2798,3688,-890
2,5,9,3,12,2850,3620,-770
2,5,10,3,12,2927,3586,-659
2,5,11,3,12,3038,3588,-550
2,5,12,3,12,3153,3636,-483
2,6,0,3,12,3485,4114,-629
2,6,1,3,12,3423,4120,-697
2,6,2,3,12,3346,4267,-921
2,6,3,3,12,3329,4383,-1054
2,6,4,3,12,3415,4512,-1097
2,6,5,3,12,3535,4516,-981
2,6,6,3,12,3583,4619,-1036
2,6,7,3,12,3578,4583,-1005
2,6,8,3,12,3551,4507,-956
2,6,9,3,12,3528,4464,-936
2,6,10,3,12,3547,4428,-881
2,6,11,3,12,3595,4421,-826
2,6,12,3,12,3661,4431,-770
2,7,0,3,12,3137,5425,-2288
2,7,1,3,12,3059,5478,-2419
2,7,2,3,12,2996,5630,-2634
2,7,3,3,12,2978,5787,-2809
2,7,4,3,12,3095,5939,-2844
2,7,5,3,12,3243,5939,-2696
2,7,6,3,12,3318,6068,-2750
2,7,7,3,12,3323,6005,-2682
2,7,8,3,12,3247,5947,-2700
2,7,9,3,12,3183,5903,-2720
2,7,10,3,12,3183,5934,-2751
2,7,11,3,12,3231,5965,-2734
2,7,12,3,12,3318,5924,-2606
2,8,0,3,12,3423,6003,-2580
2,8,1,3,12,3397,5999,-2602
2,8,2,3,12,3449,6000,-2551
2,8,3,3,12,3488,6074,-2586
2,8,4,3,12,3611,6207,-2596
2,8,5,3,12,3697,6272,-2575
2,8,6,3,12,3776,6334,-2558
2,8,7,3,12,3773,6330,-2557
2,8,8,3,12,3688,6289,-2601
2,8,9,3,12,3620,6200,-2580
2,8,10,3,12,3586,6365,-2779
2,8,11,3,12,3588,6520,-2932
2,8,12,3,12,3636,6533,-2897
2,9,0,3,12,4114,5822,-1708
2,9,1,3,12,4120,5723,-1603
2,9,2,3,12,4267,5567,-1300
2,9,3,3,12,4383,5536,-1153
2,9,4,3,12,4512,5636,-1124
2,9,5,3,12,4516,5777,-1261
2,9,6,3,12,4619,5704,-1085
2,9,7,3,12,4583,5826,-1243
2,9,8,3,12,4507,5786,-1279
2,9,9,3,12,4464,5617,-1153
2,9,10,3,12,4428,5886,-1458
2,9,11,3,12,4421,6136,-1715
2,9,12,3,12,4431,6254,-1823
2,10,0,3,12,5425,5779,-354
2,10,1,3,12,5478,5659,-181
2,10,2,3,12,5630,5462,168
2,10,3,3,12,5787,5411,376
2,10,4,3,12,5939,5519,420
2,10,5,3,12,5939,5694,245
2,10,6,3,12,6068,5505,563
2,10,7,3,12,6005,5723,282
2,10,8,3,12,5947,5671,276
2,10,9,3,12,5903,5427,476
2,10,10,3,12,5934,5725,209
2,10,11,3,12,5965,5958,7
2,10,12,3,12,5924,6107,-183
2,11,0,3,12,6003,5669,334
2,11,1,3,12,5999,5604,395
2,11,2,3,12,6000,5468,532
2,11,3,3,12,6074,5459,615
2,11,4,3,12,6207,5588,619
2,11,5,3,12,6272,5736,536
2,11,6,3,12,6334,5504,830
2,11,7,3,12,6330,5733,597
2,11,8,3,12,6289,5670,619
2,11,9,3,12,6200,5415,785
2,11,10,3,12,6365,5686,679
2,11,11,3,12,6520,5828,692
2,11,12,3,12,6533,5982,551
2,12,0,3,12,5822,5328,494
2,12,1,3,12,5723,5281,442
2,12,2,3,12,5567,5210,357
2,12,3,3,12,5536,5210,326
2,12,4,3,12,5636,5300,336
2,12,5,3,12,5777,5418,359
2,12,6,3,12,5704,5230,474
2,12,7,3,12,5826,5335,491
2,12,8,3,12,5786,5219,567
2,12,9,3,12,5617,5025,592
2,12,10,3,12,5886,5296,590
2,12,11,3,12,6136,5347,789
2,12,12,3,12,6254,5528,726
2,13,0,3,12,5779,4828,951
2,13,1,3,12,5659,4807,852
2,13,2,3,12,5462,4796,666
2,13,3,3,12,5411,4844,567
2,13,4,3,12,5519,4791,728
2,13,5,3,12,5694,4690,1004
2,13,6,3,12,5505,4560,945
2,13,7,3,12,5723,4586,1137
2,13,8,3,12,5671,4481,1190
2,13,9,3,12,5427,4464,963
2,13,10,3,12,5725,4711,1014
2,13,11,3,12,5958,4700,1258
2,13,12,3,12,6107,4871,1236
2,14,0,3,12,5669,4607,1062
2,14,1,3,12,5604,4535,1069
2,14,2,3,12,5468,4593,875
2,14,3,3,12,5459,4624,835
2,14,4,3,12,5588,4347,1241
2,14,5,3,12,5736,4269,1467
2,14,6,3,12,5504,4346,1158
2,14,7,3,12,5733,4310,1423
2,14,8,3,12,5670,4200,1470
2,14,9,3,12,5415,4256,1159
2,14,10,3,12,5686,4398,1288
2,14,11,3,12,5828,4303,1525
2,14,12,3,12,5982,4498,1484
2,15,0,3,12,5328,4635,693
2,15,1,3,12,5281,4550,731
2,15,2,3,12,5210,4670,540
2,15,3,3,12,5210,4719,491
2,15,4,3,12,5300,4293,1007
2,15,5,3,12,5418,4221,1197
2,15,6,3,12,5230,4405,825
2,15,7,3,12,5335,4381,954
2,15,8,3,12,5219,4240,979
2,15,9,3,12,5025,4237,788
2,15,10,3,12,5296,4197,1099
2,15,11,3,12,5347,4021,1326
2,15,12,3,12,5528,4219,1309
2,16,0,3,12,4828,4294,534
2,16,1,3,12,4807,4109,698
2,16,2,3,12,4796,4210,586
2,16,3,3,12,4844,4167,677
2,16,4,3,12,4791,3663,1128
2,16,5,3,12,4690,3743,947
2,16,6,3,12,4560,3986,574
2,16,7,3,12,4586,3955,631
2,16,8,3,12,4481,3817,664
2,16,9,3,12,4464,3682,782
2,16,10,3,12,4711,3599,1112
2,16,11,3,12,4700,3487,1213
2,16,12,3,12,4871,3777,1094
2,17,0,3,12,4607,3611,996
2,17,1,3,12,4535,3477,1058
2,17,2,3,12,4593,3520,1073
2,17,3,3,12,4624,3428,1196
2,17,4,3,12,4347,3071,1276
2,17,5,3,12,4269,3165,1104
2,17,6,3,12,4346,3313,1033
2,17,7,3,12,4310,3260,1050
2,17,8,3,12,4200,3121,1079
2,17,9,3,12,4256,2893,1363
2,17,10,3,12,4398,2859,1539
2,17,11,3,12,4303,2815,1488
2,17,12,3,12,4498,3030,1468
2,18,0,3,12,4635,2910,1725
2,18,1,3,12,4550,2835,1715
2,18,2,3,12,4670,2829,1841
2,18,3,3,12,4719,2759,1960
2,18,4,3,12,4293,2582,1711
2,18,5,3,12,4221,2673,1548
2,18,6,3,12,4405,2746,1659
2,18,7,3,12,4381,2712,1669
2,18,8,3,12,4240,2665,1575
2,18,9,3,12,4237,2446,1791
2,18,10,3,12,4197,2434,1763
2,18,11,3,12,4021,2507,1514
2,18,12,3,12,4219,2618,1601
2,0,0,4,12,5030,4239,791
2,0,1,4,12,4969,4038,931
2,0,2,4,12,4897,3825,1072
2,0,3,4,12,4856,3669,1187
2,0,4,4,12,4830,3575,1255
2,0,5,4,12,4805,3487,1318
2,0,6,4,12,4780,3402,1378
2,0,7,4,12,4794,3427,1367
2,0,8,4,12,4786,3543,1243
2,0,9,4,12,4796,3656,1140
2,0,10,4,12,4833,3792,1041
2,0,11,4,12,4901,3968,933
2,0,12,4,12,4947,4148,799
2,1,0,4,12,4852,4571,281
2,1,1,4,12,4729,4460,269
2,1,2,4,12,4587,4326,261
2,1,3,4,12,4471,4254,217
2,1,4,4,12,4371,4287,84
2,1,5,4,12,4292,4337,-45
2,1,6,4,12,4231,4334,-103
2,1,7,4,12,4251,4341,-90
2,1,8,4,12,4288,4382,-94
2,1,9,4,12,4365,4406,-41
2,1,10,4,12,4461,4476,-15
2,1,11,4,12,4587,4575,12
2,1,12,4,12,4698,4684,14
2,2,0,4,12,4658,4149,509
2,2,1,4,12,4489,4020,469
2,2,2,4,12,4297,3902,395
2,2,3,4,12,4128,3843,285
2,2,4,4,12,3974,3939,35
2,2,5,4,12,3822,4077,-255
2,2,6,4,12,3711,4136,-425
2,2,7,4,12,3741,4145,-404
2,2,8,4,12,3851,4098,-247
2,2,9,4,12,3982,4062,-80
2,2,10,4,12,4124,4100,24
2,2,11,4,12,4291,4195,96
2,2,12,4,12,4446,4328,118
2,3,0,4,12,4342,4488,-146
2,3,1,4,12,4122,4431,-309
2,3,2,4,12,3882,4456,-574
2,3,3,4,12,3674,4502,-828
2,3,4,4,12,3495,4672,-1177
2,3,5,4,12,3326,4817,-1491
2,3,6,4,12,3198,4923,-1725
2,3,7,4,12,3231,4917,-1686
2,3,8,4,12,3381,4804,-1423
2,3,9,4,12,3552,4713,-1161
2,3,10,4,12,3735,4667,-932
2,3,11,4,12,3943,4682,-739
2,3,12,4,12,4145,4756,-611
2,4,0,4,12,4239,5522,-1283
2,4,1,4,12,4038,5548,-1510
2,4,2,4,12,3825,5700,-1875
2,4,3,4,12,3669,5833,-2164
2,4,4,4,12,3575,6022,-2447
2,4,5,4,12,3487,6097,-2610
2,4,6,4,12,3402,6237,-2835
2,4,7,4,12,3427,6195,-2768
2,4,8,4,12,3543,6091,-2548
2,4,9,4,12,3656,6020,-2364
2,4,10,4,12,3792,5977,-2185
2,4,11,4,12,3968,5958,-1990
2,4,12,4,12,4148,5962,-1814
2,5,0,4,12,4571,6089,-1518
2,5,1,4,12,4460,6075,-1615
2,5,2,4,12,4326,6186,-1860
2,5,3,4,12,4254,6301,-2047
2,5,4,4,12,4287,6463,-2176
2,5,5,4,12,4337,6481,-2144
2,5,6,4,12,4334,6621,-2287
2,5,7,4,12,4341,6572,-2231
2,5,8,4,12,4382,6494,-2112
2,5,9,4,12,4406,6437,-2031
2,5,10,4,12,4476,6487,-2011
2,5,11,4,12,4575,6565,-1990
2,5,12,4,12,4684,6591,-1907
2,6,0,4,12,4149,7354,-3205
2,6,1,4,12,4020,7371,-3351
2,6,2,4,12,3902,7460,-3558
2,6,3,4,12,3843,7598,-3755
2,6,4,4,12,3939,7784,-3845
2,6,5,4,12,4077,7846,-3769
2,6,6,4,12,4136,7939,-3803
2,6,7,4,12,4145,7924,-3779
2,6,8,4,12,4098,7846,-3748
2,6,9,4,12,4062,7730,-3668
2,6,10,4,12,4100,7849,-3749
2,6,11,4,12,4195,7971,-3776
2,6,12,4,12,4328,7971,-3643
2,7,0,4,12,4488,7921,-3433
2,7,1,4,12,4431,7874,-3443
2,7,2,4,12,4456,7818,-3362
2,7,3,4,12,4502,7881,-3379
2,7,4,4,12,4672,8047,-3375
2,7,5,4,12,4817,8177,-3360
2,7,6,4,12,4923,8165,-3242
2,7,7,4,12,4917,8248,-3331
2,7,8,4,12,4804,8189,-3385
2,7,9,4,12,4713,8017,-3304
2,7,10,4,12,4667,8277,-3610
2,7,11,4,12,4682,8506,-3824
2,7,12,4,12,4756,8580,-3824
2,8,0,4,12,5522,7754,-2232
2,8,1,4,12,5548,7614,-2066
2,8,2,4,12,5700,7381,-1681
2,8,3,4,12,5833,7329,-1496
2,8,4,4,12,6022,7470,-1448
2,8,5,4,12,6097,7659,-1562
2,8,6,4,12,6237,7507,-1270
2,8,7,4,12,6195,7712,-1517
2,8,8,4,12,6091,7658,-1567
2,8,9,4,12,6020,7400,-1380
2,8,10,4,12,5977,7784,-1807
2,8,11,4,12,5958,8102,-2144
2,8,12,4,12,5962,8267,-2305
2,9,0,4,12,6089,7598,-1509
2,9,1,4,12,6075,7497,-1422
2,9,2,4,12,6186,7298,-1112
2,9,3,4,12,6301,7270,-969
2,9,4,4,12,6463,7433,-970
2,9,5,4,12,6481,7643,-1162
2,9,6,4,12,6621,7375,-754
2,9,7,4,12,6572,7652,-1080
2,9,8,4,12,6494,7569,-1075
2,9,9,4,12,6437,7242,-805
2,9,10,4,12,6487,7601,-1114
2,9,11,4,12,6565,7834,-1269
2,9,12,4,12,6591,8029,-1438
2,10,0,4,12,7354,7246,108
2,10,1,4,12,7371,7156,215
2,10,2,4,12,7460,7028,432
2,10,3,4,12,7598,7017,581
2,10,4,4,12,7784,7140,644
2,10,5,4,12,7846,7323,523
2,10,6,4,12,7939,7061,878
2,10,7,4,12,7924,7253,671
2,10,8,4,12,7846,7119,727
2,10,9,4,12,7730,6842,888
2,10,10,4,12,7849,7208,641
2,10,11,4,12,7971,7333,638
2,10,12,4,12,7971,7575,396
2,11,0,4,12,7921,6760,1161
2,11,1,4,12,7874,6698,1176
2,11,2,4,12,7818,6610,1208
2,11,3,4,12,7881,6637,1244
2,11,4,4,12,8047,6625,1422
2,11,5,4,12,8177,6572,1605
2,11,6,4,12,8165,6363,1802
2,11,7,4,12,8248,6472,1776
2,11,8,4,12,8189,6353,1836
2,11,9,4,12,8017,6247,1770
2,11,10,4,12,8277,6609,1668
2,11,11,4,12,8506,6666,1840
2,11,12,4,12,8580,6884,1696
2,12,0,4,12,7754,6426,1328
2,12,1,4,12,7614,6373,1241
2,12,2,4,12,7381,6429,952
2,12,3,4,12,7329,6483,846
2,12,4,4,12,7470,6261,1209
2,12,5,4,12,7659,6218,1441
2,12,6,4,12,7507,6216,1291
2,12,7,4,12,7712,6239,1473
2,12,8,4,12,7658,6098,1560
2,12,9,4,12,7400,6071,1329
2,12,10,4,12,7784,6274,1510
2,12,11,4,12,8102,6179,1923
2,12,12,4,12,8267,6420,1847
2,13,0,4,12,7598,6212,1386
2,13,1,4,12,7497,6102,1395
2,13,2,4,12,7298,6230,1068
2,13,3,4,12,7270,6277,993
2,13,4,4,12,7433,5845,1588
2,13,5,4,12,7643,5808,1835
2,13,6,4,12,7375,5962,1413
2,13,7,4,12,7652,5901,1751
2,13,8,4,12,7569,5689,1880
2,13,9,4,12,7242,5664,1578
2,13,10,4,12,7601,5719,1882
2,13,11,4,12,7834,5526,2308
2,13,12,4,12,8029,5812,2217
2,14,0,4,12,7246,5726,1520
2,14,1,4,12,7156,5526,1630
2,14,2,4,12,7028,5610,1418
2,14,3,4,12,7017,5594,1423
2,14,4,4,12,7140,4988,2152
2,14,5,4,12,7323,4897,2426
2,14,6,4,12,7061,5119,1942
2,14,7,4,12,7253,5092,2161
2,14,8,4,12,7119,4951,2168
2,14,9,4,12,6842,4904,1938
2,14,10,4,12,7208,4912,2296
2,14,11,4,12,7333,4806,2527
2,14,12,4,12,7575,5133,2442
2,15,0,4,12,6760,5209,1551
2,15,1,4,12,6698,5043,1655
2,15,2,4,12,6610,5153,1457
2,15,3,4,12,6637,5067,1570
2,15,4,4,12,6625,4541,2084
2,15,5,4,12,6572,4693,1879
2,15,6,4,12,6363,4969,1394
2,15,7,4,12,6472,4913,1559
2,15,8,4,12,6353,4738,1615
2,15,9,4,12,6247,4500,1747
2,15,10,4,12,6609,4422,2187
2,15,11,4,12,6666,4294,2372
2,15,12,4,12,6884,4579,2305
2,16,0,4,12,6426,4515,1911
2,16,1,4,12,6373,4402,1971
2,16,2,4,12,6429,4466,1963
2,16,3,4,12,6483,4412,2071
2,16,4,4,12,6261,4080,2181
2,16,5,4,12,6218,4212,2006
2,16,6,4,12,6216,4362,1854
2,16,7,4,12,6239,4303,1936
2,16,8,4,12,6098,4154,1944
2,16,9,4,12,6071,3854,2217
2,16,10,4,12,6274,3755,2519
2,16,11,4,12,6179,3730,2449
2,16,12,4,12,6420,3932,2488
2,0,0,5,12,6106,5235,871
2,0,1,5,12,5975,5057,918
2,0,2,5,12,5829,4882,947
2,0,3,5,12,5721,4768,953
2,0,4,5,12,5628,4811,817
2,0,5,5,12,5536,4879,657
2,0,6,5,12,5466,4887,579
2,0,7,5,12,5492,4908,584
2,0,8,5,12,5531,4929,602
2,0,9,5,12,5602,4940,662
2,0,10,5,12,5698,5029,669
2,0,11,5,12,5831,5175,656
2,0,12,5,12,5942,5351,591
2,1,0,5,12,5938,5500,438
2,1,1,5,12,5766,5392,374
2,1,2,5,12,5567,5362,205
2,1,3,5,12,5396,5367,29
2,1,4,5,12,5243,5516,-273
2,1,5,5,12,5094,5651,-557
2,1,6,5,12,4982,5741,-759
2,1,7,5,12,5014,5739,-725
2,1,8,5,12,5119,5655,-536
2,1,9,5,12,5243,5592,-349
2,1,10,5,12,5390,5584,-194
2,1,11,5,12,5567,5646,-79
2,1,12,5,12,5721,5766,-45
2,2,0,5,12,5670,6587,-917
2,2,1,5,12,5450,6582,-1132
2,2,2,5,12,5203,6707,-1504
2,2,3,5,12,4993,6847,-1854
2,2,4,5,12,4818,7083,-2265
2,2,5,5,12,4656,7217,-2561
2,2,6,5,12,4529,7384,-2855
2,2,7,5,12,4563,7339,-2776
2,2,8,5,12,4702,7207,-2505
2,2,9,5,12,4861,7113,-2252
2,2,10,5,12,5041,7058,-2017
2,2,11,5,12,5255,7052,-1797
2,2,12,5,12,5456,7082,-1626
2,3,0,5,12,5407,7497,-2090
2,3,1,5,12,5156,7503,-2347
2,3,2,5,12,4889,7619,-2730
2,3,3,5,12,4688,7751,-3063
2,3,4,5,12,4556,7973,-3417
2,3,5,5,12,4446,8062,-3616
2,3,6,5,12,4345,8239,-3894
2,3,7,5,12,4375,8184,-3809
2,3,8,5,12,4497,8078,-3581
2,3,9,5,12,4645,7993,-3348
2,3,10,5,12,4816,8036,-3220
2,3,11,5,12,5037,8102,-3065
2,3,12,5,12,5265,8122,-2857
2,4,0,5,12,5647,8018,-2371
2,4,1,5,12,5466,7968,-2502
2,4,2,5,12,5258,8016,-2758
2,4,3,5,12,5119,8112,-2993
2,4,4,5,12,5085,8308,-3223
2,4,5,5,12,5068,8388,-3320
2,4,6,5,12,5020,8492,-3472
2,4,7,5,12,5039,8491,-3452
2,4,8,5,12,5127,8393,-3266
2,4,9,5,12,5212,8264,-3052
2,4,10,5,12,5341,8402,-3061
2,4,11,5,12,5505,8571,-3066
2,4,12,5,12,5679,8638,-2959
2,5,0,5,12,5235,9272,-4037
2,5,1,5,12,5057,9246,-4189
2,5,2,5,12,4882,9278,-4396
2,5,3,5,12,4768,9405,-4637
2,5,4,5,12,4811,9624,-4813
2,5,5,5,12,4879,9751,-4872
2,5,6,5,12,4887,9770,-4883
2,5,7,5,12,4908,9842,-4934
2,5,8,5,12,4929,9746,-4817
2,5,9,5,12,4940,9547,-4607
2,5,10,5,12,5029,9761,-4732
2,5,11,5,12,5175,9957,-4782
2,5,12,5,12,5351,10018,-4667
2,6,0,5,12,5500,9853,-4353
2,6,1,5,12,5392,9765,-4373
2,6,2,5,12,5362,9632,-4270
2,6,3,5,12,5367,9674,-4307
2,6,4,5,12,5516,9881,-4365
2,6,5,5,12,5651,10059,-4408
2,6,6,5,12,5741,9968,-4227
2,6,7,5,12,5739,10134,-4395
2,6,8,5,12,5655,10061,-4406
2,6,9,5,12,5592,9800,-4208
2,6,10,5,12,5584,10175,-4591
2,6,11,5,12,5646,10472,-4826
2,6,12,5,12,5766,10593,-4827
2,7,0,5,12,6587,9573,-2986
2,7,1,5,12,6582,9452,-2870
2,7,2,5,12,6707,9217,-2510
2,7,3,5,12,6847,9188,-2341
2,7,4,5,12,7083,9384,-2301
2,7,5,5,12,7217,9608,-2391
2,7,6,5,12,7384,9377,-1993
2,7,7,5,12,7339,9641,-2302
2,7,8,5,12,7207,9556,-2349
2,7,9,5,12,7113,9215,-2102
2,7,10,5,12,7058,9660,-2602
2,7,11,5,12,7052,9978,-2926
2,7,12,5,12,7082,10189,-3107
2,8,0,5,12,7497,9175,-1678
2,8,1,5,12,7503,9049,-1546
2,8,2,5,12,7619,8858,-1239
2,8,3,5,12,7751,8828,-1077
2,8,4,5,12,7973,8985,-1012
2,8,5,5,12,8062,9230,-1168
2,8,6,5,12,8239,8932,-693
2,8,7,5,12,8184,9172,-988
2,8,8,5,12,8078,9018,-940
2,8,9,5,12,7993,8669,-676
2,8,10,5,12,8036,9123,-1087
2,8,11,5,12,8102,9339,-1237
2,8,12,5,12,8122,9622,-1500
2,9,0,5,12,8018,8678,-660
2,9,1,5,12,7968,8573,-605
2,9,2,5,12,8016,8428,-412
2,9,3,5,12,8112,8444,-332
2,9,4,5,12,8308,8465,-157
2,9,5,5,12,8388,8477,-89
2,9,6,5,12,8492,8194,298
2,9,7,5,12,8491,8390,101
2,9,8,5,12,8393,8253,140
2,9,9,5,12,8264,8064,200
2,9,10,5,12,8402,8521,-119
2,9,11,5,12,8571,8652,-81
2,9,12,5,12,8638,8931,-293
2,10,0,5,12,9272,8358,914
2,10,1,5,12,9246,8264,982
2,10,2,5,12,9278,8243,1035
2,10,3,5,12,9405,8276,1129
2,10,4,5,12,9624,8095,1529
2,10,5,5,12,9751,8100,1651
2,10,6,5,12,9770,8019,1751
2,10,7,5,12,9842,8125,1717
2,10,8,5,12,9746,7970,1776
2,10,9,5,12,9547,7854,1693
2,10,10,5,12,9761,8172,1589
2,10,11,5,12,9957,8145,1812
2,10,12,5,12,10018,8433,1585
2,11,0,5,12,9853,8031,1822
2,11,1,5,12,9765,7940,1825
2,11,2,5,12,9632,8066,1566
2,11,3,5,12,9674,8136,1538
2,11,4,5,12,9881,7759,2122
2,11,5,5,12,10059,7757,2302
2,11,6,5,12,9968,7832,2136
2,11,7,5,12,10134,7830,2304
2,11,8,5,12,10061,7587,2474
2,11,9,5,12,9800,7479,2321
2,11,10,5,12,10175,7595,2580
2,11,11,5,12,10472,7402,3070
2,11,12,5,12,10593,7734,2859
2,12,0,5,12,9573,7303,2270
2,12,1,5,12,9452,7078,2374
2,12,2,5,12,9217,7170,2047
2,12,3,5,12,9188,7152,2036
2,12,4,5,12,9384,6540,2844
2,12,5,5,12,9608,6484,3124
2,12,6,5,12,9377,6676,2701
2,12,7,5,12,9641,6612,3029
2,12,8,5,12,9556,6400,3156
2,12,9,5,12,9215,6331,2884
2,12,10,5,12,9660,6434,3226
2,12,11,5,12,9978,6311,3667
2,12,12,5,12,10189,6726,3463
2,13,0,5,12,9175,6641,2534
2,13,1,5,12,9049,6460,2589
2,13,2,5,12,8858,6553,2305
2,13,3,5,12,8828,6494,2334
2,13,4,5,12,8985,5866,3119
2,13,5,5,12,9230,5847,3383
2,13,6,5,12,8932,6102,2830
2,13,7,5,12,9172,6050,3122
2,13,8,5,12,9018,5872,3146
2,13,9,5,12,8669,5722,2947
2,13,10,5,12,9123,5735,3388
2,13,11,5,12,9339,5613,3726
2,13,12,5,12,9622,5935,3687
2,14,0,5,12,8678,6113,2565
2,14,1,5,12,8573,5968,2605
2,14,2,5,12,8428,6099,2329
2,14,3,5,12,8444,6051,2393
2,14,4,5,12,8465,5550,2915
2,14,5,5,12,8477,5740,2737
2,14,6,5,12,8194,6018,2176
2,14,7,5,12,8390,5956,2434
2,14,8,5,12,8253,5771,2482
2,14,9,5,12,8064,5461,2603
2,14,10,5,12,8521,5318,3203
2,14,11,5,12,8652,5209,3443
2,14,12,5,12,8931,5481,3450
2,0,0,6,12,7192,7599,-407
2,0,1,6,12,7012,7543,-531
2,0,2,6,12,6809,7613,-804
2,0,3,6,12,6646,7712,-1066
2,0,4,6,12,6500,7927,-1427
2,0,5,6,12,6338,8051,-1713
2,0,6,6,12,6217,8202,-1985
2,0,7,6,12,6255,8161,-1906
2,0,8,6,12,6362,8058,-1696
2,0,9,6,12,6480,7992,-1512
2,0,10,6,12,6627,7975,-1348
2,0,11,6,12,6811,8016,-1205
2,0,12,6,12,6965,8092,-1127
2,1,0,6,12,6950,8562,-1612
2,1,1,6,12,6727,8537,-1810
2,1,2,6,12,6473,8626,-2153
2,1,3,6,12,6261,8765,-2504
2,1,4,6,12,6087,9034,-2947
2,1,5,6,12,5928,9182,-3254
2,1,6,6,12,5800,9386,-3586
2,1,7,6,12,5836,9328,-3492
2,1,8,6,12,5970,9194,-3224
2,1,9,6,12,6122,9086,-2964
2,1,10,6,12,6307,9117,-2810
2,1,11,6,12,6531,9196,-2665
2,1,12,6,12,6731,9242,-2511
2,2,0,6,12,6735,9426,-2691
2,2,1,6,12,6484,9396,-2912
2,2,2,6,12,6210,9449,-3239
2,2,3,6,12,6007,9562,-3555
2,2,4,6,12,5879,9818,-3939
2,2,5,6,12,5776,9969,-4193
2,2,6,6,12,5676,10110,-4434
2,2,7,6,12,5707,10103,-4396
2,2,8,6,12,5818,9977,-4159
2,2,9,6,12,5954,9820,-3866
2,2,10,6,12,6122,9951,-3829
2,2,11,6,12,6349,10108,-3759
2,2,12,6,12,6576,10169,-3593
2,3,0,6,12,6815,9936,-3121
2,3,1,6,12,6584,9843,-3259
2,3,2,6,12,6322,9834,-3512
2,3,3,6,12,6138,9919,-3781
2,3,4,6,12,6066,10148,-4082
2,3,5,6,12,6027,10293,-4266
2,3,6,6,12,5963,10323,-4360
2,3,7,6,12,5987,10409,-4422
2,3,8,6,12,6081,10293,-4212
2,3,9,6,12,6201,10081,-3880
2,3,10,6,12,6365,10314,-3949
2,3,11,6,12,6574,10557,-3983
2,3,12,6,12,6796,10685,-3889
2,4,0,6,12,6311,11204,-4893
2,4,1,6,12,6063,11137,-5074
2,4,2,6,12,5814,11092,-5278
2,4,3,6,12,5633,11198,-5565
2,4,4,6,12,5609,11458,-5849
2,4,5,6,12,5610,11633,-6023
2,4,6,6,12,5573,11573,-6000
2,4,7,6,12,5606,11728,-6122
2,4,8,6,12,5674,11618,-5944
2,4,9,6,12,5746,11330,-5584
2,4,10,6,12,5894,11659,-5765
2,4,11,6,12,6105,11923,-5818
2,4,12,6,12,6346,12031,-5685
2,5,0,6,12,6586,11672,-5086
2,5,1,6,12,6429,11603,-5174
2,5,2,6,12,6342,11468,-5126
2,5,3,6,12,6292,11533,-5241
2,5,4,6,12,6388,11795,-5407
2,5,5,6,12,6453,12008,-5555
2,5,6,6,12,6492,11838,-5346
2,5,7,6,12,6502,12063,-5561
2,5,8,6,12,6486,11959,-5473
2,5,9,6,12,6470,11615,-5145
2,5,10,6,12,6513,12051,-5538
2,5,11,6,12,6626,12348,-5722
2,5,12,6,12,6789,12515,-5726
2,6,0,6,12,7599,11150,-3551
2,6,1,6,12,7543,11004,-3461
2,6,2,6,12,7613,10777,-3164
2,6,3,6,12,7712,10746,-3034
2,6,4,6,12,7927,10936,-3009
2,6,5,6,12,8051,11195,-3144
2,6,6,6,12,8202,10934,-2732
2,6,7,6,12,8161,11161,-3000
2,6,8,6,12,8058,11005,-2947
2,6,9,6,12,7992,10642,-2650
2,6,10,6,12,7975,11182,-3207
2,6,11,6,12,8016,11483,-3467
2,6,12,6,12,8092,11782,-3690
2,7,0,6,12,8562,10607,-2045
2,7,1,6,12,8537,10466,-1929
2,7,2,6,12,8626,10258,-1632
2,7,3,6,12,8765,10255,-1490
2,7,4,6,12,9034,10310,-1276
2,7,5,6,12,9182,10384,-1202
2,7,6,6,12,9386,10065,-679
2,7,7,6,12,9328,10309,-981
2,7,8,6,12,9194,10152,-958
2,7,9,6,12,9086,9891,-805
2,7,10,6,12,9117,10436,-1319
2,7,11,6,12,9196,10658,-1462
2,7,12,6,12,9242,10978,-1736
2,8,0,6,12,9426,10276,-850
2,8,1,6,12,9396,10139,-743
2,8,2,6,12,9449,10061,-612
2,8,3,6,12,9562,10083,-521
2,8,4,6,12,9818,9935,-117
2,8,5,6,12,9969,10005,-36
2,8,6,6,12,10110,9850,260
2,8,7,6,12,10103,10043,60
2,8,8,6,12,9977,9870,107
2,8,9,6,12,9820,9671,149
2,8,10,6,12,9951,10084,-133
2,8,11,6,12,10108,10131,-23
2,8,12,6,12,10169,10480,-311
2,9,0,6,12,9936,9963,-27
2,9,1,6,12,9843,9831,12
2,9,2,6,12,9834,9880,-46
2,9,3,6,12,9919,9929,-10
2,9,4,6,12,10148,9593,555
2,9,5,6,12,10293,9639,654
2,9,6,6,12,10323,9635,688
2,9,7,6,12,10409,9716,693
2,9,8,6,12,10293,9459,834
2,9,9,6,12,10081,9262,819
2,9,10,6,12,10314,9493,821
2,9,11,6,12,10557,9368,1189
2,9,12,6,12,10685,9747,938
2,10,0,6,12,11204,9122,2082
2,10,1,6,12,11137,8916,2221
2,10,2,6,12,11092,9006,2086
2,10,3,6,12,11198,9011,2187
2,10,4,6,12,11458,8454,3004
2,10,5,6,12,11633,8433,3200
2,10,6,6,12,11573,8546,3027
2,10,7,6,12,11728,8541,3187
2,10,8,6,12,11618,8298,3320
2,10,9,6,12,11330,8146,3184
2,10,10,6,12,11659,8310,3349
2,10,11,6,12,11923,8187,3736
2,10,12,6,12,12031,8648,3383
2,11,0,6,12,11672,8218,3454
2,11,1,6,12,11603,8012,3591
2,11,2,6,12,11468,8113,3355
2,11,3,6,12,11533,8052,3481
2,11,4,6,12,11795,7418,4377
2,11,5,6,12,12008,7434,4574
2,11,6,6,12,11838,7659,4179
2,11,7,6,12,12063,7570,4493
2,11,8,6,12,11959,7321,4638
2,11,9,6,12,11615,7149,4466
2,11,10,6,12,12051,7257,4794
2,11,11,6,12,12348,7118,5230
2,11,12,6,12,12515,7528,4987
2,12,0,6,12,11150,7545,3605
2,12,1,6,12,11004,7385,3619
2,12,2,6,12,10777,7499,3278
2,12,3,6,12,10746,7478,3268
2,12,4,6,12,10936,6875,4061
2,12,5,6,12,11195,6894,4301
2,12,6,6,12,10934,7151,3783
2,12,7,6,12,11161,7093,4068
2,12,8,6,12,11005,6905,4100
2,12,9,6,12,10642,6683,3959
2,12,10,6,12,11182,6631,4551
2,12,11,6,12,11483,6528,4955
2,12,12,6,12,11782,6837,4945
2,0,0,7,12,8204,10491,-2287
2,0,1,7,12,7973,10430,-2457
2,0,2,7,12,7715,10456,-2741
2,0,3,7,12,7511,10576,-3065
2,0,4,7,12,7344,10879,-3535
2,0,5,7,12,7172,11089,-3917
2,0,6,7,12,7035,11257,-4222
2,0,7,7,12,7077,11247,-4170
2,0,8,7,12,7213,11093,-3880
2,0,9,7,12,7359,10913,-3554
2,0,10,7,12,7544,11032,-3488
2,0,11,7,12,7775,11202,-3427
2,0,12,7,12,7975,11289,-3314
2,1,0,7,12,8015,11344,-3329
2,1,1,7,12,7761,11271,-3510
2,1,2,7,12,7480,11267,-3787
2,1,3,7,12,7275,11369,-4094
2,1,4,7,12,7148,11658,-4510
2,1,5,7,12,7048,11874,-4826
2,1,6,7,12,6947,11941,-4994
2,1,7,7,12,6980,12021,-5041
2,1,8,7,12,7086,11877,-4791
2,1,9,7,12,7215,11637,-4422
2,1,10,7,12,7388,11863,-4475
2,1,11,7,12,7625,12094,-4469
2,1,12,7,12,7851,12216,-4365
2,2,0,7,12,8143,11868,-3725
2,2,1,7,12,7912,11734,-3822
2,2,2,7,12,7643,11648,-4005
2,2,3,7,12,7457,11712,-4255
2,2,4,7,12,7389,11982,-4593
2,2,5,7,12,7357,12175,-4818
2,2,6,7,12,7294,12126,-4832
2,2,7,7,12,7319,12295,-4976
2,2,8,7,12,7402,12165,-4763
2,2,9,7,12,7510,11864,-4354
2,2,10,7,12,7671,12212,-4541
2,2,11,7,12,7886,12523,-4637
2,2,12,7,12,8107,12698,-4591
2,3,0,7,12,7479,13023,-5544
2,3,1,7,12,7181,12975,-5794
2,3,2,7,12,6878,12928,-6050
2,3,3,7,12,6652,13057,-6405
2,3,4,7,12,6590,13372,-6782
2,3,5,7,12,6569,13582,-7013
2,3,6,7,12,6516,13443,-6927
2,3,7,7,12,6554,13657,-7103
2,3,8,7,12,6628,13516,-6888
2,3,9,7,12,6735,13145,-6410
2,3,10,7,12,6918,13535,-6617
2,3,11,7,12,7174,13799,-6625
2,3,12,7,12,7463,13953,-6490
2,4,0,7,12,7662,13249,-5587
2,4,1,7,12,7435,13155,-5720
2,4,2,7,12,7274,13028,-5754
2,4,3,7,12,7157,13091,-5934
2,4,4,7,12,7186,13347,-6161
2,4,5,7,12,7184,13595,-6411
2,4,6,7,12,7178,13395,-6217
2,4,7,7,12,7200,13583,-6383
2,4,8,7,12,7231,13408,-6177
2,4,9,7,12,7276,13042,-5766
2,4,10,7,12,7378,13573,-6195
2,4,11,7,12,7556,13853,-6297
2,4,12,7,12,7784,14108,-6324
2,5,0,7,12,8685,12582,-3897
2,5,1,7,12,8580,12421,-3841
2,5,2,7,12,8593,12177,-3584
2,5,3,7,12,8637,12173,-3536
2,5,4,7,12,8799,12261,-3462
2,5,5,7,12,8853,12349,-3496
2,5,6,7,12,8953,12067,-3114
2,5,7,7,12,8924,12298,-3374
2,5,8,7,12,8889,12139,-3250
2,5,9,7,12,8870,11864,-2994
2,5,10,7,12,8904,12495,-3591
2,5,11,7,12,8996,12802,-3806
2,5,12,7,12,9115,13138,-4023
2,6,0,7,12,9574,12205,-2631
2,6,1,7,12,9498,12032,-2534
2,6,2,7,12,9532,11891,-2359
2,6,3,7,12,9630,11894,-2264
2,6,4,7,12,9878,11780,-1902
2,6,5,7,12,10016,11912,-1896
2,6,6,7,12,10204,11721,-1517
2,6,7,7,12,10150,11962,-1812
2,6,8,7,12,10045,11769,-1724
2,6,9,7,12,9965,11498,-1533
2,6,10,7,12,10034,11999,-1965
2,6,11,7,12,10160,12137,-1977
2,6,12,7,12,10252,12527,-2275
2,7,0,7,12,10491,11881,-1390
2,7,1,7,12,10430,11706,-1276
2,7,2,7,12,10456,11698,-1242
2,7,3,7,12,10576,11736,-1160
2,7,4,7,12,10879,11433,-554
2,7,5,7,12,11089,11544,-455
2,7,6,7,12,11257,11466,-209
2,7,7,7,12,11247,11634,-387
2,7,8,7,12,11093,11359,-266
2,7,9,7,12,10913,11079,-166
2,7,10,7,12,11032,11405,-373
2,7,11,7,12,11202,11354,-152
2,7,12,7,12,11289,11794,-505
2,8,0,7,12,11344,11054,290
2,8,1,7,12,11271,10807,464
2,8,2,7,12,11267,10820,447
2,8,3,7,12,11369,10804,565
2,8,4,7,12,11658,10288,1370
2,8,5,7,12,11874,10315,1559
2,8,6,7,12,11941,10349,1592
2,8,7,7,12,12021,10427,1594
2,8,8,7,12,11877,10170,1707
2,8,9,7,12,11637,9929,1708
2,8,10,7,12,11863,10208,1655
2,8,11,7,12,12094,10153,1941
2,8,12,7,12,12216,10661,1555
2,9,0,7,12,11868,10037,1831
2,9,1,7,12,11734,9850,1884
2,9,2,7,12,11648,9949,1699
2,9,3,7,12,11712,9911,1801
2,9,4,7,12,11982,9332,2650
2,9,5,7,12,12175,9383,2792
2,9,6,7,12,12126,9529,2597
2,9,7,7,12,12295,9499,2796
2,9,8,7,12,12165,9219,2946
2,9,9,7,12,11864,8964,2900
2,9,10,7,12,12212,9133,3079
2,9,11,7,12,12523,8994,3529
2,9,12,7,12,12698,9450,3248
2,10,0,7,12,13023,9122,3901
2,10,1,7,12,12975,8937,4038
2,10,2,7,12,12928,9059,3869
2,10,3,7,12,13057,9036,4021
2,10,4,7,12,13372,8427,4945
2,10,5,7,12,13582,8481,5101
2,10,6,7,12,13443,8708,4735
2,10,7,7,12,13657,8613,5044
2,10,8,7,12,13516,8354,5162
2,10,9,7,12,13145,8110,5035
2,10,10,7,12,13535,8153,5382
2,10,11,7,12,13799,8033,5766
2,10,12,7,12,13953,8430,5523
2,0,0,8,12,9269,13276,-4007
2,0,1,8,12,9007,13162,-4155
2,0,2,8,12,8722,13081,-4359
2,0,3,8,12,8525,13162,-4637
2,0,4,8,12,8405,13492,-5087
2,0,5,8,12,8292,13756,-5464
2,0,6,8,12,8182,13744,-5562
2,0,7,8,12,8221,13907,-5686
2,0,8,8,12,8329,13749,-5420
2,0,9,8,12,8452,13420,-4968
2,0,10,8,12,8625,13761,-5136
2,0,11,8,12,8869,14060,-5191
2,0,12,8,12,9095,14229,-5134
2,1,0,8,12,9423,13687,-4264
2,1,1,8,12,9189,13572,-4383
2,1,2,8,12,8913,13484,-4571
2,1,3,8,12,8725,13571,-4846
2,1,4,8,12,8658,13896,-5238
2,1,5,8,12,8629,14124,-5495
2,1,6,8,12,8565,13996,-5431
2,1,7,8,12,8592,14224,-5632
2,1,8,8,12,8670,14063,-5393
2,1,9,8,12,8771,13679,-4908
2,1,10,8,12,8937,14088,-5151
2,1,11,8,12,9162,14399,-5237
2,1,12,8,12,9382,14620,-5238
2,2,0,8,12,8807,14600,-5793
2,2,1,8,12,8509,14527,-6018
2,2,2,8,12,8199,14488,-6289
2,2,3,8,12,7971,14615,-6644
2,2,4,8,12,7913,14924,-7011
2,2,5,8,12,7899,15169,-7270
2,2,6,8,12,7847,15000,-7153
2,2,7,8,12,7886,15177,-7291
2,2,8,8,12,7949,14965,-7016
2,2,9,8,12,8044,14572,-6528
2,2,10,8,12,8224,15057,-6833
2,2,11,8,12,8486,15304,-6818
2,2,12,8,12,8774,15546,-6772
2,3,0,8,12,8830,14681,-5851
2,3,1,8,12,8553,14572,-6019
2,3,2,8,12,8338,14428,-6090
2,3,3,8,12,8176,14518,-6342
2,3,4,8,12,8167,14672,-6505
2,3,5,8,12,8143,14749,-6606
2,3,6,8,12,8121,14528,-6407
2,3,7,8,12,8148,14720,-6572
2,3,8,8,12,8185,14542,-6357
2,3,9,8,12,8265,14264,-5999
2,3,10,8,12,8402,14886,-6484
2,3,11,8,12,8625,15172,-6547
2,3,12,8,12,8901,15464,-6563
2,4,0,8,12,9761,14180,-4419
2,4,1,8,12,9586,13987,-4401
2,4,2,8,12,9525,13810,-4285
2,4,3,8,12,9502,13812,-4310
2,4,4,8,12,9597,13731,-4134
2,4,5,8,12,9584,13877,-4293
2,4,6,8,12,9639,13723,-4084
2,4,7,8,12,9622,13951,-4329
2,4,8,8,12,9634,13756,-4122
2,4,9,8,12,9676,13471,-3795
2,4,10,8,12,9769,14058,-4289
2,4,11,8,12,9926,14281,-4355
2,4,12,8,12,10110,14687,-4577
2,5,0,8,12,10660,13810,-3150
2,5,1,8,12,10535,13599,-3064
2,5,2,8,12,10512,13528,-3016
2,5,3,8,12,10555,13547,-2992
2,5,4,8,12,10750,13278,-2528
2,5,5,8,12,10818,13451,-2633
2,5,6,8,12,10955,13337,-2382
2,5,7,8,12,10913,13553,-2640
2,5,8,8,12,10876,13258,-2382
2,5,9,8,12,10843,12906,-2063
2,5,10,8,12,10963,13320,-2357
2,5,11,8,12,11140,13360,-2220
2,5,12,8,12,11275,13841,-2566
2,6,0,8,12,11503,12972,-1469
2,6,1,8,12,11391,12682,-1291
2,6,2,8,12,11362,12638,-1276
2,6,3,8,12,11441,12611,-1170
2,6,4,8,12,11723,12128,-405
2,6,5,8,12,11923,12220,-297
2,6,6,8,12,12075,12180,-105
2,6,7,8,12,12069,12345,-276
2,6,8,8,12,11944,12070,-126
2,6,9,8,12,11792,11746,46
2,6,10,8,12,11949,12120,-171
2,6,11,8,12,12166,12139,27
2,6,12,8,12,12299,12708,-409
2,7,0,8,12,12409,11969,440
2,7,1,8,12,12305,11741,564
2,7,2,8,12,12274,11763,511
2,7,3,8,12,12383,11704,679
2,7,4,8,12,12719,11166,1553
2,7,5,8,12,12994,11265,1729
2,7,6,8,12,13088,11332,1756
2,7,7,8,12,13165,11385,1780
2,7,8,8,12,12993,11091,1902
2,7,9,8,12,12730,10747,1983
2,7,10,8,12,12944,11031,1913
2,7,11,8,12,13188,10960,2228
2,7,12,8,12,13336,11463,1873
2,8,0,8,12,13276,10941,2335
2,8,1,8,12,13162,10775,2387
2,8,2,8,12,13081,10895,2186
2,8,3,8,12,13162,10895,2267
2,8,4,8,12,13492,10341,3151
2,8,5,8,12,13756,10430,3326
2,8,6,8,12,13744,10578,3166
2,8,7,8,12,13907,10542,3365
2,8,8,8,12,13749,10252,3497
2,8,9,8,12,13420,9925,3495
2,8,10,8,12,13761,10029,3732
2,8,11,8,12,14060,9909,4151
2,8,12,8,12,14229,10352,3877
2,0,0,9,12,10677,15264,-4587
2,0,1,9,12,10435,15124,-4689
2,0,2,9,12,10155,15044,-4889
2,0,3,9,12,9975,15129,-5154
2,0,4,9,12,9915,15448,-5533
2,0,5,9,12,9873,15711,-5838
2,0,6,9,12,9800,15553,-5753
2,0,7,9,12,9833,15744,-5911
2,0,8,9,12,9913,15512,-5599
2,0,9,9,12,10008,15106,-5098
2,0,10,9,12,10174,15610,-5436
2,0,11,9,12,10406,15904,-5498
2,0,12,9,12,10626,16213,-5587
2,1,0,9,12,10087,16032,-5945
2,1,1,9,12,9786,15944,-6158
2,1,2,9,12,9469,15888,-6419
2,1,3,9,12,9239,16042,-6803
2,1,4,9,12,9182,16249,-7067
2,1,5,9,12,9171,16323,-7152
2,1,6,9,12,9118,16133,-7015
2,1,7,9,12,9159,16314,-7155
2,1,8,9,12,9217,16099,-6882
2,1,9,9,12,9305,15794,-6489
2,1,10,9,12,9490,16370,-6880
2,1,11,9,12,9762,16623,-6861
2,1,12,9,12,10049,16902,-6853
2,2,0,9,12,10158,16279,-6121
2,2,1,9,12,9881,16138,-6257
2,2,2,9,12,9659,16061,-6402
2,2,3,9,12,9495,16157,-6662
2,2,4,9,12,9490,16142,-6652
2,2,5,9,12,9473,16277,-6804
2,2,6,9,12,9452,16184,-6732
2,2,7,9,12,9480,16373,-6893
2,2,8,9,12,9506,16159,-6653
2,2,9,9,12,9574,15871,-6297
2,2,10,9,12,9708,16449,-6741
2,2,11,9,12,9937,16651,-6714
2,2,12,9,12,10212,17013,-6801
2,3,0,9,12,10929,15785,-4856
2,3,1,9,12,10704,15554,-4850
2,3,2,9,12,10589,15447,-4858
2,3,3,9,12,10521,15465,-4944
2,3,4,9,12,10578,15229,-4651
2,3,5,9,12,10543,15416,-4873
2,3,6,9,12,10582,15339,-4757
2,3,7,9,12,10570,15542,-4972
2,3,8,9,12,10588,15245,-4657
2,3,9,9,12,10665,14879,-4214
2,3,10,9,12,10793,15379,-4586
2,3,11,9,12,10995,15504,-4509
2,3,12,9,12,11227,16001,-4774
2,4,0,9,12,11736,14901,-3165
2,4,1,9,12,11541,14575,-3034
2,4,2,9,12,11444,14468,-3024
2,4,3,9,12,11420,14422,-3002
2,4,4,9,12,11548,13973,-2425
2,4,5,9,12,11549,14127,-2578
2,4,6,9,12,11641,14051,-2410
2,4,7,9,12,11611,14264,-2653
2,4,8,9,12,11621,13969,-2348
2,4,9,9,12,11649,13573,-1924
2,4,10,9,12,11828,14035,-2207
2,4,11,9,12,12070,14145,-2075
2,4,12,9,12,12270,14755,-2485
2,5,0,9,12,12589,13887,-1298
2,5,1,9,12,12428,13616,-1188
2,5,2,9,12,12342,13581,-1239
2,5,3,9,12,12366,13511,-1145
2,5,4,9,12,12595,13006,-411
2,5,5,9,12,12725,13170,-445
2,5,6,9,12,12826,13163,-337
2,5,7,9,12,12832,13303,-471
2,5,8,9,12,12775,12991,-216
2,5,9,9,12,12670,12564,106
2,5,10,9,12,12878,12943,-65
2,5,11,9,12,13146,12946,200
2,5,12,9,12,13322,13510,-188
2,6,0,9,12,13421,12873,548
2,6,1,9,12,13266,12666,600
2,6,2,9,12,13180,12709,471
2,6,3,9,12,13248,12688,560
2,6,4,9,12,13563,12175,1388
2,6,5,9,12,13828,12312,1516
2,6,6,9,12,13906,12381,1525
2,6,7,9,12,13987,12428,1559
2,6,8,9,12,13844,12124,1720
2,6,9,9,12,13609,11708,1901
2,6,10,9,12,13861,11927,1934
2,6,11,9,12,14152,11875,2277
2,6,12,9,12,14346,12365,1981
2,0,0,10,12,11341,17630,-6289
2,0,1,10,12,11032,17510,-6478
2,0,2,10,12,10711,17521,-6810
2,0,3,10,12,10489,17681,-7192
2,0,4,10,12,10439,17719,-7280
2,0,5,10,12,10415,17851,-7436
2,0,6,10,12,10353,17789,-7436
2,0,7,10,12,10400,17967,-7567
2,0,8,10,12,10460,17716,-7256
2,0,9,10,12,10542,17401,-6859
2,0,10,10,12,10727,17933,-7206
2,0,11,10,12,11006,18102,-7096
2,0,12,10,12,11293,18451,-7158
2,1,0,10,12,11438,17884,-6446
2,1,1,10,12,11158,17705,-6547
2,1,2,10,12,10929,17698,-6769
2,1,3,10,12,10763,17810,-7047
2,1,4,10,12,10759,17640,-6881
2,1,5,10,12,10745,17816,-7071
2,1,6,10,12,10723,17800,-7077
2,1,7,10,12,10753,17964,-7211
2,1,8,10,12,10774,17648,-6874
2,1,9,10,12,10835,17279,-6444
2,1,10,10,12,10974,17770,-6796
2,1,11,10,12,11213,17874,-6661
2,1,12,10,12,11487,18327,-6840
2,2,0,10,12,12257,16876,-4619
2,2,1,10,12,12032,16530,-4498
2,2,2,10,12,11910,16387,-4477
2,2,3,10,12,11840,16340,-4500
2,2,4,10,12,11901,15924,-4023
2,2,5,10,12,11873,16092,-4219
2,2,6,10,12,11913,16053,-4140
2,2,7,10,12,11902,16253,-4351
2,2,8,10,12,11909,15956,-4047
2,2,9,10,12,11974,15546,-3572
2,2,10,10,12,12099,16094,-3995
2,2,11,10,12,12307,16289,-3982
2,2,12,10,12,12538,16915,-4377
2,3,0,10,12,12904,15816,-2912
2,3,1,10,12,12659,15509,-2850
2,3,2,10,12,12508,15411,-2903
2,3,3,10,12,12439,15322,-2883
2,3,4,10,12,12529,14851,-2322
2,3,5,10,12,12508,15077,-2569
2,3,6,10,12,12584,15034,-2450
2,3,7,10,12,12559,15222,-2663
2,3,8,10,12,12575,14890,-2315
2,3,9,10,12,12638,14391,-1753
2,3,10,10,12,12852,14858,-2006
2,3,11,10,12,13139,14952,-1813
2,3,12,10,12,13387,15557,-2170
2,4,0,10,12,13665,14791,-1126
2,4,1,10,12,13434,14541,-1107
2,4,2,10,12,13274,14527,-1253
2,4,3,10,12,13231,14495,-1264
2,4,4,10,12,13393,14015,-622
2,4,5,10,12,13456,14217,-761
2,4,6,10,12,13512,14212,-700
2,4,7,10,12,13530,14346,-816
2,4,8,10,12,13520,14024,-504
2,4,9,10,12,13476,13525,-49
2,4,10,10,12,13743,13839,-96
2,4,11,10,12,14076,13861,215
2,4,12,10,12,14317,14412,-95
2,0,0,11,12,12692,18975,-6283
2,0,1,11,12,12404,18681,-6277
2,0,2,11,12,12171,18638,-6467
2,0,3,11,12,12013,18685,-6672
2,0,4,11,12,12016,18335,-6319
2,0,5,11,12,11989,18492,-6503
2,0,6,11,12,11958,18514,-6556
2,0,7,11,12,11994,18675,-6681
2,0,8,11,12,12017,18359,-6342
2,0,9,11,12,12072,17946,-5874
2,0,10,11,12,12211,18485,-6274
2,0,11,11,12,12457,18659,-6202
2,0,12,11,12,12731,19241,-6510
2,1,0,11,12,13537,17791,-4254
2,1,1,11,12,13309,17464,-4155
2,1,2,11,12,13180,17330,-4150
2,1,3,11,12,13108,17240,-4132
2,1,4,11,12,13170,16802,-3632
2,1,5,11,12,13145,17042,-3897
2,1,6,11,12,13184,17036,-3852
2,1,7,11,12,13175,17211,-4036
2,1,8,11,12,13177,16877,-3700
2,1,9,11,12,13235,16364,-3129
2,1,10,11,12,13365,16917,-3552
2,1,11,11,12,13583,17096,-3513
2,1,12,11,12,13813,17717,-3904
2,2,0,11,12,14232,16720,-2488
2,2,1,11,12,13987,16434,-2447
2,2,2,11,12,13829,16357,-2528
2,2,3,11,12,13758,16306,-2548
2,2,4,11,12,13852,15860,-2008
2,2,5,11,12,13838,16124,-2286
2,2,6,11,12,13915,16083,-2168
2,2,7,11,12,13891,16265,-2374
2,2,8,11,12,13896,15923,-2027
2,2,9,11,12,13947,15352,-1405
2,2,10,11,12,14158,15754,-1596
2,2,11,11,12,14451,15867,-1416
2,2,12,11,12,14698,16459,-1761
2,0,0,12,12,14791,18695,-3904
2,0,1,12,12,14555,18389,-3834
2,0,2,12,12,14422,18276,-3854
2,0,3,12,12,14358,18224,-3866
2,0,4,12,12,14427,17811,-3384
2,0,5,12,12,14389,18089,-3700
2,0,6,12,12,14419,18085,-3666
2,0,7,12,12,14416,18254,-3838
2,0,8,12,12,14420,17910,-3490
2,0,9,12,12,14472,17325,-2853
2,0,10,12,12,14602,17813,-3211
2,0,11,12,12,14827,18011,-3184
2,0,12,12,12,15057,18619,-3562
2,0,0,1,13,1356,1383,-27
2,0,1,1,13,1349,1381,-32
2,0,2,1,13,1346,1375,-29
2,0,3,1,13,1355,1375,-20
2,0,4,1,13,1355,1384,-29
2,0,5,1,13,1346,1379,-33
2,0,6,1,13,1345,1375,-30
2,0,7,1,13,1349,1375,-26
2,0,8,1,13,1341,1369,-28
2,0,9,1,13,1340,1372,-32
2,0,10,1,13,1346,1380,-34
2,0,11,1,13,1346,1378,-32
2,1,0,1,13,1383,1434,-51
2,1,1,1,13,1381,1436,-55
2,1,2,1,13,1375,1431,-56
2,1,3,1,13,1375,1430,-55
2,1,4,1,13,1384,1440,-56
2,1,5,1,13,1379,1439,-60
2,1,6,1,13,1375,1440,-65
2,1,7,1,13,1375,1439,-64
2,1,8,1,13,1369,1424,-55
2,1,9,1,13,1372,1419,-47
2,1,10,1,13,1380,1421,-41
2,1,11,1,13,1378,1418,-40
2,2,0,1,13,1434,1230,204
2,2,1,1,13,1436,1181,255
2,2,2,1,13,1431,1129,302
2,2,3,1,13,1430,1086,344
2,2,4,1,13,1440,1071,369
2,2,5,1,13,1439,1058,381
2,2,6,1,13,1440,1060,380
2,2,7,1,13,1439,1069,370
2,2,8,1,13,1424,1061,363
2,2,9,1,13,1419,1093,326
2,2,10,1,13,1421,1135,286
2,2,11,1,13,1418,1180,238
2,3,0,1,13,1230,1120,110
2,3,1,1,13,1181,1051,130
2,3,2,1,13,1129,979,150
2,3,3,1,13,1086,913,173
2,3,4,1,13,1071,857,214
2,3,5,1,13,1058,806,252
2,3,6,1,13,1060,792,268
2,3,7,1,13,1069,821,248
2,3,8,1,13,1061,860,201
2,3,9,1,13,1093,916,177
2,3,10,1,13,1135,978,157
2,3,11,1,13,1180,1040,140
2,4,0,1,13,1120,1151,-31
2,4,1,1,13,1051,1102,-51
2,4,2,1,13,979,1045,-66
2,4,3,1,13,913,991,-78
2,4,4,1,13,857,927,-70
2,4,5,1,13,806,860,-54
2,4,6,1,13,792,832,-40
2,4,7,1,13,821,870,-49
2,4,8,1,13,860,947,-87
2,4,9,1,13,916,997,-81
2,4,10,1,13,978,1047,-69
2,4,11,1,13,1040,1088,-48
2,5,0,1,13,1151,1081,70
2,5,1,1,13,1102,1030,72
2,5,2,1,13,1045,974,71
2,5,3,1,13,991,933,58
2,5,4,1,13,927,921,6
2,5,5,1,13,860,900,-40
2,5,6,1,13,832,889,-57
2,5,7,1,13,870,909,-39
2,5,8,1,13,947,948,-1
2,5,9,1,13,997,986,11
2,5,10,1,13,1047,1033,14
2,5,11,1,13,1088,1079,9
2,6,0,1,13,1081,1164,-83
2,6,1,1,13,1030,1132,-102
2,6,2,1,13,974,1104,-130
2,6,3,1,13,933,1110,-177
2,6,4,1,13,921,1160,-239
2,6,5,1,13,900,1204,-304
2,6,6,1,13,889,1226,-337
2,6,7,1,13,909,1221,-312
2,6,8,1,13,948,1188,-240
2,6,9,1,13,986,1177,-191
2,6,10,1,13,1033,1191,-158
2,6,11,1,13,1079,1219,-140
2,7,0,1,13,1164,1554,-390
2,7,1,1,13,1132,1574,-442
2,7,2,1,13,1104,1571,-467
2,7,3,1,13,1110,1588,-478
2,7,4,1,13,1160,1644,-484
2,7,5,1,13,1204,1712,-508
2,7,6,1,13,1226,1747,-521
2,7,7,1,13,1221,1705,-484
2,7,8,1,13,1188,1683,-495
2,7,9,1,13,1177,1684,-507
2,7,10,1,13,1191,1667,-476
2,7,11,1,13,1219,1668,-449
2,8,0,1,13,1554,703,851
2,8,1,1,13,1574,625,949
2,8,2,1,13,1571,583,988
2,8,3,1,13,1588,567,1021
2,8,4,1,13,1644,583,1061
2,8,5,1,13,1712,608,1104
2,8,6,1,13,1747,611,1136
2,8,7,1,13,1705,614,1091
2,8,8,1,13,1683,598,1085
2,8,9,1,13,1684,594,1090
2,8,10,1,13,1667,629,1038
2,8,11,1,13,1668,703,965
2,9,0,1,13,703,1476,-773
2,9,1,1,13,625,1504,-879
2,9,2,1,13,583,1584,-1001
2,9,3,1,13,567,1653,-1086
2,9,4,1,13,583,1722,-1139
2,9,5,1,13,608,1723,-1115
2,9,6,1,13,611,1717,-1106
2,9,7,1,13,614,1714,-1100
2,9,8,1,13,598,1672,-1074
2,9,9,1,13,594,1612,-1018
2,9,10,1,13,629,1583,-954
2,9,11,1,13,703,1557,-854
2,10,0,1,13,1476,2290,-814
2,10,1,1,13,1504,2351,-847
2,10,2,1,13,1584,2435,-851
2,10,3,1,13,1653,2534,-881
2,10,4,1,13,1722,2653,-931
2,10,5,1,13,1723,2636,-913
2,10,6,1,13,1717,2645,-928
2,10,7,1,13,1714,2633,-919
2,10,8,1,13,1672,2616,-944
2,10,9,1,13,1612,2569,-957
2,10,10,1,13,1583,2564,-981
2,10,11,1,13,1557,2504,-947
2,11,0,1,13,2290,2106,184
2,11,1,1,13,2351,2066,285
2,11,2,1,13,2435,2022,413
2,11,3,1,13,2534,2077,457
2,11,4,1,13,2653,2202,451
2,11,5,1,13,2636,2203,433
2,11,6,1,13,2645,2202,443
2,11,7,1,13,2633,2211,422
2,11,8,1,13,2616,2205,411
2,11,9,1,13,2569,2170,399
2,11,10,1,13,2564,2258,306
2,11,11,1,13,2504,2275,229
2,12,0,1,13,2106,2039,67
2,12,1,1,13,2066,1989,77
2,12,2,1,13,2022,1921,101
2,12,3,1,13,2077,1968,109
2,12,4,1,13,2202,2094,108
2,12,5,1,13,2203,2124,79
2,12,6,1,13,2202,2089,113
2,12,7,1,13,2211,2132,79
2,12,8,1,13,2205,2076,129
2,12,9,1,13,2170,2015,155
2,12,10,1,13,2258,2112,146
2,12,11,1,13,2275,2140,135
2,13,0,1,13,2039,2027,12
2,13,1,1,13,1989,1987,2
2,13,2,1,13,1921,1922,-1
2,13,3,1,13,1968,1962,6
2,13,4,1,13,2094,2081,13
2,13,5,1,13,2124,2085,39
2,13,6,1,13,2089,2061,28
2,13,7,1,13,2132,2131,1
2,13,8,1,13,2076,2053,23
2,13,9,1,13,2015,2012,3
2,13,10,1,13,2112,2113,-1
2,13,11,1,13,2140,2140,0
2,14,0,1,13,2027,2037,-10
2,14,1,1,13,1987,1983,4
2,14,2,1,13,1922,1900,22
2,14,3,1,13,1962,1953,9
2,14,4,1,13,2081,2089,-8
2,14,5,1,13,2085,2053,32
2,14,6,1,13,2061,2050,11
2,14,7,1,13,2131,2109,22
2,14,8,1,13,2053,2021,32
2,14,9,1,13,2012,1981,31
2,14,10,1,13,2113,2084,29
2,14,11,1,13,2140,2107,33
2,15,0,1,13,2037,1946,91
2,15,1,1,13,1983,1950,33
2,15,2,1,13,1900,1934,-34
2,15,3,1,13,1953,2033,-80
2,15,4,1,13,2089,2168,-79
2,15,5,1,13,2053,2119,-66
2,15,6,1,13,2050,2059,-9
2,15,7,1,13,2109,2146,-37
2,15,8,1,13,2021,2054,-33
2,15,9,1,13,1981,1983,-2
2,15,10,1,13,2084,1993,91
2,15,11,1,13,2107,2016,91
2,16,0,1,13,1946,1660,286
2,16,1,1,13,1950,1635,315
2,16,2,1,13,1934,1621,313
2,16,3,1,13,2033,1698,335
2,16,4,1,13,2168,1794,374
2,16,5,1,13,2119,1748,371
2,16,6,1,13,2059,1632,427
2,16,7,1,13,2146,1680,466
2,16,8,1,13,2054,1623,431
2,16,9,1,13,1983,1593,390
2,16,10,1,13,1993,1615,378
2,16,11,1,13,2016,1660,356
2,17,0,1,13,1660,1539,121
2,17,1,1,13,1635,1492,143
2,17,2,1,13,1621,1503,118
2,17,3,1,13,1698,1509,189
2,17,4,1,13,1794,1392,402
2,17,5,1,13,1748,1312,436
2,17,6,1,13,1632,1206,426
2,17,7,1,13,1680,1262,418
2,17,8,1,13,1623,1334,289
2,17,9,1,13,1593,1386,207
2,17,10,1,13,1615,1394,221
2,17,11,1,13,1660,1440,220
2,18,0,1,13,1539,1756,-217
2,18,1,1,13,1492,1723,-231
2,18,2,1,13,1503,1743,-240
2,18,3,1,13,1509,1704,-195
2,18,4,1,13,1392,1658,-266
2,18,5,1,13,1312,1736,-424
2,18,6,1,13,1206,1725,-519
2,18,7,1,13,1262,1716,-454
2,18,8,1,13,1334,1794,-460
2,18,9,1,13,1386,1686,-300
2,18,10,1,13,1394,1637,-243
2,18,11,1,13,1440,1680,-240
2,19,0,1,13,1756,1757,-1
2,19,1,1,13,1723,1713,10
2,19,2,1,13,1743,1721,22
2,19,3,1,13,1704,1728,-24
2,19,4,1,13,1658,1636,22
2,19,5,1,13,1736,1659,77
2,19,6,1,13,1725,1664,61
2,19,7,1,13,1716,1668,48
2,19,8,1,13,1794,1652,142
2,19,9,1,13,1686,1453,233
2,19,10,1,13,1637,1376,261
2,19,11,1,13,1680,1434,246
2,20,0,1,13,1757,1179,578
2,20,1,1,13,1713,1012,701
2,20,2,1,13,1721,964,757
2,20,3,1,13,1728,930,798
2,20,4,1,13,1636,738,898
2,20,5,1,13,1659,746,913
2,20,6,1,13,1664,769,895
2,20,7,1,13,1668,795,873
2,20,8,1,13,1652,812,840
2,20,9,1,13,1453,756,697
2,20,10,1,13,1376,811,565
2,20,11,1,13,1434,958,476
2,21,0,1,13,1179,1031,148
2,21,1,1,13,1012,1017,-5
2,21,2,1,13,964,976,-12
2,21,3,1,13,930,998,-68
2,21,4,1,13,738,990,-252
2,21,5,1,13,746,1020,-274
2,21,6,1,13,769,1003,-234
2,21,7,1,13,795,1016,-221
2,21,8,1,13,812,969,-157
2,21,9,1,13,756,872,-116
2,21,10,1,13,811,877,-66
2,21,11,1,13,958,863,95
2,22,0,1,13,1031,1036,-5
2,22,1,1,13,1017,1015,2
2,22,2,1,13,976,1038,-62
2,22,3,1,13,998,1078,-80
2,22,4,1,13,990,1116,-126
2,22,5,1,13,1020,1114,-94
2,22,6,1,13,1003,1091,-88
2,22,7,1,13,1016,1113,-97
2,22,8,1,13,969,1087,-118
2,22,9,1,13,872,994,-122
2,22,10,1,13,877,970,-93
2,22,11,1,13,863,962,-99
2,0,0,2,13,2739,2664,75
2,0,1,2,13,2730,2617,113
2,0,2,2,13,2721,2560,161
2,0,3,2,13,2730,2516,214
2,0,4,2,13,2739,2511,228
2,0,5,2,13,2725,2497,228
2,0,6,2,13,2720,2500,220
2,0,7,2,13,2724,2508,216
2,0,8,2,13,2710,2485,225
2,0,9,2,13,2712,2512,200
2,0,10,2,13,2726,2556,170
2,0,11,2,13,2724,2598,126
2,1,0,2,13,2817,2350,467
2,1,1,2,13,2817,2232,585
2,1,2,2,13,2806,2108,698
2,1,3,2,13,2805,1999,806
2,1,4,2,13,2824,1928,896
2,1,5,2,13,2818,1864,954
2,1,6,2,13,2815,1852,963
2,1,7,2,13,2814,1890,924
2,1,8,2,13,2793,1921,872
2,1,9,2,13,2791,2009,782
2,1,10,2,13,2801,2113,688
2,1,11,2,13,2796,2220,576
2,2,0,2,13,2664,2271,393
2,2,1,2,13,2617,2153,464
2,2,2,2,13,2560,2024,536
2,2,3,2,13,2516,1904,612
2,2,4,2,13,2511,1784,727
2,2,5,2,13,2497,1666,831
2,2,6,2,13,2500,1624,876
2,2,7,2,13,2508,1691,817
2,2,8,2,13,2485,1807,678
2,2,9,2,13,2512,1913,599
2,2,10,2,13,2556,2025,531
2,2,11,2,13,2598,2128,470
2,3,0,2,13,2350,2232,118
2,3,1,2,13,2232,2132,100
2,3,2,2,13,2108,2019,89
2,3,3,2,13,1999,1924,75
2,3,4,2,13,1928,1848,80
2,3,5,2,13,1864,1760,104
2,3,6,2,13,1852,1721,131
2,3,7,2,13,1890,1779,111
2,3,8,2,13,1921,1895,26
2,3,9,2,13,2009,1983,26
2,3,10,2,13,2113,2080,33
2,3,11,2,13,2220,2167,53
2,4,0,2,13,2271,2245,26
2,4,1,2,13,2153,2162,-9
2,4,2,2,13,2024,2078,-54
2,4,3,2,13,1904,2043,-139
2,4,4,2,13,1784,2081,-297
2,4,5,2,13,1666,2104,-438
2,4,6,2,13,1624,2115,-491
2,4,7,2,13,1691,2130,-439
2,4,8,2,13,1807,2136,-329
2,4,9,2,13,1913,2163,-250
2,4,10,2,13,2025,2224,-199
2,4,11,2,13,2128,2298,-170
2,5,0,2,13,2232,2718,-486
2,5,1,2,13,2132,2706,-574
2,5,2,2,13,2019,2675,-656
2,5,3,2,13,1924,2698,-774
2,5,4,2,13,1848,2804,-956
2,5,5,2,13,1760,2916,-1156
2,5,6,2,13,1721,2973,-1252
2,5,7,2,13,1779,2926,-1147
2,5,8,2,13,1895,2871,-976
2,5,9,2,13,1983,2861,-878
2,5,10,2,13,2080,2858,-778
2,5,11,2,13,2167,2887,-720
2,6,0,2,13,2245,2257,-12
2,6,1,2,13,2162,2199,-37
2,6,2,2,13,2078,2154,-76
2,6,3,2,13,2043,2155,-112
2,6,4,2,13,2081,2227,-146
2,6,5,2,13,2104,2320,-216
2,6,6,2,13,2115,2358,-243
2,6,7,2,13,2130,2319,-189
2,6,8,2,13,2136,2281,-145
2,6,9,2,13,2163,2278,-115
2,6,10,2,13,2224,2296,-72
2,6,11,2,13,2298,2371,-73
2,7,0,2,13,2718,2179,539
2,7,1,2,13,2706,2129,577
2,7,2,2,13,2675,2167,508
2,7,3,2,13,2698,2220,478
2,7,4,2,13,2804,2305,499
2,7,5,2,13,2916,2331,585
2,7,6,2,13,2973,2328,645
2,7,7,2,13,2926,2328,598
2,7,8,2,13,2871,2270,601
2,7,9,2,13,2861,2206,655
2,7,10,2,13,2858,2212,646
2,7,11,2,13,2887,2260,627
2,8,0,2,13,2257,3766,-1509
2,8,1,2,13,2199,3855,-1656
2,8,2,2,13,2154,4019,-1865
2,8,3,2,13,2155,4187,-2032
2,8,4,2,13,2227,4375,-2148
2,8,5,2,13,2320,4359,-2039
2,8,6,2,13,2358,4362,-2004
2,8,7,2,13,2319,4347,-2028
2,8,8,2,13,2281,4288,-2007
2,8,9,2,13,2278,4181,-1903
2,8,10,2,13,2296,4147,-1851
2,8,11,2,13,2371,4061,-1690
2,9,0,2,13,2179,4396,-2217
2,9,1,2,13,2129,4417,-2288
2,9,2,2,13,2167,4457,-2290
2,9,3,2,13,2220,4611,-2391
2,9,4,2,13,2305,4855,-2550
2,9,5,2,13,2331,4839,-2508
2,9,6,2,13,2328,4847,-2519
2,9,7,2,13,2328,4844,-2516
2,9,8,2,13,2270,4821,-2551
2,9,9,2,13,2206,4739,-2533
2,9,10,2,13,2212,4822,-2610
2,9,11,2,13,2260,4779,-2519
2,10,0,2,13,3766,4145,-379
2,10,1,2,13,3855,4055,-200
2,10,2,2,13,4019,3943,76
2,10,3,2,13,4187,4045,142
2,10,4,2,13,4375,4296,79
2,10,5,2,13,4359,4327,32
2,10,6,2,13,4362,4291,71
2,10,7,2,13,4347,4343,4
2,10,8,2,13,4288,4281,7
2,10,9,2,13,4181,4185,-4
2,10,10,2,13,4147,4370,-223
2,10,11,2,13,4061,4415,-354
2,11,0,2,13,4396,4066,330
2,11,1,2,13,4417,3976,441
2,11,2,2,13,4457,3843,614
2,11,3,2,13,4611,3930,681
2,11,4,2,13,4855,4175,680
2,11,5,2,13,4839,4209,630
2,11,6,2,13,4847,4150,697
2,11,7,2,13,4844,4263,581
2,11,8,2,13,4821,4129,692
2,11,9,2,13,4739,4027,712
2,11,10,2,13,4822,4225,597
2,11,11,2,13,4779,4280,499
2,12,0,2,13,4145,4064,81
2,12,1,2,13,4055,3970,85
2,12,2,2,13,3943,3822,121
2,12,3,2,13,4045,3915,130
2,12,4,2,13,4296,4170,126
2,12,5,2,13,4327,4138,189
2,12,6,2,13,4291,4111,180
2,12,7,2,13,4343,4240,103
2,12,8,2,13,4281,4074,207
2,12,9,2,13,4185,3993,192
2,12,10,2,13,4370,4197,173
2,12,11,2,13,4415,4247,168
2,13,0,2,13,4066,3983,83
2,13,1,2,13,3976,3933,43
2,13,2,2,13,3843,3834,9
2,13,3,2,13,3930,3986,-56
2,13,4,2,13,4175,4257,-82
2,13,5,2,13,4209,4172,37
2,13,6,2,13,4150,4109,41
2,13,7,2,13,4263,4255,8
2,13,8,2,13,4129,4075,54
2,13,9,2,13,4027,3964,63
2,13,10,2,13,4225,4077,148
2,13,11,2,13,4280,4123,157
2,14,0,2,13,4064,3606,458
2,14,1,2,13,3970,3585,385
2,14,2,2,13,3822,3555,267
2,14,3,2,13,3915,3731,184
2,14,4,2,13,4170,3962,208
2,14,5,2,13,4138,3867,271
2,14,6,2,13,4111,3691,420
2,14,7,2,13,4240,3826,414
2,14,8,2,13,4074,3677,397
2,14,9,2,13,3993,3576,417
2,14,10,2,13,4197,3608,589
2,14,11,2,13,4247,3676,571
2,15,0,2,13,3983,3199,784
2,15,1,2,13,3933,3127,806
2,15,2,2,13,3834,3124,710
2,15,3,2,13,3986,3207,779
2,15,4,2,13,4257,3186,1071
2,15,5,2,13,4172,3060,1112
2,15,6,2,13,4109,2838,1271
2,15,7,2,13,4255,2942,1313
2,15,8,2,13,4075,2957,1118
2,15,9,2,13,3964,2979,985
2,15,10,2,13,4077,3009,1068
2,15,11,2,13,4123,3100,1023
2,16,0,2,13,3606,3295,311
2,16,1,2,13,3585,3215,370
2,16,2,2,13,3555,3246,309
2,16,3,2,13,3731,3213,518
2,16,4,2,13,3962,3050,912
2,16,5,2,13,3867,3048,819
2,16,6,2,13,3691,2931,760
2,16,7,2,13,3826,2978,848
2,16,8,2,13,3677,3128,549
2,16,9,2,13,3576,3072,504
2,16,10,2,13,3608,3031,577
2,16,11,2,13,3676,3120,556
2,17,0,2,13,3199,3513,-314
2,17,1,2,13,3127,3436,-309
2,17,2,2,13,3124,3464,-340
2,17,3,2,13,3207,3432,-225
2,17,4,2,13,3186,3294,-108
2,17,5,2,13,3060,3395,-335
2,17,6,2,13,2838,3389,-551
2,17,7,2,13,2942,3384,-442
2,17,8,2,13,2957,3446,-489
2,17,9,2,13,2979,3139,-160
2,17,10,2,13,3009,3013,-4
2,17,11,2,13,3100,3114,-14
2,18,0,2,13,3295,2936,359
2,18,1,2,13,3215,2725,490
2,18,2,2,13,3246,2685,561
2,18,3,2,13,3213,2658,555
2,18,4,2,13,3050,2374,676
2,18,5,2,13,3048,2405,643
2,18,6,2,13,2931,2433,498
2,18,7,2,13,2978,2463,515
2,18,8,2,13,3128,2464,664
2,18,9,2,13,3072,2209,863
2,18,10,2,13,3031,2187,844
2,18,11,2,13,3120,2392,728
2,19,0,2,13,3513,2210,1303
2,19,1,2,13,3436,2029,1407
2,19,2,2,13,3464,1940,1524
2,19,3,2,13,3432,1928,1504
2,19,4,2,13,3294,1728,1566
2,19,5,2,13,3395,1766,1629
2,19,6,2,13,3389,1772,1617
2,19,7,2,13,3384,1811,1573
2,19,8,2,13,3446,1781,1665
2,19,9,2,13,3139,1628,1511
2,19,10,2,13,3013,1688,1325
2,19,11,2,13,3114,1821,1293
2,20,0,2,13,2936,2067,869
2,20,1,2,13,2725,2032,693
2,20,2,2,13,2685,2014,671
2,20,3,2,13,2658,2076,582
2,20,4,2,13,2374,2106,268
2,20,5,2,13,2405,2134,271
2,20,6,2,13,2433,2094,339
2,20,7,2,13,2463,2129,334
2,20,8,2,13,2464,2056,408
2,20,9,2,13,2209,1866,343
2,20,10,2,13,2187,1847,340
2,20,11,2,13,2392,1825,567
2,0,0,3,13,4173,3501,672
2,0,1,3,13,4166,3334,832
2,0,2,3,13,4152,3153,999
2,0,3,3,13,4160,2990,1170
2,0,4,3,13,4179,2855,1324
2,0,5,3,13,4164,2724,1440
2,0,6,3,13,4160,2684,1476
2,0,7,3,13,4163,2760,1403
2,0,8,3,13,4134,2868,1266
2,0,9,3,13,4131,3006,1125
2,0,10,3,13,4147,3160,987
2,0,11,3,13,4142,3308,834
2,1,0,3,13,4047,3352,695
2,1,1,3,13,3998,3183,815
2,1,2,3,13,3935,2998,937
2,1,3,3,13,3891,2837,1054
2,1,4,3,13,3895,2705,1190
2,1,5,3,13,3876,2566,1310
2,1,6,3,13,3875,2513,1362
2,1,7,3,13,3883,2600,1283
2,1,8,3,13,3854,2755,1099
2,1,9,3,13,3884,2899,985
2,1,10,3,13,3936,3058,878
2,1,11,3,13,3976,3207,769
2,2,0,3,13,3784,3396,388
2,2,1,3,13,3668,3264,404
2,2,2,3,13,3539,3123,416
2,2,3,3,13,3429,3034,395
2,2,4,3,13,3368,3008,360
2,2,5,3,13,3303,2964,339
2,2,6,3,13,3292,2947,345
2,2,7,3,13,3329,3000,329
2,2,8,3,13,3345,3083,262
2,2,9,3,13,3428,3160,268
2,2,10,3,13,3534,3271,263
2,2,11,3,13,3638,3386,252
2,3,0,3,13,3501,3799,-298
2,3,1,3,13,3334,3736,-402
2,3,2,3,13,3153,3649,-496
2,3,3,3,13,2990,3631,-641
2,3,4,3,13,2855,3725,-870
2,3,5,3,13,2724,3816,-1092
2,3,6,3,13,2684,3862,-1178
2,3,7,3,13,2760,3835,-1075
2,3,8,3,13,2868,3819,-951
2,3,9,3,13,3006,3847,-841
2,3,10,3,13,3160,3891,-731
2,3,11,3,13,3308,3966,-658
2,4,0,3,13,3352,3421,-69
2,4,1,3,13,3183,3331,-148
2,4,2,3,13,2998,3258,-260
2,4,3,3,13,2837,3265,-428
2,4,4,3,13,2705,3387,-682
2,4,5,3,13,2566,3524,-958
2,4,6,3,13,2513,3584,-1071
2,4,7,3,13,2600,3540,-940
2,4,8,3,13,2755,3469,-714
2,4,9,3,13,2899,3455,-556
2,4,10,3,13,3058,3487,-429
2,4,11,3,13,3207,3590,-383
2,5,0,3,13,3396,3733,-337
2,5,1,3,13,3264,3703,-439
2,5,2,3,13,3123,3738,-615
2,5,3,3,13,3034,3808,-774
2,5,4,3,13,3008,3949,-941
2,5,5,3,13,2964,4043,-1079
2,5,6,3,13,2947,4075,-1128
2,5,7,3,13,3000,4033,-1033
2,5,8,3,13,3083,3953,-870
2,5,9,3,13,3160,3890,-730
2,5,10,3,13,3271,3879,-608
2,5,11,3,13,3386,3928,-542
2,6,0,3,13,3799,4469,-670
2,6,1,3,13,3736,4480,-744
2,6,2,3,13,3649,4602,-953
2,6,3,3,13,3631,4754,-1123
2,6,4,3,13,3725,4958,-1233
2,6,5,3,13,3816,4967,-1151
2,6,6,3,13,3862,4973,-1111
2,6,7,3,13,3835,4961,-1126
2,6,8,3,13,3819,4886,-1067
2,6,9,3,13,3847,4775,-928
2,6,10,3,13,3891,4776,-885
2,6,11,3,13,3966,4764,-798
2,7,0,3,13,3421,5872,-2451
2,7,1,3,13,3331,5921,-2590
2,7,2,3,13,3258,6041,-2783
2,7,3,3,13,3265,6264,-2999
2,7,4,3,13,3387,6577,-3190
2,7,5,3,13,3524,6562,-3038
2,7,6,3,13,3584,6564,-2980
2,7,7,3,13,3540,6558,-3018
2,7,8,3,13,3469,6493,-3024
2,7,9,3,13,3455,6351,-2896
2,7,10,3,13,3487,6405,-2918
2,7,11,3,13,3590,6336,-2746
2,8,0,3,13,3733,6435,-2702
2,8,1,3,13,3703,6406,-2703
2,8,2,3,13,3738,6378,-2640
2,8,3,3,13,3808,6579,-2771
2,8,4,3,13,3949,6949,-3000
2,8,5,3,13,4043,6963,-2920
2,8,6,3,13,4075,6936,-2861
2,8,7,3,13,4033,6976,-2943
2,8,8,3,13,3953,6897,-2944
2,8,9,3,13,3890,6754,-2864
2,8,10,3,13,3879,6934,-3055
2,8,11,3,13,3928,6919,-2991
2,9,0,3,13,4469,6172,-1703
2,9,1,3,13,4480,6042,-1562
2,9,2,3,13,4602,5865,-1263
2,9,3,3,13,4754,6007,-1253
2,9,4,3,13,4958,6377,-1419
2,9,5,3,13,4967,6412,-1445
2,9,6,3,13,4973,6352,-1379
2,9,7,3,13,4961,6474,-1513
2,9,8,3,13,4886,6334,-1448
2,9,9,3,13,4775,6197,-1422
2,9,10,3,13,4776,6483,-1707
2,9,11,3,13,4764,6555,-1791
2,10,0,3,13,5872,6103,-231
2,10,1,3,13,5921,5959,-38
2,10,2,3,13,6041,5743,298
2,10,3,3,13,6264,5883,381
2,10,4,3,13,6577,6264,313
2,10,5,3,13,6562,6262,300
2,10,6,3,13,6564,6200,364
2,10,7,3,13,6558,6372,186
2,10,8,3,13,6493,6150,343
2,10,9,3,13,6351,6008,343
2,10,10,3,13,6405,6309,96
2,10,11,3,13,6336,6387,-51
2,11,0,3,13,6435,6010,425
2,11,1,3,13,6406,5920,486
2,11,2,3,13,6378,5756,622
2,11,3,3,13,6579,5948,631
2,11,4,3,13,6949,6338,611
2,11,5,3,13,6963,6257,706
2,11,6,3,13,6936,6170,766
2,11,7,3,13,6976,6386,590
2,11,8,3,13,6897,6128,769
2,11,9,3,13,6754,5976,778
2,11,10,3,13,6934,6190,744
2,11,11,3,13,6919,6263,656
2,12,0,3,13,6172,5643,529
2,12,1,3,13,6042,5568,474
2,12,2,3,13,5865,5455,410
2,12,3,3,13,6007,5684,323
2,12,4,3,13,6377,6051,326
2,12,5,3,13,6412,5920,492
2,12,6,3,13,6352,5741,611
2,12,7,3,13,6474,5935,539
2,12,8,3,13,6334,5698,636
2,12,9,3,13,6197,5557,640
2,12,10,3,13,6483,5692,791
2,12,11,3,13,6555,5783,772
2,13,0,3,13,6103,5145,958
2,13,1,3,13,5959,5077,882
2,13,2,3,13,5743,5058,685
2,13,3,3,13,5883,5240,643
2,13,4,3,13,6264,5354,910
2,13,5,3,13,6262,5179,1083
2,13,6,3,13,6200,4897,1303
2,13,7,3,13,6372,5088,1284
2,13,8,3,13,6150,5011,1139
2,13,9,3,13,6008,4962,1046
2,13,10,3,13,6309,5002,1307
2,13,11,3,13,6387,5116,1271
2,14,0,3,13,6010,4955,1055
2,14,1,3,13,5920,4850,1070
2,14,2,3,13,5756,4867,889
2,14,3,3,13,5948,4911,1037
2,14,4,3,13,6338,4844,1494
2,14,5,3,13,6257,4796,1461
2,14,6,3,13,6170,4563,1607
2,14,7,3,13,6386,4658,1728
2,14,8,3,13,6128,4751,1377
2,14,9,3,13,5976,4665,1311
2,14,10,3,13,6190,4646,1544
2,14,11,3,13,6263,4780,1483
2,15,0,3,13,5643,5052,591
2,15,1,3,13,5568,4928,640
2,15,2,3,13,5455,4967,488
2,15,3,3,13,5684,4941,743
2,15,4,3,13,6051,4686,1365
2,15,5,3,13,5920,4707,1213
2,15,6,3,13,5741,4595,1146
2,15,7,3,13,5935,4646,1289
2,15,8,3,13,5698,4780,918
2,15,9,3,13,5557,4525,1032
2,15,10,3,13,5692,4407,1285
2,15,11,3,13,5783,4554,1229
2,16,0,3,13,5145,4692,453
2,16,1,3,13,5077,4448,629
2,16,2,3,13,5058,4428,630
2,16,3,3,13,5240,4362,878
2,16,4,3,13,5354,4032,1322
2,16,5,3,13,5179,4141,1038
2,16,6,3,13,4897,4158,739
2,16,7,3,13,5088,4179,909
2,16,8,3,13,5011,4258,753
2,16,9,3,13,4962,3895,1067
2,16,10,3,13,5002,3824,1178
2,16,11,3,13,5116,4072,1044
2,17,0,3,13,4955,3967,988
2,17,1,3,13,4850,3742,1108
2,17,2,3,13,4867,3661,1206
2,17,3,3,13,4911,3656,1255
2,17,4,3,13,4844,3364,1480
2,17,5,3,13,4796,3425,1371
2,17,6,3,13,4563,3436,1127
2,17,7,3,13,4658,3479,1179
2,17,8,3,13,4751,3433,1318
2,17,9,3,13,4665,3081,1584
2,17,10,3,13,4646,3064,1582
2,17,11,3,13,4780,3255,1525
2,18,0,3,13,5052,3246,1806
2,18,1,3,13,4928,3044,1884
2,18,2,3,13,4967,2978,1989
2,18,3,3,13,4941,3006,1935
2,18,4,3,13,4686,2844,1842
2,18,5,3,13,4707,2880,1827
2,18,6,3,13,4595,2863,1732
2,18,7,3,13,4646,2924,1722
2,18,8,3,13,4780,2868,1912
2,18,9,3,13,4525,2622,1903
2,18,10,3,13,4407,2658,1749
2,18,11,3,13,4554,2783,1771
2,0,0,4,13,5403,4516,887
2,0,1,4,13,5347,4315,1032
2,0,2,4,13,5281,4102,1179
2,0,3,4,13,5246,3947,1299
2,0,4,4,13,5250,3865,1385
2,0,5,4,13,5222,3770,1452
2,0,6,4,13,5220,3739,1481
2,0,7,4,13,5232,3821,1411
2,0,8,4,13,5195,3943,1252
2,0,9,4,13,5224,4076,1148
2,0,10,4,13,5282,4249,1033
2,0,11,4,13,5322,4426,896
2,1,0,4,13,5167,4950,217
2,1,1,4,13,5049,4838,211
2,1,2,4,13,4914,4694,220
2,1,3,4,13,4804,4622,182
2,1,4,4,13,4752,4652,100
2,1,5,4,13,4682,4676,6
2,1,6,4,13,4667,4694,-27
2,1,7,4,13,4704,4705,-1
2,1,8,4,13,4714,4766,-52
2,1,9,4,13,4800,4844,-44
2,1,10,4,13,4914,4938,-24
2,1,11,4,13,5016,5054,-38
2,2,0,4,13,4935,4502,433
2,2,1,4,13,4770,4361,409
2,2,2,4,13,4584,4232,352
2,2,3,4,13,4420,4198,222
2,2,4,4,13,4295,4308,-13
2,2,5,4,13,4163,4424,-261
2,2,6,4,13,4124,4473,-349
2,2,7,4,13,4199,4449,-250
2,2,8,4,13,4292,4417,-125
2,2,9,4,13,4425,4441,-16
2,2,10,4,13,4581,4520,61
2,2,11,4,13,4726,4669,57
2,3,0,4,13,4582,4897,-315
2,3,1,4,13,4364,4835,-471
2,3,2,4,13,4127,4842,-715
2,3,3,4,13,3923,4918,-995
2,3,4,4,13,3776,5109,-1333
2,3,5,4,13,3624,5247,-1623
2,3,6,4,13,3573,5301,-1728
2,3,7,4,13,3669,5254,-1585
2,3,8,4,13,3816,5141,-1325
2,3,9,4,13,3992,5067,-1075
2,3,10,4,13,4193,5070,-877
2,3,11,4,13,4387,5147,-760
2,4,0,4,13,4516,6023,-1507
2,4,1,4,13,4315,6054,-1739
2,4,2,4,13,4102,6173,-2071
2,4,3,4,13,3947,6342,-2395
2,4,4,4,13,3865,6602,-2737
2,4,5,4,13,3770,6679,-2909
2,4,6,4,13,3739,6720,-2981
2,4,7,4,13,3821,6666,-2845
2,4,8,4,13,3943,6569,-2626
2,4,9,4,13,4076,6459,-2383
2,4,10,4,13,4249,6443,-2194
2,4,11,4,13,4426,6432,-2006
2,5,0,4,13,4950,6575,-1625
2,5,1,4,13,4838,6546,-1708
2,5,2,4,13,4694,6624,-1930
2,5,3,4,13,4622,6831,-2209
2,5,4,4,13,4652,7160,-2508
2,5,5,4,13,4676,7170,-2494
2,5,6,4,13,4694,7175,-2481
2,5,7,4,13,4705,7172,-2467
2,5,8,4,13,4766,7091,-2325
2,5,9,4,13,4844,6945,-2101
2,5,10,4,13,4938,7034,-2096
2,5,11,4,13,5054,7039,-1985
2,6,0,4,13,4502,7911,-3409
2,6,1,4,13,4361,7910,-3549
2,6,2,4,13,4232,7962,-3730
2,6,3,4,13,4198,8232,-4034
2,6,4,4,13,4308,8671,-4363
2,6,5,4,13,4424,8686,-4262
2,6,6,4,13,4473,8653,-4180
2,6,7,4,13,4449,8690,-4241
2,6,8,4,13,4417,8569,-4152
2,6,9,4,13,4441,8366,-3925
2,6,10,4,13,4520,8517,-3997
2,6,11,4,13,4669,8476,-3807
2,7,0,4,13,4897,8462,-3565
2,7,1,4,13,4835,8393,-3558
2,7,2,4,13,4842,8300,-3458
2,7,3,4,13,4918,8541,-3623
2,7,4,4,13,5109,9030,-3921
2,7,5,4,13,5247,9048,-3801
2,7,6,4,13,5301,8997,-3696
2,7,7,4,13,5254,9107,-3853
2,7,8,4,13,5141,8950,-3809
2,7,9,4,13,5067,8766,-3699
2,7,10,4,13,5070,9047,-3977
2,7,11,4,13,5147,9059,-3912
2,8,0,4,13,6023,8209,-2186
2,8,1,4,13,6054,8025,-1971
2,8,2,4,13,6173,7765,-1592
2,8,3,4,13,6342,7960,-1618
2,8,4,4,13,6602,8466,-1864
2,8,5,4,13,6679,8465,-1786
2,8,6,4,13,6720,8402,-1682
2,8,7,4,13,6666,8583,-1917
2,8,8,4,13,6569,8355,-1786
2,8,9,4,13,6459,8178,-1719
2,8,10,4,13,6443,8567,-2124
2,8,11,4,13,6432,8662,-2230
2,9,0,4,13,6575,8049,-1474
2,9,1,4,13,6546,7909,-1363
2,9,2,4,13,6624,7677,-1053
2,9,3,4,13,6831,7916,-1085
2,9,4,4,13,7160,8432,-1272
2,9,5,4,13,7170,8381,-1211
2,9,6,4,13,7175,8259,-1084
2,9,7,4,13,7172,8518,-1346
2,9,8,4,13,7091,8204,-1113
2,9,9,4,13,6945,7991,-1046
2,9,10,4,13,7034,8302,-1268
2,9,11,4,13,7039,8403,-1364
2,10,0,4,13,7911,7670,241
2,10,1,4,13,7910,7555,355
2,10,2,4,13,7962,7377,585
2,10,3,4,13,8232,7646,586
2,10,4,4,13,8671,8132,539
2,10,5,4,13,8686,8005,681
2,10,6,4,13,8653,7802,851
2,10,7,4,13,8690,8066,624
2,10,8,4,13,8569,7751,818
2,10,9,4,13,8366,7569,797
2,10,10,4,13,8517,7805,712
2,10,11,4,13,8476,7923,553
2,11,0,4,13,8462,7182,1280
2,11,1,4,13,8393,7060,1333
2,11,2,4,13,8300,6958,1342
2,11,3,4,13,8541,7193,1348
2,11,4,4,13,9030,7443,1587
2,11,5,4,13,9048,7232,1816
2,11,6,4,13,8997,6947,2050
2,11,7,4,13,9107,7197,1910
2,11,8,4,13,8950,7032,1918
2,11,9,4,13,8766,6943,1823
2,11,10,4,13,9047,7086,1961
2,11,11,4,13,9059,7223,1836
2,12,0,4,13,8209,6901,1308
2,12,1,4,13,8025,6800,1225
2,12,2,4,13,7765,6801,964
2,12,3,4,13,7960,6944,1016
2,12,4,4,13,8466,7012,1454
2,12,5,4,13,8465,6915,1550
2,12,6,4,13,8402,6622,1780
2,12,7,4,13,8583,6804,1779
2,12,8,4,13,8355,6805,1550
2,12,9,4,13,8178,6648,1530
2,12,10,4,13,8567,6639,1928
2,12,11,4,13,8662,6796,1866
2,13,0,4,13,8049,6712,1337
2,13,1,4,13,7909,6563,1346
2,13,2,4,13,7677,6588,1089
2,13,3,4,13,7916,6639,1277
2,13,4,4,13,8432,6480,1952
2,13,5,4,13,8381,6455,1926
2,13,6,4,13,8259,6227,2032
2,13,7,4,13,8518,6326,2192
2,13,8,4,13,8204,6403,1801
2,13,9,4,13,7991,6118,1873
2,13,10,4,13,8302,6022,2280
2,13,11,4,13,8403,6214,2189
2,14,0,4,13,7670,6231,1439
2,14,1,4,13,7555,5940,1615
2,14,2,4,13,7377,5931,1446
2,14,3,4,13,7646,5871,1775
2,14,4,4,13,8132,5424,2708
2,14,5,4,13,8005,5453,2552
2,14,6,4,13,7802,5364,2438
2,14,7,4,13,8066,5441,2625
2,14,8,4,13,7751,5592,2159
2,14,9,4,13,7569,5281,2288
2,14,10,4,13,7805,5218,2587
2,14,11,4,13,7923,5512,2411
2,15,0,4,13,7182,5723,1459
2,15,1,4,13,7060,5465,1595
2,15,2,4,13,6958,5404,1554
2,15,3,4,13,7193,5360,1833
2,15,4,4,13,7443,5022,2421
2,15,5,4,13,7232,5161,2071
2,15,6,4,13,6947,5161,1786
2,15,7,4,13,7197,5195,2002
2,15,8,4,13,7032,5227,1805
2,15,9,4,13,6943,4767,2176
2,15,10,4,13,7086,4701,2385
2,15,11,4,13,7223,4935,2288
2,16,0,4,13,6901,5003,1898
2,16,1,4,13,6800,4757,2043
2,16,2,4,13,6801,4699,2102
2,16,3,4,13,6944,4734,2210
2,16,4,4,13,7012,4480,2532
2,16,5,4,13,6915,4539,2376
2,16,6,4,13,6622,4527,2095
2,16,7,4,13,6804,4592,2212
2,16,8,4,13,6805,4520,2285
2,16,9,4,13,6648,4075,2573
2,16,10,4,13,6639,4034,2605
2,16,11,4,13,6796,4217,2579
2,0,0,5,13,6523,5653,870
2,0,1,5,13,6398,5463,935
2,0,2,5,13,6260,5277,983
2,0,3,5,13,6159,5189,970
2,0,4,5,13,6107,5235,872
2,0,5,5,13,6028,5284,744
2,0,6,5,13,6012,5305,707
2,0,7,5,13,6053,5319,734
2,0,8,5,13,6055,5364,691
2,0,9,5,13,6140,5438,702
2,0,10,5,13,6260,5567,693
2,0,11,5,13,6362,5757,605
2,1,0,5,13,6318,5978,340
2,1,1,5,13,6151,5865,286
2,1,2,5,13,5959,5816,143
2,1,3,5,13,5795,5851,-56
2,1,4,5,13,5679,6030,-351
2,1,5,5,13,5542,6147,-605
2,1,6,5,13,5499,6190,-691
2,1,7,5,13,5574,6163,-589
2,1,8,5,13,5661,6089,-428
2,1,9,5,13,5797,6053,-256
2,1,10,5,13,5961,6103,-142
2,1,11,5,13,6104,6226,-122
2,2,0,5,13,6016,7187,-1171
2,2,1,5,13,5800,7186,-1386
2,2,2,5,13,5558,7277,-1719
2,2,3,5,13,5353,7452,-2099
2,2,4,5,13,5216,7762,-2546
2,2,5,5,13,5063,7883,-2820
2,2,6,5,13,5013,7946,-2933
2,2,7,5,13,5108,7887,-2779
2,2,8,5,13,5240,7757,-2517
2,2,9,5,13,5411,7636,-2225
2,2,10,5,13,5614,7634,-2020
2,2,11,5,13,5805,7651,-1846
2,3,0,5,13,5746,8129,-2383
2,3,1,5,13,5496,8120,-2624
2,3,2,5,13,5231,8195,-2964
2,3,3,5,13,5033,8419,-3386
2,3,4,5,13,4936,8804,-3868
2,3,5,5,13,4828,8882,-4054
2,3,6,5,13,4799,8922,-4123
2,3,7,5,13,4890,8877,-3987
2,3,8,5,13,5004,8774,-3770
2,3,9,5,13,5169,8629,-3460
2,3,10,5,13,5384,8701,-3317
2,3,11,5,13,5606,8707,-3101
2,4,0,5,13,6070,8614,-2544
2,4,1,5,13,5889,8535,-2646
2,4,2,5,13,5673,8545,-2872
2,4,3,5,13,5535,8799,-3264
2,4,4,5,13,5509,9254,-3745
2,4,5,5,13,5482,9294,-3812
2,4,6,5,13,5486,9264,-3778
2,4,7,5,13,5526,9304,-3778
2,4,8,5,13,5626,9167,-3541
2,4,9,5,13,5760,8960,-3200
2,4,10,5,13,5916,9146,-3230
2,4,11,5,13,6094,9179,-3085
2,5,0,5,13,5653,9938,-4285
2,5,1,5,13,5463,9897,-4434
2,5,2,5,13,5277,9884,-4607
2,5,3,5,13,5189,10194,-5005
2,5,4,5,13,5235,10752,-5517
2,5,5,5,13,5284,10771,-5487
2,5,6,5,13,5305,10714,-5409
2,5,7,5,13,5319,10821,-5502
2,5,8,5,13,5364,10622,-5258
2,5,9,5,13,5438,10378,-4940
2,5,10,5,13,5567,10630,-5063
2,5,11,5,13,5757,10616,-4859
2,6,0,5,13,5978,10499,-4521
2,6,1,5,13,5865,10376,-4511
2,6,2,5,13,5816,10200,-4384
2,6,3,5,13,5851,10494,-4643
2,6,4,5,13,6030,11119,-5089
2,6,5,5,13,6147,11101,-4954
2,6,6,5,13,6190,11047,-4857
2,6,7,5,13,6163,11216,-5053
2,6,8,5,13,6089,10971,-4882
2,6,9,5,13,6053,10747,-4694
2,6,10,5,13,6103,11131,-5028
2,6,11,5,13,6226,11166,-4940
2,7,0,5,13,7187,10155,-2968
2,7,1,5,13,7186,9975,-2789
2,7,2,5,13,7277,9699,-2422
2,7,3,5,13,7452,9993,-2541
2,7,4,5,13,7762,10634,-2872
2,7,5,5,13,7883,10584,-2701
2,7,6,5,13,7946,10461,-2515
2,7,7,5,13,7887,10729,-2842
2,7,8,5,13,7757,10409,-2652
2,7,9,5,13,7636,10161,-2525
2,7,10,5,13,7634,10560,-2926
2,7,11,5,13,7651,10678,-3027
2,8,0,5,13,8129,9709,-1580
2,8,1,5,13,8120,9544,-1424
2,8,2,5,13,8195,9298,-1103
2,8,3,5,13,8419,9614,-1195
2,8,4,5,13,8804,10226,-1422
2,8,5,5,13,8882,10129,-1247
2,8,6,5,13,8922,9891,-969
2,8,7,5,13,8877,10198,-1321
2,8,8,5,13,8774,9827,-1053
2,8,9,5,13,8629,9584,-955
2,8,10,5,13,8701,9917,-1216
2,8,11,5,13,8707,10063,-1356
2,9,0,5,13,8614,9209,-595
2,9,1,5,13,8535,9047,-512
2,9,2,5,13,8545,8880,-335
2,9,3,5,13,8799,9155,-356
2,9,4,5,13,9254,9524,-270
2,9,5,5,13,9294,9317,-23
2,9,6,5,13,9264,9008,256
2,9,7,5,13,9304,9328,-24
2,9,8,5,13,9167,9085,82
2,9,9,5,13,8960,8955,5
2,9,10,5,13,9146,9199,-53
2,9,11,5,13,9179,9363,-184
2,10,0,5,13,9938,8938,1000
2,10,1,5,13,9897,8783,1114
2,10,2,5,13,9884,8701,1183
2,10,3,5,13,10194,8897,1297
2,10,4,5,13,10752,9101,1651
2,10,5,5,13,10771,8968,1803
2,10,6,5,13,10714,8672,2042
2,10,7,5,13,10821,8913,1908
2,10,8,5,13,10622,8826,1796
2,10,9,5,13,10378,8629,1749
2,10,10,5,13,10630,8723,1907
2,10,11,5,13,10616,8903,1713
2,11,0,5,13,10499,8658,1841
2,11,1,5,13,10376,8513,1863
2,11,2,5,13,10200,8522,1678
2,11,3,5,13,10494,8672,1822
2,11,4,5,13,11119,8648,2471
2,11,5,5,13,11101,8574,2527
2,11,6,5,13,11047,8286,2761
2,11,7,5,13,11216,8472,2744
2,11,8,5,13,10971,8457,2514
2,11,9,5,13,10747,8101,2646
2,11,10,5,13,11131,8015,3116
2,11,11,5,13,11166,8230,2936
2,12,0,5,13,10155,7891,2264
2,12,1,5,13,9975,7575,2400
2,12,2,5,13,9699,7552,2147
2,12,3,5,13,9993,7569,2424
2,12,4,5,13,10634,7218,3416
2,12,5,5,13,10584,7201,3383
2,12,6,5,13,10461,6996,3465
2,12,7,5,13,10729,7121,3608
2,12,8,5,13,10409,7215,3194
2,12,9,5,13,10161,6874,3287
2,12,10,5,13,10560,6833,3727
2,12,11,5,13,10678,7172,3506
2,13,0,5,13,9709,7262,2447
2,13,1,5,13,9544,6957,2587
2,13,2,5,13,9298,6907,2391
2,13,3,5,13,9614,6869,2745
2,13,4,5,13,10226,6414,3812
2,13,5,5,13,10129,6473,3656
2,13,6,5,13,9891,6367,3524
2,13,7,5,13,10198,6457,3741
2,13,8,5,13,9827,6561,3266
2,13,9,5,13,9584,6153,3431
2,13,10,5,13,9917,6095,3822
2,13,11,5,13,10063,6375,3688
2,14,0,5,13,9209,6759,2450
2,14,1,5,13,9047,6480,2567
2,14,2,5,13,8880,6442,2438
2,14,3,5,13,9155,6438,2717
2,14,4,5,13,9524,6138,3386
2,14,5,5,13,9317,6275,3042
2,14,6,5,13,9008,6252,2756
2,14,7,5,13,9328,6308,3020
2,14,8,5,13,9085,6314,2771
2,14,9,5,13,8955,5761,3194
2,14,10,5,13,9199,5671,3528
2,14,11,5,13,9363,5897,3466
2,0,0,6,13,7674,8268,-594
2,0,1,6,13,7500,8216,-716
2,0,2,6,13,7305,8251,-946
2,0,3,6,13,7150,8385,-1235
2,0,4,6,13,7034,8683,-1649
2,0,5,6,13,6888,8783,-1895
2,0,6,6,13,6844,8835,-1991
2,0,7,6,13,6923,8796,-1873
2,0,8,6,13,7002,8705,-1703
2,0,9,6,13,7137,8622,-1485
2,0,10,6,13,7307,8667,-1360
2,0,11,6,13,7450,8730,-1280
2,1,0,6,13,7399,9293,-1894
2,1,1,6,13,7181,9252,-2071
2,1,2,6,13,6933,9299,-2366
2,1,3,6,13,6728,9529,-2801
2,1,4,6,13,6600,9964,-3364
2,1,5,6,13,6442,10086,-3644
2,1,6,6,13,6388,10148,-3760
2,1,7,6,13,6483,10098,-3615
2,1,8,6,13,6609,9962,-3353
2,1,9,6,13,6783,9806,-3023
2,1,10,6,13,6994,9892,-2898
2,1,11,6,13,7183,9926,-2743
2,2,0,6,13,7180,10168,-2988
2,2,1,6,13,6932,10109,-3177
2,2,2,6,13,6662,10116,-3454
2,2,3,6,13,6463,10387,-3924
2,2,4,6,13,6376,10898,-4522
2,2,5,6,13,6267,11006,-4739
2,2,6,6,13,6239,11011,-4772
2,2,7,6,13,6329,11009,-4680
2,2,8,6,13,6428,10850,-4422
2,2,9,6,13,6588,10644,-4056
2,2,10,6,13,6805,10813,-4008
2,2,11,6,13,7024,10847,-3823
2,3,0,6,13,7300,10641,-3341
2,3,1,6,13,7070,10522,-3452
2,3,2,6,13,6802,10467,-3665
2,3,3,6,13,6621,10761,-4140
2,3,4,6,13,6580,11335,-4755
2,3,5,6,13,6540,11379,-4839
2,3,6,6,13,6546,11325,-4779
2,3,7,6,13,6595,11435,-4840
2,3,8,6,13,6687,11220,-4533
2,3,9,6,13,6853,10972,-4119
2,3,10,6,13,7051,11259,-4208
2,3,11,6,13,7274,11319,-4045
2,4,0,6,13,6773,11975,-5202
2,4,1,6,13,6514,11880,-5366
2,4,2,6,13,6256,11784,-5528
2,4,3,6,13,6102,12147,-6045
2,4,4,6,13,6092,12841,-6749
2,4,5,6,13,6090,12824,-6734
2,4,6,6,13,6097,12764,-6667
2,4,7,6,13,6140,12930,-6790
2,4,8,6,13,6224,12643,-6419
2,4,9,6,13,6354,12359,-6005
2,4,10,6,13,6545,12714,-6169
2,4,11,6,13,6797,12723,-5926
2,5,0,6,13,7129,12445,-5316
2,5,1,6,13,6967,12326,-5359
2,5,2,6,13,6861,12134,-5273
2,5,3,6,13,6842,12527,-5685
2,5,4,6,13,6957,13287,-6330
2,5,5,6,13,7007,13220,-6213
2,5,6,6,13,7022,13106,-6084
2,5,7,6,13,7033,13362,-6329
2,5,8,6,13,7036,13025,-5989
2,5,9,6,13,7050,12730,-5680
2,5,10,6,13,7150,13124,-5974
2,5,11,6,13,7314,13182,-5868
2,6,0,6,13,8268,11815,-3547
2,6,1,6,13,8216,11610,-3394
2,6,2,6,13,8251,11320,-3069
2,6,3,6,13,8385,11691,-3306
2,6,4,6,13,8683,12428,-3745
2,6,5,6,13,8783,12332,-3549
2,6,6,6,13,8835,12093,-3258
2,6,7,6,13,8796,12409,-3613
2,6,8,6,13,8705,12032,-3327
2,6,9,6,13,8622,11754,-3132
2,6,10,6,13,8667,12175,-3508
2,6,11,6,13,8730,12338,-3608
2,7,0,6,13,9293,11248,-1955
2,7,1,6,13,9252,11036,-1784
2,7,2,6,13,9299,10801,-1502
2,7,3,6,13,9529,11123,-1594
2,7,4,6,13,9964,11618,-1654
2,7,5,6,13,10086,11441,-1355
2,7,6,6,13,10148,11097,-949
2,7,7,6,13,10098,11460,-1362
2,7,8,6,13,9962,11161,-1199
2,7,9,6,13,9806,10970,-1164
2,7,10,6,13,9892,11311,-1419
2,7,11,6,13,9926,11503,-1577
2,8,0,6,13,10168,10965,-797
2,8,1,6,13,10109,10770,-661
2,8,2,6,13,10116,10623,-507
2,8,3,6,13,10387,10859,-472
2,8,4,6,13,10898,11182,-284
2,8,5,6,13,11006,11053,-47
2,8,6,6,13,11011,10733,278
2,8,7,6,13,11009,11044,-35
2,8,8,6,13,10850,10879,-29
2,8,9,6,13,10644,10641,3
2,8,10,6,13,10813,10836,-23
2,8,11,6,13,10847,11043,-196
2,9,0,6,13,10641,10695,-54
2,9,1,6,13,10522,10496,26
2,9,2,6,13,10467,10422,45
2,9,3,6,13,10761,10625,136
2,9,4,6,13,11335,10737,598
2,9,5,6,13,11379,10627,752
2,9,6,6,13,11325,10336,989
2,9,7,6,13,11435,10581,854
2,9,8,6,13,11220,10478,742
2,9,9,6,13,10972,10082,890
2,9,10,6,13,11259,10099,1160
2,9,11,6,13,11319,10337,982
2,10,0,6,13,11975,9837,2138
2,10,1,6,13,11880,9525,2355
2,10,2,6,13,11784,9486,2298
2,10,3,6,13,12147,9602,2545
2,10,4,6,13,12841,9386,3455
2,10,5,6,13,12824,9320,3504
2,10,6,6,13,12764,9055,3709
2,10,7,6,13,12930,9267,3663
2,10,8,6,13,12643,9269,3374
2,10,9,6,13,12359,8857,3502
2,10,10,6,13,12714,8826,3888
2,10,11,6,13,12723,9188,3535
2,11,0,6,13,12445,8922,3523
2,11,1,6,13,12326,8592,3734
2,11,2,6,13,12134,8528,3606
2,11,3,6,13,12527,8567,3960
2,11,4,6,13,13287,8208,5079
2,11,5,6,13,13220,8221,4999
2,11,6,6,13,13106,7999,5107
2,11,7,6,13,13362,8137,5225
2,11,8,6,13,13025,8184,4841
2,11,9,6,13,12730,7746,4984
2,11,10,6,13,13124,7710,5414
2,11,11,6,13,13182,8035,5147
2,12,0,6,13,11815,8298,3517
2,12,1,6,13,11610,7972,3638
2,12,2,6,13,11320,7945,3375
2,12,3,6,13,11691,7947,3744
2,12,4,6,13,12428,7530,4898
2,12,5,6,13,12332,7587,4745
2,12,6,6,13,12093,7458,4635
2,12,7,6,13,12409,7570,4839
2,12,8,6,13,12032,7648,4384
2,12,9,6,13,11754,7147,4607
2,12,10,6,13,12175,7065,5110
2,12,11,6,13,12338,7337,5001
2,0,0,7,13,8755,11332,-2577
2,0,1,7,13,8530,11241,-2711
2,0,2,7,13,8279,11220,-2941
2,0,3,7,13,8083,11497,-3414
2,0,4,7,13,7955,12058,-4103
2,0,5,7,13,7788,12210,-4422
2,0,6,7,13,7733,12237,-4504
2,0,7,7,13,7832,12230,-4398
2,0,8,7,13,7950,12038,-4088
2,0,9,7,13,8123,11821,-3698
2,0,10,7,13,8340,12004,-3664
2,0,11,7,13,8529,12066,-3537
2,1,0,7,13,8563,12195,-3632
2,1,1,7,13,8313,12096,-3783
2,1,2,7,13,8037,12038,-4001
2,1,3,7,13,7838,12349,-4511
2,1,4,7,13,7760,12979,-5219
2,1,5,7,13,7646,13091,-5445
2,1,6,7,13,7614,13072,-5458
2,1,7,7,13,7704,13140,-5436
2,1,8,7,13,7797,12903,-5106
2,1,9,7,13,7960,12656,-4696
2,1,10,7,13,8185,12926,-4741
2,1,11,7,13,8402,12987,-4585
2,2,0,7,13,8734,12678,-3944
2,2,1,7,13,8506,12505,-3999
2,2,2,7,13,8233,12367,-4134
2,2,3,7,13,8051,12714,-4663
2,2,4,7,13,8020,13424,-5404
2,2,5,7,13,7979,13432,-5453
2,2,6,7,13,7986,13375,-5389
2,2,7,7,13,8034,13544,-5510
2,2,8,7,13,8111,13241,-5130
2,2,9,7,13,8272,12953,-4681
2,2,10,7,13,8472,13343,-4871
2,2,11,7,13,8692,13426,-4734
2,3,0,7,13,8003,13921,-5918
2,3,1,7,13,7695,13830,-6135
2,3,2,7,13,7385,13718,-6333
2,3,3,7,13,7188,14180,-6992
2,3,4,7,13,7163,15009,-7846
2,3,5,7,13,7148,14943,-7795
2,3,6,7,13,7157,14823,-7666
2,3,7,7,13,7209,15076,-7867
2,3,8,7,13,7285,14697,-7412
2,3,9,7,13,7447,14342,-6895
2,3,10,7,13,7680,14707,-7027
2,3,11,7,13,7977,14739,-6762
2,4,0,7,13,8249,14105,-5856
2,4,1,7,13,8018,13961,-5943
2,4,2,7,13,7840,13755,-5915
2,4,3,7,13,7755,14225,-6470
2,4,4,7,13,7814,15081,-7267
2,4,5,7,13,7813,14968,-7155
2,4,6,7,13,7814,14738,-6924
2,4,7,7,13,7854,15042,-7188
2,4,8,7,13,7896,14648,-6752
2,4,9,7,13,7966,14323,-6357
2,4,10,7,13,8128,14739,-6611
2,4,11,7,13,8354,14842,-6488
2,5,0,7,13,9419,13354,-3935
2,5,1,7,13,9318,13102,-3784
2,5,2,7,13,9296,12823,-3527
2,5,3,7,13,9376,13200,-3824
2,5,4,7,13,9610,13820,-4210
2,5,5,7,13,9643,13644,-4001
2,5,6,7,13,9667,13299,-3632
2,5,7,7,13,9666,13671,-4005
2,5,8,7,13,9652,13366,-3714
2,5,9,7,13,9619,13140,-3521
2,5,10,7,13,9714,13569,-3855
2,5,11,7,13,9818,13778,-3960
2,6,0,7,13,10374,13004,-2630
2,6,1,7,13,10282,12759,-2477
2,6,2,7,13,10273,12544,-2271
2,6,3,7,13,10462,12827,-2365
2,6,4,7,13,10885,13276,-2391
2,6,5,7,13,10986,13177,-2191
2,6,6,7,13,11037,12822,-1785
2,6,7,7,13,11007,13176,-2169
2,6,8,7,13,10910,12955,-2045
2,6,9,7,13,10792,12656,-1864
2,6,10,7,13,10925,12948,-2023
2,6,11,7,13,11005,13183,-2178
2,7,0,7,13,11332,12722,-1390
2,7,1,7,13,11241,12483,-1242
2,7,2,7,13,11220,12344,-1124
2,7,3,7,13,11497,12587,-1090
2,7,4,7,13,12058,12818,-760
2,7,5,7,13,12210,12712,-502
2,7,6,7,13,12237,12397,-160
2,7,7,7,13,12230,12712,-482
2,7,8,7,13,12038,12531,-493
2,7,9,7,13,11821,12094,-273
2,7,10,7,13,12004,12212,-208
2,7,11,7,13,12066,12477,-411
2,8,0,7,13,12195,11874,321
2,8,1,7,13,12096,11508,588
2,8,2,7,13,12038,11386,652
2,8,3,7,13,12349,11555,794
2,8,4,7,13,12979,11475,1504
2,8,5,7,13,13091,11373,1718
2,8,6,7,13,13072,11105,1967
2,8,7,7,13,13140,11376,1764
2,8,8,7,13,12903,11290,1613
2,8,9,7,13,12656,10838,1818
2,8,10,7,13,12926,10910,2016
2,8,11,7,13,12987,11295,1692
2,9,0,7,13,12678,10868,1810
2,9,1,7,13,12505,10542,1963
2,9,2,7,13,12367,10462,1905
2,9,3,7,13,12714,10600,2114
2,9,4,7,13,13424,10376,3048
2,9,5,7,13,13432,10340,3092
2,9,6,7,13,13375,10058,3317
2,9,7,7,13,13544,10283,3261
2,9,8,7,13,13241,10238,3003
2,9,9,7,13,12953,9729,3224
2,9,10,7,13,13343,9703,3640
2,9,11,7,13,13426,10051,3375
2,10,0,7,13,13921,9958,3963
2,10,1,7,13,13830,9607,4223
2,10,2,7,13,13718,9566,4152
2,10,3,7,13,14180,9645,4535
2,10,4,7,13,15009,9324,5685
2,10,5,7,13,14943,9335,5608
2,10,6,7,13,14823,9090,5733
2,10,7,7,13,15076,9250,5826
2,10,8,7,13,14697,9271,5426
2,10,9,7,13,14342,8740,5602
2,10,10,7,13,14707,8680,6027
2,10,11,7,13,14739,8997,5742
2,0,0,8,13,9919,14232,-4313
2,0,1,8,13,9662,14079,-4417
2,0,2,8,13,9383,13938,-4555
2,0,3,8,13,9193,14302,-5109
2,0,4,8,13,9115,15068,-5953
2,0,5,8,13,8992,15144,-6152
2,0,6,8,13,8959,15122,-6163
2,0,7,8,13,9053,15249,-6196
2,0,8,8,13,9138,14924,-5786
2,0,9,8,13,9300,14637,-5337
2,0,10,8,13,9531,15010,-5479
2,0,11,8,13,9748,15094,-5346
2,1,0,8,13,10117,14624,-4507
2,1,1,8,13,9887,14455,-4568
2,1,2,8,13,9608,14301,-4693
2,1,3,8,13,9426,14747,-5321
2,1,4,8,13,9404,15592,-6188
2,1,5,8,13,9358,15551,-6193
2,1,6,8,13,9361,15434,-6073
2,1,7,8,13,9409,15690,-6281
2,1,8,8,13,9480,15295,-5815
2,1,9,8,13,9644,14936,-5292
2,1,10,8,13,9852,15336,-5484
2,1,11,8,13,10070,15442,-5372
2,2,0,8,13,9437,15581,-6144
2,2,1,8,13,9131,15465,-6334
2,2,2,8,13,8816,15339,-6523
2,2,3,8,13,8618,15878,-7260
2,2,4,8,13,8603,16803,-8200
2,2,5,8,13,8587,16691,-8104
2,2,6,8,13,8597,16455,-7858
2,2,7,8,13,8648,16756,-8108
2,2,8,8,13,8709,16320,-7611
2,2,9,8,13,8866,15935,-7069
2,2,10,8,13,9101,16322,-7221
2,2,11,8,13,9395,16399,-7004
2,3,0,8,13,9479,15644,-6165
2,3,1,8,13,9199,15453,-6254
2,3,2,8,13,8969,15258,-6289
2,3,3,8,13,8841,15734,-6893
2,3,4,8,13,8885,16473,-7588
2,3,5,8,13,8871,16280,-7409
2,3,6,8,13,8874,15944,-7070
2,3,7,8,13,8923,16304,-7381
2,3,8,8,13,8957,15982,-7025
2,3,9,8,13,9059,15709,-6650
2,3,10,8,13,9263,16133,-6870
2,3,11,8,13,9534,16282,-6748
2,4,0,8,13,10539,15110,-4571
2,4,1,8,13,10369,14825,-4456
2,4,2,8,13,10275,14566,-4291
2,4,3,8,13,10289,14904,-4615
2,4,4,8,13,10467,15478,-5011
2,4,5,8,13,10449,15380,-4931
2,4,6,8,13,10459,15024,-4565
2,4,7,8,13,10487,15387,-4900
2,4,8,8,13,10512,15160,-4648
2,4,9,8,13,10535,14826,-4291
2,4,10,8,13,10692,15206,-4514
2,4,11,8,13,10858,15458,-4600
2,5,0,8,13,11525,14761,-3236
2,5,1,8,13,11384,14472,-3088
2,5,2,8,13,11318,14265,-2947
2,5,3,8,13,11453,14555,-3102
2,5,4,8,13,11812,14912,-3100
2,5,5,8,13,11846,14836,-2990
2,5,6,8,13,11869,14486,-2617
2,5,7,8,13,11877,14844,-2967
2,5,8,8,13,11857,14607,-2750
2,5,9,8,13,11789,14109,-2320
2,5,10,8,13,11972,14324,-2352
2,5,11,8,13,12093,14617,-2524
2,6,0,8,13,12413,13901,-1488
2,6,1,8,13,12271,13495,-1224
2,6,2,8,13,12194,13308,-1114
2,6,3,8,13,12430,13517,-1087
2,6,4,8,13,12979,13556,-577
2,6,5,8,13,13110,13458,-348
2,6,6,8,13,13126,13166,-40
2,6,7,8,13,13139,13507,-368
2,6,8,8,13,12986,13343,-357
2,6,9,8,13,12807,12850,-43
2,6,10,8,13,13037,13023,14
2,6,11,8,13,13145,13435,-290
2,7,0,8,13,13359,12905,454
2,7,1,8,13,13228,12525,703
2,7,2,8,13,13142,12362,780
2,7,3,8,13,13459,12553,906
2,7,4,8,13,14139,12465,1674
2,7,5,8,13,14295,12393,1902
2,7,6,8,13,14298,12108,2190
2,7,7,8,13,14361,12392,1969
2,7,8,8,13,14091,12259,1832
2,7,9,8,13,13833,11710,2123
2,7,10,8,13,14117,11787,2330
2,7,11,8,13,14206,12158,2048
2,8,0,8,13,14232,11904,2328
2,8,1,8,13,14079,11557,2522
2,8,2,8,13,13938,11500,2438
2,8,3,8,13,14302,11678,2624
2,8,4,8,13,15068,11492,3576
2,8,5,8,13,15144,11454,3690
2,8,6,8,13,15122,11149,3973
2,8,7,8,13,15249,11396,3853
2,8,8,8,13,14924,11325,3599
2,8,9,8,13,14637,10723,3914
2,8,10,8,13,15010,10673,4337
2,8,11,8,13,15094,11013,4081
2,0,0,9,13,11473,16284,-4811
2,0,1,9,13,11236,16090,-4854
2,0,2,9,13,10954,15922,-4968
2,0,3,9,13,10781,16445,-5664
2,0,4,9,13,10759,17386,-6627
2,0,5,9,13,10704,17299,-6595
2,0,6,9,13,10706,17066,-6360
2,0,7,9,13,10758,17370,-6612
2,0,8,9,13,10821,16918,-6097
2,0,9,9,13,10984,16529,-5545
2,0,10,9,13,11198,16951,-5753
2,0,11,9,13,11416,17102,-5686
2,1,0,9,13,10820,17120,-6300
2,1,1,9,13,10512,16957,-6445
2,1,2,9,13,10191,16842,-6651
2,1,3,9,13,9993,17387,-7394
2,1,4,9,13,9987,18195,-8208
2,1,5,9,13,9966,18003,-8037
2,1,6,9,13,9972,17661,-7689
2,1,7,9,13,10023,18018,-7995
2,1,8,9,13,10078,17654,-7576
2,1,9,9,13,10238,17321,-7083
2,1,10,9,13,10481,17716,-7235
2,1,11,9,13,10773,17839,-7066
2,2,0,9,13,10913,17400,-6487
2,2,1,9,13,10635,17176,-6541
2,2,2,9,13,10400,17001,-6601
2,2,3,9,13,10271,17438,-7167
2,2,4,9,13,10325,18131,-7806
2,2,5,9,13,10310,18016,-7706
2,2,6,9,13,10314,17669,-7355
2,2,7,9,13,10362,18020,-7658
2,2,8,9,13,10381,17776,-7395
2,2,9,9,13,10478,17395,-6917
2,2,10,9,13,10684,17770,-7086
2,2,11,9,13,10952,17962,-7010
2,3,0,9,13,11769,16867,-5098
2,3,1,9,13,11550,16538,-4988
2,3,2,9,13,11404,16287,-4883
2,3,3,9,13,11375,16632,-5257
2,3,4,9,13,11538,17114,-5576
2,3,5,9,13,11507,17039,-5532
2,3,6,9,13,11519,16688,-5169
2,3,7,9,13,11556,17055,-5499
2,3,8,9,13,11573,16812,-5239
2,3,9,9,13,11628,16279,-4651
2,3,10,9,13,11827,16582,-4755
2,3,11,9,13,12038,16892,-4854
2,4,0,9,13,12645,15940,-3295
2,4,1,9,13,12435,15484,-3049
2,4,2,9,13,12297,15229,-2932
2,4,3,9,13,12366,15485,-3119
2,4,4,9,13,12669,15650,-2981
2,4,5,9,13,12652,15582,-2930
2,4,6,9,13,12661,15255,-2594
2,4,7,9,13,12698,15639,-2941
2,4,8,9,13,12717,15419,-2702
2,4,9,9,13,12705,14865,-2160
2,4,10,9,13,12950,15135,-2185
2,4,11,9,13,13133,15575,-2442
2,5,0,9,13,13564,14932,-1368
2,5,1,9,13,13373,14512,-1139
2,5,2,9,13,13239,14284,-1045
2,5,3,9,13,13421,14515,-1094
2,5,4,9,13,13906,14546,-640
2,5,5,9,13,13970,14478,-508
2,5,6,9,13,13958,14169,-211
2,5,7,9,13,14009,14523,-514
2,5,8,9,13,13933,14312,-379
2,5,9,9,13,13804,13722,82
2,5,10,9,13,14084,13900,184
2,5,11,9,13,14233,14298,-65
2,6,0,9,13,14440,13941,499
2,6,1,9,13,14258,13540,718
2,6,2,9,13,14116,13400,716
2,6,3,9,13,14392,13631,761
2,6,4,9,13,15060,13581,1479
2,6,5,9,13,15195,13507,1688
2,6,6,9,13,15187,13199,1988
2,6,7,9,13,15270,13505,1765
2,6,8,9,13,15039,13346,1693
2,6,9,9,13,14819,12704,2115
2,6,10,9,13,15150,12757,2393
2,6,11,9,13,15285,13120,2165
2,0,0,10,13,12176,18876,-6700
2,0,1,10,13,11861,18680,-6819
2,0,2,10,13,11537,18585,-7048
2,0,3,10,13,11348,19091,-7743
2,0,4,10,13,11342,19853,-8511
2,0,5,10,13,11312,19739,-8427
2,0,6,10,13,11317,19386,-8069
2,0,7,10,13,11372,19734,-8362
2,0,8,10,13,11419,19448,-8029
2,0,9,10,13,11578,19007,-7429
2,0,10,10,13,11827,19353,-7526
2,0,11,10,13,12119,19519,-7400
2,1,0,10,13,12296,19157,-6861
2,1,1,10,13,12016,18889,-6873
2,1,2,10,13,11775,18722,-6947
2,1,3,10,13,11646,19166,-7520
2,1,4,10,13,11709,19767,-8058
2,1,5,10,13,11689,19675,-7986
2,1,6,10,13,11689,19333,-7644
2,1,7,10,13,11737,19688,-7951
2,1,8,10,13,11750,19428,-7678
2,1,9,10,13,11850,18848,-6998
2,1,10,10,13,12064,19146,-7082
2,1,11,10,13,12330,19396,-7066
2,2,0,10,13,13203,18046,-4843
2,2,1,10,13,12986,17550,-4564
2,2,2,10,13,12835,17251,-4416
2,2,3,10,13,12805,17562,-4757
2,2,4,10,13,12978,17852,-4874
2,2,5,10,13,12946,17785,-4839
2,2,6,10,13,12959,17457,-4498
2,2,7,10,13,12995,17850,-4855
2,2,8,10,13,12997,17624,-4627
2,2,9,10,13,13047,17035,-3988
2,2,10,10,13,13248,17393,-4145
2,2,11,10,13,13456,17850,-4394
2,3,0,10,13,13875,16971,-3096
2,3,1,10,13,13616,16501,-2885
2,3,2,10,13,13426,16205,-2779
2,3,3,10,13,13452,16483,-3031
2,3,4,10,13,13740,16640,-2900
2,3,5,10,13,13710,16602,-2892
2,3,6,10,13,13721,16258,-2537
2,3,7,10,13,13767,16655,-2888
2,3,8,10,13,13778,16388,-2610
2,3,9,10,13,13798,15737,-1939
2,3,10,10,13,14085,16012,-1927
2,3,11,10,13,14313,16438,-2125
2,4,0,10,13,14684,15968,-1284
2,4,1,10,13,14424,15527,-1103
2,4,2,10,13,14218,15322,-1104
2,4,3,10,13,14334,15593,-1259
2,4,4,10,13,14763,15662,-899
2,4,5,10,13,14776,15592,-816
2,4,6,10,13,14750,15260,-510
2,4,7,10,13,14830,15636,-806
2,4,8,10,13,14793,15399,-606
2,4,9,10,13,14720,14716,4
2,4,10,10,13,15062,14870,192
2,4,11,10,13,15273,15260,13
2,0,0,11,13,13652,20336,-6684
2,0,1,11,13,13365,19901,-6536
2,0,2,11,13,13121,19686,-6565
2,0,3,11,13,13001,20096,-7095
2,0,4,11,13,13064,20505,-7441
2,0,5,11,13,13035,20421,-7386
2,0,6,11,13,13034,20102,-7068
2,0,7,11,13,13086,20483,-7397
2,0,8,11,13,13091,20240,-7149
2,0,9,11,13,13190,19604,-6414
2,0,10,11,13,13410,19957,-6547
2,0,11,11,13,13676,20354,-6678
2,1,0,11,13,14586,19077,-4491
2,1,1,11,13,14367,18567,-4200
2,1,2,11,13,14210,18227,-4017
2,1,3,11,13,14180,18560,-4380
2,1,4,11,13,14362,18842,-4480
2,1,5,11,13,14325,18805,-4480
2,1,6,11,13,14334,18460,-4126
2,1,7,11,13,14370,18866,-4496
2,1,8,11,13,14366,18593,-4227
2,1,9,11,13,14419,17907,-3488
2,1,10,11,13,14628,18270,-3642
2,1,11,11,13,14834,18713,-3879
2,2,0,11,13,15309,18007,-2698
2,2,1,11,13,15052,17516,-2464
2,2,2,11,13,14857,17243,-2386
2,2,3,11,13,14882,17561,-2679
2,2,4,11,13,15180,17756,-2576
2,2,5,11,13,15149,17716,-2567
2,2,6,11,13,15161,17349,-2188
2,2,7,11,13,15206,17768,-2562
2,2,8,11,13,15202,17475,-2273
2,2,9,11,13,15217,16731,-1514
2,2,10,11,13,15506,16982,-1476
2,2,11,11,13,15731,17400,-1669
2,0,0,12,13,15942,20113,-4171
2,0,1,12,13,15716,19582,-3866
2,0,2,12,13,15556,19265,-3709
2,0,3,12,13,15535,19638,-4103
2,0,4,12,13,15717,19958,-4241
2,0,5,12,13,15671,19919,-4248
2,0,6,12,13,15679,19551,-3872
2,0,7,12,13,15719,19979,-4260
2,0,8,12,13,15707,19680,-3973
2,0,9,12,13,15759,18901,-3142
2,0,10,12,13,15974,19240,-3266
2,0,11,12,13,16180,19675,-3495
2,0,0,1,14,1459,1487,-28
2,0,1,1,14,1453,1486,-33
2,0,2,1,14,1451,1482,-31
2,0,3,1,14,1453,1490,-37
2,0,4,1,14,1457,1491,-34
2,0,5,1,14,1456,1483,-27
2,0,6,1,14,1453,1477,-24
2,0,7,1,14,1447,1476,-29
2,0,8,1,14,1444,1480,-36
2,0,9,1,14,1449,1486,-37
2,0,10,1,14,1448,1482,-34
2,1,0,1,14,1487,1542,-55
2,1,1,1,14,1486,1546,-60
2,1,2,1,14,1482,1542,-60
2,1,3,1,14,1490,1547,-57
2,1,4,1,14,1491,1549,-58
2,1,5,1,14,1483,1548,-65
2,1,6,1,14,1477,1547,-70
2,1,7,1,14,1476,1542,-66
2,1,8,1,14,1480,1534,-54
2,1,9,1,14,1486,1534,-48
2,1,10,1,14,1482,1527,-45
2,2,0,1,14,1542,1293,249
2,2,1,1,14,1546,1246,300
2,2,2,1,14,1542,1196,346
2,2,3,1,14,1547,1176,371
2,2,4,1,14,1549,1170,379
2,2,5,1,14,1548,1175,373
2,2,6,1,14,1547,1181,366
2,2,7,1,14,1542,1176,366
2,2,8,1,14,1534,1165,369
2,2,9,1,14,1534,1204,330
2,2,10,1,14,1527,1246,281
2,3,0,1,14,1293,1165,128
2,3,1,1,14,1246,1098,148
2,3,2,1,14,1196,1027,169
2,3,3,1,14,1176,972,204
2,3,4,1,14,1170,932,238
2,3,5,1,14,1175,912,263
2,3,6,1,14,1181,915,266
2,3,7,1,14,1176,936,240
2,3,8,1,14,1165,970,195
2,3,9,1,14,1204,1029,175
2,3,10,1,14,1246,1088,158
2,4,0,1,14,1165,1216,-51
2,4,1,1,14,1098,1167,-69
2,4,2,1,14,1027,1111,-84
2,4,3,1,14,972,1046,-74
2,4,4,1,14,932,985,-53
2,4,5,1,14,912,941,-29
2,4,6,1,14,915,939,-24
2,4,7,1,14,936,986,-50
2,4,8,1,14,970,1066,-96
2,4,9,1,14,1029,1115,-86
2,4,10,1,14,1088,1155,-67
2,5,0,1,14,1216,1150,66
2,5,1,1,14,1167,1098,69
2,5,2,1,14,1111,1042,69
2,5,3,1,14,1046,1010,36
2,5,4,1,14,985,987,-2
2,5,5,1,14,941,971,-30
2,5,6,1,14,939,976,-37
2,5,7,1,14,986,1006,-20
2,5,8,1,14,1066,1055,11
2,5,9,1,14,1115,1102,13
2,5,10,1,14,1155,1148,7
2,6,0,1,14,1150,1262,-112
2,6,1,1,14,1098,1229,-131
2,6,2,1,14,1042,1200,-158
2,6,3,1,14,1010,1209,-199
2,6,4,1,14,987,1244,-257
2,6,5,1,14,971,1283,-312
2,6,6,1,14,976,1303,-327
2,6,7,1,14,1006,1293,-287
2,6,8,1,14,1055,1272,-217
2,6,9,1,14,1102,1287,-185
2,6,10,1,14,1148,1316,-168
2,7,0,1,14,1262,1700,-438
2,7,1,1,14,1229,1712,-483
2,7,2,1,14,1200,1709,-509
2,7,3,1,14,1209,1722,-513
2,7,4,1,14,1244,1775,-531
2,7,5,1,14,1283,1841,-558
2,7,6,1,14,1303,1840,-537
2,7,7,1,14,1293,1804,-511
2,7,8,1,14,1272,1811,-539
2,7,9,1,14,1287,1802,-515
2,7,10,1,14,1316,1798,-482
2,8,0,1,14,1700,731,969
2,8,1,1,14,1712,652,1060
2,8,2,1,14,1709,636,1073
2,8,3,1,14,1722,626,1096
2,8,4,1,14,1775,649,1126
2,8,5,1,14,1841,666,1175
2,8,6,1,14,1840,658,1182
2,8,7,1,14,1804,665,1139
2,8,8,1,14,1811,658,1153
2,8,9,1,14,1802,670,1132
2,8,10,1,14,1798,732,1066
2,9,0,1,14,731,1608,-877
2,9,1,1,14,652,1628,-976
2,9,2,1,14,636,1713,-1077
2,9,3,1,14,626,1798,-1172
2,9,4,1,14,649,1871,-1222
2,9,5,1,14,666,1835,-1169
2,9,6,1,14,658,1837,-1179
2,9,7,1,14,665,1829,-1164
2,9,8,1,14,658,1754,-1096
2,9,9,1,14,670,1711,-1041
2,9,10,1,14,732,1689,-957
2,10,0,1,14,1608,2490,-882
2,10,1,1,14,1628,2535,-907
2,10,2,1,14,1713,2624,-911
2,10,3,1,14,1798,2776,-978
2,10,4,1,14,1871,2889,-1018
2,10,5,1,14,1835,2820,-985
2,10,6,1,14,1837,2856,-1019
2,10,7,1,14,1829,2846,-1017
2,10,8,1,14,1754,2785,-1031
2,10,9,1,14,1711,2742,-1031
2,10,10,1,14,1689,2698,-1009
2,11,0,1,14,2490,2217,273
2,11,1,1,14,2535,2169,366
2,11,2,1,14,2624,2181,443
2,11,3,1,14,2776,2328,448
2,11,4,1,14,2889,2440,449
2,11,5,1,14,2820,2403,417
2,11,6,1,14,2856,2424,432
2,11,7,1,14,2846,2429,417
2,11,8,1,14,2785,2402,383
2,11,9,1,14,2742,2369,373
2,11,10,1,14,2698,2389,309
2,12,0,1,14,2217,2135,82
2,12,1,1,14,2169,2080,89
2,12,2,1,14,2181,2078,103
2,12,3,1,14,2328,2217,111
2,12,4,1,14,2440,2311,129
2,12,5,1,14,2403,2342,61
2,12,6,1,14,2424,2302,122
2,12,7,1,14,2429,2309,120
2,12,8,1,14,2402,2264,138
2,12,9,1,14,2369,2212,157
2,12,10,1,14,2389,2246,143
2,13,0,1,14,2135,2139,-4
2,13,1,1,14,2080,2091,-11
2,13,2,1,14,2078,2077,1
2,13,3,1,14,2217,2203,14
2,13,4,1,14,2311,2261,50
2,13,5,1,14,2342,2315,27
2,13,6,1,14,2302,2274,28
2,13,7,1,14,2309,2284,25
2,13,8,1,14,2264,2248,16
2,13,9,1,14,2212,2213,-1
2,13,10,1,14,2246,2267,-21
2,14,0,1,14,2139,2129,10
2,14,1,1,14,2091,2069,22
2,14,2,1,14,2077,2060,17
2,14,3,1,14,2203,2208,-5
2,14,4,1,14,2261,2260,1
2,14,5,1,14,2315,2300,15
2,14,6,1,14,2274,2273,1
2,14,7,1,14,2284,2258,26
2,14,8,1,14,2248,2219,29
2,14,9,1,14,2213,2167,46
2,14,10,1,14,2267,2225,42
2,15,0,1,14,2129,2058,71
2,15,1,1,14,2069,2048,21
2,15,2,1,14,2060,2108,-48
2,15,3,1,14,2208,2287,-79
2,15,4,1,14,2260,2338,-78
2,15,5,1,14,2300,2308,-8
2,15,6,1,14,2273,2276,-3
2,15,7,1,14,2258,2302,-44
2,15,8,1,14,2219,2222,-3
2,15,9,1,14,2167,2100,67
2,15,10,1,14,2225,2133,92
2,16,0,1,14,2058,1743,315
2,16,1,1,14,2048,1696,352
2,16,2,1,14,2108,1761,347
2,16,3,1,14,2287,1940,347
2,16,4,1,14,2338,1955,383
2,16,5,1,14,2308,1823,485
2,16,6,1,14,2276,1792,484
2,16,7,1,14,2302,1854,448
2,16,8,1,14,2222,1789,433
2,16,9,1,14,2100,1686,414
2,16,10,1,14,2133,1770,363
2,17,0,1,14,1743,1614,129
2,17,1,1,14,1696,1595,101
2,17,2,1,14,1761,1585,176
2,17,3,1,14,1940,1576,364
2,17,4,1,14,1955,1550,405
2,17,5,1,14,1823,1385,438
2,17,6,1,14,1792,1331,461
2,17,7,1,14,1854,1462,392
2,17,8,1,14,1789,1498,291
2,17,9,1,14,1686,1467,219
2,17,10,1,14,1770,1515,255
2,18,0,1,14,1614,1913,-299
2,18,1,1,14,1595,1833,-238
2,18,2,1,14,1585,1808,-223
2,18,3,1,14,1576,1892,-316
2,18,4,1,14,1550,1866,-316
2,18,5,1,14,1385,1805,-420
2,18,6,1,14,1331,1788,-457
2,18,7,1,14,1462,1893,-431
2,18,8,1,14,1498,1873,-375
2,18,9,1,14,1467,1760,-293
2,18,10,1,14,1515,1838,-323
2,19,0,1,14,1913,1903,10
2,19,1,1,14,1833,1797,36
2,19,2,1,14,1808,1796,12
2,19,3,1,14,1892,1866,26
2,19,4,1,14,1866,1756,110
2,19,5,1,14,1805,1707,98
2,19,6,1,14,1788,1741,47
2,19,7,1,14,1893,1831,62
2,19,8,1,14,1873,1697,176
2,19,9,1,14,1760,1508,252
2,19,10,1,14,1838,1587,251
2,20,0,1,14,1903,1215,688
2,20,1,1,14,1797,1036,761
2,20,2,1,14,1796,1019,777
2,20,3,1,14,1866,973,893
2,20,4,1,14,1756,808,948
2,20,5,1,14,1707,801,906
2,20,6,1,14,1741,853,888
2,20,7,1,14,1831,896,935
2,20,8,1,14,1697,901,796
2,20,9,1,14,1508,852,656
2,20,10,1,14,1587,984,603
2,21,0,1,14,1215,1114,101
2,21,1,1,14,1036,1050,-14
2,21,2,1,14,1019,1074,-55
2,21,3,1,14,973,1110,-137
2,21,4,1,14,808,1060,-252
2,21,5,1,14,801,1040,-239
2,21,6,1,14,853,1061,-208
2,21,7,1,14,896,1064,-168
2,21,8,1,14,901,1023,-122
2,21,9,1,14,852,926,-74
2,21,10,1,14,984,933,51
2,22,0,1,14,1114,1126,-12
2,22,1,1,14,1050,1107,-57
2,22,2,1,14,1074,1132,-58
2,22,3,1,14,1110,1185,-75
2,22,4,1,14,1060,1183,-123
2,22,5,1,14,1040,1156,-116
2,22,6,1,14,1061,1161,-100
2,22,7,1,14,1064,1167,-103
2,22,8,1,14,1023,1120,-97
2,22,9,1,14,926,1068,-142
2,22,10,1,14,933,1017,-84
2,0,0,2,14,2946,2835,111
2,0,1,2,14,2939,2792,147
2,0,2,2,14,2933,2738,195
2,0,3,2,14,2943,2723,220
2,0,4,2,14,2948,2719,229
2,0,5,2,14,2939,2723,216
2,0,6,2,14,2930,2728,202
2,0,7,2,14,2923,2718,205
2,0,8,2,14,2924,2699,225
2,0,9,2,14,2935,2738,197
2,0,10,2,14,2930,2773,157
2,1,0,2,14,3029,2458,571
2,1,1,2,14,3032,2344,688
2,1,2,2,14,3024,2223,801
2,1,3,2,14,3037,2148,889
2,1,4,2,14,3040,2102,938
2,1,5,2,14,3031,2087,944
2,1,6,2,14,3024,2096,928
2,1,7,2,14,3018,2112,906
2,1,8,2,14,3014,2135,879
2,1,9,2,14,3020,2233,787
2,1,10,2,14,3009,2334,675
2,2,0,2,14,2835,2381,454
2,2,1,2,14,2792,2265,527
2,2,2,2,14,2738,2138,600
2,2,3,2,14,2723,2018,705
2,2,4,2,14,2719,1917,802
2,2,5,2,14,2723,1853,870
2,2,6,2,14,2728,1854,874
2,2,7,2,14,2718,1922,796
2,2,8,2,14,2699,2036,663
2,2,9,2,14,2738,2144,594
2,2,10,2,14,2773,2243,530
2,3,0,2,14,2458,2366,92
2,3,1,2,14,2344,2265,79
2,3,2,2,14,2223,2153,70
2,3,3,2,14,2148,2056,92
2,3,4,2,14,2102,1972,130
2,3,5,2,14,2087,1912,175
2,3,6,2,14,2096,1915,181
2,3,7,2,14,2112,1992,120
2,3,8,2,14,2135,2121,14
2,3,9,2,14,2233,2217,16
2,3,10,2,14,2334,2303,31
2,4,0,2,14,2381,2412,-31
2,4,1,2,14,2265,2327,-62
2,4,2,2,14,2138,2242,-104
2,4,3,2,14,2018,2219,-201
2,4,4,2,14,1917,2231,-314
2,4,5,2,14,1853,2254,-401
2,4,6,2,14,1854,2279,-425
2,4,7,2,14,1922,2299,-377
2,4,8,2,14,2036,2327,-291
2,4,9,2,14,2144,2389,-245
2,4,10,2,14,2243,2464,-221
2,5,0,2,14,2366,2962,-596
2,5,1,2,14,2265,2941,-676
2,5,2,2,14,2153,2909,-756
2,5,3,2,14,2056,2931,-875
2,5,4,2,14,1972,3019,-1047
2,5,5,2,14,1912,3124,-1212
2,5,6,2,14,1915,3143,-1228
2,5,7,2,14,1992,3097,-1105
2,5,8,2,14,2121,3083,-962
2,5,9,2,14,2217,3089,-872
2,5,10,2,14,2303,3114,-811
2,6,0,2,14,2412,2431,-19
2,6,1,2,14,2327,2364,-37
2,6,2,2,14,2242,2345,-103
2,6,3,2,14,2219,2348,-129
2,6,4,2,14,2231,2424,-193
2,6,5,2,14,2254,2507,-253
2,6,6,2,14,2279,2498,-219
2,6,7,2,14,2299,2469,-170
2,6,8,2,14,2327,2469,-142
2,6,9,2,14,2389,2472,-83
2,6,10,2,14,2464,2530,-66
2,7,0,2,14,2962,2339,623
2,7,1,2,14,2941,2280,661
2,7,2,2,14,2909,2349,560
2,7,3,2,14,2931,2424,507
2,7,4,2,14,3019,2520,499
2,7,5,2,14,3124,2501,623
2,7,6,2,14,3143,2495,648
2,7,7,2,14,3097,2494,603
2,7,8,2,14,3083,2412,671
2,7,9,2,14,3089,2381,708
2,7,10,2,14,3114,2421,693
2,8,0,2,14,2431,4098,-1667
2,8,1,2,14,2364,4163,-1799
2,8,2,2,14,2345,4337,-1992
2,8,3,2,14,2348,4574,-2226
2,8,4,2,14,2424,4760,-2336
2,8,5,2,14,2507,4655,-2148
2,8,6,2,14,2498,4693,-2195
2,8,7,2,14,2469,4675,-2206
2,8,8,2,14,2469,4539,-2070
2,8,9,2,14,2472,4453,-1981
2,8,10,2,14,2530,4387,-1857
2,9,0,2,14,2339,4707,-2368
2,9,1,2,14,2280,4704,-2424
2,9,2,2,14,2349,4805,-2456
2,9,3,2,14,2424,5104,-2680
2,9,4,2,14,2520,5329,-2809
2,9,5,2,14,2501,5223,-2722
2,9,6,2,14,2495,5280,-2785
2,9,7,2,14,2494,5275,-2781
2,9,8,2,14,2412,5187,-2775
2,9,9,2,14,2381,5111,-2730
2,9,10,2,14,2421,5087,-2666
2,10,0,2,14,4098,4352,-254
2,10,1,2,14,4163,4249,-86
2,10,2,2,14,4337,4259,78
2,10,3,2,14,4574,4545,29
2,10,4,2,14,4760,4751,9
2,10,5,2,14,4655,4745,-90
2,10,6,2,14,4693,4726,-33
2,10,7,2,14,4675,4738,-63
2,10,8,2,14,4539,4666,-127
2,10,9,2,14,4453,4581,-128
2,10,10,2,14,4387,4635,-248
2,11,0,2,14,4707,4274,433
2,11,1,2,14,4704,4171,533
2,11,2,2,14,4805,4155,650
2,11,3,2,14,5104,4420,684
2,11,4,2,14,5329,4572,757
2,11,5,2,14,5223,4657,566
2,11,6,2,14,5280,4576,704
2,11,7,2,14,5275,4593,682
2,11,8,2,14,5187,4512,675
2,11,9,2,14,5111,4425,686
2,11,10,2,14,5087,4513,574
2,12,0,2,14,4352,4268,84
2,12,1,2,14,4249,4160,89
2,12,2,2,14,4259,4137,122
2,12,3,2,14,4545,4411,134
2,12,4,2,14,4751,4521,230
2,12,5,2,14,4745,4615,130
2,12,6,2,14,4726,4547,179
2,12,7,2,14,4738,4542,196
2,12,8,2,14,4666,4467,199
2,12,9,2,14,4581,4380,201
2,12,10,2,14,4635,4492,143
2,13,0,2,14,4274,4187,87
2,13,1,2,14,4171,4117,54
2,13,2,2,14,4155,4168,-13
2,13,3,2,14,4420,4495,-75
2,13,4,2,14,4572,4598,-26
2,13,5,2,14,4657,4608,49
2,13,6,2,14,4576,4549,27
2,13,7,2,14,4593,4560,33
2,13,8,2,14,4512,4441,71
2,13,9,2,14,4425,4267,158
2,13,10,2,14,4513,4358,155
2,14,0,2,14,4268,3801,467
2,14,1,2,14,4160,3744,416
2,14,2,2,14,4137,3869,268
2,14,3,2,14,4411,4227,184
2,14,4,2,14,4521,4293,228
2,14,5,2,14,4615,4131,484
2,14,6,2,14,4547,4068,479
2,14,7,2,14,4542,4156,386
2,14,8,2,14,4467,4011,456
2,14,9,2,14,4380,3786,594
2,14,10,2,14,4492,3903,589
2,15,0,2,14,4187,3357,830
2,15,1,2,14,4117,3291,826
2,15,2,2,14,4168,3346,822
2,15,3,2,14,4495,3516,979
2,15,4,2,14,4598,3505,1093
2,15,5,2,14,4608,3208,1400
2,15,6,2,14,4549,3123,1426
2,15,7,2,14,4560,3316,1244
2,15,8,2,14,4441,3287,1154
2,15,9,2,14,4267,3153,1114
2,15,10,2,14,4358,3285,1073
2,16,0,2,14,3801,3527,274
2,16,1,2,14,3744,3428,316
2,16,2,2,14,3869,3393,476
2,16,3,2,14,4227,3468,759
2,16,4,2,14,4293,3416,877
2,16,5,2,14,4131,3190,941
2,16,6,2,14,4068,3119,949
2,16,7,2,14,4156,3355,801
2,16,8,2,14,4011,3371,640
2,16,9,2,14,3786,3227,559
2,16,10,2,14,3903,3353,550
2,17,0,2,14,3357,3816,-459
2,17,1,2,14,3291,3630,-339
2,17,2,2,14,3346,3604,-258
2,17,3,2,14,3516,3758,-242
2,17,4,2,14,3505,3622,-117
2,17,5,2,14,3208,3512,-304
2,17,6,2,14,3123,3529,-406
2,17,7,2,14,3316,3724,-408
2,17,8,2,14,3287,3570,-283
2,17,9,2,14,3153,3268,-115
2,17,10,2,14,3285,3425,-140
2,18,0,2,14,3527,3118,409
2,18,1,2,14,3428,2833,595
2,18,2,2,14,3393,2815,578
2,18,3,2,14,3468,2839,629
2,18,4,2,14,3416,2564,852
2,18,5,2,14,3190,2508,682
2,18,6,2,14,3119,2594,525
2,18,7,2,14,3355,2727,628
2,18,8,2,14,3371,2598,773
2,18,9,2,14,3227,2360,867
2,18,10,2,14,3353,2571,782
2,19,0,2,14,3816,2329,1487
2,19,1,2,14,3630,2086,1544
2,19,2,2,14,3604,2093,1511
2,19,3,2,14,3758,2083,1675
2,19,4,2,14,3622,1868,1754
2,19,5,2,14,3512,1841,1671
2,19,6,2,14,3529,1914,1615
2,19,7,2,14,3724,1960,1764
2,19,8,2,14,3570,1924,1646
2,19,9,2,14,3268,1778,1490
2,19,10,2,14,3425,1917,1508
2,20,0,2,14,3118,2240,878
2,20,1,2,14,2833,2157,676
2,20,2,2,14,2815,2206,609
2,20,3,2,14,2839,2295,544
2,20,4,2,14,2564,2243,321
2,20,5,2,14,2508,2196,312
2,20,6,2,14,2594,2222,372
2,20,7,2,14,2727,2231,496
2,20,8,2,14,2598,2143,455
2,20,9,2,14,2360,1994,366
2,20,10,2,14,2571,1950,621
2,0,0,3,14,4488,3674,814
2,0,1,3,14,4485,3511,974
2,0,2,3,14,4475,3334,1141
2,0,3,3,14,4490,3194,1296
2,0,4,3,14,4497,3087,1410
2,0,5,3,14,4487,3028,1459
2,0,6,3,14,4477,3035,1442
2,0,7,3,14,4465,3098,1367
2,0,8,3,14,4458,3201,1257
2,0,9,3,14,4469,3348,1121
2,0,10,3,14,4457,3489,968
2,1,0,3,14,4322,3531,791
2,1,1,3,14,4278,3363,915
2,1,2,3,14,4220,3180,1040
2,1,3,3,14,4213,3028,1185
2,1,4,3,14,4210,2904,1306
2,1,5,3,14,4206,2824,1382
2,1,6,3,14,4205,2830,1375
2,1,7,3,14,4194,2928,1266
2,1,8,3,14,4179,3091,1088
2,1,9,3,14,4224,3246,978
2,1,10,3,14,4255,3391,864
2,2,0,3,14,4000,3628,372
2,2,1,3,14,3890,3494,396
2,2,2,3,14,3765,3353,412
2,2,3,3,14,3695,3265,430
2,2,4,3,14,3651,3216,435
2,2,5,3,14,3635,3195,440
2,2,6,3,14,3643,3218,425
2,2,7,3,14,3654,3285,369
2,2,8,3,14,3669,3393,276
2,2,9,3,14,3767,3504,263
2,2,10,3,14,3861,3619,242
2,3,0,3,14,3674,4112,-438
2,3,1,3,14,3511,4039,-528
2,3,2,3,14,3334,3951,-617
2,3,3,3,14,3194,3941,-747
2,3,4,3,14,3087,4006,-919
2,3,5,3,14,3028,4095,-1067
2,3,6,3,14,3035,4119,-1084
2,3,7,3,14,3098,4103,-1005
2,3,8,3,14,3201,4138,-937
2,3,9,3,14,3348,4191,-843
2,3,10,3,14,3489,4262,-773
2,4,0,3,14,3531,3693,-162
2,4,1,3,14,3363,3593,-230
2,4,2,3,14,3180,3545,-365
2,4,3,3,14,3028,3557,-529
2,4,4,3,14,2904,3668,-764
2,4,5,3,14,2824,3790,-966
2,4,6,3,14,2830,3801,-971
2,4,7,3,14,2928,3762,-834
2,4,8,3,14,3091,3741,-650
2,4,9,3,14,3246,3759,-513
2,4,10,3,14,3391,3846,-455
2,5,0,3,14,3628,4039,-411
2,5,1,3,14,3494,3992,-498
2,5,2,3,14,3353,4058,-705
2,5,3,3,14,3265,4146,-881
2,5,4,3,14,3216,4295,-1079
2,5,5,3,14,3195,4342,-1147
2,5,6,3,14,3218,4335,-1117
2,5,7,3,14,3285,4298,-1013
2,5,8,3,14,3393,4223,-830
2,5,9,3,14,3504,4183,-679
2,5,10,3,14,3619,4219,-600
2,6,0,3,14,4112,4829,-717
2,6,1,3,14,4039,4815,-776
2,6,2,3,14,3951,4973,-1022
2,6,3,3,14,3941,5200,-1259
2,6,4,3,14,4006,5409,-1403
2,6,5,3,14,4095,5321,-1226
2,6,6,3,14,4119,5351,-1232
2,6,7,3,14,4103,5340,-1237
2,6,8,3,14,4138,5197,-1059
2,6,9,3,14,4191,5123,-932
2,6,10,3,14,4262,5119,-857
2,7,0,3,14,3693,6315,-2622
2,7,1,3,14,3593,6332,-2739
2,7,2,3,14,3545,6518,-2973
2,7,3,3,14,3557,6902,-3345
2,7,4,3,14,3668,7200,-3532
2,7,5,3,14,3790,7058,-3268
2,7,6,3,14,3801,7117,-3316
2,7,7,3,14,3762,7104,-3342
2,7,8,3,14,3741,6941,-3200
2,7,9,3,14,3759,6822,-3063
2,7,10,3,14,3846,6776,-2930
2,8,0,3,14,4039,6842,-2803
2,8,1,3,14,3992,6784,-2792
2,8,2,3,14,4058,6883,-2825
2,8,3,3,14,4146,7321,-3175
2,8,4,3,14,4295,7640,-3345
2,8,5,3,14,4342,7565,-3223
2,8,6,3,14,4335,7582,-3247
2,8,7,3,14,4298,7584,-3286
2,8,8,3,14,4223,7451,-3228
2,8,9,3,14,4183,7323,-3140
2,8,10,3,14,4219,7333,-3114
2,9,0,3,14,4829,6491,-1662
2,9,1,3,14,4815,6340,-1525
2,9,2,3,14,4973,6336,-1363
2,9,3,3,14,5200,6748,-1548
2,9,4,3,14,5409,7012,-1603
2,9,5,3,14,5321,7060,-1739
2,9,6,3,14,5351,7000,-1649
2,9,7,3,14,5340,7022,-1682
2,9,8,3,14,5197,6914,-1717
2,9,9,3,14,5123,6794,-1671
2,9,10,3,14,5119,6902,-1783
2,10,0,3,14,6315,6403,-88
2,10,1,3,14,6332,6240,92
2,10,2,3,14,6518,6215,303
2,10,3,3,14,6902,6628,274
2,10,4,3,14,7200,6832,368
2,10,5,3,14,7058,6957,101
2,10,6,3,14,7117,6849,268
2,10,7,3,14,7104,6851,253
2,10,8,3,14,6941,6731,210
2,10,9,3,14,6822,6592,230
2,10,10,3,14,6776,6738,38
2,11,0,3,14,6842,6326,516
2,11,1,3,14,6784,6208,576
2,11,2,3,14,6883,6245,638
2,11,3,3,14,7321,6698,623
2,11,4,3,14,7640,6859,781
2,11,5,3,14,7565,6923,642
2,11,6,3,14,7582,6823,759
2,11,7,3,14,7584,6844,740
2,11,8,3,14,7451,6689,762
2,11,9,3,14,7323,6480,843
2,11,10,3,14,7333,6625,708
2,12,0,3,14,6491,5930,561
2,12,1,3,14,6340,5813,527
2,12,2,3,14,6336,5929,407
2,12,3,3,14,6748,6435,313
2,12,4,3,14,7012,6553,459
2,12,5,3,14,7060,6431,629
2,12,6,3,14,7000,6341,659
2,12,7,3,14,7022,6414,608
2,12,8,3,14,6914,6230,684
2,12,9,3,14,6794,5953,841
2,12,10,3,14,6902,6128,774
2,13,0,3,14,6403,5415,988
2,13,1,3,14,6240,5339,901
2,13,2,3,14,6215,5454,761
2,13,3,3,14,6628,5803,825
2,13,4,3,14,6832,5843,989
2,13,5,3,14,6957,5516,1441
2,13,6,3,14,6849,5399,1450
2,13,7,3,14,6851,5618,1233
2,13,8,3,14,6731,5509,1222
2,13,9,3,14,6592,5253,1339
2,13,10,3,14,6738,5418,1320
2,14,0,3,14,6326,5270,1056
2,14,1,3,14,6208,5124,1084
2,14,2,3,14,6245,5154,1091
2,14,3,3,14,6698,5408,1290
2,14,4,3,14,6859,5371,1488
2,14,5,3,14,6923,5013,1910
2,14,6,3,14,6823,4911,1912
2,14,7,3,14,6844,5209,1635
2,14,8,3,14,6689,5160,1529
2,14,9,3,14,6480,4913,1567
2,14,10,3,14,6625,5123,1502
2,15,0,3,14,5930,5430,500
2,15,1,3,14,5813,5225,588
2,15,2,3,14,5929,5189,740
2,15,3,3,14,6435,5334,1101
2,15,4,3,14,6553,5172,1381
2,15,5,3,14,6431,4897,1534
2,15,6,3,14,6341,4860,1481
2,15,7,3,14,6414,5186,1228
2,15,8,3,14,6230,5068,1162
2,15,9,3,14,5953,4735,1218
2,15,10,3,14,6128,4940,1188
2,16,0,3,14,5415,5031,384
2,16,1,3,14,5339,4666,673
2,16,2,3,14,5454,4623,831
2,16,3,3,14,5803,4731,1072
2,16,4,3,14,5843,4430,1413
2,16,5,3,14,5516,4313,1203
2,16,6,3,14,5399,4382,1017
2,16,7,3,14,5618,4620,998
2,16,8,3,14,5509,4471,1038
2,16,9,3,14,5253,4120,1133
2,16,10,3,14,5418,4409,1009
2,17,0,3,14,5270,4232,1038
2,17,1,3,14,5124,3883,1241
2,17,2,3,14,5154,3889,1265
2,17,3,3,14,5408,3949,1459
2,17,4,3,14,5371,3624,1747
2,17,5,3,14,5013,3548,1465
2,17,6,3,14,4911,3655,1256
2,17,7,3,14,5209,3791,1418
2,17,8,3,14,5160,3621,1539
2,17,9,3,14,4913,3286,1627
2,17,10,3,14,5123,3504,1619
2,18,0,3,14,5430,3455,1975
2,18,1,3,14,5225,3193,2032
2,18,2,3,14,5189,3225,1964
2,18,3,3,14,5334,3268,2066
2,18,4,3,14,5172,3051,2121
2,18,5,3,14,4897,2997,1900
2,18,6,3,14,4860,3075,1785
2,18,7,3,14,5186,3127,2059
2,18,8,3,14,5068,3044,2024
2,18,9,3,14,4735,2846,1889
2,18,10,3,14,4940,2934,2006
2,0,0,4,14,5781,4793,988
2,0,1,4,14,5731,4592,1139
2,0,2,4,14,5671,4380,1291
2,0,3,4,14,5666,4237,1429
2,0,4,4,14,5667,4148,1519
2,0,5,4,14,5662,4107,1555
2,0,6,4,14,5658,4133,1525
2,0,7,4,14,5641,4221,1420
2,0,8,4,14,5623,4363,1260
2,0,9,4,14,5673,4533,1140
2,0,10,4,14,5703,4707,996
2,1,0,4,14,5487,5328,159
2,1,1,4,14,5376,5206,170
2,1,2,4,14,5247,5062,185
2,1,3,4,14,5185,4987,198
2,1,4,4,14,5142,4991,151
2,1,5,4,14,5118,5036,82
2,1,6,4,14,5120,5058,62
2,1,7,4,14,5130,5089,41
2,1,8,4,14,5149,5204,-55
2,1,9,4,14,5253,5306,-53
2,1,10,4,14,5343,5417,-74
2,2,0,4,14,5216,4843,373
2,2,1,4,14,5057,4691,366
2,2,2,4,14,4876,4587,289
2,2,3,4,14,4741,4567,174
2,2,4,4,14,4636,4655,-19
2,2,5,4,14,4576,4761,-185
2,2,6,4,14,4582,4777,-195
2,2,7,4,14,4640,4768,-128
2,2,8,4,14,4735,4796,-61
2,2,9,4,14,4882,4861,21
2,2,10,4,14,5016,4994,22
2,3,0,4,14,4824,5301,-477
2,3,1,4,14,4609,5221,-612
2,3,2,4,14,4376,5258,-882
2,3,3,4,14,4204,5355,-1151
2,3,4,4,14,4074,5539,-1465
2,3,5,4,14,3999,5625,-1626
2,3,6,4,14,4011,5638,-1627
2,3,7,4,14,4104,5591,-1487
2,3,8,4,14,4256,5495,-1239
2,3,9,4,14,4450,5470,-1020
2,3,10,4,14,4637,5535,-898
2,4,0,4,14,4793,6529,-1736
2,4,1,4,14,4592,6527,-1935
2,4,2,4,14,4380,6682,-2302
2,4,3,4,14,4237,6922,-2685
2,4,4,4,14,4148,7184,-3036
2,4,5,4,14,4107,7162,-3055
2,4,6,4,14,4133,7191,-3058
2,4,7,4,14,4221,7144,-2923
2,4,8,4,14,4363,7008,-2645
2,4,9,4,14,4533,6925,-2392
2,4,10,4,14,4707,6917,-2210
2,5,0,4,14,5328,7046,-1718
2,5,1,4,14,5206,6984,-1778
2,5,2,4,14,5062,7154,-2092
2,5,3,4,14,4987,7528,-2541
2,5,4,4,14,4991,7849,-2858
2,5,5,4,14,5036,7724,-2688
2,5,6,4,14,5058,7775,-2717
2,5,7,4,14,5089,7769,-2680
2,5,8,4,14,5204,7599,-2395
2,5,9,4,14,5306,7492,-2186
2,5,10,4,14,5417,7508,-2091
2,6,0,4,14,4843,8450,-3607
2,6,1,4,14,4691,8412,-3721
2,6,2,4,14,4587,8596,-4009
2,6,3,4,14,4567,9119,-4552
2,6,4,4,14,4655,9511,-4856
2,6,5,4,14,4761,9400,-4639
2,6,6,4,14,4777,9419,-4642
2,6,7,4,14,4768,9413,-4645
2,6,8,4,14,4796,9205,-4409
2,6,9,4,14,4861,9034,-4173
2,6,10,4,14,4994,9022,-4028
2,7,0,4,14,5301,8981,-3680
2,7,1,4,14,5221,8875,-3654
2,7,2,4,14,5258,8960,-3702
2,7,3,4,14,5355,9524,-4169
2,7,4,4,14,5539,9901,-4362
2,7,5,4,14,5625,9880,-4255
2,7,6,4,14,5638,9856,-4218
2,7,7,4,14,5591,9868,-4277
2,7,8,4,14,5495,9699,-4204
2,7,9,4,14,5470,9536,-4066
2,7,10,4,14,5535,9600,-4065
2,8,0,4,14,6529,8620,-2091
2,8,1,4,14,6527,8409,-1882
2,8,2,4,14,6682,8396,-1714
2,8,3,4,14,6922,8956,-2034
2,8,4,4,14,7184,9272,-2088
2,8,5,4,14,7162,9360,-2198
2,8,6,4,14,7191,9273,-2082
2,8,7,4,14,7144,9280,-2136
2,8,8,4,14,7008,9133,-2125
2,8,9,4,14,6925,8961,-2036
2,8,10,4,14,6917,9127,-2210
2,9,0,4,14,7046,8461,-1415
2,9,1,4,14,6984,8288,-1304
2,9,2,4,14,7154,8323,-1169
2,9,3,4,14,7528,8915,-1387
2,9,4,4,14,7849,9170,-1321
2,9,5,4,14,7724,9265,-1541
2,9,6,4,14,7775,9125,-1350
2,9,7,4,14,7769,9153,-1384
2,9,8,4,14,7599,8953,-1354
2,9,9,4,14,7492,8692,-1200
2,9,10,4,14,7508,8871,-1363
2,10,0,4,14,8450,8069,381
2,10,1,4,14,8412,7904,508
2,10,2,4,14,8596,8006,590
2,10,3,4,14,9119,8638,481
2,10,4,4,14,9511,8814,697
2,10,5,4,14,9400,8746,654
2,10,6,4,14,9419,8615,804
2,10,7,4,14,9413,8698,715
2,10,8,4,14,9205,8478,727
2,10,9,4,14,9034,8166,868
2,10,10,4,14,9022,8395,627
2,11,0,4,14,8981,7544,1437
2,11,1,4,14,8875,7408,1467
2,11,2,4,14,8960,7514,1446
2,11,3,4,14,9524,8011,1513
2,11,4,4,14,9901,8103,1798
2,11,5,4,14,9880,7816,2064
2,11,6,4,14,9856,7672,2184
2,11,7,4,14,9868,7876,1992
2,11,8,4,14,9699,7728,1971
2,11,9,4,14,9536,7420,2116
2,11,10,4,14,9600,7643,1957
2,12,0,4,14,8620,7328,1292
2,12,1,4,14,8409,7172,1237
2,12,2,4,14,8396,7262,1134
2,12,3,4,14,8956,7695,1261
2,12,4,4,14,9272,7709,1563
2,12,5,4,14,9360,7321,2039
2,12,6,4,14,9273,7187,2086
2,12,7,4,14,9280,7511,1769
2,12,8,4,14,9133,7382,1751
2,12,9,4,14,8961,7013,1948
2,12,10,4,14,9127,7256,1871
2,13,0,4,14,8461,7173,1288
2,13,1,4,14,8288,6921,1367
2,13,2,4,14,8323,6950,1373
2,13,3,4,14,8915,7274,1641
2,13,4,4,14,9170,7127,2043
2,13,5,4,14,9265,6720,2545
2,13,6,4,14,9125,6652,2473
2,13,7,4,14,9153,7040,2113
2,13,8,4,14,8953,6857,2096
2,13,9,4,14,8692,6421,2271
2,13,10,4,14,8871,6710,2161
2,14,0,4,14,8069,6645,1424
2,14,1,4,14,7904,6261,1643
2,14,2,4,14,8006,6208,1798
2,14,3,4,14,8638,6307,2331
2,14,4,4,14,8814,5980,2834
2,14,5,4,14,8746,5698,3048
2,14,6,4,14,8615,5713,2902
2,14,7,4,14,8698,6082,2616
2,14,8,4,14,8478,5969,2509
2,14,9,4,14,8166,5587,2579
2,14,10,4,14,8395,5924,2471
2,15,0,4,14,7544,6145,1399
2,15,1,4,14,7408,5716,1692
2,15,2,4,14,7514,5697,1817
2,15,3,4,14,8011,5841,2170
2,15,4,4,14,8103,5490,2613
2,15,5,4,14,7816,5353,2463
2,15,6,4,14,7672,5443,2229
2,15,7,4,14,7876,5684,2192
2,15,8,4,14,7728,5494,2234
2,15,9,4,14,7420,5046,2374
2,15,10,4,14,7643,5342,2301
2,16,0,4,14,7328,5358,1970
2,16,1,4,14,7172,4990,2182
2,16,2,4,14,7262,5021,2241
2,16,3,4,14,7695,5134,2561
2,16,4,4,14,7709,4807,2902
2,16,5,4,14,7321,4704,2617
2,16,6,4,14,7187,4816,2371
2,16,7,4,14,7511,4958,2553
2,16,8,4,14,7382,4741,2641
2,16,9,4,14,7013,4354,2659
2,16,10,4,14,7256,4521,2735
2,0,0,5,14,6946,6059,887
2,0,1,5,14,6829,5858,971
2,0,2,5,14,6698,5698,1000
2,0,3,5,14,6638,5613,1025
2,0,4,5,14,6599,5640,959
2,0,5,5,14,6574,5702,872
2,0,6,5,14,6573,5716,857
2,0,7,5,14,6577,5754,823
2,0,8,5,14,6593,5862,731
2,0,9,5,14,6702,5976,726
2,0,10,5,14,6791,6149,642
2,1,0,5,14,6703,6451,252
2,1,1,5,14,6543,6319,224
2,1,2,5,14,6358,6300,58
2,1,3,5,14,6231,6365,-134
2,1,4,5,14,6127,6526,-399
2,1,5,5,14,6059,6596,-537
2,1,6,5,14,6059,6614,-555
2,1,7,5,14,6116,6597,-481
2,1,8,5,14,6215,6550,-335
2,1,9,5,14,6368,6572,-204
2,1,10,5,14,6498,6683,-185
2,2,0,5,14,6366,7791,-1425
2,2,1,5,14,6155,7756,-1601
2,2,2,5,14,5918,7882,-1964
2,2,3,5,14,5751,8131,-2380
2,2,4,5,14,5623,8428,-2805
2,2,5,5,14,5547,8445,-2898
2,2,6,5,14,5558,8494,-2936
2,2,7,5,14,5646,8437,-2791
2,2,8,5,14,5790,8280,-2490
2,2,9,5,14,5984,8212,-2228
2,2,10,5,14,6164,8233,-2069
2,3,0,5,14,6086,8746,-2660
2,3,1,5,14,5838,8696,-2858
2,3,2,5,14,5576,8863,-3287
2,3,3,5,14,5413,9250,-3837
2,3,4,5,14,5318,9624,-4306
2,3,5,5,14,5282,9565,-4283
2,3,6,5,14,5314,9615,-4301
2,3,7,5,14,5397,9573,-4176
2,3,8,5,14,5528,9410,-3882
2,3,9,5,14,5737,9294,-3557
2,3,10,5,14,5953,9306,-3353
2,4,0,5,14,6493,9181,-2688
2,4,1,5,14,6304,9064,-2760
2,4,2,5,14,6089,9232,-3143
2,4,3,5,14,5959,9745,-3786
2,4,4,5,14,5923,10160,-4237
2,4,5,5,14,5948,10066,-4118
2,4,6,5,14,5973,10077,-4104
2,4,7,5,14,6025,10078,-4053
2,4,8,5,14,6174,9863,-3689
2,4,9,5,14,6335,9704,-3369
2,4,10,5,14,6505,9754,-3249
2,5,0,5,14,6059,10589,-4530
2,5,1,5,14,5858,10503,-4645
2,5,2,5,14,5698,10673,-4975
2,5,3,5,14,5613,11322,-5709
2,5,4,5,14,5640,11772,-6132
2,5,5,5,14,5702,11715,-6013
2,5,6,5,14,5716,11693,-5977
2,5,7,5,14,5754,11697,-5943
2,5,8,5,14,5862,11453,-5591
2,5,9,5,14,5976,11247,-5271
2,5,10,5,14,6149,11289,-5140
2,6,0,5,14,6451,11110,-4659
2,6,1,5,14,6319,10944,-4625
2,6,2,5,14,6300,11020,-4720
2,6,3,5,14,6365,11732,-5367
2,6,4,5,14,6526,12161,-5635
2,6,5,5,14,6596,12180,-5584
2,6,6,5,14,6614,12129,-5515
2,6,7,5,14,6597,12126,-5529
2,6,8,5,14,6550,11918,-5368
2,6,9,5,14,6572,11703,-5131
2,6,10,5,14,6683,11825,-5142
2,7,0,5,14,7791,10678,-2887
2,7,1,5,14,7756,10457,-2701
2,7,2,5,14,7882,10504,-2622
2,7,3,5,14,8131,11243,-3112
2,7,4,5,14,8428,11610,-3182
2,7,5,5,14,8445,11668,-3223
2,7,6,5,14,8494,11549,-3055
2,7,7,5,14,8437,11582,-3145
2,7,8,5,14,8280,11355,-3075
2,7,9,5,14,8212,11061,-2849
2,7,10,5,14,8233,11260,-3027
2,8,0,5,14,8746,10204,-1458
2,8,1,5,14,8696,9984,-1288
2,8,2,5,14,8863,10084,-1221
2,8,3,5,14,9250,10855,-1605
2,8,4,5,14,9624,11125,-1501
2,8,5,5,14,9565,11088,-1523
2,8,6,5,14,9615,10917,-1302
2,8,7,5,14,9573,11007,-1434
2,8,8,5,14,9410,10742,-1332
2,8,9,5,14,9294,10378,-1084
2,8,10,5,14,9306,10641,-1335
2,9,0,5,14,9181,9683,-502
2,9,1,5,14,9064,9499,-435
2,9,2,5,14,9232,9591,-359
2,9,3,5,14,9745,10214,-469
2,9,4,5,14,10160,10364,-204
2,9,5,5,14,10066,10131,-65
2,9,6,5,14,10077,9946,131
2,9,7,5,14,10078,10160,-82
2,9,8,5,14,9863,9976,-113
2,9,9,5,14,9704,9633,71
2,9,10,5,14,9754,9910,-156
2,10,0,5,14,10589,9457,1132
2,10,1,5,14,10503,9241,1262
2,10,2,5,14,10673,9322,1351
2,10,3,5,14,11322,9903,1419
2,10,4,5,14,11772,9969,1803
2,10,5,5,14,11715,9621,2094
2,10,6,5,14,11693,9460,2233
2,10,7,5,14,11697,9769,1928
2,10,8,5,14,11453,9601,1852
2,10,9,5,14,11247,9180,2067
2,10,10,5,14,11289,9481,1808
2,11,0,5,14,11110,9231,1879
2,11,1,5,14,10944,8969,1975
2,11,2,5,14,11020,9058,1962
2,11,3,5,14,11732,9561,2171
2,11,4,5,14,12161,9465,2696
2,11,5,5,14,12180,9028,3152
2,11,6,5,14,12129,8928,3201
2,11,7,5,14,12126,9342,2784
2,11,8,5,14,11918,9079,2839
2,11,9,5,14,11703,8521,3182
2,11,10,5,14,11825,8843,2982
2,12,0,5,14,10678,8388,2290
2,12,1,5,14,10457,7957,2500
2,12,2,5,14,10504,7969,2535
2,12,3,5,14,11243,8247,2996
2,12,4,5,14,11610,7935,3675
2,12,5,5,14,11668,7521,4147
2,12,6,5,14,11549,7505,4044
2,12,7,5,14,11582,7936,3646
2,12,8,5,14,11355,7758,3597
2,12,9,5,14,11061,7273,3788
2,12,10,5,14,11260,7694,3566
2,13,0,5,14,10204,7759,2445
2,13,1,5,14,9984,7311,2673
2,13,2,5,14,10084,7282,2802
2,13,3,5,14,10855,7417,3438
2,13,4,5,14,11125,7040,4085
2,13,5,5,14,11088,6738,4350
2,13,6,5,14,10917,6774,4143
2,13,7,5,14,11007,7146,3861
2,13,8,5,14,10742,6992,3750
2,13,9,5,14,10378,6513,3865
2,13,10,5,14,10641,6857,3784
2,14,0,5,14,9683,7271,2412
2,14,1,5,14,9499,6823,2676
2,14,2,5,14,9591,6829,2762
2,14,3,5,14,10214,7026,3188
2,14,4,5,14,10364,6673,3691
2,14,5,5,14,10131,6509,3622
2,14,6,5,14,9946,6604,3342
2,14,7,5,14,10160,6851,3309
2,14,8,5,14,9976,6614,3362
2,14,9,5,14,9633,6114,3519
2,14,10,5,14,9910,6359,3551
2,0,0,6,14,8162,8941,-779
2,0,1,6,14,7996,8854,-858
2,0,2,6,14,7809,8924,-1115
2,0,3,6,14,7684,9141,-1457
2,0,4,6,14,7584,9415,-1831
2,0,5,6,14,7515,9416,-1901
2,0,6,6,14,7512,9470,-1958
2,0,7,6,14,7563,9443,-1880
2,0,8,6,14,7659,9335,-1676
2,0,9,6,14,7817,9314,-1497
2,0,10,6,14,7946,9381,-1435
2,1,0,6,14,7853,10008,-2155
2,1,1,6,14,7641,9925,-2284
2,1,2,6,14,7400,10063,-2663
2,1,3,6,14,7241,10459,-3218
2,1,4,6,14,7114,10868,-3754
2,1,5,6,14,7030,10848,-3818
2,1,6,6,14,7035,10918,-3883
2,1,7,6,14,7122,10866,-3744
2,1,8,6,14,7270,10682,-3412
2,1,9,6,14,7470,10581,-3111
2,1,10,6,14,7646,10622,-2976
2,2,0,6,14,7628,10881,-3253
2,2,1,6,14,7384,10776,-3392
2,2,2,6,14,7118,10941,-3823
2,2,3,6,14,6960,11467,-4507
2,2,4,6,14,6867,11935,-5068
2,2,5,6,14,6830,11907,-5077
2,2,6,6,14,6861,11917,-5056
2,2,7,6,14,6939,11882,-4943
2,2,8,6,14,7062,11674,-4612
2,2,9,6,14,7271,11506,-4235
2,2,10,6,14,7480,11552,-4072
2,3,0,6,14,7786,11320,-3534
2,3,1,6,14,7550,11155,-3605
2,3,2,6,14,7285,11309,-4024
2,3,3,6,14,7135,11948,-4813
2,3,4,6,14,7093,12421,-5328
2,3,5,6,14,7123,12381,-5258
2,3,6,6,14,7154,12351,-5197
2,3,7,6,14,7201,12362,-5161
2,3,8,6,14,7339,12111,-4772
2,3,9,6,14,7539,11917,-4378
2,3,10,6,14,7751,12021,-4270
2,4,0,6,14,7224,12718,-5494
2,4,1,6,14,6956,12572,-5616
2,4,2,6,14,6725,12733,-6008
2,4,3,6,14,6585,13530,-6945
2,4,4,6,14,6572,14032,-7460
2,4,5,6,14,6614,14015,-7401
2,4,6,6,14,6631,13966,-7335
2,4,7,6,14,6690,13955,-7265
2,4,8,6,14,6832,13672,-6840
2,4,9,6,14,7005,13414,-6409
2,4,10,6,14,7237,13514,-6277
2,5,0,6,14,7667,13168,-5501
2,5,1,6,14,7486,12992,-5506
2,5,2,6,14,7411,13128,-5717
2,5,3,6,14,7411,14019,-6608
2,5,4,6,14,7511,14499,-6988
2,5,5,6,14,7537,14488,-6951
2,5,6,6,14,7553,14405,-6852
2,5,7,6,14,7583,14428,-6845
2,5,8,6,14,7616,14140,-6524
2,5,9,6,14,7687,13803,-6116
2,5,10,6,14,7838,13958,-6120
2,6,0,6,14,8941,12421,-3480
2,6,1,6,14,8854,12153,-3299
2,6,2,6,14,8924,12265,-3341
2,6,3,6,14,9141,13183,-4042
2,6,4,6,14,9415,13565,-4150
2,6,5,6,14,9416,13491,-4075
2,6,6,6,14,9470,13341,-3871
2,6,7,6,14,9443,13436,-3993
2,6,8,6,14,9335,13144,-3809
2,6,9,6,14,9314,12747,-3433
2,6,10,6,14,9381,13030,-3649
2,7,0,6,14,10008,11818,-1810
2,7,1,6,14,9925,11579,-1654
2,7,2,6,14,10063,11669,-1606
2,7,3,6,14,10459,12431,-1972
2,7,4,6,14,10868,12675,-1807
2,7,5,6,14,10848,12473,-1625
2,7,6,6,14,10918,12248,-1330
2,7,7,6,14,10866,12469,-1603
2,7,8,6,14,10682,12240,-1558
2,7,9,6,14,10581,11845,-1264
2,7,10,6,14,10622,12156,-1534
2,8,0,6,14,10881,11596,-715
2,8,1,6,14,10776,11332,-556
2,8,2,6,14,10941,11399,-458
2,8,3,6,14,11467,12106,-639
2,8,4,6,14,11935,12230,-295
2,8,5,6,14,11907,11936,-29
2,8,6,6,14,11917,11734,183
2,8,7,6,14,11882,12053,-171
2,8,8,6,14,11674,11849,-175
2,8,9,6,14,11506,11393,113
2,8,10,6,14,11552,11748,-196
2,9,0,6,14,11320,11360,-40
2,9,1,6,14,11155,11038,117
2,9,2,6,14,11309,11118,191
2,9,3,6,14,11948,11769,179
2,9,4,6,14,12421,11725,696
2,9,5,6,14,12381,11328,1053
2,9,6,6,14,12351,11201,1150
2,9,7,6,14,12362,11600,762
2,9,8,6,14,12111,11298,813
2,9,9,6,14,11917,10688,1229
2,9,10,6,14,12021,11068,953
2,10,0,6,14,12718,10446,2272
2,10,1,6,14,12572,10005,2567
2,10,2,6,14,12733,10077,2656
2,10,3,6,14,13530,10534,2996
2,10,4,6,14,14032,10273,3759
2,10,5,6,14,14015,9829,4186
2,10,6,6,14,13966,9781,4185
2,10,7,6,14,13955,10238,3717
2,10,8,6,14,13672,9980,3692
2,10,9,6,14,13414,9373,4041
2,10,10,6,14,13514,9827,3687
2,11,0,6,14,13168,9502,3666
2,11,1,6,14,12992,9007,3985
2,11,2,6,14,13128,9043,4085
2,11,3,6,14,14019,9357,4662
2,11,4,6,14,14499,8995,5504
2,11,5,6,14,14488,8561,5927
2,11,6,6,14,14405,8566,5839
2,11,7,6,14,14428,9000,5428
2,11,8,6,14,14140,8781,5359
2,11,9,6,14,13803,8199,5604
2,11,10,6,14,13958,8627,5331
2,12,0,6,14,12421,8885,3536
2,12,1,6,14,12153,8418,3735
2,12,2,6,14,12265,8414,3851
2,12,3,6,14,13183,8602,4581
2,12,4,6,14,13565,8223,5342
2,12,5,6,14,13491,7894,5597
2,12,6,6,14,13341,7935,5406
2,12,7,6,14,13436,8313,5123
2,12,8,6,14,13144,8112,5032
2,12,9,6,14,12747,7581,5166
2,12,10,6,14,13030,7874,5156
2,0,0,7,14,9312,12143,-2831
2,0,1,7,14,9094,12005,-2911
2,0,2,7,14,8851,12141,-3290
2,0,3,7,14,8694,12676,-3982
2,0,4,7,14,8571,13179,-4608
2,0,5,7,14,8486,13190,-4704
2,0,6,7,14,8488,13220,-4732
2,0,7,7,14,8569,13175,-4606
2,0,8,7,14,8714,12946,-4232
2,0,9,7,14,8919,12793,-3874
2,0,10,7,14,9094,12868,-3774
2,1,0,7,14,9115,13020,-3905
2,1,1,7,14,8870,12867,-3997
2,1,2,7,14,8600,13018,-4418
2,1,3,7,14,8450,13670,-5220
2,1,4,7,14,8358,14196,-5838
2,1,5,7,14,8313,14222,-5909
2,1,6,7,14,8338,14191,-5853
2,1,7,7,14,8415,14166,-5751
2,1,8,7,14,8542,13922,-5380
2,1,9,7,14,8757,13719,-4962
2,1,10,7,14,8962,13819,-4857
2,2,0,7,14,9328,13449,-4121
2,2,1,7,14,9096,13224,-4128
2,2,2,7,14,8827,13369,-4542
2,2,3,7,14,8682,14156,-5474
2,2,4,7,14,8642,14681,-6039
2,2,5,7,14,8671,14681,-6010
2,2,6,7,14,8701,14624,-5923
2,2,7,7,14,8743,14620,-5877
2,2,8,7,14,8873,14330,-5457
2,2,9,7,14,9073,14084,-5011
2,2,10,7,14,9278,14246,-4968
2,3,0,7,14,8517,14776,-6259
2,3,1,7,14,8202,14620,-6418
2,3,2,7,14,7921,14841,-6920
2,3,3,7,14,7761,15817,-8056
2,3,4,7,14,7742,16370,-8628
2,3,5,7,14,7789,16323,-8534
2,3,6,7,14,7812,16242,-8430
2,3,7,7,14,7866,16257,-8391
2,3,8,7,14,7997,15894,-7897
2,3,9,7,14,8209,15514,-7305
2,3,10,7,14,8483,15647,-7164
2,4,0,7,14,8832,14911,-6079
2,4,1,7,14,8584,14688,-6104
2,4,2,7,14,8438,14889,-6451
2,4,3,7,14,8383,15959,-7576
2,4,4,7,14,8443,16454,-8011
2,4,5,7,14,8449,16311,-7862
2,4,6,7,14,8468,16197,-7729
2,4,7,7,14,8519,16282,-7763
2,4,8,7,14,8586,15929,-7343
2,4,9,7,14,8716,15489,-6773
2,4,10,7,14,8926,15728,-6802
2,5,0,7,14,10157,14035,-3878
2,5,1,7,14,10021,13748,-3727
2,5,2,7,14,10035,13850,-3815
2,5,3,7,14,10187,14759,-4572
2,5,4,7,14,10400,15115,-4715
2,5,5,7,14,10357,14876,-4519
2,5,6,7,14,10409,14672,-4263
2,5,7,7,14,10429,14898,-4469
2,5,8,7,14,10401,14642,-4241
2,5,9,7,14,10429,14214,-3785
2,5,10,7,14,10536,14545,-4009
2,6,0,7,14,11158,13731,-2573
2,6,1,7,14,11023,13412,-2389
2,6,2,7,14,11105,13477,-2372
2,6,3,7,14,11469,14323,-2854
2,6,4,7,14,11855,14541,-2686
2,6,5,7,14,11819,14278,-2459
2,6,6,7,14,11894,14036,-2142
2,6,7,7,14,11872,14362,-2490
2,6,8,7,14,11737,14113,-2376
2,6,9,7,14,11683,13605,-1922
2,6,10,7,14,11770,13994,-2224
2,7,0,7,14,12143,13499,-1356
2,7,1,7,14,12005,13129,-1124
2,7,2,7,14,12141,13195,-1054
2,7,3,7,14,12676,13972,-1296
2,7,4,7,14,13179,13986,-807
2,7,5,7,14,13190,13643,-453
2,7,6,7,14,13220,13475,-255
2,7,7,7,14,13175,13884,-709
2,7,8,7,14,12946,13546,-600
2,7,9,7,14,12793,12901,-108
2,7,10,7,14,12868,13335,-467
2,8,0,7,14,13020,12575,445
2,8,1,7,14,12867,12074,793
2,8,2,7,14,13018,12137,881
2,8,3,7,14,13670,12742,928
2,8,4,7,14,14196,12533,1663
2,8,5,7,14,14222,12129,2093
2,8,6,7,14,14191,12054,2137
2,8,7,7,14,14166,12496,1670
2,8,8,7,14,13922,12199,1723
2,8,9,7,14,13719,11540,2179
2,8,10,7,14,13819,12052,1767
2,9,0,7,14,13449,11560,1889
2,9,1,7,14,13224,11055,2169
2,9,2,7,14,13369,11151,2218
2,9,3,7,14,14156,11644,2512
2,9,4,7,14,14681,11333,3348
2,9,5,7,14,14681,10869,3812
2,9,6,7,14,14624,10842,3782
2,9,7,7,14,14620,11302,3318
2,9,8,7,14,14330,11003,3327
2,9,9,7,14,14084,10299,3785
2,9,10,7,14,14246,10760,3486
2,10,0,7,14,14776,10628,4148
2,10,1,7,14,14620,10114,4506
2,10,2,7,14,14841,10175,4666
2,10,3,7,14,15817,10542,5275
2,10,4,7,14,16370,10178,6192
2,10,5,7,14,16323,9717,6606
2,10,6,7,14,16242,9727,6515
2,10,7,7,14,16257,10167,6090
2,10,8,7,14,15894,9901,5993
2,10,9,7,14,15514,9267,6247
2,10,10,7,14,15647,9644,6003
2,0,0,8,14,10574,15149,-4575
2,0,1,8,14,10323,14936,-4613
2,0,2,8,14,10051,15078,-5027
2,0,3,8,14,9903,15878,-5975
2,0,4,8,14,9815,16456,-6641
2,0,5,8,14,9769,16522,-6753
2,0,6,8,14,9791,16464,-6673
2,0,7,8,14,9862,16424,-6562
2,0,8,8,14,9986,16141,-6155
2,0,9,8,14,10206,15886,-5680
2,0,10,8,14,10410,16044,-5634
2,1,0,8,14,10815,15507,-4692
2,1,1,8,14,10582,15272,-4690
2,1,2,8,14,10309,15477,-5168
2,1,3,8,14,10172,16443,-6271
2,1,4,8,14,10133,17019,-6886
2,1,5,8,14,10154,16989,-6835
2,1,6,8,14,10178,16900,-6722
2,1,7,8,14,10219,16922,-6703
2,1,8,8,14,10353,16552,-6199
2,1,9,8,14,10559,16184,-5625
2,1,10,8,14,10760,16379,-5619
2,2,0,8,14,10059,16519,-6460
2,2,1,8,14,9748,16316,-6568
2,2,2,8,14,9463,16602,-7139
2,2,3,8,14,9308,17757,-8449
2,2,4,8,14,9291,18325,-9034
2,2,5,8,14,9337,18146,-8809
2,2,6,8,14,9359,18034,-8675
2,2,7,8,14,9408,18111,-8703
2,2,8,8,14,9531,17683,-8152
2,2,9,8,14,9743,17200,-7457
2,2,10,8,14,10010,17417,-7407
2,3,0,8,14,10125,16525,-6400
2,3,1,8,14,9830,16283,-6453
2,3,2,8,14,9634,16474,-6840
2,3,3,8,14,9559,17535,-7976
2,3,4,8,14,9613,18004,-8391
2,3,5,8,14,9624,17696,-8072
2,3,6,8,14,9649,17528,-7879
2,3,7,8,14,9695,17744,-8049
2,3,8,8,14,9751,17427,-7676
2,3,9,8,14,9920,16956,-7036
2,3,10,8,14,10172,17243,-7071
2,4,0,8,14,11322,15948,-4626
2,4,1,8,14,11119,15581,-4462
2,4,2,8,14,11062,15658,-4596
2,4,3,8,14,11159,16651,-5492
2,4,4,8,14,11332,16981,-5649
2,4,5,8,14,11269,16681,-5412
2,4,6,8,14,11324,16460,-5136
2,4,7,8,14,11365,16791,-5426
2,4,8,8,14,11371,16515,-5144
2,4,9,8,14,11458,15974,-4516
2,4,10,8,14,11624,16383,-4759
2,5,0,8,14,12374,15634,-3260
2,5,1,8,14,12190,15209,-3019
2,5,2,8,14,12216,15273,-3057
2,5,3,8,14,12515,16189,-3674
2,5,4,8,14,12840,16297,-3457
2,5,5,8,14,12760,15985,-3225
2,5,6,8,14,12833,15777,-2944
2,5,7,8,14,12858,16193,-3335
2,5,8,8,14,12803,15810,-3007
2,5,9,8,14,12798,15113,-2315
2,5,10,8,14,12925,15581,-2656
2,6,0,8,14,13293,14714,-1421
2,6,1,8,14,13103,14165,-1062
2,6,2,8,14,13183,14214,-1031
2,6,3,8,14,13686,14945,-1259
2,6,4,8,14,14166,14794,-628
2,6,5,8,14,14161,14444,-283
2,6,6,8,14,14196,14328,-132
2,6,7,8,14,14181,14780,-599
2,6,8,8,14,14001,14447,-446
2,6,9,8,14,13895,13753,142
2,6,10,8,14,14016,14319,-303
2,7,0,8,14,14282,13689,593
2,7,1,8,14,14096,13124,972
2,7,2,8,14,14218,13211,1007
2,7,3,8,14,14879,13852,1027
2,7,4,8,14,15440,13593,1847
2,7,5,8,14,15505,13169,2336
2,7,6,8,14,15494,13115,2379
2,7,7,8,14,15459,13560,1899
2,7,8,8,14,15194,13222,1972
2,7,9,8,14,15006,12466,2540
2,7,10,8,14,15135,12985,2150
2,8,0,8,14,15149,12686,2463
2,8,1,8,14,14936,12162,2774
2,8,2,8,14,15078,12283,2795
2,8,3,8,14,15878,12829,3049
2,8,4,8,14,16456,12516,3940
2,8,5,8,14,16522,12025,4497
2,8,6,8,14,16464,12003,4461
2,8,7,8,14,16424,12469,3955
2,8,8,8,14,16141,12123,4018
2,8,9,8,14,15886,11367,4519
2,8,10,8,14,16044,11777,4267
2,0,0,9,14,12274,17250,-4976
2,0,1,9,14,12035,16968,-4933
2,0,2,9,14,11760,17238,-5478
2,0,3,9,14,11625,18383,-6758
2,0,4,9,14,11590,18974,-7384
2,0,5,9,14,11610,18812,-7202
2,0,6,9,14,11631,18692,-7061
2,0,7,9,14,11666,18776,-7110
2,0,8,9,14,11797,18341,-6544
2,0,9,9,14,12008,17870,-5862
2,0,10,9,14,12208,18149,-5941
2,1,0,9,14,11546,18133,-6587
2,1,1,9,14,11234,17911,-6677
2,1,2,9,14,10945,18187,-7242
2,1,3,9,14,10798,19333,-8535
2,1,4,9,14,10782,19875,-9093
2,1,5,9,14,10820,19531,-8711
2,1,6,9,14,10836,19365,-8529
2,1,7,9,14,10884,19573,-8689
2,1,8,9,14,11011,19181,-8170
2,1,9,9,14,11229,18667,-7438
2,1,10,9,14,11492,18932,-7440
2,2,0,9,14,11667,18438,-6771
2,2,1,9,14,11376,18116,-6740
2,2,2,9,14,11176,18282,-7106
2,2,3,9,14,11106,19427,-8321
2,2,4,9,14,11162,19870,-8708
2,2,5,9,14,11172,19501,-8329
2,2,6,9,14,11196,19316,-8120
2,2,7,9,14,11237,19637,-8400
2,2,8,9,14,11285,19300,-8015
2,2,9,9,14,11454,18716,-7262
2,2,10,9,14,11699,19081,-7382
2,3,0,9,14,12615,17851,-5236
2,3,1,9,14,12365,17378,-5013
2,3,2,9,14,12258,17454,-5196
2,3,3,9,14,12335,18517,-6182
2,3,4,9,14,12502,18737,-6235
2,3,5,9,14,12444,18388,-5944
2,3,6,9,14,12505,18201,-5696
2,3,7,9,14,12541,18622,-6081
2,3,8,9,14,12536,18212,-5676
2,3,9,9,14,12662,17482,-4820
2,3,10,9,14,12870,17970,-5100
2,4,0,9,14,13539,16849,-3310
2,4,1,9,14,13288,16245,-2957
2,4,2,9,14,13243,16292,-3049
2,4,3,9,14,13487,17162,-3675
2,4,4,9,14,13772,17105,-3333
2,4,5,9,14,13672,16786,-3114
2,4,6,9,14,13748,16630,-2882
2,4,7,9,14,13794,17089,-3295
2,4,8,9,14,13773,16711,-2938
2,4,9,9,14,13827,15965,-2138
2,4,10,9,14,14013,16565,-2552
2,5,0,9,14,14509,15828,-1319
2,5,1,9,14,14270,15215,-945
2,5,2,9,14,14294,15288,-994
2,5,3,9,14,14732,16055,-1323
2,5,4,9,14,15151,15854,-703
2,5,5,9,14,15102,15484,-382
2,5,6,9,14,15135,15389,-254
2,5,7,9,14,15167,15844,-677
2,5,8,9,14,15067,15470,-403
2,5,9,9,14,15010,14679,331
2,5,10,9,14,15171,15252,-81
2,6,0,9,14,15432,14815,617
2,6,1,9,14,15194,14231,963
2,6,2,9,14,15260,14343,917
2,6,3,9,14,15889,15037,852
2,6,4,9,14,16427,14776,1651
2,6,5,9,14,16476,14325,2151
2,6,6,9,14,16470,14276,2194
2,6,7,9,14,16465,14727,1738
2,6,8,9,14,16249,14342,1907
2,6,9,9,14,16108,13534,2574
2,6,10,9,14,16283,14002,2281
2,0,0,10,14,13005,20046,-7041
2,0,1,10,14,12687,19744,-7057
2,0,2,10,14,12396,19995,-7599
2,0,3,10,14,12251,21225,-8974
2,0,4,10,14,12239,21741,-9502
2,0,5,10,14,12276,21336,-9060
2,0,6,10,14,12289,21153,-8864
2,0,7,10,14,12331,21466,-9135
2,0,8,10,14,12455,21054,-8599
2,0,9,10,14,12678,20427,-7749
2,0,10,10,14,12940,20770,-7830
2,1,0,10,14,13154,20341,-7187
2,1,1,10,14,12862,19913,-7051
2,1,2,10,14,12658,20078,-7420
2,1,3,10,14,12596,21293,-8697
2,1,4,10,14,12653,21626,-8973
2,1,5,10,14,12655,21208,-8553
2,1,6,10,14,12673,21057,-8384
2,1,7,10,14,12713,21468,-8755
2,1,8,10,14,12765,20997,-8232
2,1,9,10,14,12940,20224,-7284
2,1,10,10,14,13181,20668,-7487
2,2,0,10,14,14157,19066,-4909
2,2,1,10,14,13911,18414,-4503
2,2,2,10,14,13800,18473,-4673
2,2,3,10,14,13882,19490,-5608
2,2,4,10,14,14051,19545,-5494
2,2,5,10,14,13992,19189,-5197
2,2,6,10,14,14052,19054,-5002
2,2,7,10,14,14083,19518,-5435
2,2,8,10,14,14070,19113,-5043
2,2,9,10,14,14196,18334,-4138
2,2,10,10,14,14397,18954,-4557
2,3,0,10,14,14832,17963,-3131
2,3,1,10,14,14534,17295,-2761
2,3,2,10,14,14439,17366,-2927
2,3,3,10,14,14663,18272,-3609
2,3,4,10,14,14942,18165,-3223
2,3,5,10,14,14847,17826,-2979
2,3,6,10,14,14929,17691,-2762
2,3,7,10,14,14970,18153,-3183
2,3,8,10,14,14938,17734,-2796
2,3,9,10,14,15031,16891,-1860
2,3,10,10,14,15259,17498,-2239
2,4,0,10,14,15674,16954,-1280
2,4,1,10,14,15368,16322,-954
2,4,2,10,14,15321,16420,-1099
2,4,3,10,14,15704,17240,-1536
2,4,4,10,14,16083,17037,-954
2,4,5,10,14,16014,16640,-626
2,4,6,10,14,16050,16550,-500
2,4,7,10,14,16103,17011,-908
2,4,8,10,14,16037,16590,-553
2,4,9,10,14,16039,15747,292
2,4,10,10,14,16259,16269,-10
2,0,0,11,14,14613,21556,-6943
2,0,1,11,14,14315,20949,-6634
2,0,2,11,14,14109,21097,-6988
2,0,3,11,14,14049,22266,-8217
2,0,4,11,14,14110,22434,-8324
2,0,5,11,14,14111,22009,-7898
2,0,6,11,14,14126,21910,-7784
2,0,7,11,14,14160,22364,-8204
2,0,8,11,14,14209,21898,-7689
2,0,9,11,14,14389,21076,-6687
2,0,10,11,14,14629,21652,-7023
2,1,0,11,14,15644,20180,-4536
2,1,1,11,14,15397,19464,-4067
2,1,2,11,14,15282,19547,-4265
2,1,3,11,14,15372,20600,-5228
2,1,4,11,14,15542,20605,-5063
2,1,5,11,14,15475,20229,-4754
2,1,6,11,14,15529,20115,-4586
2,1,7,11,14,15559,20582,-5023
2,1,8,11,14,15550,20136,-4586
2,1,9,11,14,15682,19260,-3578
2,1,10,11,14,15879,19887,-4008
2,2,0,11,14,16374,19089,-2715
2,2,1,11,14,16080,18402,-2322
2,2,2,11,14,15981,18498,-2517
2,2,3,11,14,16210,19457,-3247
2,2,4,11,14,16491,19348,-2857
2,2,5,11,14,16395,18982,-2587
2,2,6,11,14,16476,18852,-2376
2,2,7,11,14,16512,19320,-2808
2,2,8,11,14,16472,18854,-2382
2,2,9,11,14,16565,17959,-1394
2,2,10,11,14,16786,18515,-1729
2,0,0,12,14,17103,21306,-4203
2,0,1,12,14,16850,20571,-3721
2,0,2,12,14,16733,20679,-3946
2,0,3,12,14,16825,21785,-4960
2,0,4,12,14,16999,21788,-4789
2,0,5,12,14,16931,21385,-4454
2,0,6,12,14,16982,21276,-4294
2,0,7,12,14,17006,21749,-4743
2,0,8,12,14,16994,21256,-4262
2,0,9,12,14,17131,20328,-3197
2,0,10,12,14,17327,20904,-3577
2,0,0,1,15,1563,1592,-29
2,0,1,1,15,1558,1593,-35
2,0,2,1,15,1549,1597,-48
2,0,3,1,15,1555,1597,-42
2,0,4,1,15,1567,1595,-28
2,0,5,1,15,1564,1585,-21
2,0,6,1,15,1551,1578,-27
2,0,7,1,15,1550,1587,-37
2,0,8,1,15,1553,1594,-41
2,0,9,1,15,1551,1588,-37
2,1,0,1,15,1592,1652,-60
2,1,1,1,15,1593,1657,-64
2,1,2,1,15,1597,1659,-62
2,1,3,1,15,1597,1656,-59
2,1,4,1,15,1595,1658,-63
2,1,5,1,15,1585,1655,-70
2,1,6,1,15,1578,1650,-72
2,1,7,1,15,1587,1652,-65
2,1,8,1,15,1594,1649,-55
2,1,9,1,15,1588,1640,-52
2,2,0,1,15,1652,1358,294
2,2,1,1,15,1657,1313,344
2,2,2,1,15,1659,1286,373
2,2,3,1,15,1656,1275,381
2,2,4,1,15,1658,1287,371
2,2,5,1,15,1655,1296,359
2,2,6,1,15,1650,1288,362
2,2,7,1,15,1652,1280,372
2,2,8,1,15,1649,1276,373
2,2,9,1,15,1640,1315,325
2,3,0,1,15,1358,1212,146
2,3,1,1,15,1313,1146,167
2,3,2,1,15,1286,1086,200
2,3,3,1,15,1275,1047,228
2,3,4,1,15,1287,1038,249
2,3,5,1,15,1296,1035,261
2,3,6,1,15,1288,1030,258
2,3,7,1,15,1280,1046,234
2,3,8,1,15,1276,1083,193
2,3,9,1,15,1315,1139,176
2,4,0,1,15,1212,1281,-69
2,4,1,1,15,1146,1233,-87
2,4,2,1,15,1086,1166,-80
2,4,3,1,15,1047,1104,-57
2,4,4,1,15,1038,1066,-28
2,4,5,1,15,1035,1048,-13
2,4,6,1,15,1030,1055,-25
2,4,7,1,15,1046,1105,-59
2,4,8,1,15,1083,1184,-101
2,4,9,1,15,1139,1223,-84
2,5,0,1,15,1281,1218,63
2,5,1,1,15,1233,1166,67
2,5,2,1,15,1166,1119,47
2,5,3,1,15,1104,1076,28
2,5,4,1,15,1066,1058,8
2,5,5,1,15,1048,1058,-10
2,5,6,1,15,1055,1073,-18
2,5,7,1,15,1105,1113,-8
2,5,8,1,15,1184,1171,13
2,5,9,1,15,1223,1217,6
2,6,0,1,15,1218,1359,-141
2,6,1,1,15,1166,1325,-159
2,6,2,1,15,1119,1299,-180
2,6,3,1,15,1076,1293,-217
2,6,4,1,15,1058,1323,-265
2,6,5,1,15,1058,1360,-302
2,6,6,1,15,1073,1375,-302
2,6,7,1,15,1113,1377,-264
2,6,8,1,15,1171,1382,-211
2,6,9,1,15,1217,1412,-195
2,7,0,1,15,1359,1838,-479
2,7,1,1,15,1325,1850,-525
2,7,2,1,15,1299,1843,-544
2,7,3,1,15,1293,1853,-560
2,7,4,1,15,1323,1904,-581
2,7,5,1,15,1360,1934,-574
2,7,6,1,15,1375,1939,-564
2,7,7,1,15,1377,1932,-555
2,7,8,1,15,1382,1929,-547
2,7,9,1,15,1412,1933,-521
2,8,0,1,15,1838,758,1080
2,8,1,1,15,1850,705,1145
2,8,2,1,15,1843,695,1148
2,8,3,1,15,1853,692,1161
2,8,4,1,15,1904,707,1197
2,8,5,1,15,1934,713,1221
2,8,6,1,15,1939,709,1230
2,8,7,1,15,1932,725,1207
2,8,8,1,15,1929,734,1195
2,8,9,1,15,1933,773,1160
2,9,0,1,15,758,1732,-974
2,9,1,1,15,705,1757,-1052
2,9,2,1,15,695,1858,-1163
2,9,3,1,15,692,1947,-1255
2,9,4,1,15,707,1983,-1276
2,9,5,1,15,713,1955,-1242
2,9,6,1,15,709,1952,-1243
2,9,7,1,15,725,1911,-1186
2,9,8,1,15,734,1853,-1119
2,9,9,1,15,773,1817,-1044
2,10,0,1,15,1732,2674,-942
2,10,1,1,15,1757,2724,-967
2,10,2,1,15,1858,2866,-1008
2,10,3,1,15,1947,3012,-1065
2,10,4,1,15,1983,3073,-1090
2,10,5,1,15,1955,3031,-1076
2,10,6,1,15,1952,3069,-1117
2,10,7,1,15,1911,3015,-1104
2,10,8,1,15,1853,2958,-1105
2,10,9,1,15,1817,2876,-1059
2,11,0,1,15,2674,2320,354
2,11,1,1,15,2724,2328,396
2,11,2,1,15,2866,2432,434
2,11,3,1,15,3012,2566,446
2,11,4,1,15,3073,2640,433
2,11,5,1,15,3031,2625,406
2,11,6,1,15,3069,2642,427
2,11,7,1,15,3015,2626,389
2,11,8,1,15,2958,2601,357
2,11,9,1,15,2876,2500,376
2,12,0,1,15,2320,2226,94
2,12,1,1,15,2328,2237,91
2,12,2,1,15,2432,2327,105
2,12,3,1,15,2566,2434,132
2,12,4,1,15,2640,2529,111
2,12,5,1,15,2625,2555,70
2,12,6,1,15,2642,2479,163
2,12,7,1,15,2626,2497,129
2,12,8,1,15,2601,2461,140
2,12,9,1,15,2500,2346,154
2,13,0,1,15,2226,2243,-17
2,13,1,1,15,2237,2246,-9
2,13,2,1,15,2327,2318,9
2,13,3,1,15,2434,2383,51
2,13,4,1,15,2529,2491,38
2,13,5,1,15,2555,2528,27
2,13,6,1,15,2479,2427,52
2,13,7,1,15,2497,2479,18
2,13,8,1,15,2461,2449,12
2,13,9,1,15,2346,2367,-21
2,14,0,1,15,2243,2215,28
2,14,1,1,15,2246,2229,17
2,14,2,1,15,2318,2315,3
2,14,3,1,15,2383,2379,4
2,14,4,1,15,2491,2507,-16
2,14,5,1,15,2528,2523,5
2,14,6,1,15,2427,2422,5
2,14,7,1,15,2479,2456,23
2,14,8,1,15,2449,2405,44
2,14,9,1,15,2367,2308,59
2,15,0,1,15,2215,2156,59
2,15,1,1,15,2229,2222,7
2,15,2,1,15,2315,2362,-47
2,15,3,1,15,2379,2457,-78
2,15,4,1,15,2507,2527,-20
2,15,5,1,15,2523,2525,-2
2,15,6,1,15,2422,2432,-10
2,15,7,1,15,2456,2470,-14
2,15,8,1,15,2405,2339,66
2,15,9,1,15,2308,2240,68
2,16,0,1,15,2156,1804,352
2,16,1,1,15,2222,1836,386
2,16,2,1,15,2362,2003,359
2,16,3,1,15,2457,2101,356
2,16,4,1,15,2527,2030,497
2,16,5,1,15,2525,1983,542
2,16,6,1,15,2432,1966,466
2,16,7,1,15,2470,2020,450
2,16,8,1,15,2339,1882,457
2,16,9,1,15,2240,1841,399
2,17,0,1,15,1804,1717,87
2,17,1,1,15,1836,1677,159
2,17,2,1,15,2003,1652,351
2,17,3,1,15,2101,1734,367
2,17,4,1,15,2030,1623,407
2,17,5,1,15,1983,1510,473
2,17,6,1,15,1966,1531,435
2,17,7,1,15,2020,1626,394
2,17,8,1,15,1882,1579,303
2,17,9,1,15,1841,1588,253
2,18,0,1,15,1717,2023,-306
2,18,1,1,15,1677,1898,-221
2,18,2,1,15,1652,1996,-344
2,18,3,1,15,1734,2100,-366
2,18,4,1,15,1623,1935,-312
2,18,5,1,15,1510,1868,-358
2,18,6,1,15,1531,1965,-434
2,18,7,1,15,1626,1972,-346
2,18,8,1,15,1579,1947,-368
2,18,9,1,15,1588,1961,-373
2,19,0,1,15,2023,1987,36
2,19,1,1,15,1898,1872,26
2,19,2,1,15,1996,1934,62
2,19,3,1,15,2100,1986,114
2,19,4,1,15,1935,1804,131
2,19,5,1,15,1868,1784,84
2,19,6,1,15,1965,1904,61
2,19,7,1,15,1972,1876,96
2,19,8,1,15,1947,1752,195
2,19,9,1,15,1961,1719,242
2,20,0,1,15,1987,1239,748
2,20,1,1,15,1872,1091,781
2,20,2,1,15,1934,1062,872
2,20,3,1,15,1986,1043,943
2,20,4,1,15,1804,863,941
2,20,5,1,15,1784,885,899
2,20,6,1,15,1904,954,950
2,20,7,1,15,1876,985,891
2,20,8,1,15,1752,997,755
2,20,9,1,15,1719,1025,694
2,21,0,1,15,1239,1147,92
2,21,1,1,15,1091,1148,-57
2,21,2,1,15,1062,1186,-124
2,21,3,1,15,1043,1180,-137
2,21,4,1,15,863,1080,-217
2,21,5,1,15,885,1098,-213
2,21,6,1,15,954,1109,-155
2,21,7,1,15,985,1118,-133
2,21,8,1,15,997,1077,-80
2,21,9,1,15,1025,982,43
2,22,0,1,15,1147,1218,-71
2,22,1,1,15,1148,1201,-53
2,22,2,1,15,1186,1239,-53
2,22,3,1,15,1180,1252,-72
2,22,4,1,15,1080,1225,-145
2,22,5,1,15,1098,1226,-128
2,22,6,1,15,1109,1215,-106
2,22,7,1,15,1118,1200,-82
2,22,8,1,15,1077,1194,-117
2,22,9,1,15,982,1115,-133
2,0,0,2,15,3155,3010,145
2,0,1,2,15,3151,2970,181
2,0,2,2,15,3146,2945,201
2,0,3,2,15,3152,2931,221
2,0,4,2,15,3162,2945,217
2,0,5,2,15,3149,2951,198
2,0,6,2,15,3129,2938,191
2,0,7,2,15,3137,2932,205
2,0,8,2,15,3147,2925,222
2,0,9,2,15,3139,2955,184
2,1,0,2,15,3244,2570,674
2,1,1,2,15,3250,2459,791
2,1,2,2,15,3256,2372,884
2,1,3,2,15,3253,2322,931
2,1,4,2,15,3253,2325,928
2,1,5,2,15,3240,2331,909
2,1,6,2,15,3228,2318,910
2,1,7,2,15,3239,2326,913
2,1,8,2,15,3243,2359,884
2,1,9,2,15,3228,2454,774
2,2,0,2,15,3010,2493,517
2,2,1,2,15,2970,2379,591
2,2,2,2,15,2945,2252,693
2,2,3,2,15,2931,2151,780
2,2,4,2,15,2945,2104,841
2,2,5,2,15,2951,2083,868
2,2,6,2,15,2938,2085,853
2,2,7,2,15,2932,2151,781
2,2,8,2,15,2925,2267,658
2,2,9,2,15,2955,2362,593
2,3,0,2,15,2570,2499,71
2,3,1,2,15,2459,2399,60
2,3,2,2,15,2372,2285,87
2,3,3,2,15,2322,2180,142
2,3,4,2,15,2325,2124,201
2,3,5,2,15,2331,2106,225
2,3,6,2,15,2318,2128,190
2,3,7,2,15,2326,2218,108
2,3,8,2,15,2359,2355,4
2,3,9,2,15,2454,2440,14
2,4,0,2,15,2493,2577,-84
2,4,1,2,15,2379,2491,-112
2,4,2,2,15,2252,2418,-166
2,4,3,2,15,2151,2369,-218
2,4,4,2,15,2104,2381,-277
2,4,5,2,15,2083,2418,-335
2,4,6,2,15,2085,2448,-363
2,4,7,2,15,2151,2490,-339
2,4,8,2,15,2267,2553,-286
2,4,9,2,15,2362,2629,-267
2,5,0,2,15,2499,3197,-698
2,5,1,2,15,2399,3175,-776
2,5,2,2,15,2285,3142,-857
2,5,3,2,15,2180,3146,-966
2,5,4,2,15,2124,3227,-1103
2,5,5,2,15,2106,3294,-1188
2,5,6,2,15,2128,3314,-1186
2,5,7,2,15,2218,3309,-1091
2,5,8,2,15,2355,3311,-956
2,5,9,2,15,2440,3345,-905
2,6,0,2,15,2577,2596,-19
2,6,1,2,15,2491,2555,-64
2,6,2,2,15,2418,2538,-120
2,6,3,2,15,2369,2545,-176
2,6,4,2,15,2381,2611,-230
2,6,5,2,15,2418,2647,-229
2,6,6,2,15,2448,2648,-200
2,6,7,2,15,2490,2657,-167
2,6,8,2,15,2553,2663,-110
2,6,9,2,15,2629,2706,-77
2,7,0,2,15,3197,2490,707
2,7,1,2,15,3175,2462,713
2,7,2,2,15,3142,2553,589
2,7,3,2,15,3146,2639,507
2,7,4,2,15,3227,2690,537
2,7,5,2,15,3294,2668,626
2,7,6,2,15,3314,2661,653
2,7,7,2,15,3309,2636,673
2,7,8,2,15,3311,2587,724
2,7,9,2,15,3345,2590,755
2,8,0,2,15,2596,4406,-1810
2,8,1,2,15,2555,4481,-1926
2,8,2,2,15,2538,4724,-2186
2,8,3,2,15,2545,4959,-2414
2,8,4,2,15,2611,5056,-2445
2,8,5,2,15,2647,4986,-2339
2,8,6,2,15,2648,5021,-2373
2,8,7,2,15,2657,4926,-2269
2,8,8,2,15,2663,4811,-2148
2,8,9,2,15,2706,4693,-1987
2,9,0,2,15,2490,4994,-2504
2,9,1,2,15,2462,5052,-2590
2,9,2,2,15,2553,5298,-2745
2,9,3,2,15,2639,5578,-2939
2,9,4,2,15,2690,5713,-3023
2,9,5,2,15,2668,5656,-2988
2,9,6,2,15,2661,5711,-3050
2,9,7,2,15,2636,5641,-3005
2,9,8,2,15,2587,5559,-2972
2,9,9,2,15,2590,5376,-2786
2,10,0,2,15,4406,4546,-140
2,10,1,2,15,4481,4565,-84
2,10,2,2,15,4724,4759,-35
2,10,3,2,15,4959,5000,-41
2,10,4,2,15,5056,5169,-113
2,10,5,2,15,4986,5180,-194
2,10,6,2,15,5021,5121,-100
2,10,7,2,15,4926,5123,-197
2,10,8,2,15,4811,5062,-251
2,10,9,2,15,4693,4846,-153
2,11,0,2,15,4994,4469,525
2,11,1,2,15,5052,4483,569
2,11,2,2,15,5298,4645,653
2,11,3,2,15,5578,4817,761
2,11,4,2,15,5713,5020,693
2,11,5,2,15,5656,5083,573
2,11,6,2,15,5711,4906,805
2,11,7,2,15,5641,4976,665
2,11,8,2,15,5559,4910,649
2,11,9,2,15,5376,4713,663
2,12,0,2,15,4546,4458,88
2,12,1,2,15,4565,4475,90
2,12,2,2,15,4759,4633,126
2,12,3,2,15,5000,4762,238
2,12,4,2,15,5169,4998,171
2,12,5,2,15,5180,5051,129
2,12,6,2,15,5121,4849,272
2,12,7,2,15,5123,4935,188
2,12,8,2,15,5062,4854,208
2,12,9,2,15,4846,4675,171
2,13,0,2,15,4469,4371,98
2,13,1,2,15,4483,4451,32
2,13,2,2,15,4645,4677,-32
2,13,3,2,15,4817,4836,-19
2,13,4,2,15,5020,5034,-14
2,13,5,2,15,5083,5048,35
2,13,6,2,15,4906,4854,52
2,13,7,2,15,4976,4926,50
2,13,8,2,15,4910,4744,166
2,13,9,2,15,4713,4548,165
2,14,0,2,15,4458,3960,498
2,14,1,2,15,4475,4058,417
2,14,2,2,15,4633,4365,268
2,14,3,2,15,4762,4558,204
2,14,4,2,15,4998,4557,441
2,14,5,2,15,5051,4508,543
2,14,6,2,15,4849,4398,451
2,14,7,2,15,4935,4490,445
2,14,8,2,15,4854,4221,633
2,14,9,2,15,4675,4081,594
2,15,0,2,15,4371,3521,850
2,15,1,2,15,4451,3513,938
2,15,2,2,15,4677,3655,1022
2,15,3,2,15,4836,3835,1001
2,15,4,2,15,5034,3653,1381
2,15,5,2,15,5048,3493,1555
2,15,6,2,15,4854,3497,1357
2,15,7,2,15,4926,3646,1280
2,15,8,2,15,4744,3461,1283
2,15,9,2,15,4548,3429,1119
2,16,0,2,15,3960,3740,220
2,16,1,2,15,4058,3575,483
2,16,2,2,15,4365,3648,717
2,16,3,2,15,4558,3834,724
2,16,4,2,15,4557,3558,999
2,16,5,2,15,4508,3378,1130
2,16,6,2,15,4398,3496,902
2,16,7,2,15,4490,3598,892
2,16,8,2,15,4221,3526,695
2,16,9,2,15,4081,3549,532
2,17,0,2,15,3521,4010,-489
2,17,1,2,15,3513,3770,-257
2,17,2,2,15,3655,3930,-275
2,17,3,2,15,3835,4086,-251
2,17,4,2,15,3653,3739,-86
2,17,5,2,15,3493,3652,-159
2,17,6,2,15,3497,3869,-372
2,17,7,2,15,3646,3848,-202
2,17,8,2,15,3461,3699,-238
2,17,9,2,15,3429,3680,-251
2,18,0,2,15,3740,3226,514
2,18,1,2,15,3575,2963,612
2,18,2,2,15,3648,2996,652
2,18,3,2,15,3834,3029,805
2,18,4,2,15,3558,2667,891
2,18,5,2,15,3378,2669,709
2,18,6,2,15,3496,2858,638
2,18,7,2,15,3598,2861,737
2,18,8,2,15,3526,2749,777
2,18,9,2,15,3549,2744,805
2,19,0,2,15,4010,2386,1624
2,19,1,2,15,3770,2239,1531
2,19,2,2,15,3930,2248,1682
2,19,3,2,15,4086,2223,1863
2,19,4,2,15,3739,1943,1796
2,19,5,2,15,3652,1983,1669
2,19,6,2,15,3869,2063,1806
2,19,7,2,15,3848,2103,1745
2,19,8,2,15,3699,2074,1625
2,19,9,2,15,3680,2007,1673
2,20,0,2,15,3226,2365,861
2,20,1,2,15,2963,2349,614
2,20,2,2,15,2996,2425,571
2,20,3,2,15,3029,2432,597
2,20,4,2,15,2667,2305,362
2,20,5,2,15,2669,2324,345
2,20,6,2,15,2858,2324,534
2,20,7,2,15,2861,2318,543
2,20,8,2,15,2749,2271,478
2,20,9,2,15,2744,2097,647
2,0,0,3,15,4807,3851,956
2,0,1,3,15,4808,3692,1116
2,0,2,3,15,4805,3538,1267
2,0,3,3,15,4808,3426,1382
2,0,4,3,15,4820,3391,1429
2,0,5,3,15,4804,3379,1425
2,0,6,3,15,4779,3373,1406
2,0,7,3,15,4789,3431,1358
2,0,8,3,15,4796,3543,1253
2,0,9,3,15,4779,3677,1102
2,1,0,3,15,4602,3711,891
2,1,1,3,15,4563,3545,1018
2,1,2,3,15,4542,3371,1171
2,1,3,3,15,4528,3227,1301
2,1,4,3,15,4540,3162,1378
2,1,5,3,15,4536,3141,1395
2,1,6,3,15,4516,3158,1358
2,1,7,3,15,4519,3264,1255
2,1,8,3,15,4519,3438,1081
2,1,9,3,15,4543,3579,964
2,2,0,3,15,4222,3858,364
2,2,1,3,15,4116,3724,392
2,2,2,3,15,4031,3584,447
2,2,3,3,15,3978,3473,505
2,2,4,3,15,3983,3447,536
2,2,5,3,15,3986,3466,520
2,2,6,3,15,3968,3503,465
2,2,7,3,15,3978,3595,383
2,2,8,3,15,4008,3737,271
2,2,9,3,15,4094,3852,242
2,3,0,3,15,3851,4415,-564
2,3,1,3,15,3692,4341,-649
2,3,2,3,15,3538,4261,-723
2,3,3,3,15,3426,4222,-796
2,3,4,3,15,3391,4285,-894
2,3,5,3,15,3379,4352,-973
2,3,6,3,15,3373,4387,-1014
2,3,7,3,15,3431,4422,-991
2,3,8,3,15,3543,4482,-939
2,3,9,3,15,3677,4562,-885
2,4,0,3,15,3711,3955,-244
2,4,1,3,15,3545,3880,-335
2,4,2,3,15,3371,3837,-466
2,4,3,3,15,3227,3838,-611
2,4,4,3,15,3162,3934,-772
2,4,5,3,15,3141,4007,-866
2,4,6,3,15,3158,4023,-865
2,4,7,3,15,3264,4034,-770
2,4,8,3,15,3438,4045,-607
2,4,9,3,15,3579,4118,-539
2,5,0,3,15,3858,4328,-470
2,5,1,3,15,3724,4312,-588
2,5,2,3,15,3584,4396,-812
2,5,3,3,15,3473,4492,-1019
2,5,4,3,15,3447,4594,-1147
2,5,5,3,15,3466,4602,-1136
2,5,6,3,15,3503,4600,-1097
2,5,7,3,15,3595,4568,-973
2,5,8,3,15,3737,4516,-779
2,5,9,3,15,3852,4523,-671
2,6,0,3,15,4415,5164,-749
2,6,1,3,15,4341,5186,-845
2,6,2,3,15,4261,5419,-1158
2,6,3,3,15,4222,5651,-1429
2,6,4,3,15,4285,5763,-1478
2,6,5,3,15,4352,5699,-1347
2,6,6,3,15,4387,5730,-1343
2,6,7,3,15,4422,5651,-1229
2,6,8,3,15,4482,5545,-1063
2,6,9,3,15,4562,5466,-904
2,7,0,3,15,3955,6726,-2771
2,7,1,3,15,3880,6809,-2929
2,7,2,3,15,3837,7156,-3319
2,7,3,3,15,3838,7525,-3687
2,7,4,3,15,3934,7696,-3762
2,7,5,3,15,4007,7611,-3604
2,7,6,3,15,4023,7663,-3640
2,7,7,3,15,4034,7552,-3518
2,7,8,3,15,4045,7412,-3367
2,7,9,3,15,4118,7193,-3075
2,8,0,3,15,4328,7220,-2892
2,8,1,3,15,4312,7289,-2977
2,8,2,3,15,4396,7625,-3229
2,8,3,3,15,4492,8012,-3520
2,8,4,3,15,4594,8242,-3648
2,8,5,3,15,4602,8211,-3609
2,8,6,3,15,4600,8190,-3590
2,8,7,3,15,4568,8138,-3570
2,8,8,3,15,4516,8020,-3504
2,8,9,3,15,4523,7722,-3199
2,9,0,3,15,5164,6789,-1625
2,9,1,3,15,5186,6811,-1625
2,9,2,3,15,5419,7077,-1658
2,9,3,3,15,5651,7383,-1732
2,9,4,3,15,5763,7660,-1897
2,9,5,3,15,5699,7708,-2009
2,9,6,3,15,5730,7548,-1818
2,9,7,3,15,5651,7602,-1951
2,9,8,3,15,5545,7511,-1966
2,9,9,3,15,5466,7213,-1747
2,10,0,3,15,6726,6684,42
2,10,1,3,15,6809,6712,97
2,10,2,3,15,7156,6960,196
2,10,3,3,15,7525,7196,329
2,10,4,3,15,7696,7527,169
2,10,5,3,15,7611,7606,5
2,10,6,3,15,7663,7328,335
2,10,7,3,15,7552,7432,120
2,10,8,3,15,7412,7315,97
2,10,9,3,15,7193,7021,172
2,11,0,3,15,7220,6614,606
2,11,1,3,15,7289,6697,592
2,11,2,3,15,7625,6995,630
2,11,3,3,15,8012,7219,793
2,11,4,3,15,8242,7525,717
2,11,5,3,15,8211,7576,635
2,11,6,3,15,8190,7281,909
2,11,7,3,15,8138,7405,733
2,11,8,3,15,8020,7193,827
2,11,9,3,15,7722,6915,807
2,12,0,3,15,6789,6175,614
2,12,1,3,15,6811,6287,524
2,12,2,3,15,7077,6680,397
2,12,3,3,15,7383,6937,446
2,12,4,3,15,7660,7064,596
2,12,5,3,15,7708,7031,677
2,12,6,3,15,7548,6820,728
2,12,7,3,15,7602,6946,656
2,12,8,3,15,7511,6626,885
2,12,9,3,15,7213,6389,824
2,13,0,3,15,6684,5677,1007
2,13,1,3,15,6712,5735,977
2,13,2,3,15,6960,6017,943
2,13,3,3,15,7196,6292,904
2,13,4,3,15,7527,6180,1347
2,13,5,3,15,7606,6018,1588
2,13,6,3,15,7328,5929,1399
2,13,7,3,15,7432,6116,1316
2,13,8,3,15,7315,5800,1515
2,13,9,3,15,7021,5669,1352
2,14,0,3,15,6614,5544,1070
2,14,1,3,15,6697,5411,1286
2,14,2,3,15,6995,5651,1344
2,14,3,3,15,7219,5935,1284
2,14,4,3,15,7525,5588,1937
2,14,5,3,15,7576,5361,2215
2,14,6,3,15,7281,5462,1819
2,14,7,3,15,7405,5618,1787
2,14,8,3,15,7193,5408,1785
2,14,9,3,15,6915,5390,1525
2,15,0,3,15,6175,5727,448
2,15,1,3,15,6287,5447,840
2,15,2,3,15,6680,5582,1098
2,15,3,3,15,6937,5820,1117
2,15,4,3,15,7064,5362,1702
2,15,5,3,15,7031,5162,1869
2,15,6,3,15,6820,5400,1420
2,15,7,3,15,6946,5474,1472
2,15,8,3,15,6626,5278,1348
2,15,9,3,15,6389,5268,1121
2,16,0,3,15,5677,5249,428
2,16,1,3,15,5735,4861,874
2,16,2,3,15,6017,4992,1025
2,16,3,3,15,6292,5129,1163
2,16,4,3,15,6180,4602,1578
2,16,5,3,15,6018,4537,1481
2,16,6,3,15,5929,4823,1106
2,16,7,3,15,6116,4833,1283
2,16,8,3,15,5800,4696,1104
2,16,9,3,15,5669,4705,964
2,17,0,3,15,5544,4373,1171
2,17,1,3,15,5411,4111,1300
2,17,2,3,15,5651,4182,1469
2,17,3,3,15,5935,4209,1726
2,17,4,3,15,5588,3747,1841
2,17,5,3,15,5361,3767,1594
2,17,6,3,15,5462,3967,1495
2,17,7,3,15,5618,3979,1639
2,17,8,3,15,5408,3826,1582
2,17,9,3,15,5390,3726,1664
2,18,0,3,15,5727,3604,2123
2,18,1,3,15,5447,3440,2007
2,18,2,3,15,5582,3487,2095
2,18,3,3,15,5820,3475,2345
2,18,4,3,15,5362,3168,2194
2,18,5,3,15,5162,3209,1953
2,18,6,3,15,5400,3278,2122
2,18,7,3,15,5474,3303,2171
2,18,8,3,15,5278,3268,2010
2,18,9,3,15,5268,3122,2146
2,0,0,4,15,6165,5070,1095
2,0,1,4,15,6121,4870,1251
2,0,2,4,15,6091,4670,1421
2,0,3,4,15,6083,4520,1563
2,0,4,4,15,6107,4485,1622
2,0,5,4,15,6100,4501,1599
2,0,6,4,15,6067,4533,1534
2,0,7,4,15,6069,4641,1428
2,0,8,4,15,6072,4820,1252
2,0,9,4,15,6094,4991,1103
2,1,0,4,15,5814,5696,118
2,1,1,4,15,5709,5574,135
2,1,2,4,15,5628,5427,201
2,1,3,4,15,5575,5326,249
2,1,4,4,15,5578,5351,227
2,1,5,4,15,5571,5400,171
2,1,6,4,15,5546,5442,104
2,1,7,4,15,5565,5527,38
2,1,8,4,15,5602,5666,-64
2,1,9,4,15,5682,5785,-103
2,2,0,4,15,5503,5173,330
2,2,1,4,15,5349,5046,303
2,2,2,4,15,5197,4956,241
2,2,3,4,15,5082,4914,168
2,2,4,4,15,5049,4992,57
2,2,5,4,15,5034,5065,-31
2,2,6,4,15,5023,5096,-73
2,2,7,4,15,5083,5147,-64
2,2,8,4,15,5192,5216,-24
2,2,9,4,15,5317,5335,-18
2,3,0,4,15,5069,5687,-618
2,3,1,4,15,4858,5637,-779
2,3,2,4,15,4657,5695,-1038
2,3,3,4,15,4502,5785,-1283
2,3,4,4,15,4449,5917,-1468
2,3,5,4,15,4437,5962,-1525
2,3,6,4,15,4446,5975,-1529
2,3,7,4,15,4544,5945,-1401
2,3,8,4,15,4714,5898,-1184
2,3,9,4,15,4894,5935,-1041
2,4,0,4,15,5070,7002,-1932
2,4,1,4,15,4870,7036,-2166
2,4,2,4,15,4670,7262,-2592
2,4,3,4,15,4520,7504,-2984
2,4,4,4,15,4485,7667,-3182
2,4,5,4,15,4501,7633,-3132
2,4,6,4,15,4533,7669,-3136
2,4,7,4,15,4641,7583,-2942
2,4,8,4,15,4820,7474,-2654
2,4,9,4,15,4991,7399,-2408
2,5,0,4,15,5696,7484,-1788
2,5,1,4,15,5574,7514,-1940
2,5,2,4,15,5427,7851,-2424
2,5,3,4,15,5326,8217,-2891
2,5,4,4,15,5351,8403,-3052
2,5,5,4,15,5400,8324,-2924
2,5,6,4,15,5442,8372,-2930
2,5,7,4,15,5527,8277,-2750
2,5,8,4,15,5666,8146,-2480
2,5,9,4,15,5785,7966,-2181
2,6,0,4,15,5173,8952,-3779
2,6,1,4,15,5046,9046,-4000
2,6,2,4,15,4956,9483,-4527
2,6,3,4,15,4914,9959,-5045
2,6,4,4,15,4992,10225,-5233
2,6,5,4,15,5065,10166,-5101
2,6,6,4,15,5096,10142,-5046
2,6,7,4,15,5147,10049,-4902
2,6,8,4,15,5216,9873,-4657
2,6,9,4,15,5335,9539,-4204
2,7,0,4,15,5687,9463,-3776
2,7,1,4,15,5637,9535,-3898
2,7,2,4,15,5695,9943,-4248
2,7,3,4,15,5785,10395,-4610
2,7,4,4,15,5917,10733,-4816
2,7,5,4,15,5962,10739,-4777
2,7,6,4,15,5975,10617,-4642
2,7,7,4,15,5945,10617,-4672
2,7,8,4,15,5898,10469,-4571
2,7,9,4,15,5935,10089,-4154
2,8,0,4,15,7002,9004,-2002
2,8,1,4,15,7036,9040,-2004
2,8,2,4,15,7262,9392,-2130
2,8,3,4,15,7504,9762,-2258
2,8,4,4,15,7667,10167,-2500
2,8,5,4,15,7633,10231,-2598
2,8,6,4,15,7669,9970,-2301
2,8,7,4,15,7583,10058,-2475
2,8,8,4,15,7474,9916,-2442
2,8,9,4,15,7399,9521,-2122
2,9,0,4,15,7484,8840,-1356
2,9,1,4,15,7514,8934,-1420
2,9,2,4,15,7851,9322,-1471
2,9,3,4,15,8217,9653,-1436
2,9,4,4,15,8403,10054,-1651
2,9,5,4,15,8324,10131,-1807
2,9,6,4,15,8372,9760,-1388
2,9,7,4,15,8277,9902,-1625
2,9,8,4,15,8146,9654,-1508
2,9,9,4,15,7966,9261,-1295
2,10,0,4,15,8952,8418,534
2,10,1,4,15,9046,8533,513
2,10,2,4,15,9483,8998,485
2,10,3,4,15,9959,9320,639
2,10,4,4,15,10225,9555,670
2,10,5,4,15,10166,9559,607
2,10,6,4,15,10142,9247,895
2,10,7,4,15,10049,9425,624
2,10,8,4,15,9873,9075,798
2,10,9,4,15,9539,8756,783
2,11,0,4,15,9463,7892,1571
2,11,1,4,15,9535,7964,1571
2,11,2,4,15,9943,8332,1611
2,11,3,4,15,10395,8671,1724
2,11,4,4,15,10733,8687,2046
2,11,5,4,15,10739,8541,2198
2,11,6,4,15,10617,8351,2266
2,11,7,4,15,10617,8572,2045
2,11,8,4,15,10469,8205,2264
2,11,9,4,15,10089,7977,2112
2,12,0,4,15,9004,7700,1304
2,12,1,4,15,9040,7633,1407
2,12,2,4,15,9392,8013,1379
2,12,3,4,15,9762,8392,1370
2,12,4,4,15,10167,8115,2052
2,12,5,4,15,10231,7886,2345
2,12,6,4,15,9970,7894,2076
2,12,7,4,15,10058,8088,1970
2,12,8,4,15,9916,7747,2169
2,12,9,4,15,9521,7630,1891
2,13,0,4,15,8840,7531,1309
2,13,1,4,15,8934,7283,1651
2,13,2,4,15,9322,7585,1737
2,13,3,4,15,9653,7921,1732
2,13,4,4,15,10054,7392,2662
2,13,5,4,15,10131,7145,2986
2,13,6,4,15,9760,7366,2394
2,13,7,4,15,9902,7494,2408
2,13,8,4,15,9654,7160,2494
2,13,9,4,15,9261,7109,2152
2,14,0,4,15,8418,6966,1452
2,14,1,4,15,8533,6538,1995
2,14,2,4,15,8998,6644,2354
2,14,3,4,15,9320,6863,2457
2,14,4,4,15,9555,6225,3330
2,14,5,4,15,9559,6047,3512
2,14,6,4,15,9247,6354,2893
2,14,7,4,15,9425,6459,2966
2,14,8,4,15,9075,6275,2800
2,14,9,4,15,8756,6293,2463
2,15,0,4,15,7892,6396,1496
2,15,1,4,15,7964,6009,1955
2,15,2,4,15,8332,6178,2154
2,15,3,4,15,8671,6309,2362
2,15,4,4,15,8687,5682,3005
2,15,5,4,15,8541,5635,2906
2,15,6,4,15,8351,5932,2419
2,15,7,4,15,8572,5951,2621
2,15,8,4,15,8205,5773,2432
2,15,9,4,15,7977,5687,2290
2,16,0,4,15,7700,5591,2109
2,16,1,4,15,7633,5312,2321
2,16,2,4,15,8013,5421,2592
2,16,3,4,15,8392,5461,2931
2,16,4,4,15,8115,4972,3143
2,16,5,4,15,7886,4993,2893
2,16,6,4,15,7894,5182,2712
2,16,7,4,15,8088,5179,2909
2,16,8,4,15,7747,5020,2727
2,16,9,4,15,7630,4841,2789
2,0,0,5,15,7377,6454,923
2,0,1,5,15,7267,6279,988
2,0,2,5,15,7177,6122,1055
2,0,3,5,15,7130,6018,1112
2,0,4,5,15,7145,6058,1087
2,0,5,5,15,7135,6113,1022
2,0,6,5,15,7097,6151,946
2,0,7,5,15,7115,6252,863
2,0,8,5,15,7155,6400,755
2,0,9,5,15,7233,6558,675
2,1,0,5,15,7095,6905,190
2,1,1,5,15,6942,6803,139
2,1,2,5,15,6794,6814,-20
2,1,3,5,15,6679,6861,-182
2,1,4,5,15,6644,6975,-331
2,1,5,5,15,6619,7020,-401
2,1,6,5,15,6601,7048,-447
2,1,7,5,15,6670,7058,-388
2,1,8,5,15,6786,7069,-283
2,1,9,5,15,6905,7152,-247
2,2,0,5,15,6721,8361,-1640
2,2,1,5,15,6515,8361,-1846
2,2,2,5,15,6316,8561,-2245
2,2,3,5,15,6158,8797,-2639
2,2,4,5,15,6107,8990,-2883
2,2,5,5,15,6092,8993,-2901
2,2,6,5,15,6096,9044,-2948
2,2,7,5,15,6196,8960,-2764
2,2,8,5,15,6363,8856,-2493
2,2,9,5,15,6534,8811,-2277
2,3,0,5,15,6428,9322,-2894
2,3,1,5,15,6183,9364,-3181
2,3,2,5,15,5956,9694,-3738
2,3,3,5,15,5795,10070,-4275
2,3,4,5,15,5772,10307,-4535
2,3,5,5,15,5797,10258,-4461
2,3,6,5,15,5821,10311,-4490
2,3,7,5,15,5921,10209,-4288
2,3,8,5,15,6096,10075,-3979
2,3,9,5,15,6306,9899,-3593
2,4,0,5,15,6908,9710,-2802
2,4,1,5,15,6720,9751,-3031
2,4,2,5,15,6513,10178,-3665
2,4,3,5,15,6373,10651,-4278
2,4,4,5,15,6389,10932,-4543
2,4,5,5,15,6435,10879,-4444
2,4,6,5,15,6472,10851,-4379
2,4,7,5,15,6573,10774,-4201
2,4,8,5,15,6749,10607,-3858
2,4,9,5,15,6924,10312,-3388
2,5,0,5,15,6454,11195,-4741
2,5,1,5,15,6279,11292,-5013
2,5,2,5,15,6122,11801,-5679
2,5,3,5,15,6018,12342,-6324
2,5,4,5,15,6058,12716,-6658
2,5,5,5,15,6113,12694,-6581
2,5,6,5,15,6151,12569,-6418
2,5,7,5,15,6252,12528,-6276
2,5,8,5,15,6400,12322,-5922
2,5,9,5,15,6558,11906,-5348
2,6,0,5,15,6905,11678,-4773
2,6,1,5,15,6803,11764,-4961
2,6,2,5,15,6814,12258,-5444
2,6,3,5,15,6861,12774,-5913
2,6,4,5,15,6975,13240,-6265
2,6,5,5,15,7020,13262,-6242
2,6,6,5,15,7048,13039,-5991
2,6,7,5,15,7058,13073,-6015
2,6,8,5,15,7069,12874,-5805
2,6,9,5,15,7152,12397,-5245
2,7,0,5,15,8361,11160,-2799
2,7,1,5,15,8361,11262,-2901
2,7,2,5,15,8561,11754,-3193
2,7,3,5,15,8797,12219,-3422
2,7,4,5,15,8990,12694,-3704
2,7,5,5,15,8993,12756,-3763
2,7,6,5,15,9044,12402,-3358
2,7,7,5,15,8960,12528,-3568
2,7,8,5,15,8856,12255,-3399
2,7,9,5,15,8811,11761,-2950
2,8,0,5,15,9322,10644,-1322
2,8,1,5,15,9364,10770,-1406
2,8,2,5,15,9694,11325,-1631
2,8,3,5,15,10070,11754,-1684
2,8,4,5,15,10307,12084,-1777
2,8,5,5,15,10258,12114,-1856
2,8,6,5,15,10311,11726,-1415
2,8,7,5,15,10209,11922,-1713
2,8,8,5,15,10075,11536,-1461
2,8,9,5,15,9899,11102,-1203
2,9,0,5,15,9710,10135,-425
2,9,1,5,15,9751,10210,-459
2,9,2,5,15,10178,10650,-472
2,9,3,5,15,10651,11054,-403
2,9,4,5,15,10932,11178,-246
2,9,5,5,15,10879,11069,-190
2,9,6,5,15,10851,10778,73
2,9,7,5,15,10774,11051,-277
2,9,8,5,15,10607,10654,-47
2,9,9,5,15,10312,10344,-32
2,10,0,5,15,11195,9915,1280
2,10,1,5,15,11292,9862,1430
2,10,2,5,15,11801,10328,1473
2,10,3,5,15,12342,10771,1571
2,10,4,5,15,12716,10622,2094
2,10,5,5,15,12694,10409,2285
2,10,6,5,15,12569,10316,2253
2,10,7,5,15,12528,10544,1984
2,10,8,5,15,12322,10152,2170
2,10,9,5,15,11906,9938,1968
2,11,0,5,15,11678,9687,1991
2,11,1,5,15,11764,9505,2259
2,11,2,5,15,12258,9947,2311
2,11,3,5,15,12774,10378,2396
2,11,4,5,15,13240,9919,3321
2,11,5,5,15,13262,9670,3592
2,11,6,5,15,13039,9798,3241
2,11,7,5,15,13073,9964,3109
2,11,8,5,15,12874,9499,3375
2,11,9,5,15,12397,9349,3048
2,12,0,5,15,11160,8770,2390
2,12,1,5,15,11262,8374,2888
2,12,2,5,15,11754,8647,3107
2,12,3,5,15,12219,8964,3255
2,12,4,5,15,12694,8255,4439
2,12,5,5,15,12756,8030,4726
2,12,6,5,15,12402,8320,4082
2,12,7,5,15,12528,8479,4049
2,12,8,5,15,12255,8157,4098
2,12,9,5,15,11761,8134,3627
2,13,0,5,15,10644,8113,2531
2,13,1,5,15,10770,7686,3084
2,13,2,5,15,11325,7830,3495
2,13,3,5,15,11754,8043,3711
2,13,4,5,15,12084,7305,4779
2,13,5,5,15,12114,7145,4969
2,13,6,5,15,11726,7463,4263
2,13,7,5,15,11922,7577,4345
2,13,8,5,15,11536,7352,4184
2,13,9,5,15,11102,7275,3827
2,14,0,5,15,10135,7614,2521
2,14,1,5,15,10210,7210,3000
2,14,2,5,15,10650,7417,3233
2,14,3,5,15,11054,7561,3493
2,14,4,5,15,11178,6907,4271
2,14,5,5,15,11069,6861,4208
2,14,6,5,15,10778,7147,3631
2,14,7,5,15,11051,7151,3900
2,14,8,5,15,10654,6967,3687
2,14,9,5,15,10344,6802,3542
2,0,0,6,15,8658,9579,-921
2,0,1,6,15,8500,9527,-1027
2,0,2,6,15,8343,9680,-1337
2,0,3,6,15,8234,9873,-1639
2,0,4,6,15,8211,10048,-1837
2,0,5,6,15,8183,10051,-1868
2,0,6,6,15,8152,10117,-1965
2,0,7,6,15,8220,10073,-1853
2,0,8,6,15,8339,10027,-1688
2,0,9,6,15,8456,10028,-1572
2,1,0,6,15,8313,10681,-2368
2,1,1,6,15,8108,10689,-2581
2,1,2,6,15,7913,10993,-3080
2,1,3,6,15,7755,11363,-3608
2,1,4,6,15,7702,11630,-3928
2,1,5,6,15,7677,11618,-3941
2,1,6,6,15,7674,11686,-4012
2,1,7,6,15,7783,11586,-3803
2,1,8,6,15,7957,11457,-3500
2,1,9,6,15,8122,11311,-3189
2,2,0,6,15,8080,11548,-3468
2,2,1,6,15,7840,11601,-3761
2,2,2,6,15,7615,12021,-4406
2,2,3,6,15,7451,12504,-5053
2,2,4,6,15,7430,12836,-5406
2,2,5,6,15,7452,12813,-5361
2,2,6,6,15,7471,12790,-5319
2,2,7,6,15,7573,12706,-5133
2,2,8,6,15,7745,12536,-4791
2,2,9,6,15,7946,12245,-4299
2,3,0,6,15,8266,11953,-3687
2,3,1,6,15,8033,11997,-3964
2,3,2,6,15,7799,12496,-4697
2,3,3,6,15,7648,13034,-5386
2,3,4,6,15,7676,13423,-5747
2,3,5,6,15,7731,13407,-5676
2,3,6,6,15,7760,13278,-5518
2,3,7,6,15,7853,13253,-5400
2,3,8,6,15,8025,13056,-5031
2,3,9,6,15,8239,12679,-4440
2,4,0,6,15,7666,13410,-5744
2,4,1,6,15,7425,13521,-6096
2,4,2,6,15,7208,14116,-6908
2,4,3,6,15,7065,14721,-7656
2,4,4,6,15,7096,15223,-8127
2,4,5,6,15,7148,15217,-8069
2,4,6,6,15,7181,14991,-7810
2,4,7,6,15,7298,14984,-7686
2,4,8,6,15,7483,14727,-7244
2,4,9,6,15,7697,14214,-6517
2,5,0,6,15,8186,13834,-5648
2,5,1,6,15,8036,13986,-5950
2,5,2,6,15,7980,14620,-6640
2,5,3,6,15,7965,15231,-7266
2,5,4,6,15,8041,15767,-7726
2,5,5,6,15,8068,15787,-7719
2,5,6,6,15,8103,15471,-7368
2,5,7,6,15,8163,15543,-7380
2,5,8,6,15,8253,15213,-6960
2,5,9,6,15,8375,14637,-6262
2,6,0,6,15,9579,12964,-3385
2,6,1,6,15,9527,13098,-3571
2,6,2,6,15,9680,13757,-4077
2,6,3,6,15,9873,14320,-4447
2,6,4,6,15,10048,14724,-4676
2,6,5,6,15,10051,14739,-4688
2,6,6,6,15,10117,14368,-4251
2,6,7,6,15,10073,14548,-4475
2,6,8,6,15,10027,14137,-4110
2,6,9,6,15,10028,13602,-3574
2,7,0,6,15,10681,12361,-1680
2,7,1,6,15,10689,12447,-1758
2,7,2,6,15,10993,12977,-1984
2,7,3,6,15,11363,13488,-2125
2,7,4,6,15,11630,13707,-2077
2,7,5,6,15,11618,13624,-2006
2,7,6,6,15,11686,13257,-1571
2,7,7,6,15,11586,13548,-1962
2,7,8,6,15,11457,13115,-1658
2,7,9,6,15,11311,12690,-1379
2,8,0,6,15,11548,12158,-610
2,8,1,6,15,11601,12108,-507
2,8,2,6,15,12021,12646,-625
2,8,3,6,15,12504,13154,-650
2,8,4,6,15,12836,13113,-277
2,8,5,6,15,12813,12937,-124
2,8,6,6,15,12790,12743,47
2,8,7,6,15,12706,13023,-317
2,8,8,6,15,12536,12601,-65
2,8,9,6,15,12245,12305,-60
2,9,0,6,15,11953,11902,51
2,9,1,6,15,11997,11734,263
2,9,2,6,15,12496,12262,234
2,9,3,6,15,13034,12757,277
2,9,4,6,15,13423,12426,997
2,9,5,6,15,13407,12193,1214
2,9,6,6,15,13278,12220,1058
2,9,7,6,15,13253,12420,833
2,9,8,6,15,13056,11904,1152
2,9,9,6,15,12679,11657,1022
2,10,0,6,15,13410,10926,2484
2,10,1,6,15,13521,10596,2925
2,10,2,6,15,14116,11009,3107
2,10,3,6,15,14721,11421,3300
2,10,4,6,15,15223,10782,4441
2,10,5,6,15,15217,10555,4662
2,10,6,6,15,14991,10752,4239
2,10,7,6,15,14984,10949,4035
2,10,8,6,15,14727,10496,4231
2,10,9,6,15,14214,10374,3840
2,11,0,6,15,13834,9917,3917
2,11,1,6,15,13986,9522,4464
2,11,2,6,15,14620,9833,4787
2,11,3,6,15,15231,10144,5087
2,11,4,6,15,15767,9335,6432
2,11,5,6,15,15787,9128,6659
2,11,6,6,15,15471,9429,6042
2,11,7,6,15,15543,9597,5946
2,11,8,6,15,15213,9234,5979
2,11,9,6,15,14637,9116,5521
2,12,0,6,15,12964,9331,3633
2,12,1,6,15,13098,8887,4211
2,12,2,6,15,13757,9069,4688
2,12,3,6,15,14320,9295,5025
2,12,4,6,15,14724,8530,6194
2,12,5,6,15,14739,8371,6368
2,12,6,6,15,14368,8678,5690
2,12,7,6,15,14548,8777,5771
2,12,8,6,15,14137,8546,5591
2,12,9,6,15,13602,8390,5212
2,0,0,7,15,9876,12907,-3031
2,0,1,7,15,9666,12926,-3260
2,0,2,7,15,9462,13320,-3858
2,0,3,7,15,9310,13797,-4487
2,0,4,7,15,9269,14159,-4890
2,0,5,7,15,9241,14173,-4932
2,0,6,7,15,9225,14165,-4940
2,0,7,7,15,9333,14083,-4750
2,0,8,7,15,9510,13918,-4408
2,0,9,7,15,9673,13657,-3984
2,1,0,7,15,9672,13791,-4119
2,1,1,7,15,9433,13847,-4414
2,1,2,7,15,9212,14339,-5127
2,1,3,7,15,9048,14887,-5839
2,1,4,7,15,9025,15327,-6302
2,1,5,7,15,9037,15341,-6304
2,1,6,7,15,9049,15217,-6168
2,1,7,7,15,9160,15185,-6025
2,1,8,7,15,9339,14985,-5646
2,1,9,7,15,9534,14612,-5078
2,2,0,7,15,9918,14168,-4250
2,2,1,7,15,9690,14226,-4536
2,2,2,7,15,9458,14811,-5353
2,2,3,7,15,9304,15413,-6109
2,2,4,7,15,9334,15930,-6596
2,2,5,7,15,9386,15930,-6544
2,2,6,7,15,9410,15700,-6290
2,2,7,7,15,9505,15709,-6204
2,2,8,7,15,9674,15461,-5787
2,2,9,7,15,9879,14987,-5108
2,3,0,7,15,9024,15566,-6542
2,3,1,7,15,8738,15743,-7005
2,3,2,7,15,8494,16478,-7984
2,3,3,7,15,8340,17178,-8838
2,3,4,7,15,8383,17750,-9367
2,3,5,7,15,8444,17742,-9298
2,3,6,7,15,8469,17423,-8954
2,3,7,7,15,8578,17454,-8876
2,3,8,7,15,8759,17066,-8307
2,3,9,7,15,9012,16454,-7442
2,4,0,7,15,9398,15638,-6240
2,4,1,7,15,9182,15822,-6640
2,4,2,7,15,9066,16623,-7557
2,4,3,7,15,9012,17332,-8320
2,4,4,7,15,9079,17797,-8718
2,4,5,7,15,9103,17770,-8667
2,4,6,7,15,9133,17437,-8304
2,4,7,7,15,9209,17563,-8354
2,4,8,7,15,9336,17095,-7759
2,4,9,7,15,9514,16478,-6964
2,5,0,7,15,10860,14681,-3821
2,5,1,7,15,10760,14775,-4015
2,5,2,7,15,10846,15409,-4563
2,5,3,7,15,10977,16054,-5077
2,5,4,7,15,11114,16347,-5233
2,5,5,7,15,11099,16249,-5150
2,5,6,7,15,11172,15899,-4727
2,5,7,7,15,11178,16174,-4996
2,5,8,7,15,11211,15716,-4505
2,5,9,7,15,11251,15190,-3939
2,6,0,7,15,11899,14384,-2485
2,6,1,7,15,11855,14345,-2490
2,6,2,7,15,12112,14973,-2861
2,6,3,7,15,12439,15588,-3149
2,6,4,7,15,12688,15642,-2954
2,6,5,7,15,12676,15492,-2816
2,6,6,7,15,12759,15222,-2463
2,6,7,7,15,12699,15520,-2821
2,6,8,7,15,12628,15062,-2434
2,6,9,7,15,12528,14651,-2123
2,7,0,7,15,12907,14145,-1238
2,7,1,7,15,12926,13980,-1054
2,7,2,7,15,13320,14580,-1260
2,7,3,7,15,13797,15140,-1343
2,7,4,7,15,14159,14917,-758
2,7,5,7,15,14173,14721,-548
2,7,6,7,15,14165,14647,-482
2,7,7,7,15,14083,14899,-816
2,7,8,7,15,13918,14353,-435
2,7,9,7,15,13657,14024,-367
2,8,0,7,15,13791,13141,650
2,8,1,7,15,13847,12825,1022
2,8,2,7,15,14339,13324,1015
2,8,3,7,15,14887,13800,1087
2,8,4,7,15,15327,13289,2038
2,8,5,7,15,15341,13078,2263
2,8,6,7,15,15217,13174,2043
2,8,7,7,15,15185,13405,1780
2,8,8,7,15,14985,12901,2084
2,8,9,7,15,14612,12682,1930
2,9,0,7,15,14168,12073,2095
2,9,1,7,15,14226,11744,2482
2,9,2,7,15,14811,12195,2616
2,9,3,7,15,15413,12601,2812
2,9,4,7,15,15930,11862,4068
2,9,5,7,15,15930,11653,4277
2,9,6,7,15,15700,11861,3839
2,9,7,7,15,15709,12067,3642
2,9,8,7,15,15461,11573,3888
2,9,9,7,15,14987,11356,3631
2,10,0,7,15,15566,11135,4431
2,10,1,7,15,15743,10723,5020
2,10,2,7,15,16478,11072,5406
2,10,3,7,15,17178,11396,5782
2,10,4,7,15,17750,10560,7190
2,10,5,7,15,17742,10354,7388
2,10,6,7,15,17423,10644,6779
2,10,7,7,15,17454,10797,6657
2,10,8,7,15,17066,10428,6638
2,10,9,7,15,16454,10231,6223
2,0,0,8,15,11235,16006,-4771
2,0,1,8,15,10991,16076,-5085
2,0,2,8,15,10761,16654,-5893
2,0,3,8,15,10603,17266,-6663
2,0,4,8,15,10592,17834,-7242
2,0,5,8,15,10601,17864,-7263
2,0,6,8,15,10600,17639,-7039
2,0,7,8,15,10710,17641,-6931
2,0,8,8,15,10892,17390,-6498
2,0,9,8,15,11085,16920,-5835
2,1,0,8,15,11510,16324,-4814
2,1,1,8,15,11283,16448,-5165
2,1,2,8,15,11055,17173,-6118
2,1,3,8,15,10901,17870,-6969
2,1,4,8,15,10929,18457,-7528
2,1,5,8,15,10971,18455,-7484
2,1,6,8,15,10988,18132,-7144
2,1,7,8,15,11092,18179,-7087
2,1,8,8,15,11268,17800,-6532
2,1,9,8,15,11467,17227,-5760
2,2,0,8,15,10676,17370,-6694
2,2,1,8,15,10395,17579,-7184
2,2,2,8,15,10153,18481,-8328
2,2,3,8,15,9996,19279,-9283
2,2,4,8,15,10041,19780,-9739
2,2,5,8,15,10099,19725,-9626
2,2,6,8,15,10119,19389,-9270
2,2,7,8,15,10230,19474,-9244
2,2,8,8,15,10408,18948,-8540
2,2,9,8,15,10652,18295,-7643
2,3,0,8,15,10756,17355,-6599
2,3,1,8,15,10495,17499,-7004
2,3,2,8,15,10352,18275,-7923
2,3,3,8,15,10287,19066,-8779
2,3,4,8,15,10366,19420,-9054
2,3,5,8,15,10399,19280,-8881
2,3,6,8,15,10421,18968,-8547
2,3,7,8,15,10489,19189,-8700
2,3,8,8,15,10612,18674,-8062
2,3,9,8,15,10829,18066,-7237
2,4,0,8,15,12072,16704,-4632
2,4,1,8,15,11906,16673,-4767
2,4,2,8,15,11932,17405,-5473
2,4,3,8,15,12024,18154,-6130
2,4,4,8,15,12152,18282,-6130
2,4,5,8,15,12134,18117,-5983
2,4,6,8,15,12202,17864,-5662
2,4,7,8,15,12224,18146,-5922
2,4,8,8,15,12294,17663,-5369
2,4,9,8,15,12390,17151,-4761
2,5,0,8,15,13180,16371,-3191
2,5,1,8,15,13088,16217,-3129
2,5,2,8,15,13278,16907,-3629
2,5,3,8,15,13543,17574,-4031
2,5,4,8,15,13754,17446,-3692
2,5,5,8,15,13724,17276,-3552
2,5,6,8,15,13814,17126,-3312
2,5,7,8,15,13804,17396,-3592
2,5,8,8,15,13812,16814,-3002
2,5,9,8,15,13751,16370,-2619
2,6,0,8,15,14125,15384,-1259
2,6,1,8,15,14092,15071,-979
2,6,2,8,15,14439,15642,-1203
2,6,3,8,15,14873,16183,-1310
2,6,4,8,15,15217,15780,-563
2,6,5,8,15,15231,15606,-375
2,6,6,8,15,15238,15601,-363
2,6,7,8,15,15196,15884,-688
2,6,8,8,15,15089,15350,-261
2,6,9,8,15,14874,15049,-175
2,7,0,8,15,15150,14288,862
2,7,1,8,15,15172,13973,1199
2,7,2,8,15,15638,14510,1128
2,7,3,8,15,16180,14980,1200
2,7,4,8,15,16650,14369,2281
2,7,5,8,15,16701,14176,2525
2,7,6,8,15,16592,14283,2309
2,7,7,8,15,16562,14523,2039
2,7,8,8,15,16367,13978,2389
2,7,9,8,15,16024,13664,2360
2,8,0,8,15,16006,13291,2715
2,8,1,8,15,16076,12945,3131
2,8,2,8,15,16654,13434,3220
2,8,3,8,15,17266,13853,3413
2,8,4,8,15,17834,13087,4747
2,8,5,8,15,17864,12879,4985
2,8,6,8,15,17639,13076,4563
2,8,7,8,15,17641,13267,4374
2,8,8,8,15,17390,12767,4623
2,8,9,8,15,16920,12471,4449
2,0,0,9,15,13073,18128,-5055
2,0,1,9,15,12841,18284,-5443
2,0,2,9,15,12604,19176,-6572
2,0,3,9,15,12456,19971,-7515
2,0,4,9,15,12496,20487,-7991
2,0,5,9,15,12535,20438,-7903
2,0,6,9,15,12539,20098,-7559
2,0,7,9,15,12642,20199,-7557
2,0,8,9,15,12821,19682,-6861
2,0,9,9,15,13018,19068,-6050
2,1,0,9,15,12268,19087,-6819
2,1,1,9,15,11988,19256,-7268
2,1,2,9,15,11750,20133,-8383
2,1,3,9,15,11593,21013,-9420
2,1,4,9,15,11636,21403,-9767
2,1,5,9,15,11684,21235,-9551
2,1,6,9,15,11697,20920,-9223
2,1,7,9,15,11817,21100,-9283
2,1,8,9,15,12002,20527,-8525
2,1,9,9,15,12240,19883,-7643
2,2,0,9,15,12408,19378,-6970
2,2,1,9,15,12152,19397,-7245
2,2,2,9,15,12011,20271,-8260
2,2,3,9,15,11943,21166,-9223
2,2,4,9,15,12024,21355,-9331
2,2,5,9,15,12054,21148,-9094
2,2,6,9,15,12071,20933,-8862
2,2,7,9,15,12141,21161,-9020
2,2,8,9,15,12261,20621,-8360
2,2,9,9,15,12469,20027,-7558
2,3,0,9,15,13430,18691,-5261
2,3,1,9,15,13219,18545,-5326
2,3,2,9,15,13218,19339,-6121
2,3,3,9,15,13299,20140,-6841
2,3,4,9,15,13439,20086,-6647
2,3,5,9,15,13430,19901,-6471
2,3,6,9,15,13490,19768,-6278
2,3,7,9,15,13504,20022,-6518
2,3,8,9,15,13570,19415,-5845
2,3,9,9,15,13705,18870,-5165
2,4,0,9,15,14392,17610,-3218
2,4,1,9,15,14234,17308,-3074
2,4,2,9,15,14364,17969,-3605
2,4,3,9,15,14590,18617,-4027
2,4,4,9,15,14792,18309,-3517
2,4,5,9,15,14759,18161,-3402
2,4,6,9,15,14844,18080,-3236
2,4,7,9,15,14850,18381,-3531
2,4,8,9,15,14895,17811,-2916
2,4,9,9,15,14890,17395,-2505
2,5,0,9,15,15406,16531,-1125
2,5,1,9,15,15325,16219,-894
2,5,2,9,15,15605,16828,-1223
2,5,3,9,15,15977,17363,-1386
2,5,4,9,15,16283,16860,-577
2,5,5,9,15,16279,16704,-425
2,5,6,9,15,16293,16710,-417
2,5,7,9,15,16301,17002,-701
2,5,8,9,15,16273,16427,-154
2,5,9,9,15,16097,16031,66
2,6,0,9,15,16368,15506,862
2,6,1,9,15,16338,15174,1164
2,6,2,9,15,16757,15749,1008
2,6,3,9,15,17256,16232,1024
2,6,4,9,15,17708,15594,2114
2,6,5,9,15,17759,15402,2357
2,6,6,9,15,17665,15498,2167
2,6,7,9,15,17675,15723,1952
2,6,8,9,15,17538,15172,2366
2,6,9,9,15,17241,14779,2462
2,0,0,10,15,13831,21110,-7279
2,0,1,10,15,13546,21154,-7608
2,0,2,10,15,13299,22129,-8830
2,0,3,10,15,13148,23113,-9965
2,0,4,10,15,13203,23338,-10135
2,0,5,10,15,13248,23103,-9855
2,0,6,10,15,13248,22885,-9637
2,0,7,10,15,13367,23072,-9705
2,0,8,10,15,13555,22474,-8919
2,0,9,10,15,13791,21844,-8053
2,1,0,10,15,14000,21365,-7365
2,1,1,10,15,13745,21269,-7524
2,1,2,10,15,13608,22205,-8597
2,1,3,10,15,13540,23152,-9612
2,1,4,10,15,13619,23159,-9540
2,1,5,10,15,13639,22932,-9293
2,1,6,10,15,13649,22837,-9188
2,1,7,10,15,13728,23037,-9309
2,1,8,10,15,13855,22373,-8518
2,1,9,10,15,14057,21746,-7689
2,2,0,10,15,15082,19930,-4848
2,2,1,10,15,14876,19636,-4760
2,2,2,10,15,14877,20401,-5524
2,2,3,10,15,14955,21183,-6228
2,2,4,10,15,15097,20949,-5852
2,2,5,10,15,15085,20786,-5701
2,2,6,10,15,15140,20722,-5582
2,2,7,10,15,15156,21007,-5851
2,2,8,10,15,15219,20412,-5193
2,2,9,10,15,15345,19895,-4550
2,3,0,10,15,15750,18757,-3007
2,3,1,10,15,15547,18456,-2909
2,3,2,10,15,15650,19155,-3505
2,3,3,10,15,15865,19797,-3932
2,3,4,10,15,16079,19389,-3310
2,3,5,10,15,16055,19259,-3204
2,3,6,10,15,16132,19189,-3057
2,3,7,10,15,16130,19499,-3369
2,3,8,10,15,16171,18888,-2717
2,3,9,10,15,16205,18377,-2172
2,4,0,10,15,16618,17749,-1131
2,4,1,10,15,16471,17420,-949
2,4,2,10,15,16691,18067,-1376
2,4,3,10,15,17024,18615,-1591
2,4,4,10,15,17321,18085,-764
2,4,5,10,15,17314,17930,-616
2,4,6,10,15,17323,17925,-602
2,4,7,10,15,17347,18202,-855
2,4,8,10,15,17356,17621,-265
2,4,9,10,15,17236,17146,90
2,0,0,11,15,15563,22604,-7041
2,0,1,11,15,15303,22360,-7057
2,0,2,11,15,15157,23267,-8110
2,0,3,11,15,15095,24195,-9100
2,0,4,11,15,15186,24022,-8836
2,0,5,11,15,15203,23817,-8614
2,0,6,11,15,15200,23791,-8591
2,0,7,11,15,15278,24022,-8744
2,0,8,11,15,15408,23370,-7962
2,0,9,11,15,15608,22771,-7163
2,1,0,11,15,16674,21077,-4403
2,1,1,11,15,16469,20784,-4315
2,1,2,11,15,16474,21587,-5113
2,1,3,11,15,16552,22363,-5811
2,1,4,11,15,16692,22029,-5337
2,1,5,11,15,16670,21884,-5214
2,1,6,11,15,16718,21831,-5113
2,1,7,11,15,16743,22125,-5382
2,1,8,11,15,16813,21489,-4676
2,1,9,11,15,16933,20877,-3944
2,2,0,11,15,17402,19975,-2573
2,2,1,11,15,17204,19657,-2453
2,2,2,11,15,17309,20394,-3085
2,2,3,11,15,17521,21049,-3528
2,2,4,11,15,17737,20614,-2877
2,2,5,11,15,17710,20485,-2775
2,2,6,11,15,17782,20404,-2622
2,2,7,11,15,17782,20699,-2917
2,2,8,11,15,17820,20082,-2262
2,2,9,11,15,17845,19492,-1647
2,0,0,12,15,18237,22295,-4058
2,0,1,12,15,18027,21985,-3958
2,0,2,12,15,18023,22826,-4803
2,0,3,12,15,18107,23615,-5508
2,0,4,12,15,18259,23254,-4995
2,0,5,12,15,18234,23110,-4876
2,0,6,12,15,18269,23046,-4777
2,0,7,12,15,18293,23325,-5032
2,0,8,12,15,18366,22683,-4317
2,0,9,12,15,18484,21992,-3508
2,0,0,1,16,1668,1699,-31
2,0,1,1,16,1656,1708,-52
2,0,2,1,16,1651,1704,-53
2,0,3,1,16,1665,1701,-36
2,0,4,1,16,1675,1697,-22
2,0,5,1,16,1662,1686,-24
2,0,6,1,16,1654,1689,-35
2,0,7,1,16,1659,1701,-42
2,0,8,1,16,1655,1696,-41
2,1,0,1,16,1699,1763,-64
2,1,1,1,16,1708,1774,-66
2,1,2,1,16,1704,1768,-64
2,1,3,1,16,1701,1765,-64
2,1,4,1,16,1697,1765,-68
2,1,5,1,16,1686,1758,-72
2,1,6,1,16,1689,1760,-71
2,1,7,1,16,1701,1767,-66
2,1,8,1,16,1696,1755,-59
2,2,0,1,16,1763,1425,338
2,2,1,1,16,1774,1403,371
2,2,2,1,16,1768,1385,383
2,2,3,1,16,1765,1392,373
2,2,4,1,16,1765,1408,357
2,2,5,1,16,1758,1403,355
2,2,6,1,16,1760,1392,368
2,2,7,1,16,1767,1391,376
2,2,8,1,16,1755,1387,368
2,3,0,1,16,1425,1260,165
2,3,1,1,16,1403,1205,198
2,3,2,1,16,1385,1161,224
2,3,3,1,16,1392,1153,239
2,3,4,1,16,1408,1161,247
2,3,5,1,16,1403,1150,253
2,3,6,1,16,1392,1140,252
2,3,7,1,16,1391,1159,232
2,3,8,1,16,1387,1193,194
2,4,0,1,16,1260,1347,-87
2,4,1,1,16,1205,1288,-83
2,4,2,1,16,1161,1224,-63
2,4,3,1,16,1153,1185,-32
2,4,4,1,16,1161,1173,-12
2,4,5,1,16,1150,1164,-14
2,4,6,1,16,1140,1174,-34
2,4,7,1,16,1159,1223,-64
2,4,8,1,16,1193,1292,-99
2,5,0,1,16,1347,1286,61
2,5,1,1,16,1288,1243,45
2,5,2,1,16,1224,1185,39
2,5,3,1,16,1185,1147,38
2,5,4,1,16,1173,1145,28
2,5,5,1,16,1164,1155,9
2,5,6,1,16,1174,1180,-6
2,5,7,1,16,1223,1229,-6
2,5,8,1,16,1292,1286,6
2,6,0,1,16,1286,1455,-169
2,6,1,1,16,1243,1424,-181
2,6,2,1,16,1185,1383,-198
2,6,3,1,16,1147,1372,-225
2,6,4,1,16,1145,1400,-255
2,6,5,1,16,1155,1432,-277
2,6,6,1,16,1180,1459,-279
2,6,7,1,16,1229,1487,-258
2,6,8,1,16,1286,1507,-221
2,7,0,1,16,1455,1976,-521
2,7,1,1,16,1424,1984,-560
2,7,2,1,16,1383,1974,-591
2,7,3,1,16,1372,1982,-610
2,7,4,1,16,1400,1997,-597
2,7,5,1,16,1432,2033,-601
2,7,6,1,16,1459,2067,-608
2,7,7,1,16,1487,2050,-563
2,7,8,1,16,1507,2060,-553
2,8,0,1,16,1976,811,1165
2,8,1,1,16,1984,764,1220
2,8,2,1,16,1974,761,1213
2,8,3,1,16,1982,750,1232
2,8,4,1,16,1997,754,1243
2,8,5,1,16,2033,764,1269
2,8,6,1,16,2067,769,1298
2,8,7,1,16,2050,801,1249
2,8,8,1,16,2060,837,1223
2,9,0,1,16,811,1861,-1050
2,9,1,1,16,764,1902,-1138
2,9,2,1,16,761,2007,-1246
2,9,3,1,16,750,2059,-1309
2,9,4,1,16,754,2103,-1349
2,9,5,1,16,764,2070,-1306
2,9,6,1,16,769,2034,-1265
2,9,7,1,16,801,2010,-1209
2,9,8,1,16,837,1959,-1122
2,10,0,1,16,1861,2863,-1002
2,10,1,1,16,1902,2966,-1064
2,10,2,1,16,2007,3102,-1095
2,10,3,1,16,2059,3196,-1137
2,10,4,1,16,2103,3284,-1181
2,10,5,1,16,2070,3244,-1174
2,10,6,1,16,2034,3238,-1204
2,10,7,1,16,2010,3188,-1178
2,10,8,1,16,1959,3092,-1133
2,11,0,1,16,2863,2479,384
2,11,1,1,16,2966,2579,387
2,11,2,1,16,3102,2670,432
2,11,3,1,16,3196,2766,430
2,11,4,1,16,3284,2862,422
2,11,5,1,16,3244,2843,401
2,11,6,1,16,3238,2839,399
2,11,7,1,16,3188,2825,363
2,11,8,1,16,3092,2732,360
2,12,0,1,16,2479,2383,96
2,12,1,1,16,2579,2486,93
2,12,2,1,16,2670,2544,126
2,12,3,1,16,2766,2652,114
2,12,4,1,16,2862,2742,120
2,12,5,1,16,2843,2732,111
2,12,6,1,16,2839,2667,172
2,12,7,1,16,2825,2694,131
2,12,8,1,16,2732,2595,137
2,13,0,1,16,2383,2398,-15
2,13,1,1,16,2486,2487,-1
2,13,2,1,16,2544,2498,46
2,13,3,1,16,2652,2613,39
2,13,4,1,16,2742,2704,38
2,13,5,1,16,2732,2681,51
2,13,6,1,16,2667,2622,45
2,13,7,1,16,2694,2680,14
2,13,8,1,16,2595,2603,-8
2,14,0,1,16,2398,2375,23
2,14,1,1,16,2487,2484,3
2,14,2,1,16,2498,2486,12
2,14,3,1,16,2613,2626,-13
2,14,4,1,16,2704,2730,-26
2,14,5,1,16,2681,2672,9
2,14,6,1,16,2622,2620,2
2,14,7,1,16,2680,2642,38
2,14,8,1,16,2603,2546,57
2,15,0,1,16,2375,2330,45
2,15,1,1,16,2484,2476,8
2,15,2,1,16,2486,2532,-46
2,15,3,1,16,2626,2646,-20
2,15,4,1,16,2730,2744,-14
2,15,5,1,16,2672,2681,-9
2,15,6,1,16,2620,2600,20
2,15,7,1,16,2642,2587,55
2,15,8,1,16,2546,2479,67
2,16,0,1,16,2330,1944,386
2,16,1,1,16,2476,2078,398
2,16,2,1,16,2532,2164,368
2,16,3,1,16,2646,2176,470
2,16,4,1,16,2744,2190,554
2,16,5,1,16,2681,2157,524
2,16,6,1,16,2600,2132,468
2,16,7,1,16,2587,2113,474
2,16,8,1,16,2479,2037,442
2,17,0,1,16,1944,1799,145
2,17,1,1,16,2078,1744,334
2,17,2,1,16,2164,1810,354
2,17,3,1,16,2176,1807,369
2,17,4,1,16,2190,1748,442
2,17,5,1,16,2157,1710,447
2,17,6,1,16,2132,1695,437
2,17,7,1,16,2113,1707,406
2,17,8,1,16,2037,1700,337
2,18,0,1,16,1799,2088,-289
2,18,1,1,16,1744,2086,-342
2,18,2,1,16,1810,2204,-394
2,18,3,1,16,1807,2169,-362
2,18,4,1,16,1748,1998,-250
2,18,5,1,16,1710,2045,-335
2,18,6,1,16,1695,2044,-349
2,18,7,1,16,1707,2046,-339
2,18,8,1,16,1700,2148,-448
2,19,0,1,16,2088,2062,26
2,19,1,1,16,2086,2010,76
2,19,2,1,16,2204,2054,150
2,19,3,1,16,2169,2034,135
2,19,4,1,16,1998,1881,117
2,19,5,1,16,2045,1947,98
2,19,6,1,16,2044,1949,95
2,19,7,1,16,2046,1931,115
2,19,8,1,16,2148,1963,185
2,20,0,1,16,2062,1294,768
2,20,1,1,16,2010,1134,876
2,20,2,1,16,2054,1132,922
2,20,3,1,16,2034,1098,936
2,20,4,1,16,1881,947,934
2,20,5,1,16,1947,986,961
2,20,6,1,16,1949,1043,906
2,20,7,1,16,1931,1081,850
2,20,8,1,16,1963,1170,793
2,21,0,1,16,1294,1245,49
2,21,1,1,16,1134,1260,-126
2,21,2,1,16,1132,1256,-124
2,21,3,1,16,1098,1200,-102
2,21,4,1,16,947,1138,-191
2,21,5,1,16,986,1146,-160
2,21,6,1,16,1043,1163,-120
2,21,7,1,16,1081,1172,-91
2,21,8,1,16,1170,1133,37
2,22,0,1,16,1245,1312,-67
2,22,1,1,16,1260,1308,-48
2,22,2,1,16,1256,1306,-50
2,22,3,1,16,1200,1294,-94
2,22,4,1,16,1138,1295,-157
2,22,5,1,16,1146,1280,-134
2,22,6,1,16,1163,1248,-85
2,22,7,1,16,1172,1274,-102
2,22,8,1,16,1133,1241,-108
2,0,0,2,16,3367,3188,179
2,0,1,2,16,3364,3177,187
2,0,2,2,16,3355,3153,202
2,0,3,2,16,3366,3157,209
2,0,4,2,16,3372,3173,199
2,0,5,2,16,3348,3161,187
2,0,6,2,16,3343,3152,191
2,0,7,2,16,3360,3158,202
2,0,8,2,16,3351,3142,209
2,1,0,2,16,3462,2685,777
2,1,1,2,16,3482,2608,874
2,1,2,2,16,3472,2546,926
2,1,3,2,16,3466,2545,921
2,1,4,2,16,3462,2569,893
2,1,5,2,16,3444,2553,891
2,1,6,2,16,3449,2532,917
2,1,7,2,16,3468,2550,918
2,1,8,2,16,3451,2580,871
2,2,0,2,16,3188,2607,581
2,2,1,2,16,3177,2493,684
2,2,2,2,16,3153,2385,768
2,2,3,2,16,3157,2338,819
2,2,4,2,16,3173,2334,839
2,2,5,2,16,3161,2314,847
2,2,6,2,16,3152,2314,838
2,2,7,2,16,3158,2382,776
2,2,8,2,16,3142,2485,657
2,3,0,2,16,2685,2633,52
2,3,1,2,16,2608,2531,77
2,3,2,2,16,2546,2409,137
2,3,3,2,16,2545,2332,213
2,3,4,2,16,2569,2318,251
2,3,5,2,16,2553,2319,234
2,3,6,2,16,2532,2354,178
2,3,7,2,16,2550,2452,98
2,3,8,2,16,2580,2578,2
2,4,0,2,16,2607,2741,-134
2,4,1,2,16,2493,2667,-174
2,4,2,2,16,2385,2568,-183
2,4,3,2,16,2338,2519,-181
2,4,4,2,16,2334,2545,-211
2,4,5,2,16,2314,2587,-273
2,4,6,2,16,2314,2639,-325
2,4,7,2,16,2382,2716,-334
2,4,8,2,16,2485,2793,-308
2,5,0,2,16,2633,3431,-798
2,5,1,2,16,2531,3408,-877
2,5,2,2,16,2409,3357,-948
2,5,3,2,16,2332,3354,-1022
2,5,4,2,16,2318,3397,-1079
2,5,5,2,16,2319,3465,-1146
2,5,6,2,16,2354,3526,-1172
2,5,7,2,16,2452,3537,-1085
2,5,8,2,16,2578,3567,-989
2,6,0,2,16,2741,2787,-46
2,6,1,2,16,2667,2748,-81
2,6,2,2,16,2568,2735,-167
2,6,3,2,16,2519,2732,-213
2,6,4,2,16,2545,2751,-206
2,6,5,2,16,2587,2797,-210
2,6,6,2,16,2639,2836,-197
2,6,7,2,16,2716,2851,-135
2,6,8,2,16,2793,2897,-104
2,7,0,2,16,3431,2672,759
2,7,1,2,16,3408,2666,742
2,7,2,2,16,3357,2768,589
2,7,3,2,16,3354,2809,545
2,7,4,2,16,3397,2857,540
2,7,5,2,16,3465,2834,631
2,7,6,2,16,3526,2803,723
2,7,7,2,16,3537,2811,726
2,7,8,2,16,3567,2796,771
2,8,0,2,16,2787,4724,-1937
2,8,1,2,16,2748,4868,-2120
2,8,2,2,16,2735,5109,-2374
2,8,3,2,16,2732,5255,-2523
2,8,4,2,16,2751,5387,-2636
2,8,5,2,16,2797,5314,-2517
2,8,6,2,16,2836,5272,-2436
2,8,7,2,16,2851,5198,-2347
2,8,8,2,16,2897,5051,-2154
2,9,0,2,16,2672,5342,-2670
2,9,1,2,16,2666,5545,-2879
2,9,2,2,16,2768,5772,-3004
2,9,3,2,16,2809,5962,-3153
2,9,4,2,16,2857,6146,-3289
2,9,5,2,16,2834,6087,-3253
2,9,6,2,16,2803,6077,-3274
2,9,7,2,16,2811,6013,-3202
2,9,8,2,16,2796,5824,-3028
2,10,0,2,16,4724,4862,-138
2,10,1,2,16,4868,5065,-197
2,10,2,2,16,5109,5214,-105
2,10,3,2,16,5255,5418,-163
2,10,4,2,16,5387,5604,-217
2,10,5,2,16,5314,5575,-261
2,10,6,2,16,5272,5506,-234
2,10,7,2,16,5198,5519,-321
2,10,8,2,16,5051,5327,-276
2,11,0,2,16,5342,4781,561
2,11,1,2,16,5545,4973,572
2,11,2,2,16,5772,5042,730
2,11,3,2,16,5962,5265,697
2,11,4,2,16,6146,5446,700
2,11,5,2,16,6087,5413,674
2,11,6,2,16,6077,5289,788
2,11,7,2,16,6013,5374,639
2,11,8,2,16,5824,5198,626
2,12,0,2,16,4862,4773,89
2,12,1,2,16,5065,4971,94
2,12,2,2,16,5214,4984,230
2,12,3,2,16,5418,5239,179
2,12,4,2,16,5604,5434,170
2,12,5,2,16,5575,5353,222
2,12,6,2,16,5506,5242,264
2,12,7,2,16,5519,5322,197
2,12,8,2,16,5327,5149,178
2,13,0,2,16,4781,4705,76
2,13,1,2,16,4973,4960,13
2,13,2,2,16,5042,5018,24
2,13,3,2,16,5265,5272,-7
2,13,4,2,16,5446,5474,-28
2,13,5,2,16,5413,5353,60
2,13,6,2,16,5289,5220,69
2,13,7,2,16,5374,5229,145
2,13,8,2,16,5198,5025,173
2,14,0,2,16,4773,4274,499
2,14,1,2,16,4971,4554,417
2,14,2,2,16,4984,4696,288
2,14,3,2,16,5239,4822,417
2,14,4,2,16,5434,4934,500
2,14,5,2,16,5353,4838,515
2,14,6,2,16,5242,4732,510
2,14,7,2,16,5322,4700,622
2,14,8,2,16,5149,4516,633
2,15,0,2,16,4705,3743,962
2,15,1,2,16,4960,3822,1138
2,15,2,2,16,5018,3974,1044
2,15,3,2,16,5272,3983,1289
2,15,4,2,16,5474,3938,1536
2,15,5,2,16,5353,3867,1486
2,15,6,2,16,5220,3827,1393
2,15,7,2,16,5229,3820,1409
2,15,8,2,16,5025,3737,1288
2,16,0,2,16,4274,3887,387
2,16,1,2,16,4554,3830,724
2,16,2,2,16,4696,4014,682
2,16,3,2,16,4822,3976,846
2,16,4,2,16,4934,3746,1188
2,16,5,2,16,4838,3755,1083
2,16,6,2,16,4732,3739,993
2,16,7,2,16,4700,3753,947
2,16,8,2,16,4516,3848,668
2,17,0,2,16,3743,4150,-407
2,17,1,2,16,3822,4096,-274
2,17,2,2,16,3974,4258,-284
2,17,3,2,16,3983,4203,-220
2,17,4,2,16,3938,3879,59
2,17,5,2,16,3867,3992,-125
2,17,6,2,16,3827,3993,-166
2,17,7,2,16,3820,3977,-157
2,17,8,2,16,3737,4111,-374
2,18,0,2,16,3887,3356,531
2,18,1,2,16,3830,3144,686
2,18,2,2,16,4014,3186,828
2,18,3,2,16,3976,3132,844
2,18,4,2,16,3746,2828,918
2,18,5,2,16,3755,2933,822
2,18,6,2,16,3739,2992,747
2,18,7,2,16,3753,3012,741
2,18,8,2,16,3848,3133,715
2,19,0,2,16,4150,2539,1611
2,19,1,2,16,4096,2394,1702
2,19,2,2,16,4258,2388,1870
2,19,3,2,16,4203,2298,1905
2,19,4,2,16,3879,2085,1794
2,19,5,2,16,3992,2132,1860
2,19,6,2,16,3993,2206,1787
2,19,7,2,16,3977,2253,1724
2,19,8,2,16,4111,2303,1808
2,20,0,2,16,3356,2557,799
2,20,1,2,16,3144,2568,576
2,20,2,2,16,3186,2562,624
2,20,3,2,16,3132,2494,638
2,20,4,2,16,2828,2433,395
2,20,5,2,16,2933,2426,507
2,20,6,2,16,2992,2411,581
2,20,7,2,16,3012,2446,566
2,20,8,2,16,3133,2374,759
2,0,0,3,16,5130,4032,1098
2,0,1,3,16,5138,3896,1242
2,0,2,3,16,5123,3770,1353
2,0,3,3,16,5131,3730,1401
2,0,4,3,16,5137,3742,1395
2,0,5,3,16,5106,3717,1389
2,0,6,3,16,5103,3706,1397
2,0,7,3,16,5127,3773,1354
2,0,8,3,16,5106,3872,1234
2,1,0,3,16,4887,3893,994
2,1,1,3,16,4885,3736,1149
2,1,2,3,16,4857,3570,1287
2,1,3,3,16,4858,3485,1373
2,1,4,3,16,4870,3479,1391
2,1,5,3,16,4847,3469,1378
2,1,6,3,16,4841,3494,1347
2,1,7,3,16,4859,3611,1248
2,1,8,3,16,4838,3771,1067
2,2,0,3,16,4448,4088,360
2,2,1,3,16,4382,3955,427
2,2,2,3,16,4314,3792,522
2,2,3,3,16,4310,3704,606
2,2,4,3,16,4334,3718,616
2,2,5,3,16,4311,3751,560
2,2,6,3,16,4292,3813,479
2,2,7,3,16,4317,3939,378
2,2,8,3,16,4335,4085,250
2,3,0,3,16,4032,4717,-685
2,3,1,3,16,3896,4651,-755
2,3,2,3,16,3770,4542,-772
2,3,3,3,16,3730,4501,-771
2,3,4,3,16,3742,4542,-800
2,3,5,3,16,3717,4620,-903
2,3,6,3,16,3706,4706,-1000
2,3,7,3,16,3773,4766,-993
2,3,8,3,16,3872,4853,-981
2,4,0,3,16,3893,4242,-349
2,4,1,3,16,3736,4172,-436
2,4,2,3,16,3570,4118,-548
2,4,3,3,16,3485,4104,-619
2,4,4,3,16,3479,4151,-672
2,4,5,3,16,3469,4229,-760
2,4,6,3,16,3494,4295,-801
2,4,7,3,16,3611,4338,-727
2,4,8,3,16,3771,4404,-633
2,5,0,3,16,4088,4648,-560
2,5,1,3,16,3955,4650,-695
2,5,2,3,16,3792,4742,-950
2,5,3,3,16,3704,4791,-1087
2,5,4,3,16,3718,4854,-1136
2,5,5,3,16,3751,4867,-1116
2,5,6,3,16,3813,4870,-1057
2,5,7,3,16,3939,4861,-922
2,5,8,3,16,4085,4856,-771
2,6,0,3,16,4717,5535,-818
2,6,1,3,16,4651,5632,-981
2,6,2,3,16,4542,5870,-1328
2,6,3,3,16,4501,6005,-1504
2,6,4,3,16,4542,6141,-1599
2,6,5,3,16,4620,6078,-1458
2,6,6,3,16,4706,6041,-1335
2,6,7,3,16,4766,5999,-1233
2,6,8,3,16,4853,5888,-1035
2,7,0,3,16,4242,7203,-2961
2,7,1,3,16,4172,7447,-3275
2,7,2,3,16,4118,7779,-3661
2,7,3,3,16,4104,8021,-3917
2,7,4,3,16,4151,8249,-4098
2,7,5,3,16,4229,8157,-3928
2,7,6,3,16,4295,8111,-3816
2,7,7,3,16,4338,8023,-3685
2,7,8,3,16,4404,7783,-3379
2,8,0,3,16,4648,7725,-3077
2,8,1,3,16,4650,8031,-3381
2,8,2,3,16,4742,8316,-3574
2,8,3,3,16,4791,8614,-3823
2,8,4,3,16,4854,8888,-4034
2,8,5,3,16,4867,8819,-3952
2,8,6,3,16,4870,8744,-3874
2,8,7,3,16,4861,8707,-3846
2,8,8,3,16,4856,8419,-3563
2,9,0,3,16,5535,7260,-1725
2,9,1,3,16,5632,7552,-1920
2,9,2,3,16,5870,7712,-1842
2,9,3,3,16,6005,8031,-2026
2,9,4,3,16,6141,8308,-2167
2,9,5,3,16,6078,8256,-2178
2,9,6,3,16,6041,8128,-2087
2,9,7,3,16,5999,8199,-2200
2,9,8,3,16,5888,7930,-2042
2,10,0,3,16,7203,7156,47
2,10,1,3,16,7447,7457,-10
2,10,2,3,16,7779,7528,251
2,10,3,3,16,8021,7891,130
2,10,4,3,16,8249,8176,73
2,10,5,3,16,8157,8085,72
2,10,6,3,16,8111,7909,202
2,10,7,3,16,8023,8016,7
2,10,8,3,16,7783,7744,39
2,11,0,3,16,7725,7103,622
2,11,1,3,16,8031,7447,584
2,11,2,3,16,8316,7516,800
2,11,3,3,16,8614,7885,729
2,11,4,3,16,8888,8178,710
2,11,5,3,16,8819,8034,785
2,11,6,3,16,8744,7842,902
2,11,7,3,16,8707,7909,798
2,11,8,3,16,8419,7628,791
2,12,0,3,16,7260,6649,611
2,12,1,3,16,7552,7038,514
2,12,2,3,16,7712,7182,530
2,12,3,3,16,8031,7448,583
2,12,4,3,16,8308,7664,644
2,12,5,3,16,8256,7510,746
2,12,6,3,16,8128,7352,776
2,12,7,3,16,8199,7342,857
2,12,8,3,16,7930,7062,868
2,13,0,3,16,7156,6073,1083
2,13,1,3,16,7457,6298,1159
2,13,2,3,16,7528,6506,1022
2,13,3,3,16,7891,6629,1262
2,13,4,3,16,8176,6682,1494
2,13,5,3,16,8085,6548,1537
2,13,6,3,16,7909,6427,1482
2,13,7,3,16,8016,6407,1609
2,13,8,3,16,7744,6216,1528
2,14,0,3,16,7103,5831,1272
2,14,1,3,16,7447,5908,1539
2,14,2,3,16,7516,6178,1338
2,14,3,3,16,7885,6152,1733
2,14,4,3,16,8178,5936,2242
2,14,5,3,16,8034,5912,2122
2,14,6,3,16,7842,5871,1971
2,14,7,3,16,7909,5866,2043
2,14,8,3,16,7628,5885,1743
2,15,0,3,16,6649,5949,700
2,15,1,3,16,7038,5840,1198
2,15,2,3,16,7182,6068,1114
2,15,3,3,16,7448,6010,1438
2,15,4,3,16,7664,5627,2037
2,15,5,3,16,7510,5702,1808
2,15,6,3,16,7352,5688,1664
2,15,7,3,16,7342,5684,1658
2,15,8,3,16,7062,5811,1251
2,16,0,3,16,6073,5444,629
2,16,1,3,16,6298,5230,1068
2,16,2,3,16,6506,5390,1116
2,16,3,3,16,6629,5301,1328
2,16,4,3,16,6682,4826,1856
2,16,5,3,16,6548,4978,1570
2,16,6,3,16,6427,5036,1391
2,16,7,3,16,6407,5058,1349
2,16,8,3,16,6216,5281,935
2,17,0,3,16,5831,4601,1230
2,17,1,3,16,5908,4404,1504
2,17,2,3,16,6178,4442,1736
2,17,3,3,16,6152,4332,1820
2,17,4,3,16,5936,3966,1970
2,17,5,3,16,5912,4079,1833
2,17,6,3,16,5871,4155,1716
2,17,7,3,16,5866,4184,1682
2,17,8,3,16,5885,4266,1619
2,18,0,3,16,5949,3851,2098
2,18,1,3,16,5840,3702,2138
2,18,2,3,16,6068,3694,2374
2,18,3,3,16,6010,3592,2418
2,18,4,3,16,5627,3380,2247
2,18,5,3,16,5702,3412,2290
2,18,6,3,16,5688,3454,2234
2,18,7,3,16,5684,3527,2157
2,18,8,3,16,5811,3544,2267
2,0,0,4,16,6555,5348,1207
2,0,1,4,16,6541,5160,1381
2,0,2,4,16,6508,4953,1555
2,0,3,4,16,6523,4857,1666
2,0,4,4,16,6545,4879,1666
2,0,5,4,16,6509,4901,1608
2,0,6,4,16,6495,4953,1542
2,0,7,4,16,6518,5098,1420
2,0,8,4,16,6493,5278,1215
2,1,0,4,16,6147,6064,83
2,1,1,4,16,6090,5939,151
2,1,2,4,16,6018,5766,252
2,1,3,4,16,6011,5686,325
2,1,4,4,16,6031,5715,316
2,1,5,4,16,5997,5784,213
2,1,6,4,16,5981,5880,101
2,1,7,4,16,6018,5989,29
2,1,8,4,16,6031,6145,-114
2,2,0,4,16,5795,5528,267
2,2,1,4,16,5670,5415,255
2,2,2,4,16,5538,5303,235
2,2,3,4,16,5495,5251,244
2,2,4,4,16,5507,5296,211
2,2,5,4,16,5475,5384,91
2,2,6,4,16,5466,5475,-9
2,2,7,4,16,5540,5567,-27
2,2,8,4,16,5627,5690,-63
2,3,0,4,16,5318,6103,-785
2,3,1,4,16,5139,6074,-935
2,3,2,4,16,4955,6125,-1170
2,3,3,4,16,4877,6163,-1286
2,3,4,4,16,4887,6254,-1367
2,3,5,4,16,4872,6299,-1427
2,3,6,4,16,4886,6329,-1443
2,3,7,4,16,5002,6348,-1346
2,3,8,4,16,5158,6363,-1205
2,4,0,4,16,5348,7511,-2163
2,4,1,4,16,5160,7616,-2456
2,4,2,4,16,4953,7844,-2891
2,4,3,4,16,4857,7987,-3130
2,4,4,4,16,4879,8138,-3259
2,4,5,4,16,4901,8111,-3210
2,4,6,4,16,4953,8108,-3155
2,4,7,4,16,5098,8049,-2951
2,4,8,4,16,5278,7948,-2670
2,5,0,4,16,6064,8014,-1950
2,5,1,4,16,5939,8211,-2272
2,5,2,4,16,5766,8540,-2774
2,5,3,4,16,5686,8771,-3085
2,5,4,4,16,5715,9003,-3288
2,5,5,4,16,5784,8921,-3137
2,5,6,4,16,5880,8880,-3000
2,5,7,4,16,5989,8824,-2835
2,5,8,4,16,6145,8620,-2475
2,6,0,4,16,5528,9586,-4058
2,6,1,4,16,5415,9933,-4518
2,6,2,4,16,5303,10323,-5020
2,6,3,4,16,5251,10673,-5422
2,6,4,4,16,5296,10991,-5695
2,6,5,4,16,5384,10889,-5505
2,6,6,4,16,5475,10778,-5303
2,6,7,4,16,5567,10717,-5150
2,6,8,4,16,5690,10378,-4688
2,7,0,4,16,6103,10123,-4020
2,7,1,4,16,6074,10518,-4444
2,7,2,4,16,6125,10814,-4689
2,7,3,4,16,6163,11227,-5064
2,7,4,4,16,6254,11592,-5338
2,7,5,4,16,6299,11500,-5201
2,7,6,4,16,6329,11366,-5037
2,7,7,4,16,6348,11387,-5039
2,7,8,4,16,6363,11022,-4659
2,8,0,4,16,7511,9635,-2124
2,8,1,4,16,7616,10036,-2420
2,8,2,4,16,7844,10198,-2354
2,8,3,4,16,7987,10657,-2670
2,8,4,4,16,8138,11038,-2900
2,8,5,4,16,8111,10928,-2817
2,8,6,4,16,8108,10748,-2640
2,8,7,4,16,8049,10841,-2792
2,8,8,4,16,7948,10476,-2528
2,9,0,4,16,8014,9486,-1472
2,9,1,4,16,8211,9933,-1722
2,9,2,4,16,8540,10060,-1520
2,9,3,4,16,8771,10537,-1766
2,9,4,4,16,9003,10920,-1917
2,9,5,4,16,8921,10766,-1845
2,9,6,4,16,8880,10509,-1629
2,9,7,4,16,8824,10603,-1779
2,9,8,4,16,8620,10223,-1603
2,10,0,4,16,9586,9047,539
2,10,1,4,16,9933,9525,408
2,10,2,4,16,10323,9680,643
2,10,3,4,16,10673,10061,612
2,10,4,4,16,10991,10368,623
2,10,5,4,16,10889,10191,698
2,10,6,4,16,10778,9974,804
2,10,7,4,16,10717,10022,695
2,10,8,4,16,10378,9665,713
2,11,0,4,16,10123,8448,1675
2,11,1,4,16,10518,8782,1736
2,11,2,4,16,10814,8992,1822
2,11,3,4,16,11227,9255,1972
2,11,4,4,16,11592,9412,2180
2,11,5,4,16,11500,9220,2280
2,11,6,4,16,11366,9047,2319
2,11,7,4,16,11387,9049,2338
2,11,8,4,16,11022,8762,2260
2,12,0,4,16,9635,8161,1474
2,12,1,4,16,10036,8384,1652
2,12,2,4,16,10198,8710,1488
2,12,3,4,16,10657,8798,1859
2,12,4,4,16,11038,8680,2358
2,12,5,4,16,10928,8593,2335
2,12,6,4,16,10748,8471,2277
2,12,7,4,16,10841,8453,2388
2,12,8,4,16,10476,8364,2112
2,13,0,4,16,9486,7893,1593
2,13,1,4,16,9933,7918,2015
2,13,2,4,16,10060,8232,1828
2,13,3,4,16,10537,8186,2351
2,13,4,4,16,10920,7817,3103
2,13,5,4,16,10766,7859,2907
2,13,6,4,16,10509,7820,2689
2,13,7,4,16,10603,7797,2806
2,13,8,4,16,10223,7848,2375
2,14,0,4,16,9047,7243,1804
2,14,1,4,16,9525,6974,2551
2,14,2,4,16,9680,7200,2480
2,14,3,4,16,10061,7108,2953
2,14,4,4,16,10368,6574,3794
2,14,5,4,16,10191,6688,3503
2,14,6,4,16,9974,6731,3243
2,14,7,4,16,10022,6765,3257
2,14,8,4,16,9665,6981,2684
2,15,0,4,16,8448,6689,1759
2,15,1,4,16,8782,6490,2292
2,15,2,4,16,8992,6646,2346
2,15,3,4,16,9255,6501,2754
2,15,4,4,16,9412,5964,3448
2,15,5,4,16,9220,6124,3096
2,15,6,4,16,9047,6199,2848
2,15,7,4,16,9049,6230,2819
2,15,8,4,16,8762,6414,2348
2,16,0,4,16,8161,5913,2248
2,16,1,4,16,8384,5712,2672
2,16,2,4,16,8710,5748,2962
2,16,3,4,16,8798,5626,3172
2,16,4,4,16,8680,5261,3419
2,16,5,4,16,8593,5359,3234
2,16,6,4,16,8471,5403,3068
2,16,7,4,16,8453,5458,2995
2,16,8,4,16,8364,5507,2857
2,0,0,5,16,7815,6875,940
2,0,1,5,16,7746,6703,1043
2,0,2,5,16,7669,6527,1142
2,0,3,5,16,7676,6436,1240
2,0,4,5,16,7706,6469,1237
2,0,5,5,16,7659,6548,1111
2,0,6,5,16,7635,6649,986
2,0,7,5,16,7677,6790,887
2,0,8,5,16,7686,6982,704
2,1,0,5,16,7494,7389,105
2,1,1,5,16,7378,7317,61
2,1,2,5,16,7242,7310,-68
2,1,3,5,16,7196,7310,-114
2,1,4,5,16,7204,7399,-195
2,1,5,5,16,7161,7454,-293
2,1,6,5,16,7155,7509,-354
2,1,7,5,16,7241,7577,-336
2,1,8,5,16,7323,7649,-326
2,2,0,5,16,7081,8966,-1885
2,2,1,5,16,6913,9040,-2127
2,2,2,5,16,6723,9227,-2504
2,2,3,5,16,6642,9359,-2717
2,2,4,5,16,6652,9538,-2886
2,2,5,5,16,6630,9543,-2913
2,2,6,5,16,6646,9567,-2921
2,2,7,5,16,6769,9536,-2767
2,2,8,5,16,6913,9455,-2542
2,3,0,5,16,6773,9990,-3217
2,3,1,5,16,6563,10195,-3632
2,3,2,5,16,6338,10514,-4176
2,3,3,5,16,6249,10753,-4504
2,3,4,5,16,6287,11000,-4713
2,3,5,5,16,6304,10954,-4650
2,3,6,5,16,6345,10947,-4602
2,3,7,5,16,6489,10874,-4385
2,3,8,5,16,6665,10680,-4015
2,4,0,5,16,7324,10397,-3073
2,4,1,5,16,7144,10697,-3553
2,4,2,5,16,6927,11084,-4157
2,4,3,5,16,6839,11423,-4584
2,4,4,5,16,6876,11745,-4869
2,4,5,5,16,6934,11653,-4719
2,4,6,5,16,7020,11547,-4527
2,4,7,5,16,7148,11518,-4370
2,4,8,5,16,7338,11215,-3877
2,5,0,5,16,6875,11984,-5109
2,5,1,5,16,6703,12420,-5717
2,5,2,5,16,6527,12821,-6294
2,5,3,5,16,6436,13286,-6850
2,5,4,5,16,6469,13695,-7226
2,5,5,5,16,6548,13570,-7022
2,5,6,5,16,6649,13400,-6751
2,5,7,5,16,6790,13397,-6607
2,5,8,5,16,6982,12981,-5999
2,6,0,5,16,7389,12498,-5109
2,6,1,5,16,7317,13002,-5685
2,6,2,5,16,7310,13300,-5990
2,6,3,5,16,7310,13853,-6543
2,6,4,5,16,7399,14322,-6923
2,6,5,5,16,7454,14172,-6718
2,6,6,5,16,7509,13986,-6477
2,6,7,5,16,7577,14029,-6452
2,6,8,5,16,7649,13568,-5919
2,7,0,5,16,8966,11965,-2999
2,7,1,5,16,9040,12512,-3472
2,7,2,5,16,9227,12730,-3503
2,7,3,5,16,9359,13303,-3944
2,7,4,5,16,9538,13782,-4244
2,7,5,5,16,9543,13609,-4066
2,7,6,5,16,9567,13348,-3781
2,7,7,5,16,9536,13428,-3892
2,7,8,5,16,9455,12955,-3500
2,8,0,5,16,9990,11430,-1440
2,8,1,5,16,10195,12011,-1816
2,8,2,5,16,10514,12224,-1710
2,8,3,5,16,10753,12713,-1960
2,8,4,5,16,11000,13110,-2110
2,8,5,5,16,10954,12923,-1969
2,8,6,5,16,10947,12641,-1694
2,8,7,5,16,10874,12716,-1842
2,8,8,5,16,10680,12260,-1580
2,9,0,5,16,10397,10846,-449
2,9,1,5,16,10697,11269,-572
2,9,2,5,16,11084,11490,-406
2,9,3,5,16,11423,11868,-445
2,9,4,5,16,11745,12116,-371
2,9,5,5,16,11653,11901,-248
2,9,6,5,16,11547,11669,-122
2,9,7,5,16,11518,11729,-211
2,9,8,5,16,11215,11365,-150
2,10,0,5,16,11984,10536,1448
2,10,1,5,16,12420,10868,1552
2,10,2,5,16,12821,11196,1625
2,10,3,5,16,13286,11424,1862
2,10,4,5,16,13695,11410,2285
2,10,5,5,16,13570,11265,2305
2,10,6,5,16,13400,11091,2309
2,10,7,5,16,13397,11095,2302
2,10,8,5,16,12981,10910,2071
2,11,0,5,16,12498,10223,2275
2,11,1,5,16,13002,10394,2608
2,11,2,5,16,13300,10764,2536
2,11,3,5,16,13853,10832,3021
2,11,4,5,16,14322,10561,3761
2,11,5,5,16,14172,10540,3632
2,11,6,5,16,13986,10420,3566
2,11,7,5,16,14029,10384,3645
2,11,8,5,16,13568,10327,3241
2,12,0,5,16,11965,9187,2778
2,12,1,5,16,12512,9052,3460
2,12,2,5,16,12730,9364,3366
2,12,3,5,16,13303,9284,4019
2,12,4,5,16,13782,8764,5018
2,12,5,5,16,13609,8845,4764
2,12,6,5,16,13348,8863,4485
2,12,7,5,16,13428,8878,4550
2,12,8,5,16,12955,9018,3937
2,13,0,5,16,11430,8488,2942
2,13,1,5,16,12011,8234,3777
2,13,2,5,16,12224,8456,3768
2,13,3,5,16,12713,8308,4405
2,13,4,5,16,13110,7712,5398
2,13,5,5,16,12923,7834,5089
2,13,6,5,16,12641,7894,4747
2,13,7,5,16,12716,7937,4779
2,13,8,5,16,12260,8114,4146
2,14,0,5,16,10846,8001,2845
2,14,1,5,16,11269,7798,3471
2,14,2,5,16,11490,7952,3538
2,14,3,5,16,11868,7795,4073
2,14,4,5,16,12116,7259,4857
2,14,5,5,16,11901,7404,4497
2,14,6,5,16,11669,7447,4222
2,14,7,5,16,11729,7504,4225
2,14,8,5,16,11365,7655,3710
2,0,0,6,16,9162,10252,-1090
2,0,1,6,16,9034,10283,-1249
2,0,2,6,16,8893,10412,-1519
2,0,3,6,16,8861,10506,-1645
2,0,4,6,16,8879,10683,-1804
2,0,5,6,16,8823,10698,-1875
2,0,6,6,16,8809,10747,-1938
2,0,7,6,16,8900,10765,-1865
2,0,8,6,16,8978,10741,-1763
2,1,0,6,16,8780,11445,-2665
2,1,1,6,16,8621,11619,-2998
2,1,2,6,16,8427,11897,-3470
2,1,3,6,16,8343,12125,-3782
2,1,4,6,16,8349,12400,-4051
2,1,5,6,16,8316,12386,-4070
2,1,6,6,16,8335,12406,-4071
2,1,7,6,16,8470,12361,-3891
2,1,8,6,16,8609,12187,-3578
2,2,0,6,16,8536,12373,-3837
2,2,1,6,16,8337,12681,-4344
2,2,2,6,16,8106,13058,-4952
2,2,3,6,16,8014,13405,-5391
2,2,4,6,16,8052,13742,-5690
2,2,5,6,16,8062,13686,-5624
2,2,6,6,16,8105,13614,-5509
2,2,7,6,16,8256,13568,-5312
2,2,8,6,16,8420,13275,-4855
2,3,0,6,16,8749,12795,-4046
2,3,1,6,16,8547,13184,-4637
2,3,2,6,16,8312,13582,-5270
2,3,3,6,16,8231,14036,-5805
2,3,4,6,16,8284,14449,-6165
2,3,5,6,16,8337,14334,-5997
2,3,6,6,16,8412,14169,-5757
2,3,7,6,16,8539,14198,-5659
2,3,8,6,16,8725,13818,-5093
2,4,0,6,16,8135,14359,-6224
2,4,1,6,16,7908,14904,-6996
2,4,2,6,16,7688,15307,-7619
2,4,3,6,16,7589,15912,-8323
2,4,4,6,16,7630,16425,-8795
2,4,5,6,16,7698,16242,-8544
2,4,6,6,16,7789,16020,-8231
2,4,7,6,16,7949,16039,-8090
2,4,8,6,16,8175,15527,-7352
2,5,0,6,16,8736,14828,-6092
2,5,1,6,16,8605,15478,-6873
2,5,2,6,16,8534,15832,-7298
2,5,3,6,16,8495,16499,-8004
2,5,4,6,16,8572,17066,-8494
2,5,5,6,16,8618,16853,-8235
2,5,6,6,16,8683,16586,-7903
2,5,7,6,16,8800,16616,-7816
2,5,8,6,16,8941,16047,-7106
2,6,0,6,16,10252,13909,-3657
2,6,1,6,16,10283,14590,-4307
2,6,2,6,16,10412,14894,-4482
2,6,3,6,16,10506,15479,-4973
2,6,4,6,16,10683,15972,-5289
2,6,5,6,16,10698,15766,-5068
2,6,6,6,16,10747,15480,-4733
2,6,7,6,16,10765,15541,-4776
2,6,8,6,16,10741,14992,-4251
2,7,0,6,16,11445,13229,-1784
2,7,1,6,16,11619,13755,-2136
2,7,2,6,16,11897,14034,-2137
2,7,3,6,16,12125,14520,-2395
2,7,4,6,16,12400,14858,-2458
2,7,5,6,16,12386,14633,-2247
2,7,6,6,16,12406,14336,-1930
2,7,7,6,16,12361,14423,-2062
2,7,8,6,16,12187,13960,-1773
2,8,0,6,16,12373,12934,-561
2,8,1,6,16,12681,13355,-674
2,8,2,6,16,13058,13694,-636
2,8,3,6,16,13405,14037,-632
2,8,4,6,16,13742,14114,-372
2,8,5,6,16,13686,13946,-260
2,8,6,6,16,13614,13713,-99
2,8,7,6,16,13568,13775,-207
2,8,8,6,16,13275,13513,-238
2,9,0,6,16,12795,12598,197
2,9,1,6,16,13184,12878,306
2,9,2,6,16,13582,13250,332
2,9,3,6,16,14036,13458,578
2,9,4,6,16,14449,13291,1158
2,9,5,6,16,14334,13212,1122
2,9,6,6,16,14169,13040,1129
2,9,7,6,16,14198,13026,1172
2,9,8,6,16,13818,12873,945
2,10,0,6,16,14359,11517,2842
2,10,1,6,16,14904,11528,3376
2,10,2,6,16,15307,11896,3411
2,10,3,6,16,15912,11930,3982
2,10,4,6,16,16425,11508,4917
2,10,5,6,16,16242,11526,4716
2,10,6,6,16,16020,11463,4557
2,10,7,6,16,16039,11465,4574
2,10,8,6,16,15527,11497,4030
2,11,0,6,16,14828,10432,4396
2,11,1,6,16,15478,10312,5166
2,11,2,6,16,15832,10620,5212
2,11,3,6,16,16499,10484,6015
2,11,4,6,16,17066,9902,7164
2,11,5,6,16,16853,9991,6862
2,11,6,6,16,16586,10026,6560
2,11,7,6,16,16616,10050,6566
2,11,8,6,16,16047,10151,5896
2,12,0,6,16,13909,9800,4109
2,12,1,6,16,14590,9542,5048
2,12,2,6,16,14894,9762,5132
2,12,3,6,16,15479,9602,5877
2,12,4,6,16,15972,9007,6965
2,12,5,6,16,15766,9114,6652
2,12,6,6,16,15480,9142,6338
2,12,7,6,16,15541,9211,6330
2,12,8,6,16,14992,9355,5637
2,0,0,7,16,10448,13828,-3380
2,0,1,7,16,10277,14105,-3828
2,0,2,7,16,10078,14441,-4363
2,0,3,7,16,10008,14777,-4769
2,0,4,7,16,10024,15142,-5118
2,0,5,7,16,9978,15118,-5140
2,0,6,7,16,9989,15073,-5084
2,0,7,7,16,10129,15055,-4926
2,0,8,7,16,10264,14782,-4518
2,1,0,7,16,10235,14771,-4536
2,1,1,7,16,10045,15168,-5123
2,1,2,7,16,9810,15556,-5746
2,1,3,7,16,9715,16018,-6303
2,1,4,7,16,9749,16446,-6697
2,1,5,7,16,9748,16367,-6619
2,1,6,7,16,9794,16236,-6442
2,1,7,7,16,9957,16248,-6291
2,1,8,7,16,10116,15878,-5762
2,2,0,7,16,10512,15170,-4658
2,2,1,7,16,10321,15668,-5347
2,2,2,7,16,10080,16068,-5988
2,2,3,7,16,9996,16662,-6666
2,2,4,7,16,10049,17179,-7130
2,2,5,7,16,10095,17006,-6911
2,2,6,7,16,10172,16789,-6617
2,2,7,7,16,10306,16840,-6534
2,2,8,7,16,10480,16364,-5884
2,3,0,7,16,9560,16689,-7129
2,3,1,7,16,9311,17380,-8069
2,3,2,7,16,9073,17839,-8766
2,3,3,7,16,8981,18558,-9577
2,3,4,7,16,9038,19169,-10131
2,3,5,7,16,9101,18923,-9822
2,3,6,7,16,9181,18620,-9439
2,3,7,7,16,9340,18626,-9286
2,3,8,7,16,9562,18006,-8444
2,4,0,7,16,9996,16772,-6776
2,4,1,7,16,9810,17556,-7746
2,4,2,7,16,9695,17996,-8301
2,4,3,7,16,9648,18675,-9027
2,4,4,7,16,9733,19256,-9523
2,4,5,7,16,9768,19010,-9242
2,4,6,7,16,9823,18718,-8895
2,4,7,7,16,9959,18729,-8770
2,4,8,7,16,10134,18084,-7950
2,5,0,7,16,11599,15708,-4109
2,5,1,7,16,11571,16334,-4763
2,5,2,7,16,11636,16704,-5068
2,5,3,7,16,11691,17286,-5595
2,5,4,7,16,11856,17720,-5864
2,5,5,7,16,11862,17476,-5614
2,5,6,7,16,11921,17175,-5254
2,5,7,7,16,11988,17248,-5260
2,5,8,7,16,12033,16692,-4659
2,6,0,7,16,12731,15317,-2586
2,6,1,7,16,12862,15841,-2979
2,6,2,7,16,13082,16238,-3156
2,6,3,7,16,13272,16689,-3417
2,6,4,7,16,13545,16856,-3311
2,6,5,7,16,13541,16678,-3137
2,6,6,7,16,13586,16380,-2794
2,6,7,7,16,13590,16469,-2879
2,6,8,7,16,13473,16108,-2635
2,7,0,7,16,13828,14996,-1168
2,7,1,7,16,14105,15365,-1260
2,7,2,7,16,14441,15748,-1307
2,7,3,7,16,14777,16071,-1294
2,7,4,7,16,15142,15995,-853
2,7,5,7,16,15118,15893,-775
2,7,6,7,16,15073,15662,-589
2,7,7,7,16,15055,15706,-651
2,7,8,7,16,14782,15476,-694
2,8,0,7,16,14771,13892,879
2,8,1,7,16,15168,14012,1156
2,8,2,7,16,15556,14382,1174
2,8,3,7,16,16018,14556,1462
2,8,4,7,16,16446,14238,2208
2,8,5,7,16,16367,14198,2169
2,8,6,7,16,16236,14083,2153
2,8,7,7,16,16248,14107,2141
2,8,8,7,16,15878,14043,1835
2,9,0,7,16,15170,12762,2408
2,9,1,7,16,15668,12788,2880
2,9,2,7,16,16068,13152,2916
2,9,3,7,16,16662,13130,3532
2,9,4,7,16,17179,12646,4533
2,9,5,7,16,17006,12672,4334
2,9,6,7,16,16789,12626,4163
2,9,7,7,16,16840,12637,4203
2,9,8,7,16,16364,12630,3734
2,10,0,7,16,16689,11744,4945
2,10,1,7,16,17380,11620,5760
2,10,2,7,16,17839,11926,5913
2,10,3,7,16,18558,11778,6780
2,10,4,7,16,19169,11197,7972
2,10,5,7,16,18923,11271,7652
2,10,6,7,16,18620,11274,7346
2,10,7,7,16,18626,11324,7302
2,10,8,7,16,18006,11392,6614
2,0,0,8,16,11903,17146,-5243
2,0,1,8,16,11701,17652,-5951
2,0,2,8,16,11461,18042,-6581
2,0,3,8,16,11380,18644,-7264
2,0,4,8,16,11424,19176,-7752
2,0,5,8,16,11410,19039,-7629
2,0,6,8,16,11448,18856,-7408
2,0,7,8,16,11616,18890,-7274
2,0,8,8,16,11771,18424,-6653
2,1,0,8,16,12211,17500,-5289
2,1,1,8,16,12029,18144,-6115
2,1,2,8,16,11784,18600,-6816
2,1,3,8,16,11697,19308,-7611
2,1,4,8,16,11746,19923,-8177
2,1,5,8,16,11781,19687,-7906
2,1,6,8,16,11861,19389,-7528
2,1,7,8,16,12007,19427,-7420
2,1,8,8,16,12176,18843,-6667
2,2,0,8,16,11323,18633,-7310
2,2,1,8,16,11085,19458,-8373
2,2,2,8,16,10841,20003,-9162
2,2,3,8,16,10746,20734,-9988
2,2,4,8,16,10803,21359,-10556
2,2,5,8,16,10859,21080,-10221
2,2,6,8,16,10941,20752,-9811
2,2,7,8,16,11107,20739,-9632
2,2,8,8,16,11317,20043,-8726
2,3,0,8,16,11421,18571,-7150
2,3,1,8,16,11213,19300,-8087
2,3,2,8,16,11080,19806,-8726
2,3,3,8,16,11040,20482,-9442
2,3,4,8,16,11141,21004,-9863
2,3,5,8,16,11171,20720,-9549
2,3,6,8,16,11215,20413,-9198
2,3,7,8,16,11350,20436,-9086
2,3,8,8,16,11521,19784,-8263
2,4,0,8,16,12859,17796,-4937
2,4,1,8,16,12776,18420,-5644
2,4,2,8,16,12797,18908,-6111
2,4,3,8,16,12844,19455,-6611
2,4,4,8,16,13017,19718,-6701
2,4,5,8,16,13012,19521,-6509
2,4,6,8,16,13061,19219,-6158
2,4,7,8,16,13147,19294,-6147
2,4,8,8,16,13226,18840,-5614
2,5,0,8,16,14078,17379,-3301
2,5,1,8,16,14150,17851,-3701
2,5,2,8,16,14306,18292,-3986
2,5,3,8,16,14457,18723,-4266
2,5,4,8,16,14718,18737,-4019
2,5,5,8,16,14705,18625,-3920
2,5,6,8,16,14760,18329,-3569
2,5,7,8,16,14813,18400,-3587
2,5,8,8,16,14765,18071,-3306
2,6,0,8,16,15114,16290,-1176
2,6,1,8,16,15348,16499,-1151
2,6,2,8,16,15626,16880,-1254
2,6,3,8,16,15924,17169,-1245
2,6,4,8,16,16287,16942,-655
2,6,5,8,16,16273,16879,-606
2,6,6,8,16,16253,16705,-452
2,6,7,8,16,16284,16787,-503
2,6,8,8,16,16068,16646,-578
2,7,0,8,16,16226,15137,1089
2,7,1,8,16,16592,15272,1320
2,7,2,8,16,16939,15638,1301
2,7,3,8,16,17390,15756,1634
2,7,4,8,16,17846,15376,2470
2,7,5,8,16,17799,15344,2455
2,7,6,8,16,17695,15246,2449
2,7,7,8,16,17735,15279,2456
2,7,8,8,16,17385,15176,2209
2,8,0,8,16,17146,14074,3072
2,8,1,8,16,17652,14096,3556
2,8,2,8,16,18042,14458,3584
2,8,3,8,16,18644,14424,4220
2,8,4,8,16,19176,13941,5235
2,8,5,8,16,19039,13952,5087
2,8,6,8,16,18856,13874,4982
2,8,7,8,16,18890,13911,4979
2,8,8,8,16,18424,13871,4553
2,0,0,9,16,13879,19444,-5565
2,0,1,9,16,13685,20222,-6537
2,0,2,9,16,13435,20764,-7329
2,0,3,9,16,13362,21484,-8122
2,0,4,9,16,13421,22113,-8692
2,0,5,9,16,13443,21844,-8401
2,0,6,9,16,13515,21521,-8006
2,0,7,9,16,13666,21540,-7874
2,0,8,9,16,13831,20880,-7049
2,1,0,9,16,13022,20432,-7410
2,1,1,9,16,12793,21202,-8409
2,1,2,9,16,12545,21813,-9268
2,1,3,9,16,12447,22541,-10094
2,1,4,9,16,12500,23107,-10607
2,1,5,9,16,12545,22790,-10245
2,1,6,9,16,12630,22447,-9817
2,1,7,9,16,12808,22446,-9638
2,1,8,9,16,13013,21743,-8730
2,2,0,9,16,13184,20659,-7475
2,2,1,9,16,12987,21386,-8399
2,2,2,9,16,12848,22010,-9162
2,2,3,9,16,12805,22651,-9846
2,2,4,9,16,12906,23002,-10096
2,2,5,9,16,12929,22765,-9836
2,2,6,9,16,12975,22457,-9482
2,2,7,9,16,13117,22482,-9365
2,2,8,9,16,13276,21932,-8656
2,3,0,9,16,14284,19858,-5574
2,3,1,9,16,14179,20430,-6251
2,3,2,9,16,14182,20962,-6780
2,3,3,9,16,14236,21489,-7253
2,3,4,9,16,14425,21599,-7174
2,3,5,9,16,14415,21468,-7053
2,3,6,9,16,14453,21168,-6715
2,3,7,9,16,14538,21225,-6687
2,3,8,9,16,14613,20803,-6190
2,4,0,9,16,15338,18673,-3335
2,4,1,9,16,15355,18985,-3630
2,4,2,9,16,15467,19424,-3957
2,4,3,9,16,15610,19821,-4211
2,4,4,9,16,15879,19684,-3805
2,4,5,9,16,15855,19611,-3756
2,4,6,9,16,15900,19372,-3472
2,4,7,9,16,15972,19481,-3509
2,4,8,9,16,15958,19241,-3283
2,5,0,9,16,16461,17535,-1074
2,5,1,9,16,16636,17759,-1123
2,5,2,9,16,16850,18136,-1286
2,5,3,9,16,17109,18369,-1260
2,5,4,9,16,17460,18080,-620
2,5,5,9,16,17437,18025,-588
2,5,6,9,16,17427,17868,-441
2,5,7,9,16,17507,17959,-452
2,5,8,9,16,17360,17779,-419
2,6,0,9,16,17512,16449,1063
2,6,1,9,16,17835,16580,1255
2,6,2,9,16,18124,16944,1180
2,6,3,9,16,18537,17050,1487
2,6,4,9,16,18991,16671,2320
2,6,5,9,16,18954,16624,2330
2,6,6,9,16,18875,16494,2381
2,6,7,9,16,18964,16553,2411
2,6,8,9,16,18671,16417,2254
2,0,0,10,16,14690,22520,-7830
2,0,1,10,16,14449,23288,-8839
2,0,2,10,16,14196,24017,-9821
2,0,3,10,16,14112,24710,-10598
2,0,4,10,16,14175,25105,-10930
2,0,5,10,16,14207,24835,-10628
2,0,6,10,16,14284,24491,-10207
2,0,7,10,16,14467,24492,-10025
2,0,8,10,16,14668,23891,-9223
2,1,0,10,16,14883,22721,-7838
2,1,1,10,16,14695,23396,-8701
2,1,2,10,16,14552,24064,-9512
2,1,3,10,16,14506,24685,-10179
2,1,4,10,16,14603,24883,-10280
2,1,5,10,16,14615,24712,-10097
2,1,6,10,16,14664,24406,-9742
2,1,7,10,16,14818,24413,-9595
2,1,8,10,16,14972,23895,-8923
2,2,0,10,16,16047,21152,-5105
2,2,1,10,16,15953,21564,-5611
2,2,2,10,16,15950,22094,-6144
2,2,3,10,16,16001,22587,-6586
2,2,4,10,16,16190,22546,-6356
2,2,5,10,16,16173,22454,-6281
2,2,6,10,16,16213,22211,-5998
2,2,7,10,16,16305,22306,-6001
2,2,8,10,16,16368,21973,-5605
2,3,0,10,16,16763,19918,-3155
2,3,1,10,16,16758,20245,-3487
2,3,2,10,16,16852,20680,-3828
2,3,3,10,16,17002,21021,-4019
2,3,4,10,16,17287,20822,-3535
2,3,5,10,16,17258,20757,-3499
2,3,6,10,16,17292,20535,-3243
2,3,7,10,16,17363,20653,-3290
2,3,8,10,16,17345,20374,-3029
2,4,0,10,16,17721,18847,-1126
2,4,1,10,16,17841,19067,-1226
2,4,2,10,16,18011,19442,-1431
2,4,3,10,16,18262,19663,-1401
2,4,4,10,16,18621,19375,-754
2,4,5,10,16,18587,19305,-718
2,4,6,10,16,18567,19116,-549
2,4,7,10,16,18666,19233,-567
2,4,8,10,16,18553,19020,-467
2,0,0,11,16,16551,24015,-7464
2,0,1,11,16,16351,24530,-8179
2,0,2,11,16,16203,25196,-8993
2,0,3,11,16,16171,25783,-9612
2,0,4,11,16,16278,25830,-9552
2,0,5,11,16,16277,25698,-9421
2,0,6,11,16,16318,25449,-9131
2,0,7,11,16,16477,25494,-9017
2,0,8,11,16,16627,25065,-8438
2,1,0,11,16,17746,22397,-4651
2,1,1,11,16,17661,22824,-5163
2,1,2,11,16,17654,23350,-5696
2,1,3,11,16,17702,23787,-6085
2,1,4,11,16,17887,23684,-5797
2,1,5,11,16,17859,23600,-5741
2,1,6,11,16,17902,23374,-5472
2,1,7,11,16,18006,23478,-5472
2,1,8,11,16,18064,23106,-5042
2,2,0,11,16,18526,21230,-2704
2,2,1,11,16,18532,21553,-3021
2,2,2,11,16,18620,21986,-3366
2,2,3,11,16,18767,22315,-3548
2,2,4,11,16,19052,22117,-3065
2,2,5,11,16,19016,22037,-3021
2,2,6,11,16,19052,21783,-2731
2,2,7,11,16,19130,21927,-2797
2,2,8,11,16,19100,21615,-2515
2,0,0,12,16,19414,23709,-4295
2,0,1,12,16,19317,24132,-4815
2,0,2,12,16,19305,24656,-5351
2,0,3,12,16,19367,25081,-5714
2,0,4,12,16,19562,24979,-5417
2,0,5,12,16,19521,24880,-5359
2,0,6,12,16,19556,24622,-5066
2,0,7,12,16,19665,24752,-5087
2,0,8,12,16,19719,24347,-4628
2,0,0,1,17,1766,1814,-48
2,0,1,1,17,1758,1815,-57
2,0,2,1,17,1761,1808,-47
2,0,3,1,17,1773,1803,-30
2,0,4,1,17,1773,1798,-25
2,0,5,1,17,1765,1797,-32
2,0,6,1,17,1763,1803,-40
2,0,7,1,17,1761,1803,-42
2,1,0,1,17,1814,1880,-66
2,1,1,1,17,1815,1883,-68
2,1,2,1,17,1808,1877,-69
2,1,3,1,17,1803,1872,-69
2,1,4,1,17,1798,1868,-70
2,1,5,1,17,1797,1868,-71
2,1,6,1,17,1803,1875,-72
2,1,7,1,17,1803,1873,-70
2,2,0,1,17,1880,1515,365
2,2,1,1,17,1883,1502,381
2,2,2,1,17,1877,1502,375
2,2,3,1,17,1872,1513,359
2,2,4,1,17,1868,1515,353
2,2,5,1,17,1868,1507,361
2,2,6,1,17,1875,1503,372
2,2,7,1,17,1873,1502,371
2,3,0,1,17,1515,1319,196
2,3,1,1,17,1502,1280,222
2,3,2,1,17,1502,1267,235
2,3,3,1,17,1513,1276,237
2,3,4,1,17,1515,1276,239
2,3,5,1,17,1507,1260,247
2,3,6,1,17,1503,1253,250
2,3,7,1,17,1502,1269,233
2,4,0,1,17,1319,1402,-83
2,4,1,1,17,1280,1346,-66
2,4,2,1,17,1267,1305,-38
2,4,3,1,17,1276,1292,-16
2,4,4,1,17,1276,1289,-13
2,4,5,1,17,1260,1283,-23
2,4,6,1,17,1253,1292,-39
2,4,7,1,17,1269,1331,-62
2,5,0,1,17,1402,1363,39
2,5,1,1,17,1346,1309,37
2,5,2,1,17,1305,1256,49
2,5,3,1,17,1292,1234,58
2,5,4,1,17,1289,1242,47
2,5,5,1,17,1283,1262,21
2,5,6,1,17,1292,1296,-4
2,5,7,1,17,1331,1344,-13
2,6,0,1,17,1363,1554,-191
2,6,1,1,17,1309,1508,-199
2,6,2,1,17,1256,1462,-206
2,6,3,1,17,1234,1449,-215
2,6,4,1,17,1242,1472,-230
2,6,5,1,17,1262,1516,-254
2,6,6,1,17,1296,1569,-273
2,6,7,1,17,1344,1612,-268
2,7,0,1,17,1554,2110,-556
2,7,1,1,17,1508,2115,-607
2,7,2,1,17,1462,2103,-641
2,7,3,1,17,1449,2075,-626
2,7,4,1,17,1472,2096,-624
2,7,5,1,17,1516,2161,-645
2,7,6,1,17,1569,2185,-616
2,7,7,1,17,1612,2181,-569
2,8,0,1,17,2110,870,1240
2,8,1,1,17,2115,830,1285
2,8,2,1,17,2103,819,1284
2,8,3,1,17,2075,797,1278
2,8,4,1,17,2096,805,1291
2,8,5,1,17,2161,824,1337
2,8,6,1,17,2185,845,1340
2,8,7,1,17,2181,904,1277
2,9,0,1,17,870,2006,-1136
2,9,1,1,17,830,2051,-1221
2,9,2,1,17,819,2119,-1300
2,9,3,1,17,797,2179,-1382
2,9,4,1,17,805,2218,-1413
2,9,5,1,17,824,2152,-1328
2,9,6,1,17,845,2133,-1288
2,9,7,1,17,904,2116,-1212
2,10,0,1,17,2006,3105,-1099
2,10,1,1,17,2051,3202,-1151
2,10,2,1,17,2119,3286,-1167
2,10,3,1,17,2179,3407,-1228
2,10,4,1,17,2218,3497,-1279
2,10,5,1,17,2152,3413,-1261
2,10,6,1,17,2133,3411,-1278
2,10,7,1,17,2116,3322,-1206
2,11,0,1,17,3105,2730,375
2,11,1,1,17,3202,2817,385
2,11,2,1,17,3286,2870,416
2,11,3,1,17,3407,2988,419
2,11,4,1,17,3497,3080,417
2,11,5,1,17,3413,3040,373
2,11,6,1,17,3411,3038,373
2,11,7,1,17,3322,2956,366
2,12,0,1,17,2730,2632,98
2,12,1,1,17,2817,2703,114
2,12,2,1,17,2870,2762,108
2,12,3,1,17,2988,2865,123
2,12,4,1,17,3080,2919,161
2,12,5,1,17,3040,2920,120
2,12,6,1,17,3038,2864,174
2,12,7,1,17,2956,2828,128
2,13,0,1,17,2632,2639,-7
2,13,1,1,17,2703,2667,36
2,13,2,1,17,2762,2728,34
2,13,3,1,17,2865,2826,39
2,13,4,1,17,2919,2857,62
2,13,5,1,17,2920,2876,44
2,13,6,1,17,2864,2823,41
2,13,7,1,17,2828,2834,-6
2,14,0,1,17,2639,2630,9
2,14,1,1,17,2667,2655,12
2,14,2,1,17,2728,2733,-5
2,14,3,1,17,2826,2849,-23
2,14,4,1,17,2857,2879,-22
2,14,5,1,17,2876,2870,6
2,14,6,1,17,2823,2806,17
2,14,7,1,17,2834,2783,51
2,15,0,1,17,2630,2584,46
2,15,1,1,17,2655,2646,9
2,15,2,1,17,2733,2721,12
2,15,3,1,17,2849,2863,-14
2,15,4,1,17,2879,2900,-21
2,15,5,1,17,2870,2849,21
2,15,6,1,17,2806,2717,89
2,15,7,1,17,2783,2727,56
2,16,0,1,17,2584,2186,398
2,16,1,1,17,2646,2239,407
2,16,2,1,17,2721,2239,482
2,16,3,1,17,2863,2336,527
2,16,4,1,17,2900,2364,536
2,16,5,1,17,2849,2323,526
2,16,6,1,17,2717,2225,492
2,16,7,1,17,2727,2268,459
2,17,0,1,17,2186,1866,320
2,17,1,1,17,2239,1902,337
2,17,2,1,17,2239,1883,356
2,17,3,1,17,2336,1932,404
2,17,4,1,17,2364,1948,416
2,17,5,1,17,2323,1874,449
2,17,6,1,17,2225,1776,449
2,17,7,1,17,2268,1828,440
2,18,0,1,17,1866,2276,-410
2,18,1,1,17,1902,2294,-392
2,18,2,1,17,1883,2273,-390
2,18,3,1,17,1932,2232,-300
2,18,4,1,17,1948,2175,-227
2,18,5,1,17,1874,2124,-250
2,18,6,1,17,1776,2118,-342
2,18,7,1,17,1828,2247,-419
2,19,0,1,17,2276,2200,76
2,19,1,1,17,2294,2130,164
2,19,2,1,17,2273,2102,171
2,19,3,1,17,2232,2111,121
2,19,4,1,17,2175,2044,131
2,19,5,1,17,2124,1992,132
2,19,6,1,17,2118,2004,114
2,19,7,1,17,2247,2142,105
2,20,0,1,17,2200,1337,863
2,20,1,1,17,2130,1204,926
2,20,2,1,17,2102,1187,915
2,20,3,1,17,2111,1182,929
2,20,4,1,17,2044,1048,996
2,20,5,1,17,1992,1075,917
2,20,6,1,17,2004,1139,865
2,20,7,1,17,2142,1254,888
2,21,0,1,17,1337,1357,-20
2,21,1,1,17,1204,1330,-126
2,21,2,1,17,1187,1276,-89
2,21,3,1,17,1182,1258,-76
2,21,4,1,17,1048,1186,-138
2,21,5,1,17,1075,1200,-125
2,21,6,1,17,1139,1217,-78
2,21,7,1,17,1254,1228,26
2,22,0,1,17,1357,1419,-62
2,22,1,1,17,1330,1375,-45
2,22,2,1,17,1276,1348,-72
2,22,3,1,17,1258,1364,-106
2,22,4,1,17,1186,1349,-163
2,22,5,1,17,1200,1313,-113
2,22,6,1,17,1217,1322,-105
2,22,7,1,17,1228,1321,-93
2,0,0,2,17,3580,3395,185
2,0,1,2,17,3573,3385,188
2,0,2,2,17,3569,3379,190
2,0,3,2,17,3576,3385,191
2,0,4,2,17,3571,3383,188
2,0,5,2,17,3562,3375,187
2,0,6,2,17,3566,3378,188
2,0,7,2,17,3564,3375,189
2,1,0,2,17,3694,2834,860
2,1,1,2,17,3698,2782,916
2,1,2,2,17,3685,2769,916
2,1,3,2,17,3675,2789,886
2,1,4,2,17,3666,2791,875
2,1,5,2,17,3665,2767,898
2,1,6,2,17,3678,2756,922
2,1,7,2,17,3676,2771,905
2,2,0,2,17,3395,2721,674
2,2,1,2,17,3385,2626,759
2,2,2,2,17,3379,2572,807
2,2,3,2,17,3385,2568,817
2,2,4,2,17,3383,2565,818
2,2,5,2,17,3375,2543,832
2,2,6,2,17,3378,2545,833
2,2,7,2,17,3375,2600,775
2,3,0,2,17,2834,2765,69
2,3,1,2,17,2782,2655,127
2,3,2,2,17,2769,2561,208
2,3,3,2,17,2789,2526,263
2,3,4,2,17,2791,2531,260
2,3,5,2,17,2767,2545,222
2,3,6,2,17,2756,2588,168
2,3,7,2,17,2771,2675,96
2,4,0,2,17,2721,2917,-196
2,4,1,2,17,2626,2817,-191
2,4,2,2,17,2572,2718,-146
2,4,3,2,17,2568,2683,-115
2,4,4,2,17,2565,2714,-149
2,4,5,2,17,2543,2778,-235
2,4,6,2,17,2545,2865,-320
2,4,7,2,17,2600,2956,-356
2,5,0,2,17,2765,3664,-899
2,5,1,2,17,2655,3623,-968
2,5,2,2,17,2561,3565,-1004
2,5,3,2,17,2526,3524,-998
2,5,4,2,17,2531,3568,-1037
2,5,5,2,17,2545,3677,-1132
2,5,6,2,17,2588,3754,-1166
2,5,7,2,17,2675,3793,-1118
2,6,0,2,17,2917,2980,-63
2,6,1,2,17,2817,2945,-128
2,6,2,2,17,2718,2922,-204
2,6,3,2,17,2683,2872,-189
2,6,4,2,17,2714,2901,-187
2,6,5,2,17,2778,2985,-207
2,6,6,2,17,2865,3030,-165
2,6,7,2,17,2956,3085,-129
2,7,0,2,17,3664,2876,788
2,7,1,2,17,3623,2881,742
2,7,2,2,17,3565,2938,627
2,7,3,2,17,3524,2976,548
2,7,4,2,17,3568,3023,545
2,7,5,2,17,3677,2976,701
2,7,6,2,17,3754,2978,776
2,7,7,2,17,3793,3020,773
2,8,0,2,17,2980,5111,-2131
2,8,1,2,17,2945,5253,-2308
2,8,2,2,17,2922,5405,-2483
2,8,3,2,17,2872,5586,-2714
2,8,4,2,17,2901,5715,-2814
2,8,5,2,17,2985,5565,-2580
2,8,6,2,17,3030,5544,-2514
2,8,7,2,17,3085,5438,-2353
2,9,0,2,17,2876,5835,-2959
2,9,1,2,17,2881,6019,-3138
2,9,2,2,17,2938,6156,-3218
2,9,3,2,17,2976,6395,-3419
2,9,4,2,17,3023,6577,-3554
2,9,5,2,17,2976,6453,-3477
2,9,6,2,17,2978,6449,-3471
2,9,7,2,17,3020,6278,-3258
2,10,0,2,17,5111,5362,-251
2,10,1,2,17,5253,5520,-267
2,10,2,2,17,5405,5632,-227
2,10,3,2,17,5586,5853,-267
2,10,4,2,17,5715,5999,-284
2,10,5,2,17,5565,5960,-395
2,10,6,2,17,5544,5902,-358
2,10,7,2,17,5438,5784,-346
2,11,0,2,17,5835,5271,564
2,11,1,2,17,6019,5370,649
2,11,2,2,17,6156,5490,666
2,11,3,2,17,6395,5691,704
2,11,4,2,17,6577,5776,801
2,11,5,2,17,6453,5796,657
2,11,6,2,17,6449,5687,762
2,11,7,2,17,6278,5662,616
2,12,0,2,17,5362,5269,93
2,12,1,2,17,5520,5322,198
2,12,2,2,17,5632,5461,171
2,12,3,2,17,5853,5675,178
2,12,4,2,17,5999,5736,263
2,12,5,2,17,5960,5746,214
2,12,6,2,17,5902,5629,273
2,12,7,2,17,5784,5617,167
2,13,0,2,17,5271,5214,57
2,13,1,2,17,5370,5301,69
2,13,2,2,17,5490,5454,36
2,13,3,2,17,5691,5712,-21
2,13,4,2,17,5776,5779,-3
2,13,5,2,17,5796,5719,77
2,13,6,2,17,5687,5523,164
2,13,7,2,17,5662,5510,152
2,14,0,2,17,5269,4770,499
2,14,1,2,17,5322,4885,437
2,14,2,2,17,5461,4960,501
2,14,3,2,17,5675,5199,476
2,14,4,2,17,5736,5264,472
2,14,5,2,17,5746,5172,574
2,14,6,2,17,5629,4942,687
2,14,7,2,17,5617,4995,622
2,15,0,2,17,5214,4052,1162
2,15,1,2,17,5301,4141,1160
2,15,2,2,17,5454,4122,1332
2,15,3,2,17,5712,4268,1444
2,15,4,2,17,5779,4312,1467
2,15,5,2,17,5719,4197,1522
2,15,6,2,17,5523,4001,1522
2,15,7,2,17,5510,4096,1414
2,16,0,2,17,4770,4142,628
2,16,1,2,17,4885,4196,689
2,16,2,2,17,4960,4156,804
2,16,3,2,17,5199,4164,1035
2,16,4,2,17,5264,4123,1141
2,16,5,2,17,5172,3998,1174
2,16,6,2,17,4942,3894,1048
2,16,7,2,17,4995,4075,920
2,17,0,2,17,4052,4476,-424
2,17,1,2,17,4141,4424,-283
2,17,2,2,17,4122,4375,-253
2,17,3,2,17,4268,4343,-75
2,17,4,2,17,4312,4219,93
2,17,5,2,17,4197,4116,81
2,17,6,2,17,4001,4122,-121
2,17,7,2,17,4096,4389,-293
2,18,0,2,17,4142,3537,605
2,18,1,2,17,4196,3334,862
2,18,2,2,17,4156,3289,867
2,18,3,2,17,4164,3293,871
2,18,4,2,17,4123,3092,1031
2,18,5,2,17,3998,3067,931
2,18,6,2,17,3894,3143,751
2,18,7,2,17,4075,3396,679
2,19,0,2,17,4476,2694,1782
2,19,1,2,17,4424,2534,1890
2,19,2,2,17,4375,2463,1912
2,19,3,2,17,4343,2440,1903
2,19,4,2,17,4219,2234,1985
2,19,5,2,17,4116,2275,1841
2,19,6,2,17,4122,2356,1766
2,19,7,2,17,4389,2482,1907
2,20,0,2,17,3537,2776,761
2,20,1,2,17,3334,2705,629
2,20,2,2,17,3289,2624,665
2,20,3,2,17,3293,2622,671
2,20,4,2,17,3092,2535,557
2,20,5,2,17,3067,2513,554
2,20,6,2,17,3143,2539,604
2,20,7,2,17,3396,2549,847
2,0,0,3,17,5460,4236,1224
2,0,1,3,17,5456,4128,1328
2,0,2,3,17,5446,4074,1372
2,0,3,3,17,5448,4081,1367
2,0,4,3,17,5439,4080,1359
2,0,5,3,17,5430,4050,1380
2,0,6,3,17,5441,4048,1393
2,0,7,3,17,5437,4102,1335
2,1,0,3,17,5209,4084,1125
2,1,1,3,17,5200,3935,1265
2,1,2,3,17,5187,3828,1359
2,1,3,3,17,5188,3802,1386
2,1,4,3,17,5181,3807,1374
2,1,5,3,17,5172,3805,1367
2,1,6,3,17,5181,3841,1340
2,1,7,3,17,5178,3944,1234
2,2,0,3,17,4714,4319,395
2,2,1,3,17,4665,4163,502
2,2,2,3,17,4646,4023,623
2,2,3,3,17,4661,3975,686
2,2,4,3,17,4659,4003,656
2,2,5,3,17,4635,4061,574
2,2,6,3,17,4631,4157,474
2,2,7,3,17,4644,4287,357
2,3,0,3,17,4236,5027,-791
2,3,1,3,17,4128,4932,-804
2,3,2,3,17,4074,4821,-747
2,3,3,3,17,4081,4758,-677
2,3,4,3,17,4080,4810,-730
2,3,5,3,17,4050,4939,-889
2,3,6,3,17,4048,5050,-1002
2,3,7,3,17,4102,5137,-1035
2,4,0,3,17,4084,4534,-450
2,4,1,3,17,3935,4453,-518
2,4,2,3,17,3828,4384,-556
2,4,3,3,17,3802,4321,-519
2,4,4,3,17,3807,4373,-566
2,4,5,3,17,3805,4501,-696
2,4,6,3,17,3841,4599,-758
2,4,7,3,17,3944,4697,-753
2,5,0,3,17,4319,4986,-667
2,5,1,3,17,4163,4996,-833
2,5,2,3,17,4023,5041,-1018
2,5,3,3,17,3975,5051,-1076
2,5,4,3,17,4003,5119,-1116
2,5,5,3,17,4061,5137,-1076
2,5,6,3,17,4157,5163,-1006
2,5,7,3,17,4287,5201,-914
2,6,0,3,17,5027,5981,-954
2,6,1,3,17,4932,6083,-1151
2,6,2,3,17,4821,6224,-1403
2,6,3,3,17,4758,6383,-1625
2,6,4,3,17,4810,6520,-1710
2,6,5,3,17,4939,6389,-1450
2,6,6,3,17,5050,6389,-1339
2,6,7,3,17,5137,6342,-1205
2,7,0,3,17,4534,7841,-3307
2,7,1,3,17,4453,8070,-3617
2,7,2,3,17,4384,8275,-3891
2,7,3,3,17,4321,8574,-4253
2,7,4,3,17,4373,8795,-4422
2,7,5,3,17,4501,8605,-4104
2,7,6,3,17,4599,8582,-3983
2,7,7,3,17,4697,8394,-3697
2,8,0,3,17,4986,8467,-3481
2,8,1,3,17,4996,8722,-3726
2,8,2,3,17,5041,8918,-3877
2,8,3,3,17,5051,9260,-4209
2,8,4,3,17,5119,9496,-4377
2,8,5,3,17,5137,9373,-4236
2,8,6,3,17,5163,9313,-4150
2,8,7,3,17,5201,9106,-3905
2,9,0,3,17,5981,8001,-2020
2,9,1,3,17,6083,8187,-2104
2,9,2,3,17,6224,8360,-2136
2,9,3,3,17,6383,8679,-2296
2,9,4,3,17,6520,8856,-2336
2,9,5,3,17,6389,8836,-2447
2,9,6,3,17,6389,8725,-2336
2,9,7,3,17,6342,8618,-2276
2,10,0,3,17,7841,7901,-60
2,10,1,3,17,8070,8025,45
2,10,2,3,17,8275,8223,52
2,10,3,3,17,8574,8540,34
2,10,4,3,17,8795,8655,140
2,10,5,3,17,8605,8666,-61
2,10,6,3,17,8582,8493,89
2,10,7,3,17,8394,8445,-51
2,11,0,3,17,8467,7853,614
2,11,1,3,17,8722,7968,754
2,11,2,3,17,8918,8182,736
2,11,3,3,17,9260,8538,722
2,11,4,3,17,9496,8636,860
2,11,5,3,17,9373,8595,778
2,11,6,3,17,9313,8346,967
2,11,7,3,17,9106,8344,762
2,12,0,3,17,8001,7400,601
2,12,1,3,17,8187,7540,647
2,12,2,3,17,8360,7693,667
2,12,3,3,17,8679,8048,631
2,12,4,3,17,8856,8143,713
2,12,5,3,17,8836,8042,794
2,12,6,3,17,8725,7748,977
2,12,7,3,17,8618,7778,840
2,13,0,3,17,7901,6636,1265
2,13,1,3,17,8025,6787,1238
2,13,2,3,17,8223,6843,1380
2,13,3,3,17,8540,7131,1409
2,13,4,3,17,8655,7212,1443
2,13,5,3,17,8666,7046,1620
2,13,6,3,17,8493,6718,1775
2,13,7,3,17,8445,6823,1622
2,14,0,3,17,7853,6328,1525
2,14,1,3,17,7968,6435,1533
2,14,2,3,17,8182,6395,1787
2,14,3,3,17,8538,6500,2038
2,14,4,3,17,8636,6487,2149
2,14,5,3,17,8595,6321,2274
2,14,6,3,17,8346,6119,2227
2,14,7,3,17,8344,6343,2001
2,15,0,3,17,7400,6342,1058
2,15,1,3,17,7540,6326,1214
2,15,2,3,17,7693,6258,1435
2,15,3,3,17,8048,6275,1773
2,15,4,3,17,8143,6167,1976
2,15,5,3,17,8042,5990,2052
2,15,6,3,17,7748,5898,1850
2,15,7,3,17,7778,6217,1561
2,16,0,3,17,6636,5813,823
2,16,1,3,17,6787,5628,1159
2,16,2,3,17,6843,5562,1281
2,16,3,3,17,7131,5525,1606
2,16,4,3,17,7212,5267,1945
2,16,5,3,17,7046,5191,1855
2,16,6,3,17,6718,5261,1457
2,16,7,3,17,6823,5643,1180
2,17,0,3,17,6328,4894,1434
2,17,1,3,17,6435,4664,1771
2,17,2,3,17,6395,4565,1830
2,17,3,3,17,6500,4551,1949
2,17,4,3,17,6487,4278,2209
2,17,5,3,17,6321,4267,2054
2,17,6,3,17,6119,4360,1759
2,17,7,3,17,6343,4624,1719
2,18,0,3,17,6342,4113,2229
2,18,1,3,17,6326,3909,2417
2,18,2,3,17,6258,3811,2447
2,18,3,3,17,6275,3804,2471
2,18,4,3,17,6167,3583,2584
2,18,5,3,17,5990,3588,2402
2,18,6,3,17,5898,3678,2220
2,18,7,3,17,6217,3803,2414
2,0,0,4,17,6975,5638,1337
2,0,1,4,17,6958,5443,1515
2,0,2,4,17,6948,5290,1658
2,0,3,4,17,6961,5251,1710
2,0,4,4,17,6954,5279,1675
2,0,5,4,17,6937,5321,1616
2,0,6,4,17,6944,5410,1534
2,0,7,4,17,6939,5556,1383
2,1,0,4,17,6528,6429,99
2,1,1,4,17,6480,6278,202
2,1,2,4,17,6454,6126,328
2,1,3,4,17,6464,6050,414
2,1,4,4,17,6457,6099,358
2,1,5,4,17,6432,6222,210
2,1,6,4,17,6434,6342,92
2,1,7,4,17,6447,6468,-21
2,2,0,4,17,6116,5897,219
2,2,1,4,17,6011,5762,249
2,2,2,4,17,5951,5640,311
2,2,3,4,17,5953,5555,398
2,2,4,4,17,5948,5615,333
2,2,5,4,17,5918,5763,155
2,2,6,4,17,5923,5895,28
2,2,7,4,17,5975,6041,-66
2,3,0,4,17,5599,6540,-941
2,3,1,4,17,5437,6504,-1067
2,3,2,4,17,5330,6503,-1173
2,3,3,4,17,5315,6500,-1185
2,3,4,4,17,5322,6591,-1269
2,3,5,4,17,5312,6653,-1341
2,3,6,4,17,5344,6732,-1388
2,3,7,4,17,5446,6813,-1367
2,4,0,4,17,5638,8091,-2453
2,4,1,4,17,5443,8198,-2755
2,4,2,4,17,5290,8327,-3037
2,4,3,4,17,5251,8458,-3207
2,4,4,4,17,5279,8616,-3337
2,4,5,4,17,5321,8550,-3229
2,4,6,4,17,5410,8574,-3164
2,4,7,4,17,5556,8523,-2967
2,5,0,4,17,6429,8711,-2282
2,5,1,4,17,6278,8900,-2622
2,5,2,4,17,6126,9094,-2968
2,5,3,4,17,6050,9371,-3321
2,5,4,4,17,6099,9600,-3501
2,5,5,4,17,6222,9429,-3207
2,5,6,4,17,6342,9427,-3085
2,5,7,4,17,6468,9298,-2830
2,6,0,4,17,5897,10473,-4576
2,6,1,4,17,5762,10773,-5011
2,6,2,4,17,5640,11037,-5397
2,6,3,4,17,5555,11439,-5884
2,6,4,4,17,5615,11714,-6099
2,6,5,4,17,5763,11525,-5762
2,6,6,4,17,5895,11446,-5551
2,6,7,4,17,6041,11222,-5181
2,7,0,4,17,6540,11106,-4566
2,7,1,4,17,6504,11389,-4885
2,7,2,4,17,6503,11646,-5143
2,7,3,4,17,6500,12086,-5586
2,7,4,4,17,6591,12353,-5762
2,7,5,4,17,6653,12249,-5596
2,7,6,4,17,6732,12136,-5404
2,7,7,4,17,6813,11940,-5127
2,8,0,4,17,8091,10631,-2540
2,8,1,4,17,8198,10842,-2644
2,8,2,4,17,8327,11093,-2766
2,8,3,4,17,8458,11528,-3070
2,8,4,4,17,8616,11735,-3119
2,8,5,4,17,8550,11706,-3156
2,8,6,4,17,8574,11531,-2957
2,8,7,4,17,8523,11401,-2878
2,9,0,4,17,8711,10485,-1774
2,9,1,4,17,8900,10671,-1771
2,9,2,4,17,9094,10944,-1850
2,9,3,4,17,9371,11403,-2032
2,9,4,4,17,9600,11555,-1955
2,9,5,4,17,9429,11515,-2086
2,9,6,4,17,9427,11210,-1783
2,9,7,4,17,9298,11172,-1874
2,10,0,4,17,10473,10039,434
2,10,1,4,17,10773,10207,566
2,10,2,4,17,11037,10421,616
2,10,3,4,17,11439,10874,565
2,10,4,4,17,11714,11000,714
2,10,5,4,17,11525,10918,607
2,10,6,4,17,11446,10571,875
2,10,7,4,17,11222,10612,610
2,11,0,4,17,11106,9266,1840
2,11,1,4,17,11389,9442,1947
2,11,2,4,17,11646,9576,2070
2,11,3,4,17,12086,9980,2106
2,11,4,4,17,12353,10091,2262
2,11,5,4,17,12249,9916,2333
2,11,6,4,17,12136,9524,2612
2,11,7,4,17,11940,9606,2334
2,12,0,4,17,10631,8912,1719
2,12,1,4,17,10842,9081,1761
2,12,2,4,17,11093,9116,1977
2,12,3,4,17,11528,9363,2165
2,12,4,4,17,11735,9387,2348
2,12,5,4,17,11706,9170,2536
2,12,6,4,17,11531,8836,2695
2,12,7,4,17,11401,9070,2331
2,13,0,4,17,10485,8528,1957
2,13,1,4,17,10671,8565,2106
2,13,2,4,17,10944,8497,2447
2,13,3,4,17,11403,8611,2792
2,13,4,4,17,11555,8531,3024
2,13,5,4,17,11515,8313,3202
2,13,6,4,17,11210,8123,3087
2,13,7,4,17,11172,8485,2687
2,14,0,4,17,10039,7679,2360
2,14,1,4,17,10207,7530,2677
2,14,2,4,17,10421,7445,2976
2,14,3,4,17,10874,7457,3417
2,14,4,4,17,11000,7215,3785
2,14,5,4,17,10918,7065,3853
2,14,6,4,17,10571,7037,3534
2,14,7,4,17,10612,7471,3141
2,15,0,4,17,9266,7170,2096
2,15,1,4,17,9442,6958,2484
2,15,2,4,17,9576,6838,2738
2,15,3,4,17,9980,6783,3197
2,15,4,4,17,10091,6453,3638
2,15,5,4,17,9916,6391,3525
2,15,6,4,17,9524,6478,3046
2,15,7,4,17,9606,6871,2735
2,16,0,4,17,8912,6313,2599
2,16,1,4,17,9081,6039,3042
2,16,2,4,17,9116,5913,3203
2,16,3,4,17,9363,5915,3448
2,16,4,4,17,9387,5627,3760
2,16,5,4,17,9170,5580,3590
2,16,6,4,17,8836,5682,3154
2,16,7,4,17,9070,5945,3125
2,0,0,5,17,8294,7299,995
2,0,1,5,17,8238,7108,1130
2,0,2,5,17,8215,6945,1270
2,0,3,5,17,8237,6847,1390
2,0,4,5,17,8230,6904,1326
2,0,5,5,17,8197,7046,1151
2,0,6,5,17,8197,7187,1010
2,0,7,5,17,8208,7372,836
2,1,0,5,17,7930,7903,27
2,1,1,5,17,7826,7813,13
2,1,2,5,17,7759,7759,0
2,1,3,5,17,7756,7734,22
2,1,4,5,17,7746,7833,-87
2,1,5,5,17,7715,7915,-200
2,1,6,5,17,7726,8028,-302
2,1,7,5,17,7778,8157,-379
2,2,0,5,17,7479,9645,-2166
2,2,1,5,17,7320,9706,-2386
2,2,2,5,17,7207,9789,-2582
2,2,3,5,17,7187,9907,-2720
2,2,4,5,17,7190,10088,-2898
2,2,5,5,17,7180,10066,-2886
2,2,6,5,17,7219,10143,-2924
2,2,7,5,17,7319,10135,-2816
2,3,0,5,17,7153,10821,-3668
2,3,1,5,17,6945,11015,-4070
2,3,2,5,17,6792,11197,-4405
2,3,3,5,17,6764,11446,-4682
2,3,4,5,17,6794,11696,-4902
2,3,5,5,17,6828,11590,-4762
2,3,6,5,17,6913,11612,-4699
2,3,7,5,17,7058,11479,-4421
2,4,0,5,17,7748,11343,-3595
2,4,1,5,17,7558,11603,-4045
2,4,2,5,17,7393,11856,-4463
2,4,3,5,17,7326,12236,-4910
2,4,4,5,17,7375,12519,-5144
2,4,5,5,17,7482,12349,-4867
2,4,6,5,17,7595,12291,-4696
2,4,7,5,17,7737,12126,-4389
2,5,0,5,17,7299,13112,-5813
2,5,1,5,17,7108,13440,-6332
2,5,2,5,17,6945,13765,-6820
2,5,3,5,17,6847,14265,-7418
2,5,4,5,17,6904,14571,-7667
2,5,5,5,17,7046,14401,-7355
2,5,6,5,17,7187,14269,-7082
2,5,7,5,17,7372,14056,-6684
2,6,0,5,17,7903,13736,-5833
2,6,1,5,17,7813,14044,-6231
2,6,2,5,17,7759,14379,-6620
2,6,3,5,17,7734,14935,-7201
2,6,4,5,17,7833,15232,-7399
2,6,5,5,17,7915,15119,-7204
2,6,6,5,17,8028,14942,-6914
2,6,7,5,17,8157,14723,-6566
2,7,0,5,17,9645,13215,-3570
2,7,1,5,17,9706,13488,-3782
2,7,2,5,17,9789,13814,-4025
2,7,3,5,17,9907,14391,-4484
2,7,4,5,17,10088,14635,-4547
2,7,5,5,17,10066,14555,-4489
2,7,6,5,17,10143,14248,-4105
2,7,7,5,17,10135,14128,-3993
2,8,0,5,17,10821,12671,-1850
2,8,1,5,17,11015,12910,-1895
2,8,2,5,17,11197,13183,-1986
2,8,3,5,17,11446,13739,-2293
2,8,4,5,17,11696,13919,-2223
2,8,5,5,17,11590,13838,-2248
2,8,6,5,17,11612,13435,-1823
2,8,7,5,17,11479,13440,-1961
2,9,0,5,17,11343,11905,-562
2,9,1,5,17,11603,12109,-506
2,9,2,5,17,11856,12304,-448
2,9,3,5,17,12236,12806,-570
2,9,4,5,17,12519,12948,-429
2,9,5,5,17,12349,12792,-443
2,9,6,5,17,12291,12347,-56
2,9,7,5,17,12126,12440,-314
2,10,0,5,17,13112,11542,1570
2,10,1,5,17,13440,11736,1704
2,10,2,5,17,13765,11849,1916
2,10,3,5,17,14265,12212,2053
2,10,4,5,17,14571,12266,2305
2,10,5,5,17,14401,12040,2361
2,10,6,5,17,14269,11642,2627
2,10,7,5,17,14056,11853,2203
2,11,0,5,17,13736,11112,2624
2,11,1,5,17,14044,11211,2833
2,11,2,5,17,14379,11218,3161
2,11,3,5,17,14935,11474,3461
2,11,4,5,17,15232,11431,3801
2,11,5,5,17,15119,11162,3957
2,11,6,5,17,14942,10840,4102
2,11,7,5,17,14723,11212,3511
2,12,0,5,17,13215,9865,3350
2,12,1,5,17,13488,9769,3719
2,12,2,5,17,13814,9684,4130
2,12,3,5,17,14391,9793,4598
2,12,4,5,17,14635,9579,5056
2,12,5,5,17,14555,9388,5167
2,12,6,5,17,14248,9262,4986
2,12,7,5,17,14128,9739,4389
2,13,0,5,17,12671,9036,3635
2,13,1,5,17,12910,8860,4050
2,13,2,5,17,13183,8721,4462
2,13,3,5,17,13739,8715,5024
2,13,4,5,17,13919,8401,5518
2,13,5,5,17,13838,8265,5573
2,13,6,5,17,13435,8254,5181
2,13,7,5,17,13440,8699,4741
2,14,0,5,17,11905,8589,3316
2,14,1,5,17,12109,8333,3776
2,14,2,5,17,12304,8186,4118
2,14,3,5,17,12806,8147,4659
2,14,4,5,17,12948,7802,5146
2,14,5,5,17,12792,7704,5088
2,14,6,5,17,12347,7800,4547
2,14,7,5,17,12440,8192,4248
2,0,0,6,17,9696,11008,-1312
2,0,1,6,17,9584,11015,-1431
2,0,2,6,17,9520,11045,-1525
2,0,3,6,17,9529,11141,-1612
2,0,4,6,17,9519,11330,-1811
2,0,5,6,17,9480,11328,-1848
2,0,6,6,17,9489,11439,-1950
2,0,7,6,17,9539,11479,-1940
2,1,0,6,17,9293,12375,-3082
2,1,1,6,17,9135,12523,-3388
2,1,2,6,17,9015,12659,-3644
2,1,3,6,17,8990,12895,-3905
2,1,4,6,17,8988,13168,-4180
2,1,5,6,17,8977,13106,-4129
2,1,6,6,17,9022,13181,-4159
2,1,7,6,17,9122,13091,-3969
2,2,0,6,17,9033,13453,-4420
2,2,1,6,17,8828,13718,-4890
2,2,2,6,17,8669,13959,-5290
2,2,3,6,17,8636,14311,-5675
2,2,4,6,17,8662,14615,-5953
2,2,5,6,17,8696,14510,-5814
2,2,6,6,17,8788,14476,-5688
2,2,7,6,17,8931,14307,-5376
2,3,0,6,17,9263,13982,-4719
2,3,1,6,17,9060,14270,-5210
2,3,2,6,17,8895,14584,-5689
2,3,3,6,17,8839,15062,-6223
2,3,4,6,17,8890,15376,-6486
2,3,5,6,17,8989,15225,-6236
2,3,6,6,17,9098,15114,-6016
2,3,7,6,17,9239,14960,-5721
2,4,0,6,17,8618,15742,-7124
2,4,1,6,17,8388,16095,-7707
2,4,2,6,17,8212,16498,-8286
2,4,3,6,17,8123,17114,-8991
2,4,4,6,17,8180,17450,-9270
2,4,5,6,17,8306,17271,-8965
2,4,6,6,17,8440,17075,-8635
2,4,7,6,17,8641,16839,-8198
2,5,0,6,17,9305,16320,-7015
2,5,1,6,17,9159,16690,-7531
2,5,2,6,17,9064,17100,-8036
2,5,3,6,17,9026,17798,-8772
2,5,4,6,17,9122,18132,-9010
2,5,5,6,17,9198,17968,-8770
2,5,6,6,17,9320,17659,-8339
2,5,7,6,17,9488,17450,-7962
2,6,0,6,17,11008,15401,-4393
2,6,1,6,17,11015,15727,-4712
2,6,2,6,17,11045,16053,-5008
2,6,3,6,17,11141,16727,-5586
2,6,4,6,17,11330,16999,-5669
2,6,5,6,17,11328,16878,-5550
2,6,6,6,17,11439,16473,-5034
2,6,7,6,17,11479,16396,-4917
2,7,0,6,17,12375,14537,-2162
2,7,1,6,17,12523,14812,-2289
2,7,2,6,17,12659,15066,-2407
2,7,3,6,17,12895,15671,-2776
2,7,4,6,17,13168,15867,-2699
2,7,5,6,17,13106,15712,-2606
2,7,6,6,17,13181,15211,-2030
2,7,7,6,17,13091,15268,-2177
2,8,0,6,17,13453,14181,-728
2,8,1,6,17,13718,14403,-685
2,8,2,6,17,13959,14577,-618
2,8,3,6,17,14311,15038,-727
2,8,4,6,17,14615,15123,-508
2,8,5,6,17,14510,14916,-406
2,8,6,6,17,14476,14465,11
2,8,7,6,17,14307,14687,-380
2,9,0,6,17,13982,13742,240
2,9,1,6,17,14270,13866,404
2,9,2,6,17,14584,13951,633
2,9,3,6,17,15062,14323,739
2,9,4,6,17,15376,14310,1066
2,9,5,6,17,15225,14032,1193
2,9,6,6,17,15114,13646,1468
2,9,7,6,17,14960,13995,965
2,10,0,6,17,15742,12449,3293
2,10,1,6,17,16095,12415,3680
2,10,2,6,17,16498,12405,4093
2,10,3,6,17,17114,12656,4458
2,10,4,6,17,17450,12479,4971
2,10,5,6,17,17271,12237,5034
2,10,6,6,17,17075,11979,5096
2,10,7,6,17,16839,12466,4373
2,11,0,6,17,16320,11222,5098
2,11,1,6,17,16690,11099,5591
2,11,2,6,17,17100,10960,6140
2,11,3,6,17,17798,11051,6747
2,11,4,6,17,18132,10765,7367
2,11,5,6,17,17968,10588,7380
2,11,6,6,17,17659,10479,7180
2,11,7,6,17,17450,10967,6483
2,12,0,6,17,15401,10455,4946
2,12,1,6,17,15727,10235,5492
2,12,2,6,17,16053,10069,5984
2,12,3,6,17,16727,10079,6648
2,12,4,6,17,16999,9750,7249
2,12,5,6,17,16878,9578,7300
2,12,6,6,17,16473,9576,6897
2,12,7,6,17,16396,10020,6376
2,0,0,7,17,11059,15007,-3948
2,0,1,7,17,10893,15226,-4333
2,0,2,7,17,10776,15421,-4645
2,0,3,7,17,10763,15760,-4997
2,0,4,7,17,10761,16087,-5326
2,0,5,7,17,10742,16026,-5284
2,0,6,7,17,10785,16045,-5260
2,0,7,7,17,10883,15919,-5036
2,1,0,7,17,10847,16092,-5245
2,1,1,7,17,10643,16385,-5742
2,1,2,7,17,10477,16687,-6210
2,1,3,7,17,10439,17137,-6698
2,1,4,7,17,10460,17472,-7012
2,1,5,7,17,10493,17386,-6893
2,1,6,7,17,10591,17299,-6708
2,1,7,7,17,10734,17141,-6407
2,2,0,7,17,11143,16612,-5469
2,2,1,7,17,10943,16925,-5982
2,2,2,7,17,10772,17317,-6545
2,2,3,7,17,10711,17911,-7200
2,2,4,7,17,10758,18255,-7497
2,2,5,7,17,10857,18095,-7238
2,2,6,7,17,10973,17920,-6947
2,2,7,7,17,11112,17743,-6631
2,3,0,7,17,10133,18326,-8193
2,3,1,7,17,9890,18741,-8851
2,3,2,7,17,9714,19219,-9505
2,3,3,7,17,9636,19977,-10341
2,3,4,7,17,9695,20350,-10655
2,3,5,7,17,9813,20120,-10307
2,3,6,7,17,9943,19792,-9849
2,3,7,7,17,10143,19566,-9423
2,4,0,7,17,10624,18506,-7882
2,4,1,7,17,10439,18929,-8490
2,4,2,7,17,10331,19339,-9008
2,4,3,7,17,10302,20134,-9832
2,4,4,7,17,10398,20496,-10098
2,4,5,7,17,10458,20291,-9833
2,4,6,7,17,10573,19884,-9311
2,4,7,7,17,10757,19718,-8961
2,5,0,7,17,12410,17267,-4857
2,5,1,7,17,12361,17629,-5268
2,5,2,7,17,12350,17936,-5586
2,5,3,7,17,12433,18659,-6226
2,5,4,7,17,12619,18947,-6328
2,5,5,7,17,12611,18752,-6141
2,5,6,7,17,12731,18249,-5518
2,5,7,7,17,12810,18224,-5414
2,6,0,7,17,13738,16813,-3075
2,6,1,7,17,13832,17106,-3274
2,6,2,7,17,13915,17339,-3424
2,6,3,7,17,14129,17903,-3774
2,6,4,7,17,14410,18042,-3632
2,6,5,7,17,14368,17836,-3468
2,6,6,7,17,14477,17329,-2852
2,6,7,7,17,14435,17515,-3080
2,7,0,7,17,15007,16381,-1374
2,7,1,7,17,15226,16533,-1307
2,7,2,7,17,15421,16679,-1258
2,7,3,7,17,15760,17149,-1389
2,7,4,7,17,16087,17167,-1080
2,7,5,7,17,16026,16908,-882
2,7,6,7,17,16045,16469,-424
2,7,7,7,17,15919,16829,-910
2,8,0,7,17,16092,15079,1013
2,8,1,7,17,16385,15070,1315
2,8,2,7,17,16687,15138,1549
2,8,3,7,17,17137,15505,1632
2,8,4,7,17,17472,15358,2114
2,8,5,7,17,17386,15107,2279
2,8,6,7,17,17299,14785,2514
2,8,7,7,17,17141,15249,1892
2,9,0,7,17,16612,13806,2806
2,9,1,7,17,16925,13745,3180
2,9,2,7,17,17317,13681,3636
2,9,3,7,17,17911,13914,3997
2,9,4,7,17,18255,13665,4590
2,9,5,7,17,18095,13437,4658
2,9,6,7,17,17920,13196,4724
2,9,7,7,17,17743,13694,4049
2,10,0,7,17,18326,12641,5685
2,10,1,7,17,18741,12474,6267
2,10,2,7,17,19219,12308,6911
2,10,3,7,17,19977,12415,7562
2,10,4,7,17,20350,12114,8236
2,10,5,7,17,20120,11901,8219
2,10,6,7,17,19792,11801,7991
2,10,7,7,17,19566,12288,7278
2,0,0,8,17,12613,18722,-6109
2,0,1,8,17,12401,19040,-6639
2,0,2,8,17,12238,19420,-7182
2,0,3,8,17,12212,19986,-7774
2,0,4,8,17,12233,20351,-8118
2,0,5,8,17,12258,20256,-7998
2,0,6,8,17,12354,20105,-7751
2,0,7,8,17,12495,19924,-7429
2,1,0,8,17,12957,19196,-6239
2,1,1,8,17,12758,19571,-6813
2,1,2,8,17,12580,20038,-7458
2,1,3,8,17,12514,20774,-8260
2,1,4,8,17,12556,21155,-8599
2,1,5,8,17,12654,20944,-8290
2,1,6,8,17,12776,20637,-7861
2,1,7,8,17,12915,20470,-7555
2,2,0,8,17,12013,20512,-8499
2,2,1,8,17,11773,20980,-9207
2,2,2,8,17,11591,21458,-9867
2,2,3,8,17,11508,22313,-10805
2,2,4,8,17,11563,22714,-11151
2,2,5,8,17,11681,22443,-10762
2,2,6,8,17,11818,22017,-10199
2,2,7,8,17,12016,21834,-9818
2,3,0,8,17,12139,20372,-8233
2,3,1,8,17,11941,20831,-8890
2,3,2,8,17,11833,21222,-9389
2,3,3,8,17,11815,22066,-10251
2,3,4,8,17,11913,22444,-10531
2,3,5,8,17,11965,22165,-10200
2,3,6,8,17,12076,21660,-9584
2,3,7,8,17,12259,21546,-9287
2,4,0,8,17,13729,19543,-5814
2,4,1,8,17,13641,19923,-6282
2,4,2,8,17,13617,20209,-6592
2,4,3,8,17,13709,20891,-7182
2,4,4,8,17,13895,21122,-7227
2,4,5,8,17,13871,20876,-7005
2,4,6,8,17,13984,20367,-6383
2,4,7,8,17,14079,20471,-6392
2,5,0,8,17,15140,19013,-3873
2,5,1,8,17,15178,19236,-4058
2,5,2,8,17,15220,19441,-4221
2,5,3,8,17,15421,20014,-4593
2,5,4,8,17,15699,20086,-4387
2,5,5,8,17,15651,19828,-4177
2,5,6,8,17,15769,19333,-3564
2,5,7,8,17,15766,19657,-3891
2,6,0,8,17,16370,17718,-1348
2,6,1,8,17,16535,17737,-1202
2,6,2,8,17,16677,17866,-1189
2,6,3,8,17,16994,18331,-1337
2,6,4,8,17,17329,18215,-886
2,6,5,8,17,17288,17983,-695
2,6,6,8,17,17341,17608,-267
2,6,7,8,17,17263,18083,-820
2,7,0,8,17,17646,16436,1210
2,7,1,8,17,17893,16400,1493
2,7,2,8,17,18149,16414,1735
2,7,3,8,17,18586,16763,1823
2,7,4,8,17,18944,16544,2400
2,7,5,8,17,18902,16307,2595
2,7,6,8,17,18868,16002,2866
2,7,7,8,17,18753,16477,2276
2,8,0,8,17,18722,15225,3497
2,8,1,8,17,19040,15120,3920
2,8,2,8,17,19420,15029,4391
2,8,3,8,17,19986,15278,4708
2,8,4,8,17,20351,15014,5337
2,8,5,8,17,20256,14750,5506
2,8,6,8,17,20105,14518,5587
2,8,7,8,17,19924,15015,4909
2,0,0,9,17,14723,21382,-6659
2,0,1,9,17,14516,21810,-7294
2,0,2,9,17,14341,22277,-7936
2,0,3,9,17,14287,23110,-8823
2,0,4,9,17,14329,23519,-9190
2,0,5,9,17,14419,23267,-8848
2,0,6,9,17,14539,22862,-8323
2,0,7,9,17,14676,22738,-8062
2,1,0,9,17,13827,22378,-8551
2,1,1,9,17,13588,22882,-9294
2,1,2,9,17,13399,23341,-9942
2,1,3,9,17,13311,24245,-10934
2,1,4,9,17,13361,24662,-11301
2,1,5,9,17,13478,24317,-10839
2,1,6,9,17,13621,23793,-10172
2,1,7,9,17,13819,23662,-9843
2,2,0,9,17,14019,22648,-8629
2,2,1,9,17,13824,23125,-9301
2,2,2,9,17,13710,23495,-9785
2,2,3,9,17,13687,24298,-10611
2,2,4,9,17,13781,24619,-10838
2,2,5,9,17,13833,24289,-10456
2,2,6,9,17,13951,23778,-9827
2,2,7,9,17,14132,23793,-9661
2,3,0,9,17,15244,21743,-6499
2,3,1,9,17,15143,22053,-6910
2,3,2,9,17,15119,22311,-7192
2,3,3,9,17,15222,23002,-7780
2,3,4,9,17,15410,23166,-7756
2,3,5,9,17,15378,22868,-7490
2,3,6,9,17,15487,22371,-6884
2,3,7,9,17,15581,22613,-7032
2,4,0,9,17,16459,20350,-3891
2,4,1,9,17,16458,20440,-3982
2,4,2,9,17,16487,20628,-4141
2,4,3,9,17,16697,21196,-4499
2,4,4,9,17,16975,21134,-4159
2,4,5,9,17,16911,20903,-3992
2,4,6,9,17,17022,20472,-3450
2,4,7,9,17,17035,20911,-3876
2,5,0,9,17,17772,19075,-1303
2,5,1,9,17,17881,19067,-1186
2,5,2,9,17,17982,19142,-1160
2,5,3,9,17,18286,19589,-1303
2,5,4,9,17,18618,19401,-783
2,5,5,9,17,18571,19183,-612
2,5,6,9,17,18633,18825,-192
2,5,7,9,17,18594,19311,-717
2,6,0,9,17,19009,17855,1154
2,6,1,9,17,19202,17775,1427
2,6,2,9,17,19405,17762,1643
2,6,3,9,17,19820,18127,1693
2,6,4,9,17,20186,17893,2293
2,6,5,9,17,20164,17620,2544
2,6,6,9,17,20164,17324,2840
2,6,7,9,17,20097,17798,2299
2,0,0,10,17,15593,24654,-9061
2,0,1,10,17,15346,25176,-9830
2,0,2,10,17,15160,25614,-10454
2,0,3,10,17,15084,26477,-11393
2,0,4,10,17,15134,26837,-11703
2,0,5,10,17,15243,26441,-11198
2,0,6,10,17,15384,25911,-10527
2,0,7,10,17,15580,25909,-10329
2,1,0,10,17,15833,24848,-9015
2,1,1,10,17,15639,25255,-9616
2,1,2,10,17,15518,25597,-10079
2,1,3,10,17,15490,26409,-10919
2,1,4,10,17,15579,26663,-11084
2,1,5,10,17,15630,26281,-10651
2,1,6,10,17,15754,25782,-10028
2,1,7,10,17,15935,25935,-10000
2,2,0,10,17,17124,23080,-5956
2,2,1,10,17,17026,23257,-6231
2,2,2,10,17,16996,23498,-6502
2,2,3,10,17,17094,24184,-7090
2,2,4,10,17,17278,24214,-6936
2,2,5,10,17,17246,23943,-6697
2,2,6,10,17,17362,23510,-6148
2,2,7,10,17,17454,23867,-6413
2,3,0,10,17,17974,21707,-3733
2,3,1,10,17,17960,21770,-3810
2,3,2,10,17,17989,21904,-3915
2,3,3,10,17,18210,22454,-4244
2,3,4,10,17,18490,22320,-3830
2,3,5,10,17,18418,22103,-3685
2,3,6,10,17,18525,21689,-3164
2,3,7,10,17,18537,22139,-3602
2,4,0,10,17,19091,20494,-1403
2,4,1,10,17,19161,20442,-1281
2,4,2,10,17,19249,20490,-1241
2,4,3,10,17,19562,20953,-1391
2,4,4,10,17,19894,20750,-856
2,4,5,10,17,19831,20496,-665
2,4,6,10,17,19886,20147,-261
2,4,7,10,17,19863,20632,-769
2,0,0,11,17,17599,26185,-8586
2,0,1,11,17,17397,26459,-9062
2,0,2,11,17,17279,26784,-9505
2,0,3,11,17,17263,27591,-10328
2,0,4,11,17,17352,27711,-10359
2,0,5,11,17,17395,27356,-9961
2,0,6,11,17,17517,26921,-9404
2,0,7,11,17,17696,27189,-9493
2,1,0,11,17,18938,24437,-5499
2,1,1,11,17,18841,24587,-5746
2,1,2,11,17,18804,24774,-5970
2,1,3,11,17,18897,25442,-6545
2,1,4,11,17,19076,25400,-6324
2,1,5,11,17,19043,25143,-6100
2,1,6,11,17,19165,24727,-5562
2,1,7,11,17,19257,25095,-5838
2,2,0,11,17,19854,23126,-3272
2,2,1,11,17,19843,23145,-3302
2,2,2,11,17,19866,23252,-3386
2,2,3,11,17,20082,23818,-3736
2,2,4,11,17,20358,23669,-3311
2,2,5,11,17,20286,23416,-3130
2,2,6,11,17,20400,23011,-2611
2,2,7,11,17,20410,23460,-3050
2,0,0,12,17,20704,25856,-5152
2,0,1,12,17,20599,25962,-5363
2,0,2,12,17,20565,26122,-5557
2,0,3,12,17,20670,26806,-6136
2,0,4,12,17,20849,26749,-5900
2,0,5,12,17,20808,26456,-5648
2,0,6,12,17,20928,26049,-5121
2,0,7,12,17,21018,26416,-5398
2,0,0,1,18,1868,1921,-53
2,0,1,1,18,1868,1919,-51
2,0,2,1,18,1869,1910,-41
2,0,3,1,18,1871,1904,-33
2,0,4,1,18,1876,1909,-33
2,0,5,1,18,1874,1911,-37
2,0,6,1,18,1865,1905,-40
2,1,0,1,18,1921,1989,-68
2,1,1,1,18,1919,1992,-73
2,1,2,1,18,1910,1984,-74
2,1,3,1,18,1904,1975,-71
2,1,4,1,18,1909,1978,-69
2,1,5,1,18,1911,1983,-72
2,1,6,1,18,1905,1981,-76
2,2,0,1,18,1989,1614,375
2,2,1,1,18,1992,1619,373
2,2,2,1,18,1984,1623,361
2,2,3,1,18,1975,1620,355
2,2,4,1,18,1978,1619,359
2,2,5,1,18,1983,1618,365
2,2,6,1,18,1981,1614,367
2,3,0,1,18,1614,1394,220
2,3,1,1,18,1619,1386,233
2,3,2,1,18,1623,1390,233
2,3,3,1,18,1620,1391,229
2,3,4,1,18,1619,1386,233
2,3,5,1,18,1618,1373,245
2,3,6,1,18,1614,1363,251
2,4,0,1,18,1394,1460,-66
2,4,1,1,18,1386,1427,-41
2,4,2,1,18,1390,1412,-22
2,4,3,1,18,1391,1408,-17
2,4,4,1,18,1386,1408,-22
2,4,5,1,18,1373,1401,-28
2,4,6,1,18,1363,1400,-37
2,5,0,1,18,1460,1429,31
2,5,1,1,18,1427,1380,47
2,5,2,1,18,1412,1343,69
2,5,3,1,18,1408,1331,77
2,5,4,1,18,1408,1349,59
2,5,5,1,18,1401,1378,23
2,5,6,1,18,1400,1411,-11
2,6,0,1,18,1429,1638,-209
2,6,1,1,18,1380,1587,-207
2,6,2,1,18,1343,1539,-196
2,6,3,1,18,1331,1521,-190
2,6,4,1,18,1349,1556,-207
2,6,5,1,18,1378,1626,-248
2,6,6,1,18,1411,1694,-283
2,7,0,1,18,1638,2241,-603
2,7,1,1,18,1587,2244,-657
2,7,2,1,18,1539,2196,-657
2,7,3,1,18,1521,2174,-653
2,7,4,1,18,1556,2224,-668
2,7,5,1,18,1626,2279,-653
2,7,6,1,18,1694,2316,-622
2,8,0,1,18,2241,936,1305
2,8,1,1,18,2244,888,1356
2,8,2,1,18,2196,866,1330
2,8,3,1,18,2174,848,1326
2,8,4,1,18,2224,865,1359
2,8,5,1,18,2279,900,1379
2,8,6,1,18,2316,948,1368
2,9,0,1,18,936,2155,-1219
2,9,1,1,18,888,2163,-1275
2,9,2,1,18,866,2239,-1373
2,9,3,1,18,848,2294,-1446
2,9,4,1,18,865,2300,-1435
2,9,5,1,18,900,2251,-1351
2,9,6,1,18,948,2239,-1291
2,10,0,1,18,2155,3341,-1186
2,10,1,1,18,2163,3386,-1223
2,10,2,1,18,2239,3497,-1258
2,10,3,1,18,2294,3620,-1326
2,10,4,1,18,2300,3666,-1366
2,10,5,1,18,2251,3586,-1335
2,10,6,1,18,2239,3545,-1306
2,11,0,1,18,3341,2968,373
2,11,1,1,18,3386,3017,369
2,11,2,1,18,3497,3092,405
2,11,3,1,18,3620,3206,414
2,11,4,1,18,3666,3277,389
2,11,5,1,18,3586,3239,347
2,11,6,1,18,3545,3169,376
2,12,0,1,18,2968,2849,119
2,12,1,1,18,3017,2921,96
2,12,2,1,18,3092,2975,117
2,12,3,1,18,3206,3042,164
2,12,4,1,18,3277,3107,170
2,12,5,1,18,3239,3117,122
2,12,6,1,18,3169,2998,171
2,13,0,1,18,2849,2819,30
2,13,1,1,18,2921,2897,24
2,13,2,1,18,2975,2941,34
2,13,3,1,18,3042,2979,63
2,13,4,1,18,3107,3052,55
2,13,5,1,18,3117,3077,40
2,13,6,1,18,2998,2977,21
2,14,0,1,18,2819,2801,18
2,14,1,1,18,2897,2902,-5
2,14,2,1,18,2941,2956,-15
2,14,3,1,18,2979,2998,-19
2,14,4,1,18,3052,3077,-25
2,14,5,1,18,3077,3056,21
2,14,6,1,18,2977,2947,30
2,15,0,1,18,2801,2754,47
2,15,1,1,18,2902,2835,67
2,15,2,1,18,2956,2938,18
2,15,3,1,18,2998,3019,-21
2,15,4,1,18,3077,3068,9
2,15,5,1,18,3056,2966,90
2,15,6,1,18,2947,2857,90
2,16,0,1,18,2754,2347,407
2,16,1,1,18,2835,2314,521
2,16,2,1,18,2938,2399,539
2,16,3,1,18,3019,2510,509
2,16,4,1,18,3068,2530,538
2,16,5,1,18,2966,2416,550
2,16,6,1,18,2857,2380,477
2,17,0,1,18,2347,2024,323
2,17,1,1,18,2314,1975,339
2,17,2,1,18,2399,2008,391
2,17,3,1,18,2510,2132,378
2,17,4,1,18,2530,2112,418
2,17,5,1,18,2416,1955,461
2,17,6,1,18,2380,1897,483
2,18,0,1,18,2024,2484,-460
2,18,1,1,18,1975,2363,-388
2,18,2,1,18,2008,2336,-328
2,18,3,1,18,2132,2409,-277
2,18,4,1,18,2112,2254,-142
2,18,5,1,18,1955,2198,-243
2,18,6,1,18,1897,2319,-422
2,19,0,1,18,2484,2320,164
2,19,1,1,18,2363,2178,185
2,19,2,1,18,2336,2179,157
2,19,3,1,18,2409,2274,135
2,19,4,1,18,2254,2089,165
2,19,5,1,18,2198,2047,151
2,19,6,1,18,2319,2215,104
2,20,0,1,18,2320,1407,913
2,20,1,1,18,2178,1259,919
2,20,2,1,18,2179,1271,908
2,20,3,1,18,2274,1283,991
2,20,4,1,18,2089,1137,952
2,20,5,1,18,2047,1171,876
2,20,6,1,18,2215,1312,903
2,21,0,1,18,1407,1427,-20
2,21,1,1,18,1259,1350,-91
2,21,2,1,18,1271,1334,-63
2,21,3,1,18,1283,1306,-23
2,21,4,1,18,1137,1240,-103
2,21,5,1,18,1171,1254,-83
2,21,6,1,18,1312,1273,39
2,22,0,1,18,1427,1486,-59
2,22,1,1,18,1350,1417,-67
2,22,2,1,18,1334,1418,-84
2,22,3,1,18,1306,1418,-112
2,22,4,1,18,1240,1382,-142
2,22,5,1,18,1254,1387,-133
2,22,6,1,18,1273,1369,-96
2,0,0,2,18,3789,3603,186
2,0,1,2,18,3787,3611,176
2,0,2,2,18,3779,3607,172
2,0,3,2,18,3775,3595,180
2,0,4,2,18,3785,3597,188
2,0,5,2,18,3785,3601,184
2,0,6,2,18,3770,3595,175
2,1,0,2,18,3910,3008,902
2,1,1,2,18,3911,3005,906
2,1,2,2,18,3894,3013,881
2,1,3,2,18,3879,3011,868
2,1,4,2,18,3887,3005,882
2,1,5,2,18,3894,2991,903
2,1,6,2,18,3886,2977,909
2,2,0,2,18,3603,2854,749
2,2,1,2,18,3611,2813,798
2,2,2,2,18,3607,2802,805
2,2,3,2,18,3595,2799,796
2,2,4,2,18,3597,2794,803
2,2,5,2,18,3601,2774,827
2,2,6,2,18,3595,2763,832
2,3,0,2,18,3008,2889,119
2,3,1,2,18,3005,2807,198
2,3,2,2,18,3013,2755,258
2,3,3,2,18,3011,2739,272
2,3,4,2,18,3005,2757,248
2,3,5,2,18,2991,2779,212
2,3,6,2,18,2977,2811,166
2,4,0,2,18,2854,3067,-213
2,4,1,2,18,2813,2967,-154
2,4,2,2,18,2802,2882,-80
2,4,3,2,18,2799,2852,-53
2,4,4,2,18,2794,2905,-111
2,4,5,2,18,2774,3004,-230
2,4,6,2,18,2763,3105,-342
2,5,0,2,18,2889,3879,-990
2,5,1,2,18,2807,3831,-1024
2,5,2,2,18,2755,3735,-980
2,5,3,2,18,2739,3695,-956
2,5,4,2,18,2757,3780,-1023
2,5,5,2,18,2779,3905,-1126
2,5,6,2,18,2811,4010,-1199
2,6,0,2,18,3067,3177,-110
2,6,1,2,18,2967,3132,-165
2,6,2,2,18,2882,3062,-180
2,6,3,2,18,2852,3022,-170
2,6,4,2,18,2905,3089,-184
2,6,5,2,18,3004,3179,-175
2,6,6,2,18,3105,3264,-159
2,7,0,2,18,3879,3091,788
2,7,1,2,18,3831,3051,780
2,7,2,2,18,3735,3105,630
2,7,3,2,18,3695,3142,553
2,7,4,2,18,3780,3165,615
2,7,5,2,18,3905,3151,754
2,7,6,2,18,4010,3187,823
2,8,0,2,18,3177,5496,-2319
2,8,1,2,18,3132,5549,-2417
2,8,2,2,18,3062,5736,-2674
2,8,3,2,18,3022,5914,-2892
2,8,4,2,18,3089,5966,-2877
2,8,5,2,18,3179,5837,-2658
2,8,6,2,18,3264,5784,-2520
2,9,0,2,18,3091,6309,-3218
2,9,1,2,18,3051,6403,-3352
2,9,2,2,18,3105,6589,-3484
2,9,3,2,18,3142,6826,-3684
2,9,4,2,18,3165,6943,-3778
2,9,5,2,18,3151,6825,-3674
2,9,6,2,18,3187,6714,-3527
2,10,0,2,18,5496,5817,-321
2,10,1,2,18,5549,5938,-389
2,10,2,2,18,5736,6067,-331
2,10,3,2,18,5914,6248,-334
2,10,4,2,18,5966,6384,-418
2,10,5,2,18,5837,6356,-519
2,10,6,2,18,5784,6167,-383
2,11,0,2,18,6309,5668,641
2,11,1,2,18,6403,5818,585
2,11,2,2,18,6589,5916,673
2,11,3,2,18,6826,6021,805
2,11,4,2,18,6943,6159,784
2,11,5,2,18,6825,6194,631
2,11,6,2,18,6714,5975,739
2,12,0,2,18,5817,5620,197
2,12,1,2,18,5938,5799,139
2,12,2,2,18,6067,5897,170
2,12,3,2,18,6248,5977,271
2,12,4,2,18,6384,6129,255
2,12,5,2,18,6356,6133,223
2,12,6,2,18,6167,5924,243
2,13,0,2,18,5668,5555,113
2,13,1,2,18,5818,5737,81
2,13,2,2,18,5916,5894,22
2,13,3,2,18,6021,6017,4
2,13,4,2,18,6159,6145,14
2,13,5,2,18,6194,6022,172
2,13,6,2,18,5975,5804,171
2,14,0,2,18,5620,5101,519
2,14,1,2,18,5799,5149,650
2,14,2,2,18,5897,5337,560
2,14,3,2,18,5977,5529,448
2,14,4,2,18,6129,5598,531
2,14,5,2,18,6133,5382,751
2,14,6,2,18,5924,5237,687
2,15,0,2,18,5555,4371,1184
2,15,1,2,18,5737,4289,1448
2,15,2,2,18,5894,4407,1487
2,15,3,2,18,6017,4642,1375
2,15,4,2,18,6145,4642,1503
2,15,5,2,18,6022,4371,1651
2,15,6,2,18,5804,4277,1527
2,16,0,2,18,5101,4508,593
2,16,1,2,18,5149,4338,811
2,16,2,2,18,5337,4344,993
2,16,3,2,18,5529,4541,988
2,16,4,2,18,5598,4366,1232
2,16,5,2,18,5382,4153,1229
2,16,6,2,18,5237,4216,1021
2,17,0,2,18,4371,4804,-433
2,17,1,2,18,4289,4541,-252
2,17,2,2,18,4407,4515,-108
2,17,3,2,18,4642,4683,-41
2,17,4,2,18,4642,4343,299
2,17,5,2,18,4371,4245,126
2,17,6,2,18,4277,4534,-257
2,18,0,2,18,4508,3727,781
2,18,1,2,18,4338,3437,901
2,18,2,2,18,4344,3450,894
2,18,3,2,18,4541,3557,984
2,18,4,2,18,4366,3226,1140
2,18,5,2,18,4153,3218,935
2,18,6,2,18,4216,3527,689
2,19,0,2,18,4804,2834,1970
2,19,1,2,18,4541,2609,1932
2,19,2,2,18,4515,2605,1910
2,19,3,2,18,4683,2589,2094
2,19,4,2,18,4343,2377,1966
2,19,5,2,18,4245,2425,1820
2,19,6,2,18,4534,2585,1949
2,20,0,2,18,3727,2913,814
2,20,1,2,18,3437,2767,670
2,20,2,2,18,3450,2752,698
2,20,3,2,18,3557,2724,833
2,20,4,2,18,3226,2622,604
2,20,5,2,18,3218,2641,577
2,20,6,2,18,3527,2642,885
2,0,0,3,18,5778,4468,1310
2,0,1,3,18,5779,4432,1347
2,0,2,3,18,5763,4425,1338
2,0,3,3,18,5750,4419,1331
2,0,4,3,18,5763,4413,1350
2,0,5,3,18,5768,4392,1376
2,0,6,3,18,5751,4377,1374
2,1,0,3,18,5524,4283,1241
2,1,1,3,18,5530,4193,1337
2,1,2,3,18,5517,4145,1372
2,1,3,3,18,5499,4130,1369
2,1,4,3,18,5506,4143,1363
2,1,5,3,18,5512,4152,1360
2,1,6,3,18,5500,4174,1326
2,2,0,3,18,4997,4527,470
2,2,1,3,18,4997,4394,603
2,2,2,3,18,4997,4294,703
2,2,3,3,18,4986,4260,726
2,2,4,3,18,4983,4313,670
2,2,5,3,18,4974,4405,569
2,2,6,3,18,4958,4505,453
2,3,0,3,18,4468,5308,-840
2,3,1,3,18,4432,5211,-779
2,3,2,3,18,4425,5078,-653
2,3,3,3,18,4419,5026,-607
2,3,4,3,18,4413,5129,-716
2,3,5,3,18,4392,5283,-891
2,3,6,3,18,4377,5421,-1044
2,4,0,3,18,4283,4815,-532
2,4,1,3,18,4193,4719,-526
2,4,2,3,18,4145,4601,-456
2,4,3,3,18,4130,4543,-413
2,4,4,3,18,4143,4645,-502
2,4,5,3,18,4152,4805,-653
2,4,6,3,18,4174,4958,-784
2,5,0,3,18,4527,5332,-805
2,5,1,3,18,4394,5295,-901
2,5,2,3,18,4294,5301,-1007
2,5,3,3,18,4260,5316,-1056
2,5,4,3,18,4313,5389,-1076
2,5,5,3,18,4405,5430,-1025
2,5,6,3,18,4505,5503,-998
2,6,0,3,18,5308,6432,-1124
2,6,1,3,18,5211,6437,-1226
2,6,2,3,18,5078,6602,-1524
2,6,3,3,18,5026,6762,-1736
2,6,4,3,18,5129,6831,-1702
2,6,5,3,18,5283,6737,-1454
2,6,6,3,18,5421,6732,-1311
2,7,0,3,18,4815,8464,-3649
2,7,1,3,18,4719,8566,-3847
2,7,2,3,18,4601,8828,-4227
2,7,3,3,18,4543,9120,-4577
2,7,4,3,18,4645,9243,-4598
2,7,5,3,18,4805,9076,-4271
2,7,6,3,18,4958,8953,-3995
2,8,0,3,18,5332,9158,-3826
2,8,1,3,18,5295,9324,-4029
2,8,2,3,18,5301,9564,-4263
2,8,3,3,18,5316,9868,-4552
2,8,4,3,18,5389,10050,-4661
2,8,5,3,18,5430,9942,-4512
2,8,6,3,18,5503,9712,-4209
2,9,0,3,18,6432,8636,-2204
2,9,1,3,18,6437,8835,-2398
2,9,2,3,18,6602,9008,-2406
2,9,3,3,18,6762,9227,-2465
2,9,4,3,18,6831,9436,-2605
2,9,5,3,18,6737,9433,-2696
2,9,6,3,18,6732,9144,-2412
2,10,0,3,18,8464,8469,-5
2,10,1,3,18,8566,8720,-154
2,10,2,3,18,8828,8872,-44
2,10,3,3,18,9120,9019,101
2,10,4,3,18,9243,9236,7
2,10,5,3,18,9076,9250,-174
2,10,6,3,18,8953,8922,31
2,11,0,3,18,9158,8374,784
2,11,1,3,18,9324,8634,690
2,11,2,3,18,9564,8835,729
2,11,3,3,18,9868,8996,872
2,11,4,3,18,10050,9197,853
2,11,5,3,18,9942,9099,843
2,11,6,3,18,9712,8781,931
2,12,0,3,18,8636,7902,734
2,12,1,3,18,8835,8051,784
2,12,2,3,18,9008,8293,715
2,12,3,3,18,9227,8527,700
2,12,4,3,18,9436,8675,761
2,12,5,3,18,9433,8438,995
2,12,6,3,18,9144,8184,960
2,13,0,3,18,8469,7125,1344
2,13,1,3,18,8720,7124,1596
2,13,2,3,18,8872,7345,1527
2,13,3,3,18,9019,7661,1358
2,13,4,3,18,9236,7710,1526
2,13,5,3,18,9250,7337,1913
2,13,6,3,18,8922,7134,1788
2,14,0,3,18,8374,6855,1519
2,14,1,3,18,8634,6652,1982
2,14,2,3,18,8835,6743,2092
2,14,3,3,18,8996,7051,1945
2,14,4,3,18,9197,6896,2301
2,14,5,3,18,9099,6569,2530
2,14,6,3,18,8781,6596,2185
2,15,0,3,18,7902,6828,1074
2,15,1,3,18,8051,6516,1535
2,15,2,3,18,8293,6523,1770
2,15,3,3,18,8527,6815,1712
2,15,4,3,18,8675,6455,2220
2,15,5,3,18,8438,6200,2238
2,15,6,3,18,8184,6431,1753
2,16,0,3,18,7125,6211,914
2,16,1,3,18,7124,5800,1324
2,16,2,3,18,7345,5786,1559
2,16,3,3,18,7661,5966,1695
2,16,4,3,18,7710,5480,2230
2,16,5,3,18,7337,5416,1921
2,16,6,3,18,7134,5846,1288
2,17,0,3,18,6855,5154,1701
2,17,1,3,18,6652,4787,1865
2,17,2,3,18,6743,4784,1959
2,17,3,3,18,7051,4863,2188
2,17,4,3,18,6896,4466,2430
2,17,5,3,18,6569,4472,2097
2,17,6,3,18,6596,4800,1796
2,18,0,3,18,6828,4320,2508
2,18,1,3,18,6516,4026,2490
2,18,2,3,18,6523,4023,2500
2,18,3,3,18,6815,4007,2808
2,18,4,3,18,6455,3759,2696
2,18,5,3,18,6200,3812,2388
2,18,6,3,18,6431,3954,2477
2,0,0,4,18,7392,5921,1471
2,0,1,4,18,7398,5780,1618
2,0,2,4,18,7386,5684,1702
2,0,3,4,18,7370,5651,1719
2,0,4,4,18,7382,5699,1683
2,0,5,4,18,7386,5778,1608
2,0,6,4,18,7365,5868,1497
2,1,0,4,18,6918,6768,150
2,1,1,4,18,6916,6638,278
2,1,2,4,18,6907,6490,417
2,1,3,4,18,6890,6434,456
2,1,4,4,18,6892,6537,355
2,1,5,4,18,6885,6684,201
2,1,6,4,18,6863,6821,42
2,2,0,4,18,6457,6244,213
2,2,1,4,18,6424,6099,325
2,2,2,4,18,6409,5944,465
2,2,3,4,18,6394,5874,520
2,2,4,4,18,6391,5994,397
2,2,5,4,18,6375,6183,192
2,2,6,4,18,6358,6369,-11
2,3,0,4,18,5897,6970,-1073
2,3,1,4,18,5812,6882,-1070
2,3,2,4,18,5768,6840,-1072
2,3,3,4,18,5750,6837,-1087
2,3,4,4,18,5762,6945,-1183
2,3,5,4,18,5770,7056,-1286
2,3,6,4,18,5788,7197,-1409
2,4,0,4,18,5921,8673,-2752
2,4,1,4,18,5780,8681,-2901
2,4,2,4,18,5684,8798,-3114
2,4,3,4,18,5651,8936,-3285
2,4,4,4,18,5699,9055,-3356
2,4,5,4,18,5778,9016,-3238
2,4,6,4,18,5868,9048,-3180
2,5,0,4,18,6768,9400,-2632
2,5,1,4,18,6638,9454,-2816
2,5,2,4,18,6490,9694,-3204
2,5,3,4,18,6434,9968,-3534
2,5,4,4,18,6537,10108,-3571
2,5,5,4,18,6684,9976,-3292
2,5,6,4,18,6821,9901,-3080
2,6,0,4,18,6244,11313,-5069
2,6,1,4,18,6099,11487,-5388
2,6,2,4,18,5944,11803,-5859
2,6,3,4,18,5874,12162,-6288
2,6,4,4,18,5994,12350,-6356
2,6,5,4,18,6183,12193,-6010
2,6,6,4,18,6369,11951,-5582
2,7,0,4,18,6970,11977,-5007
2,7,1,4,18,6882,12221,-5339
2,7,2,4,18,6840,12505,-5665
2,7,3,4,18,6837,12847,-6010
2,7,4,4,18,6945,13102,-6157
2,7,5,4,18,7056,13019,-5963
2,7,6,4,18,7197,12689,-5492
2,8,0,4,18,8673,11437,-2764
2,8,1,4,18,8681,11737,-3056
2,8,2,4,18,8798,11964,-3166
2,8,3,4,18,8936,12225,-3289
2,8,4,4,18,9055,12513,-3458
2,8,5,4,18,9016,12489,-3473
2,8,6,4,18,9048,12091,-3043
2,9,0,4,18,9400,11223,-1823
2,9,1,4,18,9454,11555,-2101
2,9,2,4,18,9694,11810,-2116
2,9,3,4,18,9968,12038,-2070
2,9,4,4,18,10108,12304,-2196
2,9,5,4,18,9976,12216,-2240
2,9,6,4,18,9901,11779,-1878
2,10,0,4,18,11313,10721,592
2,10,1,4,18,11487,10948,539
2,10,2,4,18,11803,11234,569
2,10,3,4,18,12162,11506,656
2,10,4,4,18,12350,11727,623
2,10,5,4,18,12193,11515,678
2,10,6,4,18,11951,11161,790
2,11,0,4,18,11977,9926,2051
2,11,1,4,18,12221,10026,2195
2,11,2,4,18,12505,10301,2204
2,11,3,4,18,12847,10659,2188
2,11,4,4,18,13102,10787,2315
2,11,5,4,18,13019,10393,2626
2,11,6,4,18,12689,10081,2608
2,12,0,4,18,11437,9609,1828
2,12,1,4,18,11737,9487,2250
2,12,2,4,18,11964,9681,2283
2,12,3,4,18,12225,10070,2155
2,12,4,4,18,12513,9964,2549
2,12,5,4,18,12489,9535,2954
2,12,6,4,18,12091,9453,2638
2,13,0,4,18,11223,9175,2048
2,13,1,4,18,11555,8830,2725
2,13,2,4,18,11810,8922,2888
2,13,3,4,18,12038,9325,2713
2,13,4,4,18,12304,8985,3319
2,13,5,4,18,12216,8616,3600
2,13,6,4,18,11779,8811,2968
2,14,0,4,18,10721,8235,2486
2,14,1,4,18,10948,7775,3173
2,14,2,4,18,11234,7794,3440
2,14,3,4,18,11506,8098,3408
2,14,4,4,18,11727,7592,4135
2,14,5,4,18,11515,7371,4144
2,14,6,4,18,11161,7743,3418
2,15,0,4,18,9926,7638,2288
2,15,1,4,18,10026,7150,2876
2,15,2,4,18,10301,7120,3181
2,15,3,4,18,10659,7272,3387
2,15,4,4,18,10787,6720,4067
2,15,5,4,18,10393,6670,3723
2,15,6,4,18,10081,7119,2962
2,16,0,4,18,9609,6640,2969
2,16,1,4,18,9487,6204,3283
2,16,2,4,18,9681,6202,3479
2,16,3,4,18,10070,6281,3789
2,16,4,4,18,9964,5848,4116
2,16,5,4,18,9535,5859,3676
2,16,6,4,18,9453,6169,3284
2,0,0,5,18,8786,7704,1082
2,0,1,5,18,8784,7526,1258
2,0,2,5,18,8776,7356,1420
2,0,3,5,18,8761,7282,1479
2,0,4,5,18,8768,7402,1366
2,0,5,5,18,8759,7584,1175
2,0,6,5,18,8728,7769,959
2,1,0,5,18,8378,8399,-21
2,1,1,5,18,8343,8262,81
2,1,2,5,18,8319,8183,136
2,1,3,5,18,8298,8168,130
2,1,4,5,18,8300,8294,6
2,1,5,5,18,8286,8434,-148
2,1,6,5,18,8263,8608,-345
2,2,0,5,18,7886,10311,-2425
2,2,1,5,18,7804,10268,-2464
2,2,2,5,18,7752,10337,-2585
2,2,3,5,18,7725,10457,-2732
2,2,4,5,18,7740,10611,-2871
2,2,5,5,18,7753,10642,-2889
2,2,6,5,18,7769,10742,-2973
2,3,0,5,18,7535,11641,-4106
2,3,1,5,18,7399,11698,-4299
2,3,2,5,18,7307,11890,-4583
2,3,3,5,18,7271,12142,-4871
2,3,4,5,18,7318,12332,-5014
2,3,5,5,18,7396,12255,-4859
2,3,6,5,18,7482,12217,-4735
2,4,0,5,18,8162,12249,-4087
2,4,1,5,18,8024,12375,-4351
2,4,2,5,18,7880,12669,-4789
2,4,3,5,18,7825,13010,-5185
2,4,4,5,18,7923,13215,-5292
2,4,5,5,18,8057,13093,-5036
2,4,6,5,18,8184,12899,-4715
2,5,0,5,18,7704,14132,-6428
2,5,1,5,18,7526,14384,-6858
2,5,2,5,18,7356,14744,-7388
2,5,3,5,18,7282,15141,-7859
2,5,4,5,18,7402,15402,-8000
2,5,5,5,18,7584,15270,-7686
2,5,6,5,18,7769,14928,-7159
2,6,0,5,18,8399,14778,-6379
2,6,1,5,18,8262,15123,-6861
2,6,2,5,18,8183,15461,-7278
2,6,3,5,18,8168,15845,-7677
2,6,4,5,18,8294,16179,-7885
2,6,5,5,18,8434,16075,-7641
2,6,6,5,18,8608,15636,-7028
2,7,0,5,18,10311,14191,-3880
2,7,1,5,18,10268,14572,-4304
2,7,2,5,18,10337,14902,-4565
2,7,3,5,18,10457,15244,-4787
2,7,4,5,18,10611,15581,-4970
2,7,5,5,18,10642,15455,-4813
2,7,6,5,18,10742,14948,-4206
2,8,0,5,18,11641,13570,-1929
2,8,1,5,18,11698,13869,-2171
2,8,2,5,18,11890,14209,-2319
2,8,3,5,18,12142,14548,-2406
2,8,4,5,18,12332,14834,-2502
2,8,5,5,18,12255,14632,-2377
2,8,6,5,18,12217,14159,-1942
2,9,0,5,18,12249,12745,-496
2,9,1,5,18,12375,12923,-548
2,9,2,5,18,12669,13242,-573
2,9,3,5,18,13010,13638,-628
2,9,4,5,18,13215,13839,-624
2,9,5,5,18,13093,13470,-377
2,9,6,5,18,12899,13058,-159
2,10,0,5,18,14132,12410,1722
2,10,1,5,18,14384,12389,1995
2,10,2,5,18,14744,12637,2107
2,10,3,5,18,15141,13068,2073
2,10,4,5,18,15402,13041,2361
2,10,5,5,18,15270,12591,2679
2,10,6,5,18,14928,12400,2528
2,11,0,5,18,14778,11929,2849
2,11,1,5,18,15123,11665,3458
2,11,2,5,18,15461,11860,3601
2,11,3,5,18,15845,12344,3501
2,11,4,5,18,16179,12053,4126
2,11,5,5,18,16075,11582,4493
2,11,6,5,18,15636,11668,3968
2,12,0,5,18,14191,10582,3609
2,12,1,5,18,14572,10089,4483
2,12,2,5,18,14902,10193,4709
2,12,3,5,18,15244,10608,4636
2,12,4,5,18,15581,10122,5459
2,12,5,5,18,15455,9787,5668
2,12,6,5,18,14948,10123,4825
2,13,0,5,18,13570,9662,3908
2,13,1,5,18,13869,9125,4744
2,13,2,5,18,14209,9128,5081
2,13,3,5,18,14548,9404,5144
2,13,4,5,18,14834,8832,6002
2,13,5,5,18,14632,8625,6007
2,13,6,5,18,14159,9016,5143
2,14,0,5,18,12745,9124,3621
2,14,1,5,18,12923,8567,4356
2,14,2,5,18,13242,8538,4704
2,14,3,5,18,13638,8690,4948
2,14,4,5,18,13839,8102,5737
2,14,5,5,18,13470,8057,5413
2,14,6,5,18,13058,8488,4570
2,0,0,6,18,10246,11740,-1494
2,0,1,6,18,10211,11648,-1437
2,0,2,6,18,10188,11680,-1492
2,0,3,6,18,10169,11788,-1619
2,0,4,6,18,10176,11960,-1784
2,0,5,6,18,10160,12020,-1860
2,0,6,6,18,10128,12153,-2025
2,1,0,6,18,9807,13279,-3472
2,1,1,6,18,9723,13285,-3562
2,1,2,6,18,9662,13429,-3767
2,1,3,6,18,9629,13663,-4034
2,1,4,6,18,9649,13888,-4239
2,1,5,6,18,9664,13881,-4217
2,1,6,6,18,9674,13911,-4237
2,2,0,6,18,9524,14490,-4966
2,2,1,6,18,9391,14619,-5228
2,2,2,6,18,9291,14865,-5574
2,2,3,6,18,9246,15184,-5938
2,2,4,6,18,9296,15439,-6143
2,2,5,6,18,9379,15372,-5993
2,2,6,6,18,9463,15215,-5752
2,3,0,6,18,9776,15068,-5292
2,3,1,6,18,9643,15272,-5629
2,3,2,6,18,9503,15610,-6107
2,3,3,6,18,9445,15989,-6544
2,3,4,6,18,9542,16267,-6725
2,3,5,6,18,9675,16170,-6495
2,3,6,6,18,9798,15876,-6078
2,4,0,6,18,9098,16933,-7835
2,4,1,6,18,8912,17286,-8374
2,4,2,6,18,8746,17700,-8954
2,4,3,6,18,8673,18139,-9466
2,4,4,6,18,8788,18479,-9691
2,4,5,6,18,8957,18326,-9369
2,4,6,6,18,9132,17875,-8743
2,5,0,6,18,9859,17532,-7673
2,5,1,6,18,9689,17958,-8269
2,5,2,6,18,9595,18399,-8804
2,5,3,6,18,9576,18864,-9288
2,5,4,6,18,9702,19247,-9545
2,5,5,6,18,9835,19041,-9206
2,5,6,6,18,10008,18493,-8485
2,6,0,6,18,11740,16538,-4798
2,6,1,6,18,11648,16886,-5238
2,6,2,6,18,11680,17301,-5621
2,6,3,6,18,11788,17754,-5966
2,6,4,6,18,11960,18111,-6151
2,6,5,6,18,12020,17871,-5851
2,6,6,6,18,12153,17328,-5175
2,7,0,6,18,13279,15594,-2315
2,7,1,6,18,13285,15844,-2559
2,7,2,6,18,13429,16217,-2788
2,7,3,6,18,13663,16680,-3017
2,7,4,6,18,13888,16946,-3058
2,7,5,6,18,13881,16587,-2706
2,7,6,6,18,13911,16056,-2145
2,8,0,6,18,14490,15229,-739
2,8,1,6,18,14619,15286,-667
2,8,2,6,18,14865,15578,-713
2,8,3,6,18,15184,16047,-863
2,8,4,6,18,15439,16093,-654
2,8,5,6,18,15372,15668,-296
2,8,6,6,18,15215,15377,-162
2,9,0,6,18,15068,14730,338
2,9,1,6,18,15272,14567,705
2,9,2,6,18,15610,14816,794
2,9,3,6,18,15989,15342,647
2,9,4,6,18,16267,15130,1137
2,9,5,6,18,16170,14638,1532
2,9,6,6,18,15876,14615,1261
2,10,0,6,18,16933,13336,3597
2,10,1,6,18,17286,12924,4362
2,10,2,6,18,17700,13131,4569
2,10,3,6,18,18139,13627,4512
2,10,4,6,18,18479,13190,5289
2,10,5,6,18,18326,12753,5573
2,10,6,6,18,17875,12980,4895
2,11,0,6,18,17532,12009,5523
2,11,1,6,18,17958,11439,6519
2,11,2,6,18,18399,11527,6872
2,11,3,6,18,18864,11914,6950
2,11,4,6,18,19247,11362,7885
2,11,5,6,18,19041,11041,8000
2,11,6,6,18,18493,11396,7097
2,12,0,6,18,16538,11148,5390
2,12,1,6,18,16886,10542,6344
2,12,2,6,18,17301,10546,6755
2,12,3,6,18,17754,10822,6932
2,12,4,6,18,18111,10214,7897
2,12,5,6,18,17871,10012,7859
2,12,6,6,18,17328,10385,6943
2,0,0,7,18,11675,16128,-4453
2,0,1,7,18,11591,16206,-4615
2,0,2,7,18,11531,16404,-4873
2,0,3,7,18,11500,16705,-5205
2,0,4,7,18,11525,16995,-5470
2,0,5,7,18,11538,16998,-5460
2,0,6,7,18,11539,16909,-5370
2,1,0,7,18,11445,17309,-5864
2,1,1,7,18,11310,17516,-6206
2,1,2,7,18,11201,17806,-6605
2,1,3,7,18,11150,18163,-7013
2,1,4,7,18,11205,18491,-7286
2,1,5,7,18,11290,18449,-7159
2,1,6,7,18,11368,18192,-6824
2,2,0,7,18,11765,17869,-6104
2,2,1,7,18,11635,18174,-6539
2,2,2,7,18,11487,18566,-7079
2,2,3,7,18,11420,18987,-7567
2,2,4,7,18,11520,19344,-7824
2,2,5,7,18,11658,19226,-7568
2,2,6,7,18,11779,18823,-7044
2,3,0,7,18,10712,19687,-8975
2,3,1,7,18,10531,20121,-9590
2,3,2,7,18,10369,20638,-10269
2,3,3,7,18,10293,21158,-10865
2,3,4,7,18,10407,21547,-11140
2,3,5,7,18,10575,21292,-10717
2,3,6,7,18,10746,20732,-9986
2,4,0,7,18,11253,19879,-8626
2,4,1,7,18,11075,20272,-9197
2,4,2,7,18,10985,20798,-9813
2,4,3,7,18,10967,21374,-10407
2,4,4,7,18,11088,21777,-10689
2,4,5,7,18,11208,21457,-10249
2,4,6,7,18,11371,20873,-9502
2,5,0,7,18,13200,18562,-5362
2,5,1,7,18,13075,18861,-5786
2,5,2,7,18,13092,19309,-6217
2,5,3,7,18,13196,19886,-6690
2,5,4,7,18,13368,20223,-6855
2,5,5,7,18,13421,19826,-6405
2,5,6,7,18,13553,19225,-5672
2,6,0,7,18,14708,18078,-3370
2,6,1,7,18,14665,18207,-3542
2,6,2,7,18,14772,18553,-3781
2,6,3,7,18,14994,19089,-4095
2,6,4,7,18,15237,19200,-3963
2,6,5,7,18,15259,18785,-3526
2,6,6,7,18,15322,18375,-3053
2,7,0,7,18,16128,17549,-1421
2,7,1,7,18,16206,17464,-1258
2,7,2,7,18,16404,17757,-1353
2,7,3,7,18,16705,18321,-1616
2,7,4,7,18,16995,18182,-1187
2,7,5,7,18,16998,17715,-717
2,7,6,7,18,16909,17592,-683
2,8,0,7,18,17309,16137,1172
2,8,1,7,18,17516,15826,1690
2,8,2,7,18,17806,16087,1719
2,8,3,7,18,18163,16625,1538
2,8,4,7,18,18491,16267,2224
2,8,5,7,18,18449,15809,2640
2,8,6,7,18,18192,15927,2265
2,9,0,7,18,17869,14763,3106
2,9,1,7,18,18174,14274,3900
2,9,2,7,18,18566,14465,4101
2,9,3,7,18,18987,14933,4054
2,9,4,7,18,19344,14430,4914
2,9,5,7,18,19226,14007,5219
2,9,6,7,18,18823,14253,4570
2,10,0,7,18,19687,13495,6192
2,10,1,7,18,20121,12856,7265
2,10,2,7,18,20638,12945,7693
2,10,3,7,18,21158,13332,7826
2,10,4,7,18,21547,12744,8803
2,10,5,7,18,21292,12428,8864
2,10,6,7,18,20732,12765,7967
2,0,0,8,18,13313,20110,-6797
2,0,1,8,18,13178,20418,-7240
2,0,2,8,18,13070,20762,-7692
2,0,3,8,18,13021,21161,-8140
2,0,4,8,18,13081,21568,-8487
2,0,5,8,18,13164,21505,-8341
2,0,6,8,18,13233,21139,-7906
2,1,0,8,18,13686,20623,-6937
2,1,1,8,18,13554,21009,-7455
2,1,2,8,18,13397,21504,-8107
2,1,3,8,18,13324,22006,-8682
2,1,4,8,18,13429,22412,-8983
2,1,5,8,18,13569,22192,-8623
2,1,6,8,18,13684,21680,-7996
2,2,0,8,18,12701,22034,-9333
2,2,1,8,18,12523,22435,-9912
2,2,2,8,18,12353,23037,-10684
2,2,3,8,18,12268,23668,-11400
2,2,4,8,18,12385,24077,-11692
2,2,5,8,18,12558,23708,-11150
2,2,6,8,18,12727,23112,-10385
2,3,0,8,18,12867,21903,-9036
2,3,1,8,18,12694,22247,-9553
2,3,2,8,18,12608,22806,-10198
2,3,3,8,18,12587,23506,-10919
2,3,4,8,18,12707,23889,-11182
2,3,5,8,18,12826,23412,-10586
2,3,6,8,18,12985,22770,-9785
2,4,0,8,18,14594,21046,-6452
2,4,1,8,18,14461,21224,-6763
2,4,2,8,18,14482,21645,-7163
2,4,3,8,18,14587,22295,-7708
2,4,4,8,18,14754,22477,-7723
2,4,5,8,18,14794,22024,-7230
2,4,6,8,18,14916,21544,-6628
2,5,0,8,18,16168,20398,-4230
2,5,1,8,18,16092,20385,-4293
2,5,2,8,18,16184,20732,-4548
2,5,3,8,18,16402,21363,-4961
2,5,4,8,18,16645,21289,-4644
2,5,5,8,18,16660,20832,-4172
2,5,6,8,18,16722,20590,-3868
2,6,0,8,18,17557,18956,-1399
2,6,1,8,18,17586,18723,-1137
2,6,2,8,18,17747,19028,-1281
2,6,3,8,18,18036,19604,-1568
2,6,4,8,18,18344,19319,-975
2,6,5,8,18,18376,18886,-510
2,6,6,8,18,18320,18904,-584
2,7,0,8,18,18947,17564,1383
2,7,1,8,18,19103,17176,1927
2,7,2,8,18,19345,17421,1924
2,7,3,8,18,19684,17931,1753
2,7,4,8,18,20047,17507,2540
2,7,5,8,18,20075,17063,3012
2,7,6,8,18,19886,17200,2686
2,8,0,8,18,20110,16249,3861
2,8,1,8,18,20418,15691,4727
2,8,2,8,18,20762,15883,4879
2,8,3,8,18,21161,16351,4810
2,8,4,8,18,21568,15812,5756
2,8,5,8,18,21505,15394,6111
2,8,6,8,18,21139,15622,5517
2,0,0,9,18,15554,22970,-7416
2,0,1,9,18,15422,23323,-7901
2,0,2,9,18,15266,23903,-8637
2,0,3,9,18,15195,24516,-9321
2,0,4,9,18,15305,24942,-9637
2,0,5,9,18,15443,24608,-9165
2,0,6,9,18,15549,24060,-8511
2,1,0,9,18,14622,24058,-9436
2,1,1,9,18,14442,24410,-9968
2,1,2,9,18,14263,25045,-10782
2,1,3,9,18,14172,25800,-11628
2,1,4,9,18,14294,26189,-11895
2,1,5,9,18,14469,25663,-11194
2,1,6,9,18,14632,25009,-10377
2,2,0,9,18,14856,24387,-9531
2,2,1,9,18,14686,24610,-9924
2,2,2,9,18,14592,25142,-10550
2,2,3,9,18,14562,25915,-11353
2,2,4,9,18,14685,26143,-11458
2,2,5,9,18,14809,25610,-10801
2,2,6,9,18,14966,25089,-10123
2,3,0,9,18,16208,23366,-7158
2,3,1,9,18,16080,23402,-7322
2,3,2,9,18,16105,23824,-7719
2,3,3,9,18,16207,24569,-8362
2,3,4,9,18,16373,24566,-8193
2,3,5,9,18,16412,24071,-7659
2,3,6,9,18,16530,23759,-7229
2,4,0,9,18,17562,21805,-4243
2,4,1,9,18,17478,21644,-4166
2,4,2,9,18,17574,22003,-4429
2,4,3,9,18,17793,22646,-4853
2,4,4,9,18,18031,22426,-4395
2,4,5,9,18,18033,22003,-3970
2,4,6,9,18,18085,21902,-3817
2,5,0,9,18,19017,20383,-1366
2,5,1,9,18,19013,20073,-1060
2,5,2,9,18,19159,20362,-1203
2,5,3,9,18,19444,20910,-1466
2,5,4,9,18,19752,20559,-807
2,5,5,9,18,19777,20140,-363
2,5,6,9,18,19720,20177,-457
2,6,0,9,18,20376,19050,1326
2,6,1,9,18,20483,18593,1890
2,6,2,9,18,20688,18839,1849
2,6,3,9,18,21015,19349,1666
2,6,4,9,18,21396,18889,2507
2,6,5,9,18,21453,18450,3003
2,6,6,9,18,21297,18569,2728
2,0,0,10,18,16490,26542,-10052
2,0,1,10,18,16310,26773,-10463
2,0,2,10,18,16132,27381,-11249
2,0,3,10,18,16043,28209,-12166
2,0,4,10,18,16170,28443,-12273
2,0,5,10,18,16343,27861,-11518
2,0,6,10,18,16497,27328,-10831
2,1,0,10,18,16777,26707,-9930
2,1,1,10,18,16605,26788,-10183
2,1,2,10,18,16502,27321,-10819
2,1,3,10,18,16466,28189,-11723
2,1,4,10,18,16594,28232,-11638
2,1,5,10,18,16720,27657,-10937
2,1,6,10,18,16871,27304,-10433
2,2,0,10,18,18197,24773,-6576
2,2,1,10,18,18072,24661,-6589
2,2,2,10,18,18089,25095,-7006
2,2,3,10,18,18182,25852,-7670
2,2,4,10,18,18351,25703,-7352
2,2,5,10,18,18395,25242,-6847
2,2,6,10,18,18511,25071,-6560
2,3,0,10,18,19176,23232,-4056
2,3,1,10,18,19097,22994,-3897
2,3,2,10,18,19197,23337,-4140
2,3,3,10,18,19413,23952,-4539
2,3,4,10,18,19650,23666,-4016
2,3,5,10,18,19651,23257,-3606
2,3,6,10,18,19699,23175,-3476
2,4,0,10,18,20411,21869,-1458
2,4,1,10,18,20399,21490,-1091
2,4,2,10,18,20549,21780,-1231
2,4,3,10,18,20835,22328,-1493
2,4,4,10,18,21138,21941,-803
2,4,5,10,18,21150,21527,-377
2,4,6,10,18,21083,21546,-463
2,0,0,11,18,18645,28114,-9469
2,0,1,11,18,18473,28047,-9574
2,0,2,11,18,18371,28592,-10221
2,0,3,11,18,18337,29472,-11135
2,0,4,11,18,18470,29369,-10899
2,0,5,11,18,18594,28828,-10234
2,0,6,11,18,18736,28616,-9880
2,1,0,11,18,20118,26200,-6082
2,1,1,11,18,19991,26011,-6020
2,1,2,11,18,19999,26429,-6430
2,1,3,11,18,20086,27158,-7072
2,1,4,11,18,20260,26943,-6683
2,1,5,11,18,20306,26496,-6190
2,1,6,11,18,20416,26344,-5928
2,2,0,11,18,21165,24718,-3553
2,2,1,11,18,21089,24411,-3322
2,2,2,11,18,21181,24755,-3574
2,2,3,11,18,21388,25370,-3982
2,2,4,11,18,21628,25048,-3420
2,2,5,11,18,21634,24644,-3010
2,2,6,11,18,21680,24544,-2864
2,0,0,12,18,21986,27686,-5700
2,0,1,12,18,21859,27428,-5569
2,0,2,12,18,21868,27847,-5979
2,0,3,12,18,21957,28576,-6619
2,0,4,12,18,22136,28325,-6189
2,0,5,12,18,22180,27883,-5703
2,0,6,12,18,22281,27713,-5432
2,0,0,1,19,1978,2025,-47
2,0,1,1,19,1976,2021,-45
2,0,2,1,19,1967,2011,-44
2,0,3,1,19,1974,2015,-41
2,0,4,1,19,1985,2023,-38
2,0,5,1,19,1976,2013,-37
2,1,0,1,19,2025,2098,-73
2,1,1,1,19,2021,2099,-78
2,1,2,1,19,2011,2087,-76
2,1,3,1,19,2015,2085,-70
2,1,4,1,19,2023,2093,-70
2,1,5,1,19,2013,2089,-76
2,2,0,1,19,2098,1731,367
2,2,1,1,19,2099,1740,359
2,2,2,1,19,2087,1730,357
2,2,3,1,19,2085,1724,361
2,2,4,1,19,2093,1730,363
2,2,5,1,19,2089,1729,360
2,3,0,1,19,1731,1500,231
2,3,1,1,19,1740,1509,231
2,3,2,1,19,1730,1505,225
2,3,3,1,19,1724,1501,223
2,3,4,1,19,1730,1499,231
2,3,5,1,19,1729,1483,246
2,4,0,1,19,1500,1541,-41
2,4,1,1,19,1509,1534,-25
2,4,2,1,19,1505,1528,-23
2,4,3,1,19,1501,1527,-26
2,4,4,1,19,1499,1526,-27
2,4,5,1,19,1483,1509,-26
2,5,0,1,19,1541,1500,41
2,5,1,1,19,1534,1467,67
2,5,2,1,19,1528,1440,88
2,5,3,1,19,1527,1438,89
2,5,4,1,19,1526,1465,61
2,5,5,1,19,1509,1493,16
2,6,0,1,19,1500,1717,-217
2,6,1,1,19,1467,1664,-197
2,6,2,1,19,1440,1611,-171
2,6,3,1,19,1438,1605,-167
2,6,4,1,19,1465,1666,-201
2,6,5,1,19,1493,1751,-258
2,7,0,1,19,1717,2370,-653
2,7,1,1,19,1664,2337,-673
2,7,2,1,19,1611,2295,-684
2,7,3,1,19,1605,2302,-697
2,7,4,1,19,1666,2342,-676
2,7,5,1,19,1751,2410,-659
2,8,0,1,19,2370,994,1376
2,8,1,1,19,2337,935,1402
2,8,2,1,19,2295,917,1378
2,8,3,1,19,2302,908,1394
2,8,4,1,19,2342,941,1401
2,8,5,1,19,2410,1003,1407
2,9,0,1,19,994,2267,-1273
2,9,1,1,19,935,2283,-1348
2,9,2,1,19,917,2354,-1437
2,9,3,1,19,908,2376,-1468
2,9,4,1,19,941,2399,-1458
2,9,5,1,19,1003,2357,-1354
2,10,0,1,19,2267,3525,-1258
2,10,1,1,19,2283,3597,-1314
2,10,2,1,19,2354,3710,-1356
2,10,3,1,19,2376,3789,-1413
2,10,4,1,19,2399,3839,-1440
2,10,5,1,19,2357,3720,-1363
2,11,0,1,19,3525,3168,357
2,11,1,1,19,3597,3239,358
2,11,2,1,19,3710,3310,400
2,11,3,1,19,3789,3403,386
2,11,4,1,19,3839,3476,363
2,11,5,1,19,3720,3370,350
2,12,0,1,19,3168,3067,101
2,12,1,1,19,3239,3134,105
2,12,2,1,19,3310,3152,158
2,12,3,1,19,3403,3230,173
2,12,4,1,19,3476,3304,172
2,12,5,1,19,3370,3251,119
2,13,0,1,19,3067,3049,18
2,13,1,1,19,3134,3110,24
2,13,2,1,19,3152,3094,58
2,13,3,1,19,3230,3174,56
2,13,4,1,19,3304,3253,51
2,13,5,1,19,3251,3231,20
2,14,0,1,19,3049,3048,1
2,14,1,1,19,3110,3125,-15
2,14,2,1,19,3094,3105,-11
2,14,3,1,19,3174,3196,-22
2,14,4,1,19,3253,3263,-10
2,14,5,1,19,3231,3197,34
2,15,0,1,19,3048,2943,105
2,15,1,1,19,3125,3052,73
2,15,2,1,19,3105,3094,11
2,15,3,1,19,3196,3187,9
2,15,4,1,19,3263,3185,78
2,15,5,1,19,3197,3106,91
2,16,0,1,19,2943,2422,521
2,16,1,1,19,3052,2474,578
2,16,2,1,19,3094,2573,521
2,16,3,1,19,3187,2676,511
2,16,4,1,19,3185,2623,562
2,16,5,1,19,3106,2571,535
2,17,0,1,19,2422,2097,325
2,17,1,1,19,2474,2100,374
2,17,2,1,19,2573,2208,365
2,17,3,1,19,2676,2296,380
2,17,4,1,19,2623,2193,430
2,17,5,1,19,2571,2076,495
2,18,0,1,19,2097,2553,-456
2,18,1,1,19,2100,2426,-326
2,18,2,1,19,2208,2513,-305
2,18,3,1,19,2296,2488,-192
2,18,4,1,19,2193,2328,-135
2,18,5,1,19,2076,2399,-323
2,19,0,1,19,2553,2368,185
2,19,1,1,19,2426,2255,171
2,19,2,1,19,2513,2342,171
2,19,3,1,19,2488,2319,169
2,19,4,1,19,2328,2144,184
2,19,5,1,19,2399,2258,141
2,20,0,1,19,2368,1462,906
2,20,1,1,19,2255,1343,912
2,20,2,1,19,2342,1372,970
2,20,3,1,19,2319,1372,947
2,20,4,1,19,2144,1233,911
2,20,5,1,19,2258,1344,914
2,21,0,1,19,1462,1447,15
2,21,1,1,19,1343,1408,-65
2,21,2,1,19,1372,1382,-10
2,21,3,1,19,1372,1360,12
2,21,4,1,19,1233,1294,-61
2,21,5,1,19,1344,1310,34
2,22,0,1,19,1447,1528,-81
2,22,1,1,19,1408,1487,-79
2,22,2,1,19,1382,1472,-90
2,22,3,1,19,1360,1451,-91
2,22,4,1,19,1294,1456,-162
2,22,5,1,19,1310,1434,-124
2,0,0,2,19,4003,3829,174
2,0,1,2,19,3997,3839,158
2,0,2,2,19,3978,3817,161
2,0,3,2,19,3989,3809,180
2,0,4,2,19,4008,3823,185
2,0,5,2,19,3989,3818,171
2,1,0,2,19,4123,3231,892
2,1,1,2,19,4120,3249,871
2,1,2,2,19,4098,3235,863
2,1,3,2,19,4100,3225,875
2,1,4,2,19,4116,3229,887
2,1,5,2,19,4102,3212,890
2,2,0,2,19,3829,3041,788
2,2,1,2,19,3839,3043,796
2,2,2,2,19,3817,3033,784
2,2,3,2,19,3809,3028,781
2,2,4,2,19,3823,3025,798
2,2,5,2,19,3818,2992,826
2,3,0,2,19,3231,3041,190
2,3,1,2,19,3249,3001,248
2,3,2,2,19,3235,2968,267
2,3,3,2,19,3225,2965,260
2,3,4,2,19,3229,2991,238
2,3,5,2,19,3212,3002,210
2,4,0,2,19,3041,3217,-176
2,4,1,2,19,3043,3131,-88
2,4,2,2,19,3033,3051,-18
2,4,3,2,19,3028,3043,-15
2,4,4,2,19,3025,3131,-106
2,4,5,2,19,2992,3244,-252
2,5,0,2,19,3041,4087,-1046
2,5,1,2,19,3001,4001,-1000
2,5,2,2,19,2968,3906,-938
2,5,3,2,19,2965,3907,-942
2,5,4,2,19,2991,4008,-1017
2,5,5,2,19,3002,4161,-1159
2,6,0,2,19,3217,3364,-147
2,6,1,2,19,3131,3272,-141
2,6,2,2,19,3051,3212,-161
2,6,3,2,19,3043,3210,-167
2,6,4,2,19,3131,3283,-152
2,6,5,2,19,3244,3413,-169
2,7,0,2,19,4087,3261,826
2,7,1,2,19,4001,3218,783
2,7,2,2,19,3906,3271,635
2,7,3,2,19,3907,3284,623
2,7,4,2,19,4008,3340,668
2,7,5,2,19,4161,3360,801
2,8,0,2,19,3364,5792,-2428
2,8,1,2,19,3272,5880,-2608
2,8,2,2,19,3212,6064,-2852
2,8,3,2,19,3210,6165,-2955
2,8,4,2,19,3283,6238,-2955
2,8,5,2,19,3413,6077,-2664
2,9,0,2,19,3261,6693,-3432
2,9,1,2,19,3218,6836,-3618
2,9,2,2,19,3271,7020,-3749
2,9,3,2,19,3284,7192,-3908
2,9,4,2,19,3340,7315,-3975
2,9,5,2,19,3360,7090,-3730
2,10,0,2,19,5792,6235,-443
2,10,1,2,19,5880,6373,-493
2,10,2,2,19,6064,6462,-398
2,10,3,2,19,6165,6633,-468
2,10,4,2,19,6238,6780,-542
2,10,5,2,19,6077,6621,-544
2,11,0,2,19,6693,6116,577
2,11,1,2,19,6836,6244,592
2,11,2,2,19,7020,6246,774
2,11,3,2,19,7192,6404,788
2,11,4,2,19,7315,6557,758
2,11,5,2,19,7090,6482,608
2,12,0,2,19,6235,6097,138
2,12,1,2,19,6373,6235,138
2,12,2,2,19,6462,6199,263
2,12,3,2,19,6633,6370,263
2,12,4,2,19,6780,6516,264
2,12,5,2,19,6621,6428,193
2,13,0,2,19,6116,5991,125
2,13,1,2,19,6244,6177,67
2,13,2,2,19,6246,6199,47
2,13,3,2,19,6404,6383,21
2,13,4,2,19,6557,6448,109
2,13,5,2,19,6482,6303,179
2,14,0,2,19,6097,5365,732
2,14,1,2,19,6235,5526,709
2,14,2,2,19,6199,5667,532
2,14,3,2,19,6370,5863,507
2,14,4,2,19,6516,5808,708
2,14,5,2,19,6428,5677,751
2,15,0,2,19,5991,4519,1472
2,15,1,2,19,6177,4574,1603
2,15,2,2,19,6199,4781,1418
2,15,3,2,19,6383,4972,1411
2,15,4,2,19,6448,4816,1632
2,15,5,2,19,6303,4647,1656
2,16,0,2,19,5365,4650,715
2,16,1,2,19,5526,4526,1000
2,16,2,2,19,5667,4721,946
2,16,3,2,19,5863,4784,1079
2,16,4,2,19,5808,4521,1287
2,16,5,2,19,5677,4475,1202
2,17,0,2,19,4519,4921,-402
2,17,1,2,19,4574,4681,-107
2,17,2,2,19,4781,4855,-74
2,17,3,2,19,4972,4807,165
2,17,4,2,19,4816,4472,344
2,17,5,2,19,4647,4657,-10
2,18,0,2,19,4650,3830,820
2,18,1,2,19,4526,3598,928
2,18,2,2,19,4721,3714,1007
2,18,3,2,19,4784,3691,1093
2,18,4,2,19,4521,3377,1144
2,18,5,2,19,4475,3602,873
2,19,0,2,19,4921,2909,2012
2,19,1,2,19,4681,2751,1930
2,19,2,2,19,4855,2754,2101
2,19,3,2,19,4807,2732,2075
2,19,4,2,19,4472,2527,1945
2,19,5,2,19,4657,2654,2003
2,20,0,2,19,3830,2975,855
2,20,1,2,19,3598,2895,703
2,20,2,2,19,3714,2854,860
2,20,3,2,19,3691,2811,880
2,20,4,2,19,3377,2750,627
2,20,5,2,19,3602,2744,858
2,0,0,3,19,6101,4772,1329
2,0,1,3,19,6096,4783,1313
2,0,2,3,19,6065,4763,1302
2,0,3,3,19,6074,4752,1322
2,0,4,3,19,6101,4755,1346
2,0,5,3,19,6078,4721,1357
2,1,0,3,19,5854,4541,1313
2,1,1,3,19,5860,4510,1350
2,1,2,3,19,5828,4473,1355
2,1,3,3,19,5824,4466,1358
2,1,4,3,19,5846,4490,1356
2,1,5,3,19,5831,4485,1346
2,2,0,3,19,5329,4758,571
2,2,1,3,19,5348,4665,683
2,2,2,3,19,5322,4579,743
2,2,3,3,19,5310,4570,740
2,2,4,3,19,5322,4657,665
2,2,5,3,19,5301,4753,548
2,3,0,3,19,4772,5587,-815
2,3,1,3,19,4783,5468,-685
2,3,2,3,19,4763,5346,-583
2,3,3,3,19,4752,5345,-593
2,3,4,3,19,4755,5473,-718
2,3,5,3,19,4721,5654,-933
2,4,0,3,19,4541,5081,-540
2,4,1,3,19,4510,4936,-426
2,4,2,3,19,4473,4823,-350
2,4,3,3,19,4466,4815,-349
2,4,4,3,19,4490,4949,-459
2,4,5,3,19,4485,5164,-679
2,5,0,3,19,4758,5631,-873
2,5,1,3,19,4665,5555,-890
2,5,2,3,19,4579,5566,-987
2,5,3,3,19,4570,5586,-1016
2,5,4,3,19,4657,5682,-1025
2,5,5,3,19,4753,5770,-1017
2,6,0,3,19,5587,6786,-1199
2,6,1,3,19,5468,6815,-1347
2,6,2,3,19,5346,6981,-1635
2,6,3,3,19,5345,7073,-1728
2,6,4,3,19,5473,7179,-1706
2,6,5,3,19,5654,7080,-1426
2,7,0,3,19,5081,8960,-3879
2,7,1,3,19,4936,9119,-4183
2,7,2,3,19,4823,9374,-4551
2,7,3,3,19,4815,9568,-4753
2,7,4,3,19,4949,9714,-4765
2,7,5,3,19,5164,9447,-4283
2,8,0,3,19,5631,9760,-4129
2,8,1,3,19,5555,9970,-4415
2,8,2,3,19,5566,10172,-4606
2,8,3,3,19,5586,10422,-4836
2,8,4,3,19,5682,10619,-4937
2,8,5,3,19,5770,10341,-4571
2,9,0,3,19,6786,9284,-2498
2,9,1,3,19,6815,9483,-2668
2,9,2,3,19,6981,9556,-2575
2,9,3,3,19,7073,9807,-2734
2,9,4,3,19,7179,10033,-2854
2,9,5,3,19,7080,9852,-2772
2,10,0,3,19,8960,9164,-204
2,10,1,3,19,9119,9369,-250
2,10,2,3,19,9374,9351,23
2,10,3,3,19,9568,9600,-32
2,10,4,3,19,9714,9820,-106
2,10,5,3,19,9447,9679,-232
2,11,0,3,19,9760,9040,720
2,11,1,3,19,9970,9287,683
2,11,2,3,19,10172,9293,879
2,11,3,3,19,10422,9557,865
2,11,4,3,19,10619,9701,918
2,11,5,3,19,10341,9534,807
2,12,0,3,19,9284,8413,871
2,12,1,3,19,9483,8651,832
2,12,2,3,19,9556,8772,784
2,12,3,3,19,9807,9059,748
2,12,4,3,19,10033,9071,962
2,12,5,3,19,9852,8874,978
2,13,0,3,19,9164,7462,1702
2,13,1,3,19,9369,7626,1743
2,13,2,3,19,9351,7875,1476
2,13,3,3,19,9600,8159,1441
2,13,4,3,19,9820,8001,1819
2,13,5,3,19,9679,7753,1926
2,14,0,3,19,9040,7072,1968
2,14,1,3,19,9287,7000,2287
2,14,2,3,19,9293,7294,1999
2,14,3,3,19,9557,7460,2097
2,14,4,3,19,9701,7144,2557
2,14,5,3,19,9534,7046,2488
2,15,0,3,19,8413,7018,1395
2,15,1,3,19,8651,6781,1870
2,15,2,3,19,8772,7063,1709
2,15,3,3,19,9059,7103,1956
2,15,4,3,19,9071,6665,2406
2,15,5,3,19,8874,6733,2141
2,16,0,3,19,7462,6383,1079
2,16,1,3,19,7626,6024,1602
2,16,2,3,19,7875,6227,1648
2,16,3,3,19,8159,6179,1980
2,16,4,3,19,8001,5705,2296
2,16,5,3,19,7753,6001,1752
2,17,0,3,19,7072,5277,1795
2,17,1,3,19,7000,5006,1994
2,17,2,3,19,7294,5096,2198
2,17,3,3,19,7460,5051,2409
2,17,4,3,19,7144,4671,2473
2,17,5,3,19,7046,4912,2134
2,18,0,3,19,7018,4437,2581
2,18,1,3,19,6781,4238,2543
2,18,2,3,19,7063,4226,2837
2,18,3,3,19,7103,4183,2920
2,18,4,3,19,6665,3983,2682
2,18,5,3,19,6733,4088,2645
2,0,0,4,19,7832,6258,1574
2,0,1,4,19,7836,6174,1662
2,0,2,4,19,7795,6084,1711
2,0,3,4,19,7798,6071,1727
2,0,4,4,19,7831,6156,1675
2,0,5,4,19,7807,6236,1571
2,1,0,4,19,7354,7128,226
2,1,1,4,19,7369,7002,367
2,1,2,4,19,7333,6874,459
2,1,3,4,19,7325,6872,453
2,1,4,4,19,7345,6999,346
2,1,5,4,19,7314,7163,151
2,2,0,4,19,6870,6581,289
2,2,1,4,19,6882,6403,479
2,2,2,4,19,6850,6263,587
2,2,3,4,19,6837,6253,584
2,2,4,4,19,6848,6414,434
2,2,5,4,19,6810,6657,153
2,3,0,4,19,6272,7348,-1076
2,3,1,4,19,6250,7219,-969
2,3,2,4,19,6203,7177,-974
2,3,3,4,19,6190,7191,-1001
2,3,4,4,19,6220,7348,-1128
2,3,5,4,19,6214,7521,-1307
2,4,0,4,19,6258,9156,-2898
2,4,1,4,19,6174,9152,-2978
2,4,2,4,19,6084,9276,-3192
2,4,3,4,19,6071,9375,-3304
2,4,4,4,19,6156,9521,-3365
2,4,5,4,19,6236,9490,-3254
2,5,0,4,19,7128,9954,-2826
2,5,1,4,19,7002,10054,-3052
2,5,2,4,19,6874,10291,-3417
2,5,3,4,19,6872,10476,-3604
2,5,4,4,19,6999,10655,-3656
2,5,5,4,19,7163,10450,-3287
2,6,0,4,19,6581,12027,-5446
2,6,1,4,19,6403,12253,-5850
2,6,2,4,19,6263,12526,-6263
2,6,3,4,19,6253,12798,-6545
2,6,4,4,19,6414,13018,-6604
2,6,5,4,19,6657,12698,-6041
2,7,0,4,19,7348,12809,-5461
2,7,1,4,19,7219,13080,-5861
2,7,2,4,19,7177,13266,-6089
2,7,3,4,19,7191,13596,-6405
2,7,4,4,19,7348,13872,-6524
2,7,5,4,19,7521,13572,-6051
2,8,0,4,19,9156,12332,-3176
2,8,1,4,19,9152,12608,-3456
2,8,2,4,19,9276,12661,-3385
2,8,3,4,19,9375,13003,-3628
2,8,4,4,19,9521,13296,-3775
2,8,5,4,19,9490,13049,-3559
2,9,0,4,19,9954,12107,-2153
2,9,1,4,19,10054,12421,-2367
2,9,2,4,19,10291,12445,-2154
2,9,3,4,19,10476,12787,-2311
2,9,4,4,19,10655,13005,-2350
2,9,5,4,19,10450,12785,-2335
2,10,0,4,19,12027,11462,565
2,10,1,4,19,12253,11761,492
2,10,2,4,19,12526,11866,660
2,10,3,4,19,12798,12233,565
2,10,4,4,19,13018,12324,694
2,10,5,4,19,12698,12105,593
2,11,0,4,19,12809,10510,2299
2,11,1,4,19,13080,10751,2329
2,11,2,4,19,13266,10980,2286
2,11,3,4,19,13596,11355,2241
2,11,4,4,19,13872,11264,2608
2,11,5,4,19,13572,10950,2622
2,12,0,4,19,12332,10015,2317
2,12,1,4,19,12608,10052,2556
2,12,2,4,19,12661,10388,2273
2,12,3,4,19,13003,10647,2356
2,12,4,4,19,13296,10329,2967
2,12,5,4,19,13049,10152,2897
2,13,0,4,19,12107,9440,2667
2,13,1,4,19,12421,9255,3166
2,13,2,4,19,12445,9636,2809
2,13,3,4,19,12787,9779,3008
2,13,4,4,19,13005,9288,3717
2,13,5,4,19,12785,9304,3481
2,14,0,4,19,11462,8480,2982
2,14,1,4,19,11761,8124,3637
2,14,2,4,19,11866,8435,3431
2,14,3,4,19,12233,8475,3758
2,14,4,4,19,12324,7898,4426
2,14,5,4,19,12105,8077,4028
2,15,0,4,19,10510,7830,2680
2,15,1,4,19,10751,7432,3319
2,15,2,4,19,10980,7609,3371
2,15,3,4,19,11355,7539,3816
2,15,4,4,19,11264,6999,4265
2,15,5,4,19,10950,7311,3639
2,16,0,4,19,10015,6805,3210
2,16,1,4,19,10052,6493,3559
2,16,2,4,19,10388,6568,3820
2,16,3,4,19,10647,6502,4145
2,16,4,4,19,10329,6127,4202
2,16,5,4,19,10152,6346,3806
2,0,0,5,19,9332,8122,1210
2,0,1,5,19,9345,7937,1408
2,0,2,5,19,9300,7791,1509
2,0,3,5,19,9299,7780,1519
2,0,4,5,19,9330,7940,1390
2,0,5,5,19,9290,8166,1124
2,1,0,5,19,8895,8848,47
2,1,1,5,19,8903,8686,217
2,1,2,5,19,8861,8617,244
2,1,3,5,19,8852,8629,223
2,1,4,5,19,8871,8813,58
2,1,5,5,19,8823,9014,-191
2,2,0,5,19,8370,10873,-2503
2,2,1,5,19,8349,10816,-2467
2,2,2,5,19,8290,10887,-2597
2,2,3,5,19,8275,10980,-2705
2,2,4,5,19,8313,11187,-2874
2,2,5,5,19,8303,11241,-2938
2,3,0,5,19,7989,12324,-4335
2,3,1,5,19,7914,12391,-4477
2,3,2,5,19,7814,12586,-4772
2,3,3,5,19,7795,12778,-4983
2,3,4,5,19,7886,12997,-5111
2,3,5,5,19,7965,12860,-4895
2,4,0,5,19,8628,13021,-4393
2,4,1,5,19,8511,13188,-4677
2,4,2,5,19,8379,13443,-5064
2,4,3,5,19,8373,13706,-5333
2,4,4,5,19,8498,13959,-5461
2,4,5,5,19,8646,13701,-5055
2,5,0,5,19,8122,15076,-6954
2,5,1,5,19,7937,15363,-7426
2,5,2,5,19,7791,15620,-7829
2,5,3,5,19,7780,15972,-8192
2,5,4,5,19,7940,16271,-8331
2,5,5,5,19,8166,15929,-7763
2,6,0,5,19,8848,15857,-7009
2,6,1,5,19,8686,16205,-7519
2,6,2,5,19,8617,16371,-7754
2,6,3,5,19,8629,16792,-8163
2,6,4,5,19,8813,17135,-8322
2,6,5,5,19,9014,16769,-7755
2,7,0,5,19,10873,15275,-4402
2,7,1,5,19,10816,15660,-4844
2,7,2,5,19,10887,15755,-4868
2,7,3,5,19,10980,16190,-5210
2,7,4,5,19,11187,16481,-5294
2,7,5,5,19,11241,16155,-4914
2,8,0,5,19,12324,14529,-2205
2,8,1,5,19,12391,14895,-2504
2,8,2,5,19,12586,15018,-2432
2,8,3,5,19,12778,15463,-2685
2,8,4,5,19,12997,15628,-2631
2,8,5,5,19,12860,15356,-2496
2,9,0,5,19,13021,13559,-538
2,9,1,5,19,13188,13861,-673
2,9,2,5,19,13443,14074,-631
2,9,3,5,19,13706,14529,-823
2,9,4,5,19,13959,14517,-558
2,9,5,5,19,13701,14181,-480
2,10,0,5,19,15076,13063,2013
2,10,1,5,19,15363,13177,2186
2,10,2,5,19,15620,13493,2127
2,10,3,5,19,15972,13843,2129
2,10,4,5,19,16271,13592,2679
2,10,5,5,19,15929,13349,2580
2,11,0,5,19,15857,12383,3474
2,11,1,5,19,16205,12307,3898
2,11,2,5,19,16371,12730,3641
2,11,3,5,19,16792,12966,3826
2,11,4,5,19,17135,12473,4662
2,11,5,5,19,16769,12410,4359
2,12,0,5,19,15275,10902,4373
2,12,1,5,19,15660,10598,5062
2,12,2,5,19,15755,11008,4747
2,12,3,5,19,16190,11151,5039
2,12,4,5,19,16481,10521,5960
2,12,5,5,19,16155,10648,5507
2,13,0,5,19,14529,9927,4602
2,13,1,5,19,14895,9532,5363
2,13,2,5,19,15018,9817,5201
2,13,3,5,19,15463,9835,5628
2,13,4,5,19,15628,9192,6436
2,13,5,5,19,15356,9387,5969
2,14,0,5,19,13559,9358,4201
2,14,1,5,19,13861,8919,4942
2,14,2,5,19,14074,9081,4993
2,14,3,5,19,14529,8990,5539
2,14,4,5,19,14517,8455,6062
2,14,5,5,19,14181,8745,5436
2,0,0,6,19,10873,12373,-1500
2,0,1,6,19,10879,12283,-1404
2,0,2,6,19,10828,12327,-1499
2,0,3,6,19,10826,12418,-1592
2,0,4,6,19,10856,12652,-1796
2,0,5,6,19,10799,12734,-1935
2,1,0,6,19,10395,14041,-3646
2,1,1,6,19,10370,14055,-3685
2,1,2,6,19,10301,14197,-3896
2,1,3,6,19,10290,14383,-4093
2,1,4,6,19,10336,14663,-4327
2,1,5,6,19,10316,14611,-4295
2,2,0,6,19,10087,15391,-5304
2,2,1,6,19,10013,15525,-5512
2,2,2,6,19,9901,15738,-5837
2,2,3,6,19,9880,16008,-6128
2,2,4,6,19,9979,16301,-6322
2,2,5,6,19,10054,16111,-6057
2,3,0,6,19,10359,16070,-5711
2,3,1,6,19,10251,16298,-6047
2,3,2,6,19,10109,16537,-6428
2,3,3,6,19,10097,16880,-6783
2,3,4,6,19,10228,17212,-6984
2,3,5,6,19,10375,16932,-6557
2,4,0,6,19,9622,18124,-8502
2,4,1,6,19,9446,18488,-9042
2,4,2,6,19,9296,18725,-9429
2,4,3,6,19,9281,19168,-9887
2,4,4,6,19,9439,19534,-10095
2,4,5,6,19,9649,19126,-9477
2,5,0,6,19,10389,18800,-8411
2,5,1,6,19,10220,19257,-9037
2,5,2,6,19,10145,19465,-9320
2,5,3,6,19,10156,19979,-9823
2,5,4,6,19,10339,20320,-9981
2,5,5,6,19,10523,19875,-9352
2,6,0,6,19,12373,17697,-5324
2,6,1,6,19,12283,18134,-5851
2,6,2,6,19,12327,18328,-6001
2,6,3,6,19,12418,18866,-6448
2,6,4,6,19,12652,19104,-6452
2,6,5,6,19,12734,18726,-5992
2,7,0,6,19,14041,16626,-2585
2,7,1,6,19,14055,16995,-2940
2,7,2,6,19,14197,17226,-3029
2,7,3,6,19,14383,17759,-3376
2,7,4,6,19,14663,17821,-3158
2,7,5,6,19,14611,17432,-2821
2,8,0,6,19,15391,16112,-721
2,8,1,6,19,15525,16287,-762
2,8,2,6,19,15738,16587,-849
2,8,3,6,19,16008,17017,-1009
2,8,4,6,19,16301,16845,-544
2,8,5,6,19,16111,16580,-469
2,9,0,6,19,16070,15431,639
2,9,1,6,19,16298,15432,866
2,9,2,6,19,16537,15835,702
2,9,3,6,19,16880,16162,718
2,9,4,6,19,17212,15736,1476
2,9,5,6,19,16932,15607,1325
2,10,0,6,19,18124,13845,4279
2,10,1,6,19,18488,13650,4838
2,10,2,6,19,18725,14102,4623
2,10,3,6,19,19168,14338,4830
2,10,4,6,19,19534,13706,5828
2,10,5,6,19,19126,13754,5372
2,11,0,6,19,18800,12349,6451
2,11,1,6,19,19257,12006,7251
2,11,2,6,19,19465,12390,7075
2,11,3,6,19,19979,12511,7468
2,11,4,6,19,20320,11815,8505
2,11,5,6,19,19875,11958,7917
2,12,0,6,19,17697,11455,6242
2,12,1,6,19,18134,11019,7115
2,12,2,6,19,18328,11289,7039
2,12,3,6,19,18866,11286,7580
2,12,4,6,19,19104,10648,8456
2,12,5,6,19,18726,10821,7905
2,0,0,7,19,12373,17108,-4735
2,0,1,7,19,12346,17189,-4843
2,0,2,7,19,12268,17349,-5081
2,0,3,7,19,12264,17613,-5349
2,0,4,7,19,12321,17967,-5646
2,0,5,7,19,12292,17862,-5570
2,1,0,7,19,12112,18440,-6328
2,1,1,7,19,12034,18635,-6601
2,1,2,7,19,11912,18832,-6920
2,1,3,7,19,11895,19182,-7287
2,1,4,7,19,12002,19554,-7552
2,1,5,7,19,12067,19342,-7275
2,2,0,7,19,12457,19118,-6661
2,2,1,7,19,12350,19423,-7073
2,2,2,7,19,12196,19642,-7446
2,2,3,7,19,12182,20076,-7894
2,2,4,7,19,12321,20475,-8154
2,2,5,7,19,12464,20129,-7665
2,3,0,7,19,11353,21067,-9714
2,3,1,7,19,11186,21540,-10354
2,3,2,7,19,11026,21819,-10793
2,3,3,7,19,11005,22355,-11350
2,3,4,7,19,11169,22719,-11550
2,3,5,7,19,11378,22232,-10854
2,4,0,7,19,11889,21222,-9333
2,4,1,7,19,11729,21731,-10002
2,4,2,7,19,11650,22038,-10388
2,4,3,7,19,11657,22655,-10998
2,4,4,7,19,11838,22943,-11105
2,4,5,7,19,12006,22446,-10440
2,5,0,7,19,13914,19794,-5880
2,5,1,7,19,13817,20234,-6417
2,5,2,7,19,13855,20536,-6681
2,5,3,7,19,13945,21162,-7217
2,5,4,7,19,14178,21297,-7119
2,5,5,7,19,14243,20802,-6559
2,6,0,7,19,15541,19179,-3638
2,6,1,7,19,15522,19421,-3899
2,6,2,7,19,15637,19739,-4102
2,6,3,7,19,15821,20247,-4426
2,6,4,7,19,16128,20149,-4021
2,6,5,7,19,16104,19831,-3727
2,7,0,7,19,17108,18480,-1372
2,7,1,7,19,17189,18542,-1353
2,7,2,7,19,17349,18929,-1580
2,7,3,7,19,17613,19336,-1723
2,7,4,7,19,17967,18989,-1022
2,7,5,7,19,17862,18838,-976
2,8,0,7,19,18440,16893,1547
2,8,1,7,19,18635,16775,1860
2,8,2,7,19,18832,17207,1625
2,8,3,7,19,19182,17534,1648
2,8,4,7,19,19554,16969,2585
2,8,5,7,19,19342,16951,2391
2,9,0,7,19,19118,15292,3826
2,9,1,7,19,19423,15058,4365
2,9,2,7,19,19642,15484,4158
2,9,3,7,19,20076,15698,4378
2,9,4,7,19,20475,15000,5475
2,9,5,7,19,20129,15064,5065
2,10,0,7,19,21067,13877,7190
2,10,1,7,19,21540,13493,8047
2,10,2,7,19,21819,13862,7957
2,10,3,7,19,22355,13962,8393
2,10,4,7,19,22719,13271,9448
2,10,5,7,19,22232,13392,8840
2,0,0,8,19,14090,21488,-7398
2,0,1,8,19,14010,21760,-7750
2,0,2,8,19,13879,21937,-8058
2,0,3,8,19,13869,22378,-8509
2,0,4,8,19,13987,22817,-8830
2,0,5,8,19,14043,22539,-8496
2,1,0,8,19,14482,22061,-7579
2,1,1,8,19,14371,22475,-8104
2,1,2,8,19,14207,22736,-8529
2,1,3,8,19,14197,23263,-9066
2,1,4,8,19,14344,23660,-9316
2,1,5,8,19,14477,23235,-8758
2,2,0,8,19,13451,23489,-10038
2,2,1,8,19,13285,24014,-10729
2,2,2,8,19,13113,24392,-11279
2,2,3,8,19,13090,25031,-11941
2,2,4,8,19,13262,25342,-12080
2,2,5,8,19,13467,24803,-11336
2,3,0,8,19,13620,23319,-9699
2,3,1,8,19,13469,23831,-10362
2,3,2,8,19,13380,24246,-10866
2,3,3,8,19,13381,24951,-11570
2,3,4,8,19,13568,25136,-11568
2,3,5,8,19,13735,24522,-10787
2,4,0,8,19,15414,22347,-6933
2,4,1,8,19,15326,22660,-7334
2,4,2,8,19,15360,23049,-7689
2,4,3,8,19,15446,23650,-8204
2,4,4,8,19,15677,23625,-7948
2,4,5,8,19,15726,23201,-7475
2,5,0,8,19,17082,21547,-4465
2,5,1,8,19,17056,21676,-4620
2,5,2,8,19,17165,22081,-4916
2,5,3,8,19,17348,22566,-5218
2,5,4,8,19,17654,22293,-4639
2,5,5,8,19,17613,22089,-4476
2,6,0,8,19,18608,19942,-1334
2,6,1,8,19,18656,19885,-1229
2,6,2,8,19,18789,20301,-1512
2,6,3,8,19,19051,20708,-1657
2,6,4,8,19,19432,20222,-790
2,6,5,8,19,19355,20182,-827
2,7,0,8,19,20157,18340,1817
2,7,1,8,19,20299,18183,2116
2,7,2,8,19,20443,18589,1854
2,7,3,8,19,20787,18894,1893
2,7,4,8,19,21220,18263,2957
2,7,5,8,19,21093,18261,2832
2,8,0,8,19,21488,16820,4668
2,8,1,8,19,21760,16545,5215
2,8,2,8,19,21937,16956,4981
2,8,3,8,19,22378,17149,5229
2,8,4,8,19,22817,16456,6361
2,8,5,8,19,22539,16498,6041
2,0,0,9,19,16460,24483,-8023
2,0,1,9,19,16347,24949,-8602
2,0,2,9,19,16174,25309,-9135
2,0,3,9,19,16171,25939,-9768
2,0,4,9,19,16329,26283,-9954
2,0,5,9,19,16453,25806,-9353
2,1,0,9,19,15476,25586,-10110
2,1,1,9,19,15306,26114,-10808
2,1,2,9,19,15124,26600,-11476
2,1,3,9,19,15105,27327,-12222
2,1,4,9,19,15285,27535,-12250
2,1,5,9,19,15480,26879,-11399
2,2,0,9,19,15718,25872,-10154
2,2,1,9,19,15568,26257,-10689
2,2,2,9,19,15467,26759,-11292
2,2,3,9,19,15466,27439,-11973
2,2,4,9,19,15661,27464,-11803
2,2,5,9,19,15824,26921,-11097
2,3,0,9,19,17145,24715,-7570
2,3,1,9,19,17066,24915,-7849
2,3,2,9,19,17090,25391,-8301
2,3,3,9,19,17170,25969,-8799
2,3,4,9,19,17407,25769,-8362
2,3,5,9,19,17455,25459,-8004
2,4,0,9,19,18582,23009,-4427
2,4,1,9,19,18565,23019,-4454
2,4,2,9,19,18670,23453,-4783
2,4,3,9,19,18849,23938,-5089
2,4,4,9,19,19153,23526,-4373
2,4,5,9,19,19096,23433,-4337
2,5,0,9,19,20149,21389,-1240
2,5,1,9,19,20190,21293,-1103
2,5,2,9,19,20317,21683,-1366
2,5,3,9,19,20578,22068,-1490
2,5,4,9,19,20958,21516,-558
2,5,5,9,19,20864,21492,-628
2,6,0,9,19,21657,19868,1789
2,6,1,9,19,21766,19670,2096
2,6,2,9,19,21883,20061,1822
2,6,3,9,19,22225,20345,1880
2,6,4,9,19,22685,19719,2966
2,6,5,9,19,22586,19695,2891
2,0,0,10,19,17454,28139,-10685
2,0,1,10,19,17282,28540,-11258
2,0,2,10,19,17091,29113,-12022
2,0,3,10,19,17079,29815,-12736
2,0,4,10,19,17270,29863,-12593
2,0,5,10,19,17456,29278,-11822
2,1,0,10,19,17743,28240,-10497
2,1,1,10,19,17589,28512,-10923
2,1,2,10,19,17478,29101,-11623
2,1,3,10,19,17481,29758,-12277
2,1,4,10,19,17684,29608,-11924
2,1,5,10,19,17837,29179,-11342
2,2,0,10,19,19243,26177,-6934
2,2,1,10,19,19165,26258,-7093
2,2,2,10,19,19177,26763,-7586
2,2,3,10,19,19255,27341,-8086
2,2,4,10,19,19500,27002,-7502
2,2,5,10,19,19544,26803,-7259
2,3,0,10,19,20313,24456,-4143
2,3,1,10,19,20305,24427,-4122
2,3,2,10,19,20400,24835,-4435
2,3,3,10,19,20573,25298,-4725
2,3,4,10,19,20883,24820,-3937
2,3,5,10,19,20825,24743,-3918
2,4,0,10,19,21649,22917,-1268
2,4,1,10,19,21699,22780,-1081
2,4,2,10,19,21822,23155,-1333
2,4,3,10,19,22079,23519,-1440
2,4,4,10,19,22457,22972,-515
2,4,5,10,19,22347,22926,-579
2,0,0,11,19,19721,29702,-9981
2,0,1,11,19,19565,29855,-10290
2,0,2,11,19,19445,30473,-11028
2,0,3,11,19,19455,31130,-11675
2,0,4,11,19,19669,30841,-11172
2,0,5,11,19,19813,30523,-10710
2,1,0,11,19,21268,27624,-6356
2,1,1,11,19,21186,27666,-6480
2,1,2,11,19,21188,28145,-6957
2,1,3,11,19,21270,28701,-7431
2,1,4,11,19,21523,28296,-6773
2,1,5,11,19,21557,28113,-6556
2,2,0,11,19,22411,25984,-3573
2,2,1,11,19,22404,25914,-3510
2,2,2,11,19,22487,26307,-3820
2,2,3,11,19,22658,26749,-4091
2,2,4,11,19,22976,26276,-3300
2,2,5,11,19,22914,26177,-3263
2,0,0,12,19,23246,29152,-5906
2,0,1,12,19,23162,29153,-5991
2,0,2,12,19,23155,29617,-6462
2,0,3,12,19,23244,30152,-6908
2,0,4,12,19,23508,29752,-6244
2,0,5,12,19,23533,29547,-6014
2,0,0,1,20,2086,2127,-41
2,0,1,1,20,2074,2122,-48
2,0,2,1,20,2070,2122,-52
2,0,3,1,20,2083,2129,-46
2,0,4,1,20,2087,2125,-38
2,1,0,1,20,2127,2205,-78
2,1,1,1,20,2122,2202,-80
2,1,2,1,20,2122,2197,-75
2,1,3,1,20,2129,2200,-71
2,1,4,1,20,2125,2199,-74
2,2,0,1,20,2205,1852,353
2,2,1,1,20,2202,1847,355
2,2,2,1,20,2197,1834,363
2,2,3,1,20,2200,1835,365
2,2,4,1,20,2199,1841,358
2,3,0,1,20,1852,1623,229
2,3,1,1,20,1847,1624,223
2,3,2,1,20,1834,1615,219
2,3,3,1,20,1835,1614,221
2,3,4,1,20,1841,1609,232
2,4,0,1,20,1623,1648,-25
2,4,1,1,20,1624,1650,-26
2,4,2,1,20,1615,1647,-32
2,4,3,1,20,1614,1645,-31
2,4,4,1,20,1609,1634,-25
2,5,0,1,20,1648,1587,61
2,5,1,1,20,1650,1564,86
2,5,2,1,20,1647,1547,100
2,5,3,1,20,1645,1554,91
2,5,4,1,20,1634,1580,54
2,6,0,1,20,1587,1794,-207
2,6,1,1,20,1564,1736,-172
2,6,2,1,20,1547,1695,-148
2,6,3,1,20,1554,1715,-161
2,6,4,1,20,1580,1791,-211
2,7,0,1,20,1794,2463,-669
2,7,1,1,20,1736,2436,-700
2,7,2,1,20,1695,2423,-728
2,7,3,1,20,1715,2420,-705
2,7,4,1,20,1791,2473,-682
2,8,0,1,20,2463,1041,1422
2,8,1,1,20,2436,986,1450
2,8,2,1,20,2423,977,1446
2,8,3,1,20,2420,984,1436
2,8,4,1,20,2473,1044,1429
2,9,0,1,20,1041,2387,-1346
2,9,1,1,20,986,2398,-1412
2,9,2,1,20,977,2436,-1459
2,9,3,1,20,984,2475,-1491
2,9,4,1,20,1044,2505,-1461
2,10,0,1,20,2387,3736,-1349
2,10,1,1,20,2398,3810,-1412
2,10,2,1,20,2436,3879,-1443
2,10,3,1,20,2475,3962,-1487
2,10,4,1,20,2505,3973,-1468
2,11,0,1,20,3736,3390,346
2,11,1,1,20,3810,3457,353
2,11,2,1,20,3879,3507,372
2,11,3,1,20,3962,3602,360
2,11,4,1,20,3973,3607,366
2,12,0,1,20,3390,3280,110
2,12,1,1,20,3457,3311,146
2,12,2,1,20,3507,3340,167
2,12,3,1,20,3602,3427,175
2,12,4,1,20,3607,3438,169
2,13,0,1,20,3280,3262,18
2,13,1,1,20,3311,3263,48
2,13,2,1,20,3340,3289,51
2,13,3,1,20,3427,3375,52
2,13,4,1,20,3438,3407,31
2,14,0,1,20,3262,3271,-9
2,14,1,1,20,3263,3274,-11
2,14,2,1,20,3289,3303,-14
2,14,3,1,20,3375,3382,-7
2,14,4,1,20,3407,3404,3
2,15,0,1,20,3271,3160,111
2,15,1,1,20,3274,3208,66
2,15,2,1,20,3303,3262,41
2,15,3,1,20,3382,3304,78
2,15,4,1,20,3404,3325,79
2,16,0,1,20,3160,2582,578
2,16,1,1,20,3208,2648,560
2,16,2,1,20,3262,2739,523
2,16,3,1,20,3304,2769,535
2,16,4,1,20,3325,2778,547
2,17,0,1,20,2582,2222,360
2,17,1,1,20,2648,2300,348
2,17,2,1,20,2739,2372,367
2,17,3,1,20,2769,2377,392
2,17,4,1,20,2778,2314,464
2,18,0,1,20,2222,2616,-394
2,18,1,1,20,2300,2603,-303
2,18,2,1,20,2372,2592,-220
2,18,3,1,20,2377,2562,-185
2,18,4,1,20,2314,2529,-215
2,19,0,1,20,2616,2445,171
2,19,1,1,20,2603,2418,185
2,19,2,1,20,2592,2387,205
2,19,3,1,20,2562,2374,188
2,19,4,1,20,2529,2355,174
2,20,0,1,20,2445,1546,899
2,20,1,1,20,2418,1444,974
2,20,2,1,20,2387,1461,926
2,20,3,1,20,2374,1468,906
2,20,4,1,20,2355,1406,949
2,21,0,1,20,1546,1505,41
2,21,1,1,20,1444,1456,-12
2,21,2,1,20,1461,1436,25
2,21,3,1,20,1468,1414,54
2,21,4,1,20,1406,1350,56
2,22,0,1,20,1505,1598,-93
2,22,1,1,20,1456,1541,-85
2,22,2,1,20,1436,1505,-69
2,22,3,1,20,1414,1525,-111
2,22,4,1,20,1350,1503,-153
2,0,0,2,20,4213,4057,156
2,0,1,2,20,4196,4049,147
2,0,2,2,20,4192,4031,161
2,0,3,2,20,4212,4035,177
2,0,4,2,20,4212,4040,172
2,1,0,2,20,4332,3475,857
2,1,1,2,20,4324,3471,853
2,1,2,2,20,4319,3449,870
2,1,3,2,20,4329,3449,880
2,1,4,2,20,4324,3450,874
2,2,0,2,20,4057,3271,786
2,2,1,2,20,4049,3274,775
2,2,2,2,20,4031,3262,769
2,2,3,2,20,4035,3259,776
2,2,4,2,20,4040,3243,797
2,3,0,2,20,3475,3235,240
2,3,1,2,20,3471,3214,257
2,3,2,2,20,3449,3194,255
2,3,3,2,20,3449,3199,250
2,3,4,2,20,3450,3214,236
2,4,0,2,20,3271,3381,-110
2,4,1,2,20,3274,3300,-26
2,4,2,2,20,3262,3242,20
2,4,3,2,20,3259,3269,-10
2,4,4,2,20,3243,3371,-128
2,5,0,2,20,3235,4257,-1022
2,5,1,2,20,3214,4172,-958
2,5,2,2,20,3194,4118,-924
2,5,3,2,20,3199,4135,-936
2,5,4,2,20,3214,4264,-1050
2,6,0,2,20,3381,3504,-123
2,6,1,2,20,3300,3422,-122
2,6,2,2,20,3242,3400,-158
2,6,3,2,20,3269,3404,-135
2,6,4,2,20,3371,3517,-146
2,7,0,2,20,4257,3428,829
2,7,1,2,20,4172,3384,788
2,7,2,2,20,4118,3413,705
2,7,3,2,20,4135,3459,676
2,7,4,2,20,4264,3549,715
2,8,0,2,20,3504,6123,-2619
2,8,1,2,20,3422,6208,-2786
2,8,2,2,20,3400,6315,-2915
2,8,3,2,20,3404,6437,-3033
2,8,4,2,20,3517,6478,-2961
2,9,0,2,20,3428,7126,-3698
2,9,1,2,20,3384,7267,-3883
2,9,2,2,20,3413,7386,-3973
2,9,3,2,20,3459,7564,-4105
2,9,4,2,20,3549,7580,-4031
2,10,0,2,20,6123,6670,-547
2,10,1,2,20,6208,6768,-560
2,10,2,2,20,6315,6847,-532
2,10,3,2,20,6437,7029,-592
2,10,4,2,20,6478,7045,-567
2,11,0,2,20,7126,6542,584
2,11,1,2,20,7267,6574,693
2,11,2,2,20,7386,6629,757
2,11,3,2,20,7564,6802,762
2,11,4,2,20,7580,6845,735
2,12,0,2,20,6670,6533,137
2,12,1,2,20,6768,6537,231
2,12,2,2,20,6847,6592,255
2,12,3,2,20,7029,6757,272
2,12,4,2,20,7045,6811,234
2,13,0,2,20,6542,6431,111
2,13,1,2,20,6574,6482,92
2,13,2,2,20,6629,6565,64
2,13,3,2,20,6802,6686,116
2,13,4,2,20,6845,6729,116
2,14,0,2,20,6533,5742,791
2,14,1,2,20,6537,5856,681
2,14,2,2,20,6592,6001,591
2,14,3,2,20,6757,6073,684
2,14,4,2,20,6811,6103,708
2,15,0,2,20,6431,4804,1627
2,15,1,2,20,6482,4948,1534
2,15,2,2,20,6565,5111,1454
2,15,3,2,20,6686,5146,1540
2,15,4,2,20,6729,5092,1637
2,16,0,2,20,5742,4838,904
2,16,1,2,20,5856,4903,953
2,16,2,2,20,6001,4964,1037
2,16,3,2,20,6073,4939,1134
2,16,4,2,20,6103,4843,1260
2,17,0,2,20,4804,5061,-257
2,17,1,2,20,4948,5021,-73
2,17,2,2,20,5111,4979,132
2,17,3,2,20,5146,4936,210
2,17,4,2,20,5092,4884,208
2,18,0,2,20,4838,3991,847
2,18,1,2,20,4903,3862,1041
2,18,2,2,20,4964,3848,1116
2,18,3,2,20,4939,3842,1097
2,18,4,2,20,4843,3761,1082
2,19,0,2,20,5061,3051,2010
2,19,1,2,20,5021,2900,2121
2,19,2,2,20,4979,2897,2082
2,19,3,2,20,4936,2882,2054
2,19,4,2,20,4884,2756,2128
2,20,0,2,20,3991,3103,888
2,20,1,2,20,3862,2997,865
2,20,2,2,20,3848,2941,907
2,20,3,2,20,3842,2939,903
2,20,4,2,20,3761,2853,908
2,0,0,3,20,6418,5123,1295
2,0,1,3,20,6398,5121,1277
2,0,2,3,20,6389,5096,1293
2,0,3,3,20,6412,5094,1318
2,0,4,3,20,6411,5084,1327
2,1,0,3,20,6184,4858,1326
2,1,1,3,20,6171,4838,1333
2,1,2,3,20,6153,4809,1344
2,1,3,3,20,6164,4813,1351
2,1,4,3,20,6165,4823,1342
2,2,0,3,20,5680,5029,651
2,2,1,3,20,5673,4950,723
2,2,2,3,20,5646,4889,757
2,2,3,3,20,5649,4914,735
2,2,4,3,20,5649,5005,644
2,3,0,3,20,5123,5844,-721
2,3,1,3,20,5121,5736,-615
2,3,2,3,20,5096,5665,-569
2,3,3,3,20,5094,5689,-595
2,3,4,3,20,5084,5844,-760
2,4,0,3,20,4858,5298,-440
2,4,1,3,20,4838,5158,-320
2,4,2,3,20,4809,5095,-286
2,4,3,3,20,4813,5119,-306
2,4,4,3,20,4823,5308,-485
2,5,0,3,20,5029,5891,-862
2,5,1,3,20,4950,5820,-870
2,5,2,3,20,4889,5836,-947
2,5,3,3,20,4914,5879,-965
2,5,4,3,20,5005,6022,-1017
2,6,0,3,20,5844,7164,-1320
2,6,1,3,20,5736,7194,-1458
2,6,2,3,20,5665,7292,-1627
2,6,3,3,20,5689,7421,-1732
2,6,4,3,20,5844,7522,-1678
2,7,0,3,20,5298,9513,-4215
2,7,1,3,20,5158,9665,-4507
2,7,2,3,20,5095,9822,-4727
2,7,3,3,20,5119,10039,-4920
2,7,4,3,20,5308,10085,-4777
2,8,0,3,20,5891,10406,-4515
2,8,1,3,20,5820,10578,-4758
2,8,2,3,20,5836,10726,-4890
2,8,3,3,20,5879,10991,-5112
2,8,4,3,20,6022,11018,-4996
2,9,0,3,20,7164,9932,-2768
2,9,1,3,20,7194,10031,-2837
2,9,2,3,20,7292,10136,-2844
2,9,3,3,20,7421,10404,-2983
2,9,4,3,20,7522,10452,-2930
2,10,0,3,20,9513,9813,-300
2,10,1,3,20,9665,9848,-183
2,10,2,3,20,9822,9932,-110
2,10,3,3,20,10039,10184,-145
2,10,4,3,20,10085,10249,-164
2,11,0,3,20,10406,9693,713
2,11,1,3,20,10578,9745,833
2,11,2,3,20,10726,9854,872
2,11,3,3,20,10991,10061,930
2,11,4,3,20,11018,10136,882
2,12,0,3,20,9932,9013,919
2,12,1,3,20,10031,9130,901
2,12,2,3,20,10136,9304,832
2,12,3,3,20,10404,9455,949
2,12,4,3,20,10452,9507,945
2,13,0,3,20,9813,7964,1849
2,13,1,3,20,9848,8156,1692
2,13,2,3,20,9932,8373,1559
2,13,3,3,20,10184,8450,1734
2,13,4,3,20,10249,8417,1832
2,14,0,3,20,9693,7420,2273
2,14,1,3,20,9745,7551,2194
2,14,2,3,20,9854,7703,2151
2,14,3,3,20,10061,7708,2353
2,14,4,3,20,10136,7621,2515
2,15,0,3,20,9013,7283,1730
2,15,1,3,20,9130,7321,1809
2,15,2,3,20,9304,7351,1953
2,15,3,3,20,9455,7313,2142
2,15,4,3,20,9507,7198,2309
2,16,0,3,20,7964,6607,1357
2,16,1,3,20,8156,6465,1691
2,16,2,3,20,8373,6440,1933
2,16,3,3,20,8450,6404,2046
2,16,4,3,20,8417,6290,2127
2,17,0,3,20,7420,5496,1924
2,17,1,3,20,7551,5318,2233
2,17,2,3,20,7703,5284,2419
2,17,3,3,20,7708,5256,2452
2,17,4,3,20,7621,5111,2510
2,18,0,3,20,7283,4649,2634
2,18,1,3,20,7321,4441,2880
2,18,2,3,20,7351,4402,2949
2,18,3,3,20,7313,4407,2906
2,18,4,3,20,7198,4259,2939
2,0,0,4,20,8270,6652,1618
2,0,1,4,20,8245,6574,1671
2,0,2,4,20,8223,6504,1719
2,0,3,4,20,8247,6528,1719
2,0,4,4,20,8252,6614,1638
2,1,0,4,20,7807,7492,315
2,1,1,4,20,7795,7386,409
2,1,2,4,20,7768,7312,456
2,1,3,4,20,7778,7334,444
2,1,4,4,20,7774,7478,296
2,2,0,4,20,7328,6885,443
2,2,1,4,20,7323,6722,601
2,2,2,4,20,7293,6642,651
2,2,3,4,20,7294,6673,621
2,2,4,4,20,7283,6888,395
2,3,0,4,20,6710,7685,-975
2,3,1,4,20,6685,7556,-871
2,3,2,4,20,6643,7531,-888
2,3,3,4,20,6648,7594,-946
2,3,4,4,20,6664,7813,-1149
2,4,0,4,20,6652,9627,-2975
2,4,1,4,20,6574,9630,-3056
2,4,2,4,20,6504,9715,-3211
2,4,3,4,20,6528,9841,-3313
2,4,4,4,20,6614,9995,-3381
2,5,0,4,20,7492,10554,-3062
2,5,1,4,20,7386,10651,-3265
2,5,2,4,20,7312,10799,-3487
2,5,3,4,20,7334,11023,-3689
2,5,4,4,20,7478,11129,-3651
2,6,0,4,20,6885,12793,-5908
2,6,1,4,20,6722,12976,-6254
2,6,2,4,20,6642,13162,-6520
2,6,3,4,20,6673,13466,-6793
2,6,4,4,20,6888,13523,-6635
2,7,0,4,20,7685,13668,-5983
2,7,1,4,20,7556,13841,-6285
2,7,2,4,20,7531,14015,-6484
2,7,3,4,20,7594,14366,-6772
2,7,4,4,20,7813,14425,-6612
2,8,0,4,20,9627,13203,-3576
2,8,1,4,20,9630,13305,-3675
2,8,2,4,20,9715,13439,-3724
2,8,3,4,20,9841,13786,-3945
2,8,4,4,20,9995,13856,-3861
2,9,0,4,20,10554,12973,-2419
2,9,1,4,20,10651,13056,-2405
2,9,2,4,20,10799,13194,-2395
2,9,3,4,20,11023,13488,-2465
2,9,4,4,20,11129,13574,-2445
2,10,0,4,20,12793,12275,518
2,10,1,4,20,12976,12393,583
2,10,2,4,20,13162,12593,569
2,10,3,4,20,13466,12830,636
2,10,4,4,20,13523,12914,609
2,11,0,4,20,13668,11235,2433
2,11,1,4,20,13841,11430,2411
2,11,2,4,20,14015,11676,2339
2,11,3,4,20,14366,11832,2534
2,11,4,4,20,14425,11821,2604
2,12,0,4,20,13203,10580,2623
2,12,1,4,20,13305,10759,2546
2,12,2,4,20,13439,10965,2474
2,12,3,4,20,13786,11012,2774
2,12,4,4,20,13856,10946,2910
2,13,0,4,20,12973,9865,3108
2,13,1,4,20,13056,9969,3087
2,13,2,4,20,13194,10090,3104
2,13,3,4,20,13488,10082,3406
2,13,4,4,20,13574,9976,3598
2,14,0,4,20,12275,8829,3446
2,14,1,4,20,12393,8765,3628
2,14,2,4,20,12593,8812,3781
2,14,3,4,20,12830,8781,4049
2,14,4,4,20,12914,8604,4310
2,15,0,4,20,11235,8112,3123
2,15,1,4,20,11430,7921,3509
2,15,2,4,20,11676,7876,3800
2,15,3,4,20,11832,7818,4014
2,15,4,4,20,11821,7640,4181
2,16,0,4,20,10580,7094,3486
2,16,1,4,20,10759,6859,3900
2,16,2,4,20,10965,6789,4176
2,16,3,4,20,11012,6781,4231
2,16,4,4,20,10946,6614,4332
2,0,0,5,20,9893,8533,1360
2,0,1,5,20,9869,8372,1497
2,0,2,5,20,9838,8289,1549
2,0,3,5,20,9861,8318,1543
2,0,4,5,20,9861,8522,1339
2,1,0,5,20,9455,9272,183
2,1,1,5,20,9445,9120,325
2,1,2,5,20,9415,9078,337
2,1,3,5,20,9423,9148,275
2,1,4,5,20,9408,9393,15
2,2,0,5,20,8915,11421,-2506
2,2,1,5,20,8887,11366,-2479
2,2,2,5,20,8840,11410,-2570
2,2,3,5,20,8848,11556,-2708
2,2,4,5,20,8863,11786,-2923
2,3,0,5,20,8504,13017,-4513
2,3,1,5,20,8421,13087,-4666
2,3,2,5,20,8338,13222,-4884
2,3,3,5,20,8363,13443,-5080
2,3,4,5,20,8455,13602,-5147
2,4,0,5,20,9115,13834,-4719
2,4,1,5,20,9010,13962,-4952
2,4,2,5,20,8927,14139,-5212
2,4,3,5,20,8948,14450,-5502
2,4,4,5,20,9087,14567,-5480
2,5,0,5,20,8533,16055,-7522
2,5,1,5,20,8372,16239,-7867
2,5,2,5,20,8289,16451,-8162
2,5,3,5,20,8318,16841,-8523
2,5,4,5,20,8522,16930,-8408
2,6,0,5,20,9272,16939,-7667
2,6,1,5,20,9120,17115,-7995
2,6,2,5,20,9078,17318,-8240
2,6,3,5,20,9148,17748,-8600
2,6,4,5,20,9393,17829,-8436
2,7,0,5,20,11421,16363,-4942
2,7,1,5,20,11366,16513,-5147
2,7,2,5,20,11410,16701,-5291
2,7,3,5,20,11556,17090,-5534
2,7,4,5,20,11786,17181,-5395
2,8,0,5,20,13017,15555,-2538
2,8,1,5,20,13087,15704,-2617
2,8,2,5,20,13222,15933,-2711
2,8,3,5,20,13443,16257,-2814
2,8,4,5,20,13602,16352,-2750
2,9,0,5,20,13834,14497,-663
2,9,1,5,20,13962,14693,-731
2,9,2,5,20,14139,14965,-826
2,9,3,5,20,14450,15207,-757
2,9,4,5,20,14567,15228,-661
2,10,0,5,20,16055,13851,2204
2,10,1,5,20,16239,14033,2206
2,10,2,5,20,16451,14268,2183
2,10,3,5,20,16841,14394,2447
2,10,4,5,20,16930,14350,2580
2,11,0,5,20,16939,13025,3914
2,11,1,5,20,17115,13177,3938
2,11,2,5,20,17318,13352,3966
2,11,3,5,20,17748,13386,4362
2,11,4,5,20,17829,13301,4528
2,12,0,5,20,16363,11411,4952
2,12,1,5,20,16513,11413,5100
2,12,2,5,20,16701,11551,5150
2,12,3,5,20,17090,11550,5540
2,12,4,5,20,17181,11382,5799
2,13,0,5,20,15555,10334,5221
2,13,1,5,20,15704,10221,5483
2,13,2,5,20,15933,10248,5685
2,13,3,5,20,16257,10195,6062
2,13,4,5,20,16352,9954,6398
2,14,0,5,20,14497,9710,4787
2,14,1,5,20,14693,9462,5231
2,14,2,5,20,14965,9381,5584
2,14,3,5,20,15207,9343,5864
2,14,4,5,20,15228,9143,6085
2,0,0,6,20,11541,13008,-1467
2,0,1,6,20,11519,12930,-1411
2,0,2,6,20,11485,12957,-1472
2,0,3,6,20,11506,13110,-1604
2,0,4,6,20,11495,13366,-1871
2,1,0,6,20,11042,14811,-3769
2,1,1,6,20,11009,14823,-3814
2,1,2,6,20,10962,14917,-3955
2,1,3,6,20,10977,15158,-4181
2,1,4,6,20,10988,15393,-4405
2,2,0,6,20,10709,16297,-5588
2,2,1,6,20,10623,16398,-5775
2,2,2,6,20,10535,16562,-6027
2,2,3,6,20,10563,16870,-6307
2,2,4,6,20,10654,17040,-6386
2,3,0,6,20,10967,17096,-6129
2,3,1,6,20,10857,17225,-6368
2,3,2,6,20,10761,17428,-6667
2,3,3,6,20,10783,17825,-7042
2,3,4,6,20,10928,17974,-7046
2,4,0,6,20,10156,19326,-9170
2,4,1,6,20,9996,19513,-9517
2,4,2,6,20,9904,19754,-9850
2,4,3,6,20,9932,20223,-10291
2,4,4,6,20,10131,20334,-10203
2,5,0,6,20,10920,20099,-9179
2,5,1,6,20,10770,20323,-9553
2,5,2,6,20,10725,20580,-9855
2,5,3,6,20,10793,21052,-10259
2,5,4,6,20,11027,21154,-10127
2,6,0,6,20,13008,18945,-5937
2,6,1,6,20,12930,19161,-6231
2,6,2,6,20,12957,19440,-6483
2,6,3,6,20,13110,19859,-6749
2,6,4,6,20,13366,19959,-6593
2,7,0,6,20,14811,17777,-2966
2,7,1,6,20,14823,18004,-3181
2,7,2,6,20,14917,18305,-3388
2,7,3,6,20,15158,18634,-3476
2,7,4,6,20,15393,18666,-3273
2,8,0,6,20,16297,17113,-816
2,8,1,6,20,16398,17296,-898
2,8,2,6,20,16562,17557,-995
2,8,3,6,20,16870,17769,-899
2,8,4,6,20,17040,17757,-717
2,9,0,6,20,17096,16296,800
2,9,1,6,20,17225,16451,774
2,9,2,6,20,17428,16655,773
2,9,3,6,20,17825,16768,1057
2,9,4,6,20,17974,16705,1269
2,10,0,6,20,19326,14571,4755
2,10,1,6,20,19513,14621,4892
2,10,2,6,20,19754,14813,4941
2,10,3,6,20,20223,14854,5369
2,10,4,6,20,20334,14707,5627
2,11,0,6,20,20099,12916,7183
2,11,1,6,20,20323,12869,7454
2,11,2,6,20,20580,12987,7593
2,11,3,6,20,21052,12964,8088
2,11,4,6,20,21154,12732,8422
2,12,0,6,20,18945,11932,7013
2,12,1,6,20,19161,11762,7399
2,12,2,6,20,19440,11753,7687
2,12,3,6,20,19859,11720,8139
2,12,4,6,20,19959,11457,8502
2,0,0,7,20,13128,18091,-4963
2,0,1,7,20,13083,18134,-5051
2,0,2,7,20,13032,18257,-5225
2,0,3,7,20,13060,18585,-5525
2,0,4,7,20,13075,18831,-5756
2,1,0,7,20,12836,19559,-6723
2,1,1,7,20,12745,19661,-6916
2,1,2,7,20,12657,19851,-7194
2,1,3,7,20,12692,20245,-7553
2,1,4,7,20,12779,20447,-7668
2,2,0,7,20,13172,20367,-7195
2,2,1,7,20,13059,20499,-7440
2,2,2,7,20,12958,20731,-7773
2,2,3,7,20,12983,21207,-8224
2,2,4,7,20,13127,21378,-8251
2,3,0,7,20,12008,22486,-10478
2,3,1,7,20,11843,22721,-10878
2,3,2,7,20,11738,23016,-11278
2,3,3,7,20,11767,23527,-11760
2,3,4,7,20,11972,23659,-11687
2,4,0,7,20,12543,22681,-10138
2,4,1,7,20,12394,22971,-10577
2,4,2,7,20,12340,23319,-10979
2,4,3,7,20,12407,23821,-11414
2,4,4,7,20,12636,23932,-11296
2,5,0,7,20,14656,21167,-6511
2,5,1,7,20,14580,21461,-6881
2,5,2,7,20,14604,21812,-7208
2,5,3,7,20,14755,22236,-7481
2,5,4,7,20,15000,22273,-7273
2,6,0,7,20,16398,20393,-3995
2,6,1,7,20,16387,20607,-4220
2,6,2,7,20,16464,20897,-4433
2,6,3,7,20,16712,21196,-4484
2,6,4,7,20,16973,21195,-4222
2,7,0,7,20,18091,19558,-1467
2,7,1,7,20,18134,19714,-1580
2,7,2,7,20,18257,19944,-1687
2,7,3,7,20,18585,20143,-1558
2,7,4,7,20,18831,20112,-1281
2,8,0,7,20,19559,17842,1717
2,8,1,7,20,19661,17895,1766
2,8,2,7,20,19851,18116,1735
2,8,3,7,20,20245,18236,2009
2,8,4,7,20,20447,18111,2336
2,9,0,7,20,20367,16076,4291
2,9,1,7,20,20499,16077,4422
2,9,2,7,20,20731,16249,4482
2,9,3,7,20,21207,16268,4939
2,9,4,7,20,21378,16057,5321
2,10,0,7,20,22486,14514,7972
2,10,1,7,20,22721,14410,8311
2,10,2,7,20,23016,14492,8524
2,10,3,7,20,23527,14489,9038
2,10,4,7,20,23659,14235,9424
2,0,0,8,20,14922,22830,-7908
2,0,1,8,20,14819,22935,-8116
2,0,2,8,20,14727,23154,-8427
2,0,3,8,20,14775,23627,-8852
2,0,4,8,20,14866,23851,-8985
2,1,0,8,20,15299,23527,-8228
2,1,1,8,20,15181,23707,-8526
2,1,2,8,20,15080,23993,-8913
2,1,3,8,20,15112,24511,-9399
2,1,4,8,20,15252,24703,-9451
2,2,0,8,20,14213,25068,-10855
2,2,1,8,20,14045,25369,-11324
2,2,2,8,20,13935,25755,-11820
2,2,3,8,20,13967,26296,-12329
2,2,4,8,20,14171,26437,-12266
2,3,0,8,20,14395,24903,-10508
2,3,1,8,20,14241,25271,-11030
2,3,2,8,20,14174,25691,-11517
2,3,3,8,20,14242,26198,-11956
2,3,4,8,20,14477,26246,-11769
2,4,0,8,20,16279,23783,-7504
2,4,1,8,20,16204,24064,-7860
2,4,2,8,20,16219,24404,-8185
2,4,3,8,20,16369,24798,-8429
2,4,4,8,20,16609,24802,-8193
2,5,0,8,20,18046,22838,-4792
2,5,1,8,20,18037,23025,-4988
2,5,2,8,20,18111,23284,-5173
2,5,3,8,20,18357,23570,-5213
2,5,4,8,20,18607,23550,-4943
2,6,0,8,20,19678,21104,-1426
2,6,1,8,20,19698,21158,-1460
2,6,2,8,20,19804,21405,-1601
2,6,3,8,20,20139,21611,-1472
2,6,4,8,20,20411,21518,-1107
2,7,0,8,20,21353,19347,2006
2,7,1,8,20,21397,19351,2046
2,7,2,8,20,21546,19552,1994
2,7,3,8,20,21960,19650,2310
2,7,4,8,20,22238,19461,2777
2,8,0,8,20,22830,17674,5156
2,8,1,8,20,22935,17618,5317
2,8,2,8,20,23154,17754,5400
2,8,3,8,20,23627,17793,5834
2,8,4,8,20,23851,17560,6291
2,0,0,9,20,17385,26109,-8724
2,0,1,9,20,17255,26355,-9100
2,0,2,9,20,17150,26732,-9582
2,0,3,9,20,17195,27280,-10085
2,0,4,9,20,17339,27481,-10142
2,1,0,9,20,16340,27290,-10950
2,1,1,9,20,16167,27669,-11502
2,1,2,9,20,16057,28127,-12070
2,1,3,9,20,16096,28673,-12577
2,1,4,9,20,16296,28751,-12455
2,2,0,9,20,16600,27519,-10919
2,2,1,9,20,16443,27874,-11431
2,2,2,9,20,16371,28283,-11912
2,2,3,9,20,16442,28760,-12318
2,2,4,9,20,16676,28775,-12099
2,3,0,9,20,18131,26228,-8097
2,3,1,9,20,18051,26482,-8431
2,3,2,9,20,18053,26791,-8738
2,3,3,9,20,18204,27172,-8968
2,3,4,9,20,18450,27157,-8707
2,4,0,9,20,19669,24384,-4715
2,4,1,9,20,19661,24469,-4808
2,4,2,9,20,19726,24745,-5019
2,4,3,9,20,19971,25038,-5067
2,4,4,9,20,20216,24956,-4740
2,5,0,9,20,21326,22609,-1283
2,5,1,9,20,21348,22614,-1266
2,5,2,9,20,21451,22841,-1390
2,5,3,9,20,21784,23025,-1241
2,5,4,9,20,22045,22868,-823
2,6,0,9,20,22940,20945,1995
2,6,1,9,20,22961,20892,2069
2,6,2,9,20,23093,21057,2036
2,6,3,9,20,23514,21175,2339
2,6,4,9,20,23818,20964,2854
2,0,0,10,20,18426,29906,-11480
2,0,1,10,20,18241,30272,-12031
2,0,2,10,20,18127,30719,-12592
2,0,3,10,20,18179,31235,-13056
2,0,4,10,20,18383,31280,-12897
2,1,0,10,20,18727,29964,-11237
2,1,1,10,20,18565,30292,-11727
2,1,2,10,20,18493,30670,-12177
2,1,3,10,20,18571,31134,-12563
2,1,4,10,20,18801,31130,-12329
2,2,0,10,20,20336,27774,-7438
2,2,1,10,20,20253,27926,-7673
2,2,2,10,20,20250,28252,-8002
2,2,3,10,20,20404,28640,-8236
2,2,4,10,20,20649,28563,-7914
2,3,0,10,20,21521,25889,-4368
2,3,1,10,20,21508,25925,-4417
2,3,2,10,20,21560,26181,-4621
2,3,3,10,20,21806,26452,-4646
2,3,4,10,20,22057,26306,-4249
2,4,0,10,20,22949,24207,-1258
2,4,1,10,20,22972,24155,-1183
2,4,2,10,20,23066,24346,-1280
2,4,3,10,20,23398,24550,-1152
2,4,4,10,20,23654,24371,-717
2,0,0,11,20,20813,31510,-10697
2,0,1,11,20,20639,31736,-11097
2,0,2,11,20,20563,32131,-11568
2,0,3,11,20,20654,32602,-11948
2,0,4,11,20,20888,32536,-11648
2,1,0,11,20,22463,29279,-6816
2,1,1,11,20,22375,29382,-7007
2,1,2,11,20,22372,29688,-7316
2,1,3,11,20,22533,30054,-7521
2,1,4,11,20,22774,29913,-7139
2,2,0,11,20,23726,27487,-3761
2,2,1,11,20,23710,27466,-3756
2,2,2,11,20,23757,27686,-3929
2,2,3,11,20,24006,27977,-3971
2,2,4,11,20,24256,27809,-3553
2,0,0,12,20,24549,30877,-6328
2,0,1,12,20,24449,30923,-6474
2,0,2,12,20,24442,31193,-6751
2,0,3,12,20,24616,31579,-6963
2,0,4,12,20,24861,31416,-6555
2,0,0,1,21,2184,2228,-44
2,0,1,1,21,2177,2233,-56
2,0,2,1,21,2179,2236,-57
2,0,3,1,21,2185,2231,-46
2,1,0,1,21,2228,2308,-80
2,1,1,1,21,2233,2312,-79
2,1,2,1,21,2236,2312,-76
2,1,3,1,21,2231,2306,-75
2,2,0,1,21,2308,1959,349
2,2,1,1,21,2312,1951,361
2,2,2,1,21,2312,1945,367
2,2,3,1,21,2306,1946,360
2,3,0,1,21,1959,1738,221
2,3,1,1,21,1951,1734,217
2,3,2,1,21,1945,1728,217
2,3,3,1,21,1946,1724,222
2,4,0,1,21,1738,1764,-26
2,4,1,1,21,1734,1769,-35
2,4,2,1,21,1728,1765,-37
2,4,3,1,21,1724,1753,-29
2,5,0,1,21,1764,1684,80
2,5,1,1,21,1769,1671,98
2,5,2,1,21,1765,1663,102
2,5,3,1,21,1753,1669,84
2,6,0,1,21,1684,1866,-182
2,6,1,1,21,1671,1820,-149
2,6,2,1,21,1663,1805,-142
2,6,3,1,21,1669,1840,-171
2,7,0,1,21,1866,2562,-696
2,7,1,1,21,1820,2564,-744
2,7,2,1,21,1805,2541,-736
2,7,3,1,21,1840,2551,-711
2,8,0,1,21,2562,1092,1470
2,8,1,1,21,2564,1046,1518
2,8,2,1,21,2541,1053,1488
2,8,3,1,21,2551,1087,1464
2,9,0,1,21,1092,2502,-1410
2,9,1,1,21,1046,2480,-1434
2,9,2,1,21,1053,2535,-1482
2,9,3,1,21,1087,2581,-1494
2,10,0,1,21,2502,3949,-1447
2,10,1,1,21,2480,3979,-1499
2,10,2,1,21,2535,4052,-1517
2,10,3,1,21,2581,4096,-1515
2,11,0,1,21,3949,3608,341
2,11,1,1,21,3979,3654,325
2,11,2,1,21,4052,3706,346
2,11,3,1,21,4096,3733,363
2,12,0,1,21,3608,3457,151
2,12,1,1,21,3654,3499,155
2,12,2,1,21,3706,3537,169
2,12,3,1,21,3733,3561,172
2,13,0,1,21,3457,3415,42
2,13,1,1,21,3499,3458,41
2,13,2,1,21,3537,3490,47
2,13,3,1,21,3561,3529,32
2,14,0,1,21,3415,3420,-5
2,14,1,1,21,3458,3472,-14
2,14,2,1,21,3490,3489,1
2,14,3,1,21,3529,3523,6
2,15,0,1,21,3420,3316,104
2,15,1,1,21,3472,3376,96
2,15,2,1,21,3489,3379,110
2,15,3,1,21,3523,3444,79
2,16,0,1,21,3316,2756,560
2,16,1,1,21,3376,2814,562
2,16,2,1,21,3379,2832,547
2,16,3,1,21,3444,2924,520
2,17,0,1,21,2756,2422,334
2,17,1,1,21,2814,2464,350
2,17,2,1,21,2832,2453,379
2,17,3,1,21,2924,2498,426
2,18,0,1,21,2422,2793,-371
2,18,1,1,21,2464,2682,-218
2,18,2,1,21,2453,2666,-213
2,18,3,1,21,2498,2763,-265
2,19,0,1,21,2793,2608,185
2,19,1,1,21,2682,2463,219
2,19,2,1,21,2666,2442,224
2,19,3,1,21,2763,2585,178
2,20,0,1,21,2608,1647,961
2,20,1,1,21,2463,1533,930
2,20,2,1,21,2442,1557,885
2,20,3,1,21,2585,1641,944
2,21,0,1,21,1647,1553,94
2,21,1,1,21,1533,1510,23
2,21,2,1,21,1557,1490,67
2,21,3,1,21,1641,1470,171
2,22,0,1,21,1553,1652,-99
2,22,1,1,21,1510,1574,-64
2,22,2,1,21,1490,1579,-89
2,22,3,1,21,1470,1572,-102
2,0,0,2,21,4412,4267,145
2,0,1,2,21,4410,4263,147
2,0,2,2,21,4415,4257,158
2,0,3,2,21,4416,4252,164
2,1,0,2,21,4536,3697,839
2,1,1,2,21,4545,3685,860
2,1,2,2,21,4548,3673,875
2,1,3,2,21,4537,3670,867
2,2,0,2,21,4267,3502,765
2,2,1,2,21,4263,3503,760
2,2,2,2,21,4257,3493,764
2,2,3,2,21,4252,3477,775
2,3,0,2,21,3697,3448,249
2,3,1,2,21,3685,3440,245
2,3,2,2,21,3673,3428,245
2,3,3,2,21,3670,3422,248
2,4,0,2,21,3502,3550,-48
2,4,1,2,21,3503,3491,12
2,4,2,2,21,3493,3468,25
2,4,3,2,21,3477,3509,-32
2,5,0,2,21,3448,4428,-980
2,5,1,2,21,3440,4384,-944
2,5,2,2,21,3428,4346,-918
2,5,3,2,21,3422,4391,-969
2,6,0,2,21,3550,3654,-104
2,6,1,2,21,3491,3610,-119
2,6,2,2,21,3468,3594,-126
2,6,3,2,21,3509,3638,-129
2,7,0,2,21,4428,3594,834
2,7,1,2,21,4384,3526,858
2,7,2,2,21,4346,3588,758
2,7,3,2,21,4391,3668,723
2,8,0,2,21,3654,6451,-2797
2,8,1,2,21,3610,6459,-2849
2,8,2,2,21,3594,6587,-2993
2,8,3,2,21,3638,6677,-3039
2,9,0,2,21,3594,7557,-3963
2,9,1,2,21,3526,7633,-4107
2,9,2,2,21,3588,7758,-4170
2,9,3,2,21,3668,7829,-4161
2,10,0,2,21,6451,7065,-614
2,10,1,2,21,6459,7153,-694
2,10,2,2,21,6587,7243,-656
2,10,3,2,21,6677,7294,-617
2,11,0,2,21,7557,6872,685
2,11,1,2,21,7633,6957,676
2,11,2,2,21,7758,7027,731
2,11,3,2,21,7829,7090,739
2,12,0,2,21,7065,6835,230
2,12,1,2,21,7153,6930,223
2,12,2,2,21,7243,6979,264
2,12,3,2,21,7294,7052,242
2,13,0,2,21,6872,6736,136
2,13,1,2,21,6957,6848,109
2,13,2,2,21,7027,6868,159
2,13,3,2,21,7090,6967,123
2,14,0,2,21,6835,6072,763
2,14,1,2,21,6930,6190,740
2,14,2,2,21,6979,6211,768
2,14,3,2,21,7052,6368,684
2,15,0,2,21,6736,5178,1558
2,15,1,2,21,6848,5278,1570
2,15,2,2,21,6868,5285,1583
2,15,3,2,21,6967,5422,1545
2,16,0,2,21,6072,5215,857
2,16,1,2,21,6190,5146,1044
2,16,2,2,21,6211,5119,1092
2,16,3,2,21,6368,5261,1107
2,17,0,2,21,5178,5401,-223
2,17,1,2,21,5278,5145,133
2,17,2,2,21,5285,5108,177
2,17,3,2,21,5422,5348,74
2,18,0,2,21,5215,4255,960
2,18,1,2,21,5146,3996,1150
2,18,2,2,21,5119,3999,1120
2,18,3,2,21,5261,4226,1035
2,19,0,2,21,5401,3200,2201
2,19,1,2,21,5145,3043,2102
2,19,2,2,21,5108,3047,2061
2,19,3,2,21,5348,3111,2237
2,20,0,2,21,4255,3205,1050
2,20,1,2,21,3996,3084,912
2,20,2,2,21,3999,3069,930
2,20,3,2,21,4226,3042,1184
2,0,0,3,21,6720,5461,1259
2,0,1,3,21,6722,5454,1268
2,0,2,3,21,6727,5438,1289
2,0,3,3,21,6722,5423,1299
2,1,0,3,21,6495,5186,1309
2,1,1,3,21,6496,5174,1322
2,1,2,3,21,6493,5156,1337
2,1,3,3,21,6483,5146,1337
2,2,0,3,21,6005,5314,691
2,2,1,3,21,5997,5260,737
2,2,2,3,21,5985,5233,752
2,2,3,3,21,5976,5262,714
2,3,0,3,21,5461,6112,-651
2,3,1,3,21,5454,6055,-601
2,3,2,3,21,5438,6009,-571
2,3,3,3,21,5423,6060,-637
2,4,0,3,21,5186,5520,-334
2,4,1,3,21,5174,5430,-256
2,4,2,3,21,5156,5399,-243
2,4,3,3,21,5146,5478,-332
2,5,0,3,21,5314,6156,-842
2,5,1,3,21,5260,6090,-830
2,5,2,3,21,5233,6129,-896
2,5,3,3,21,5262,6219,-957
2,6,0,3,21,6112,7543,-1431
2,6,1,3,21,6055,7505,-1450
2,6,2,3,21,6009,7640,-1631
2,6,3,3,21,6060,7764,-1704
2,7,0,3,21,5520,10059,-4539
2,7,1,3,21,5430,10113,-4683
2,7,2,3,21,5399,10293,-4894
2,7,3,3,21,5478,10410,-4932
2,8,0,3,21,6156,11014,-4858
2,8,1,3,21,6090,11132,-5042
2,8,2,3,21,6129,11295,-5166
2,8,3,3,21,6219,11390,-5171
2,9,0,3,21,7543,10480,-2937
2,9,1,3,21,7505,10611,-3106
2,9,2,3,21,7640,10733,-3093
2,9,3,3,21,7764,10823,-3059
2,10,0,3,21,10059,10292,-233
2,10,1,3,21,10113,10429,-316
2,10,2,3,21,10293,10516,-223
2,10,3,3,21,10410,10613,-203
2,11,0,3,21,11014,10151,863
2,11,1,3,21,11132,10306,826
2,11,2,3,21,11295,10358,937
2,11,3,3,21,11390,10496,894
2,12,0,3,21,10480,9492,988
2,12,1,3,21,10611,9662,949
2,12,2,3,21,10733,9700,1033
2,12,3,3,21,10823,9891,932
2,13,0,3,21,10292,8494,1798
2,13,1,3,21,10429,8654,1775
2,13,2,3,21,10516,8664,1852
2,13,3,3,21,10613,8866,1747
2,14,0,3,21,10151,7971,2180
2,14,1,3,21,10306,7960,2346
2,14,2,3,21,10358,7951,2407
2,14,3,3,21,10496,8185,2311
2,15,0,3,21,9492,7823,1669
2,15,1,3,21,9662,7609,2053
2,15,2,3,21,9700,7561,2139
2,15,3,3,21,9891,7846,2045
2,16,0,3,21,8494,7048,1446
2,16,1,3,21,8654,6678,1976
2,16,2,3,21,8664,6665,1999
2,16,3,3,21,8866,6989,1877
2,17,0,3,21,7971,5808,2163
2,17,1,3,21,7960,5506,2454
2,17,2,3,21,7951,5489,2462
2,17,3,3,21,8185,5696,2489
2,18,0,3,21,7823,4852,2971
2,18,1,3,21,7609,4617,2992
2,18,2,3,21,7561,4626,2935
2,18,3,3,21,7846,4683,3163
2,0,0,4,21,8679,7052,1627
2,0,1,4,21,8673,6994,1679
2,0,2,4,21,8672,6961,1711
2,0,3,4,21,8668,6986,1682
2,1,0,4,21,8233,7876,357
2,1,1,4,21,8230,7824,406
2,1,2,4,21,8221,7774,447
2,1,3,4,21,8207,7813,394
2,2,0,4,21,7769,7204,565
2,2,1,4,21,7766,7101,665
2,2,2,4,21,7750,7062,688
2,2,3,4,21,7729,7147,582
2,3,0,4,21,7145,8022,-877
2,3,1,4,21,7125,7910,-785
2,3,2,4,21,7101,7934,-833
2,3,3,4,21,7092,8059,-967
2,4,0,4,21,7052,10105,-3053
2,4,1,4,21,6994,10069,-3075
2,4,2,4,21,6961,10181,-3220
2,4,3,4,21,6986,10315,-3329
2,5,0,4,21,7876,11151,-3275
2,5,1,4,21,7824,11159,-3335
2,5,2,4,21,7774,11346,-3572
2,5,3,4,21,7813,11497,-3684
2,6,0,4,21,7204,13516,-6312
2,6,1,4,21,7101,13612,-6511
2,6,2,4,21,7062,13830,-6768
2,6,3,4,21,7147,13971,-6824
2,7,0,4,21,8022,14429,-6407
2,7,1,4,21,7910,14590,-6680
2,7,2,4,21,7934,14785,-6851
2,7,3,4,21,8059,14919,-6860
2,8,0,4,21,10105,13900,-3795
2,8,1,4,21,10069,14083,-4014
2,8,2,4,21,10181,14222,-4041
2,8,3,4,21,10315,14346,-4031
2,9,0,4,21,11151,13608,-2457
2,9,1,4,21,11159,13805,-2646
2,9,2,4,21,11346,13895,-2549
2,9,3,4,21,11497,14057,-2560
2,10,0,4,21,13516,12907,609
2,10,1,4,21,13612,13120,492
2,10,2,4,21,13830,13190,640
2,10,3,4,21,13971,13420,551
2,11,0,4,21,14429,11914,2515
2,11,1,4,21,14590,12126,2464
2,11,2,4,21,14785,12153,2632
2,11,3,4,21,14919,12389,2530
2,12,0,4,21,13900,11287,2613
2,12,1,4,21,14083,11336,2747
2,12,2,4,21,14222,11330,2892
2,12,3,4,21,14346,11629,2717
2,13,0,4,21,13608,10579,3029
2,13,1,4,21,13805,10423,3382
2,13,2,4,21,13895,10393,3502
2,13,3,4,21,14057,10770,3287
2,14,0,4,21,12907,9470,3437
2,14,1,4,21,13120,9142,3978
2,14,2,4,21,13190,9118,4072
2,14,3,4,21,13420,9487,3933
2,15,0,4,21,11914,8601,3313
2,15,1,4,21,12126,8188,3938
2,15,2,4,21,12153,8155,3998
2,15,3,4,21,12389,8459,3930
2,16,0,4,21,11287,7460,3827
2,16,1,4,21,11336,7080,4256
2,16,2,4,21,11330,7068,4262
2,16,3,4,21,11629,7268,4361
2,0,0,5,21,10417,8968,1449
2,0,1,5,21,10407,8870,1537
2,0,2,5,21,10400,8827,1573
2,0,3,5,21,10392,8900,1492
2,1,0,5,21,9997,9706,291
2,1,1,5,21,9999,9581,418
2,1,2,5,21,9986,9597,389
2,1,3,5,21,9960,9728,232
2,2,0,5,21,9453,11971,-2518
2,2,1,5,21,9437,11889,-2452
2,2,2,5,21,9413,11986,-2573
2,2,3,5,21,9398,12155,-2757
2,3,0,5,21,9011,13713,-4702
2,3,1,5,21,8945,13723,-4778
2,3,2,5,21,8906,13887,-4981
2,3,3,5,21,8932,14048,-5116
2,4,0,5,21,9614,14608,-4994
2,4,1,5,21,9558,14658,-5100
2,4,2,5,21,9502,14883,-5381
2,4,3,5,21,9537,15058,-5521
2,5,0,5,21,8968,16931,-7963
2,5,1,5,21,8870,17070,-8200
2,5,2,5,21,8827,17320,-8493
2,5,3,5,21,8900,17500,-8600
2,6,0,5,21,9706,17849,-8143
2,6,1,5,21,9581,18062,-8481
2,6,2,5,21,9597,18274,-8677
2,6,3,5,21,9728,18442,-8714
2,7,0,5,21,11971,17216,-5245
2,7,1,5,21,11889,17459,-5570
2,7,2,5,21,11986,17601,-5615
2,7,3,5,21,12155,17790,-5635
2,8,0,5,21,13713,16364,-2651
2,8,1,5,21,13723,16619,-2896
2,8,2,5,21,13887,16727,-2840
2,8,3,5,21,14048,16981,-2933
2,9,0,5,21,14608,15329,-721
2,9,1,5,21,14658,15584,-926
2,9,2,5,21,14883,15643,-760
2,9,3,5,21,15058,15918,-860
2,10,0,5,21,16931,14707,2224
2,10,1,5,21,17070,14808,2262
2,10,2,5,21,17320,14819,2501
2,10,3,5,21,17500,15152,2348
2,11,0,5,21,17849,13895,3954
2,11,1,5,21,18062,13799,4263
2,11,2,5,21,18274,13772,4502
2,11,3,5,21,18442,14214,4228
2,12,0,5,21,17216,12226,4990
2,12,1,5,21,17459,11956,5503
2,12,2,5,21,17601,11950,5651
2,12,3,5,21,17790,12411,5379
2,13,0,5,21,16364,11023,5341
2,13,1,5,21,16619,10652,5967
2,13,2,5,21,16727,10608,6119
2,13,3,5,21,16981,10957,6024
2,14,0,5,21,15329,10253,5076
2,14,1,5,21,15584,9762,5822
2,14,2,5,21,15643,9734,5909
2,14,3,5,21,15918,10031,5887
2,0,0,6,21,12181,13655,-1474
2,0,1,6,21,12176,13560,-1384
2,0,2,6,21,12165,13649,-1484
2,0,3,6,21,12145,13824,-1679
2,1,0,6,21,11681,15579,-3898
2,1,1,6,21,11670,15543,-3873
2,1,2,6,21,11649,15692,-4043
2,1,3,6,21,11629,15888,-4259
2,2,0,6,21,11319,17170,-5851
2,2,1,6,21,11257,17222,-5965
2,2,2,6,21,11218,17424,-6206
2,2,3,6,21,11238,17609,-6371
2,3,0,6,21,11573,18023,-6450
2,3,1,6,21,11509,18116,-6607
2,3,2,6,21,11447,18373,-6926
2,3,3,6,21,11483,18587,-7104
2,4,0,6,21,10706,20351,-9645
2,4,1,6,21,10604,20542,-9938
2,4,2,6,21,10555,20809,-10254
2,4,3,6,21,10624,21023,-10399
2,5,0,6,21,11470,21165,-9695
2,5,1,6,21,11350,21438,-10088
2,5,2,6,21,11362,21653,-10291
2,5,3,6,21,11481,21886,-10405
2,6,0,6,21,13655,19972,-6317
2,6,1,6,21,13560,20273,-6713
2,6,2,6,21,13649,20433,-6784
2,6,3,6,21,13824,20714,-6890
2,7,0,6,21,15579,18786,-3207
2,7,1,6,21,15543,19083,-3540
2,7,2,6,21,15692,19180,-3488
2,7,3,6,21,15888,19479,-3591
2,8,0,6,21,17170,18122,-952
2,8,1,6,21,17222,18266,-1044
2,8,2,6,21,17424,18309,-885
2,8,3,6,21,17609,18681,-1072
2,9,0,6,21,18023,17315,708
2,9,1,6,21,18116,17271,845
2,9,2,6,21,18373,17261,1112
2,9,3,6,21,18587,17737,850
2,10,0,6,21,20351,15542,4809
2,10,1,6,21,20542,15332,5210
2,10,2,6,21,20809,15329,5480
2,10,3,6,21,21023,15855,5168
2,11,0,6,21,21165,13779,7386
2,11,1,6,21,21438,13466,7972
2,11,2,6,21,21653,13440,8213
2,11,3,6,21,21886,13881,8005
2,12,0,6,21,19972,12675,7297
2,12,1,6,21,20273,12226,8047
2,12,2,6,21,20433,12187,8246
2,12,3,6,21,20714,12529,8185
2,0,0,7,21,13865,19036,-5171
2,0,1,7,21,13847,19042,-5195
2,0,2,7,21,13828,19229,-5401
2,0,3,7,21,13814,19449,-5635
2,1,0,7,21,13547,20585,-7038
2,1,1,7,21,13490,20680,-7190
2,1,2,7,21,13454,20914,-7460
2,1,3,7,21,13469,21138,-7669
2,2,0,7,21,13881,21443,-7562
2,2,1,7,21,13821,21588,-7767
2,2,2,7,21,13759,21862,-8103
2,2,3,7,21,13789,22110,-8321
2,3,0,7,21,12665,23667,-11002
2,3,1,7,21,12555,23918,-11363
2,3,2,7,21,12500,24188,-11688
2,3,3,7,21,12570,24467,-11897
2,4,0,7,21,13208,23921,-10713
2,4,1,7,21,13084,24252,-11168
2,4,2,7,21,13090,24485,-11395
2,4,3,7,21,13205,24810,-11605
2,5,0,7,21,15419,22394,-6975
2,5,1,7,21,15329,22737,-7408
2,5,2,7,21,15414,22886,-7472
2,5,3,7,21,15577,23212,-7635
2,6,0,7,21,17263,21579,-4316
2,6,1,7,21,17214,21765,-4551
2,6,2,7,21,17355,21846,-4491
2,6,3,7,21,17557,22242,-4685
2,7,0,7,21,19036,20730,-1694
2,7,1,7,21,19042,20729,-1687
2,7,2,7,21,19229,20751,-1522
2,7,3,7,21,19449,21266,-1817
2,8,0,7,21,20585,18962,1623
2,8,1,7,21,20680,18804,1876
2,8,2,7,21,20914,18818,2096
2,8,3,7,21,21138,19378,1760
2,9,0,7,21,21443,17095,4348
2,9,1,7,21,21588,16842,4746
2,9,2,7,21,21862,16819,5043
2,9,3,7,21,22110,17325,4785
2,10,0,7,21,23667,15431,8236
2,10,1,7,21,23918,15040,8878
2,10,2,7,21,24188,15019,9169
2,10,3,7,21,24467,15453,9014
2,0,0,8,21,15731,24005,-8274
2,0,1,8,21,15667,24152,-8485
2,0,2,8,21,15633,24403,-8770
2,0,3,8,21,15654,24661,-9007
2,1,0,8,21,16109,24759,-8650
2,1,1,8,21,16054,24964,-8910
2,1,2,8,21,15995,25241,-9246
2,1,3,8,21,16020,25554,-9534
2,2,0,8,21,14973,26423,-11450
2,2,1,8,21,14867,26732,-11865
2,2,2,8,21,14812,27020,-12208
2,2,3,8,21,14876,27391,-12515
2,3,0,8,21,15167,26343,-11176
2,3,1,8,21,15035,26716,-11681
2,3,2,8,21,15035,26938,-11903
2,3,3,8,21,15151,27308,-12157
2,4,0,8,21,17157,25187,-8030
2,4,1,8,21,17063,25419,-8356
2,4,2,8,21,17142,25552,-8410
2,4,3,8,21,17301,25975,-8674
2,5,0,8,21,19027,24187,-5160
2,5,1,8,21,18983,24228,-5245
2,5,2,8,21,19120,24288,-5168
2,5,3,8,21,19310,24827,-5517
2,6,0,8,21,20720,22377,-1657
2,6,1,8,21,20713,22262,-1549
2,6,2,8,21,20892,22308,-1416
2,6,3,8,21,21118,22907,-1789
2,7,0,8,21,22451,20515,1936
2,7,1,8,21,22500,20314,2186
2,7,2,8,21,22719,20308,2411
2,7,3,8,21,22978,20848,2130
2,8,0,8,21,24005,18747,5258
2,8,1,8,21,24152,18416,5736
2,8,2,8,21,24403,18398,6005
2,8,3,8,21,24661,18897,5764
2,0,0,9,21,18293,27515,-9222
2,0,1,9,21,18231,27778,-9547
2,0,2,9,21,18174,28073,-9899
2,0,3,9,21,18205,28478,-10273
2,1,0,9,21,17201,28845,-11644
2,1,1,9,21,17100,29196,-12096
2,1,2,9,21,17048,29473,-12425
2,1,3,9,21,17107,29889,-12782
2,2,0,9,21,17475,29136,-11661
2,2,1,9,21,17347,29398,-12051
2,2,2,9,21,17347,29604,-12257
2,2,3,9,21,17457,30071,-12614
2,3,0,9,21,19116,27795,-8679
2,3,1,9,21,19014,27882,-8868
2,3,2,9,21,19087,27994,-8907
2,3,3,9,21,19247,28560,-9313
2,4,0,9,21,20765,25834,-5069
2,4,1,9,21,20717,25761,-5044
2,4,2,9,21,20848,25845,-4997
2,4,3,9,21,21034,26468,-5434
2,5,0,9,21,22484,23930,-1446
2,5,1,9,21,22482,23772,-1290
2,5,2,9,21,22657,23798,-1141
2,5,3,9,21,22871,24377,-1506
2,6,0,9,21,24135,22167,1968
2,6,1,9,21,24171,21888,2283
2,6,2,9,21,24382,21887,2495
2,6,3,9,21,24647,22420,2227
2,0,0,10,21,19385,31638,-12253
2,0,1,10,21,19277,31878,-12601
2,0,2,10,21,19227,32139,-12912
2,0,3,10,21,19292,32652,-13360
2,1,0,10,21,19703,31744,-12041
2,1,1,10,21,19580,31861,-12281
2,1,2,10,21,19583,32046,-12463
2,1,3,10,21,19688,32656,-12968
2,2,0,10,21,21424,29442,-8018
2,2,1,10,21,21326,29415,-8089
2,2,2,10,21,21399,29551,-8152
2,2,3,10,21,21553,30201,-8648
2,3,0,10,21,22724,27387,-4663
2,3,1,10,21,22668,27271,-4603
2,3,2,10,21,22793,27335,-4542
2,3,3,10,21,22980,27938,-4958
2,4,0,10,21,24222,25582,-1360
2,4,1,10,21,24216,25346,-1130
2,4,2,10,21,24385,25377,-992
2,4,3,10,21,24595,25949,-1354
2,0,0,11,21,21887,33391,-11504
2,0,1,11,21,21757,33394,-11637
2,0,2,11,21,21762,33603,-11841
2,0,3,11,21,21873,34297,-12424
2,1,0,11,21,23652,30995,-7343
2,1,1,11,21,23559,30925,-7366
2,1,2,11,21,23635,31041,-7406
2,1,3,11,21,23784,31671,-7887
2,2,0,11,21,25032,29039,-4007
2,2,1,11,21,24980,28845,-3865
2,2,2,11,21,25105,28914,-3809
2,2,3,11,21,25286,29510,-4224
2,0,0,12,21,25836,32647,-6811
2,0,1,12,21,25736,32499,-6763
2,0,2,12,21,25814,32620,-6806
2,0,3,12,21,25969,33243,-7274
2,0,0,1,22,2287,2339,-52
2,0,1,1,22,2286,2347,-61
2,0,2,1,22,2281,2338,-57
2,1,0,1,22,2339,2418,-79
2,1,1,1,22,2347,2427,-80
2,1,2,1,22,2338,2418,-80
2,2,0,1,22,2418,2063,355
2,2,1,1,22,2427,2062,365
2,2,2,1,22,2418,2056,362
2,3,0,1,22,2063,1848,215
2,3,1,1,22,2062,1847,215
2,3,2,1,22,2056,1838,218
2,4,0,1,22,1848,1883,-35
2,4,1,1,22,1847,1887,-40
2,4,2,1,22,1838,1873,-35
2,5,0,1,22,1883,1791,92
2,5,1,1,22,1887,1787,100
2,5,2,1,22,1873,1778,95
2,6,0,1,22,1791,1950,-159
2,6,1,1,22,1787,1930,-143
2,6,2,1,22,1778,1930,-152
2,7,0,1,22,1950,2690,-740
2,7,1,1,22,1930,2682,-752
2,7,2,1,22,1930,2672,-742
2,8,0,1,22,2690,1152,1538
2,8,1,1,22,2682,1122,1560
2,8,2,1,22,2672,1156,1516
2,9,0,1,22,1152,2584,-1432
2,9,1,1,22,1122,2579,-1457
2,9,2,1,22,1156,2641,-1485
2,10,0,1,22,2584,4118,-1534
2,10,1,1,22,2579,4152,-1573
2,10,2,1,22,2641,4186,-1545
2,11,0,1,22,4118,3805,313
2,11,1,1,22,4152,3853,299
2,11,2,1,22,4186,3837,349
2,12,0,1,22,3805,3645,160
2,12,1,1,22,3853,3696,157
2,12,2,1,22,3837,3671,166
2,13,0,1,22,3645,3610,35
2,13,1,1,22,3696,3659,37
2,13,2,1,22,3671,3644,27
2,14,0,1,22,3610,3618,-8
2,14,1,1,22,3659,3658,1
2,14,2,1,22,3644,3630,14
2,15,0,1,22,3618,3484,134
2,15,1,1,22,3658,3493,165
2,15,2,1,22,3630,3519,111
2,16,0,1,22,3484,2922,562
2,16,1,1,22,3493,2907,586
2,16,2,1,22,3519,2987,532
2,17,0,1,22,2922,2586,336
2,17,1,1,22,2907,2545,362
2,17,2,1,22,2987,2574,413
2,18,0,1,22,2586,2872,-286
2,18,1,1,22,2545,2756,-211
2,18,2,1,22,2574,2867,-293
2,19,0,1,22,2872,2653,219
2,19,1,1,22,2756,2518,238
2,19,2,1,22,2867,2653,214
2,20,0,1,22,2653,1736,917
2,20,1,1,22,2518,1629,889
2,20,2,1,22,2653,1730,923
2,21,0,1,22,1736,1607,129
2,21,1,1,22,1629,1564,65
2,21,2,1,22,1730,1546,184
2,22,0,1,22,1607,1685,-78
2,22,1,1,22,1564,1648,-84
2,22,2,1,22,1546,1626,-80
2,0,0,2,22,4626,4481,145
2,0,1,2,22,4633,4489,144
2,0,2,2,22,4619,4474,145
2,1,0,2,22,4757,3911,846
2,1,1,2,22,4774,3909,865
2,1,2,2,22,4756,3894,862
2,2,0,2,22,4481,3731,750
2,2,1,2,22,4489,3734,755
2,2,2,2,22,4474,3711,763
2,3,0,2,22,3911,3674,237
2,3,1,2,22,3909,3674,235
2,3,2,2,22,3894,3651,243
2,4,0,2,22,3731,3741,-10
2,4,1,2,22,3734,3717,17
2,4,2,2,22,3711,3708,3
2,5,0,2,22,3674,4640,-966
2,5,1,2,22,3674,4612,-938
2,5,2,2,22,3651,4602,-951
2,6,0,2,22,3741,3842,-101
2,6,1,2,22,3717,3804,-87
2,6,2,2,22,3708,3828,-120
2,7,0,2,22,4640,3736,904
2,7,1,2,22,4612,3701,911
2,7,2,2,22,4602,3797,805
2,8,0,2,22,3842,6702,-2860
2,8,1,2,22,3804,6731,-2927
2,8,2,2,22,3828,6827,-2999
2,9,0,2,22,3736,7923,-4187
2,9,1,2,22,3701,8005,-4304
2,9,2,2,22,3797,8023,-4226
2,10,0,2,22,6702,7450,-748
2,10,1,2,22,6731,7549,-818
2,10,2,2,22,6827,7508,-681
2,11,0,2,22,7923,7255,668
2,11,1,2,22,8005,7355,650
2,11,2,2,22,8023,7315,708
2,12,0,2,22,7450,7228,222
2,12,1,2,22,7549,7317,232
2,12,2,2,22,7508,7274,234
2,13,0,2,22,7255,7102,153
2,13,1,2,22,7355,7151,204
2,13,2,2,22,7315,7149,166
2,14,0,2,22,7228,6406,822
2,14,1,2,22,7317,6400,917
2,14,2,2,22,7274,6506,768
2,15,0,2,22,7102,5508,1594
2,15,1,2,22,7151,5452,1699
2,15,2,2,22,7149,5561,1588
2,16,0,2,22,6406,5458,948
2,16,1,2,22,6400,5301,1099
2,16,2,2,22,6506,5441,1065
2,17,0,2,22,5508,5525,-17
2,17,1,2,22,5452,5274,178
2,17,2,2,22,5561,5520,41
2,18,0,2,22,5458,4389,1069
2,18,1,2,22,5301,4147,1154
2,18,2,2,22,5441,4383,1058
2,19,0,2,22,5525,3343,2182
2,19,1,2,22,5274,3193,2081
2,19,2,2,22,5520,3276,2244
2,20,0,2,22,4389,3292,1097
2,20,1,2,22,4147,3212,935
2,20,2,2,22,4383,3172,1211
2,0,0,3,22,7044,5794,1250
2,0,1,3,22,7060,5796,1264
2,0,2,3,22,7037,5767,1270
2,1,0,3,22,6820,5522,1298
2,1,1,3,22,6836,5521,1315
2,1,2,3,22,6812,5489,1323
2,2,0,3,22,6329,5624,705
2,2,1,3,22,6336,5604,732
2,2,2,3,22,6312,5581,731
2,3,0,3,22,5794,6431,-637
2,3,1,3,22,5796,6399,-603
2,3,2,3,22,5767,6380,-613
2,4,0,3,22,5522,5792,-270
2,4,1,3,22,5521,5734,-213
2,4,2,3,22,5489,5758,-269
2,5,0,3,22,5624,6426,-802
2,5,1,3,22,5604,6383,-779
2,5,2,3,22,5581,6469,-888
2,6,0,3,22,6431,7854,-1423
2,6,1,3,22,6399,7853,-1454
2,6,2,3,22,6380,7983,-1603
2,7,0,3,22,5792,10507,-4715
2,7,1,3,22,5734,10584,-4850
2,7,2,3,22,5758,10664,-4906
2,8,0,3,22,6426,11568,-5142
2,8,1,3,22,6383,11701,-5318
2,8,2,3,22,6469,11694,-5225
2,9,0,3,22,7854,11060,-3206
2,9,1,3,22,7853,11208,-3355
2,9,2,3,22,7983,11152,-3169
2,10,0,3,22,10507,10873,-366
2,10,1,3,22,10584,11013,-429
2,10,2,3,22,10664,10945,-281
2,11,0,3,22,11568,10712,856
2,11,1,3,22,11701,10810,891
2,11,2,3,22,11694,10793,901
2,12,0,3,22,11060,10024,1036
2,12,1,3,22,11208,10058,1150
2,12,2,3,22,11152,10136,1016
2,13,0,3,22,10873,8992,1881
2,13,1,3,22,11013,8945,2068
2,13,2,3,22,10945,9080,1865
2,14,0,3,22,10712,8380,2332
2,14,1,3,22,10810,8208,2602
2,14,2,3,22,10793,8428,2365
2,15,0,3,22,10024,8111,1913
2,15,1,3,22,10058,7819,2239
2,15,2,3,22,10136,8094,2042
2,16,0,3,22,8992,7261,1731
2,16,1,3,22,8945,6903,2042
2,16,2,3,22,9080,7250,1830
2,17,0,3,22,8380,5996,2384
2,17,1,3,22,8208,5711,2497
2,17,2,3,22,8428,5929,2499
2,18,0,3,22,8111,5028,3083
2,18,1,3,22,7819,4841,2978
2,18,2,3,22,8094,4902,3192
2,0,0,4,22,9107,7472,1635
2,0,1,4,22,9122,7451,1671
2,0,2,4,22,9093,7419,1674
2,1,0,4,22,8668,8314,354
2,1,1,4,22,8683,8286,397
2,1,2,4,22,8650,8253,397
2,2,0,4,22,8212,7583,629
2,2,1,4,22,8223,7521,702
2,2,2,4,22,8185,7536,649
2,3,0,4,22,7585,8376,-791
2,3,1,4,22,7583,8313,-730
2,3,2,4,22,7545,8399,-854
2,4,0,4,22,7472,10544,-3072
2,4,1,4,22,7451,10535,-3084
2,4,2,4,22,7419,10655,-3236
2,5,0,4,22,8314,11659,-3345
2,5,1,4,22,8286,11706,-3420
2,5,2,4,22,8253,11820,-3567
2,6,0,4,22,7583,14152,-6569
2,6,1,4,22,7521,14280,-6759
2,6,2,4,22,7536,14335,-6799
2,7,0,4,22,8376,15178,-6802
2,7,1,4,22,8313,15360,-7047
2,7,2,4,22,8399,15338,-6939
2,8,0,4,22,10544,14678,-4134
2,8,1,4,22,10535,14866,-4331
2,8,2,4,22,10655,14782,-4127
2,9,0,4,22,11659,14357,-2698
2,9,1,4,22,11706,14506,-2800
2,9,2,4,22,11820,14464,-2644
2,10,0,4,22,14152,13634,518
2,10,1,4,22,14280,13717,563
2,10,2,4,22,14335,13780,555
2,11,0,4,22,15178,12610,2568
2,11,1,4,22,15360,12603,2757
2,11,2,4,22,15338,12710,2628
2,12,0,4,22,14678,11864,2814
2,12,1,4,22,14866,11701,3165
2,12,2,4,22,14782,11947,2835
2,13,0,4,22,14357,11033,3324
2,13,1,4,22,14506,10726,3780
2,13,2,4,22,14464,11081,3383
2,14,0,4,22,13634,9847,3787
2,14,1,4,22,13717,9448,4269
2,14,2,4,22,13780,9824,3956
2,15,0,4,22,12610,8868,3742
2,15,1,4,22,12603,8467,4136
2,15,2,4,22,12710,8796,3914
2,16,0,4,22,11864,7681,4183
2,16,1,4,22,11701,7359,4342
2,16,2,4,22,11947,7555,4392
2,0,0,5,22,10955,9466,1489
2,0,1,5,22,10969,9408,1561
2,0,2,5,22,10931,9409,1522
2,1,0,5,22,10551,10167,384
2,1,1,5,22,10570,10100,470
2,1,2,5,22,10523,10177,346
2,2,0,5,22,10003,12494,-2491
2,2,1,5,22,10010,12465,-2455
2,2,2,5,22,9963,12585,-2622
2,3,0,5,22,9535,14349,-4814
2,3,1,5,22,9513,14388,-4875
2,3,2,5,22,9475,14492,-5017
2,4,0,5,22,10162,15304,-5142
2,4,1,5,22,10133,15402,-5269
2,4,2,5,22,10091,15491,-5400
2,5,0,5,22,9466,17762,-8296
2,5,1,5,22,9408,17939,-8531
2,5,2,5,22,9409,17979,-8570
2,6,0,5,22,10167,18796,-8629
2,6,1,5,22,10100,19018,-8918
2,6,2,5,22,10177,18968,-8791
2,7,0,5,22,12494,18162,-5668
2,7,1,5,22,12465,18359,-5894
2,7,2,5,22,12585,18301,-5716
2,8,0,5,22,14349,17279,-2930
2,8,1,5,22,14388,17413,-3025
2,8,2,5,22,14492,17451,-2959
2,9,0,5,22,15304,16220,-916
2,9,1,5,22,15402,16262,-860
2,9,2,5,22,15491,16354,-863
2,10,0,5,22,17762,15482,2280
2,10,1,5,22,17939,15359,2580
2,10,2,5,22,17979,15577,2402
2,11,0,5,22,18796,14517,4279
2,11,1,5,22,19018,14219,4799
2,11,2,5,22,18968,14600,4368
2,12,0,5,22,18162,12769,5393
2,12,1,5,22,18359,12355,6004
2,12,2,5,22,18301,12811,5490
2,13,0,5,22,17279,11454,5825
2,13,1,5,22,17413,11012,6401
2,13,2,5,22,17451,11370,6081
2,14,0,5,22,16220,10553,5667
2,14,1,5,22,16262,10115,6147
2,14,2,5,22,16354,10422,5932
2,0,0,6,22,12838,14285,-1447
2,0,1,6,22,12856,14252,-1396
2,0,2,6,22,12804,14363,-1559
2,1,0,6,22,12342,16299,-3957
2,1,1,6,22,12357,16318,-3961
2,1,2,6,22,12301,16422,-4121
2,2,0,6,22,11953,17994,-6041
2,2,1,6,22,11940,18084,-6144
2,2,2,6,22,11893,18163,-6270
2,3,0,6,22,12225,18914,-6689
2,3,1,6,22,12195,19061,-6866
2,3,2,6,22,12147,19135,-6988
2,4,0,6,22,11314,21380,-10066
2,4,1,6,22,11255,21597,-10342
2,4,2,6,22,11247,21609,-10362
2,5,0,6,22,12050,22280,-10230
2,5,1,6,22,11987,22511,-10524
2,5,2,6,22,12050,22487,-10437
2,6,0,6,22,14285,21084,-6799
2,6,1,6,22,14252,21266,-7014
2,6,2,6,22,14363,21288,-6925
2,7,0,6,22,16299,19865,-3566
2,7,1,6,22,16318,19958,-3640
2,7,2,6,22,16422,20025,-3603
2,8,0,6,22,17994,19092,-1098
2,8,1,6,22,18084,19018,-934
2,8,2,6,22,18163,19221,-1058
2,9,0,6,22,18914,18135,779
2,9,1,6,22,19061,17877,1184
2,9,2,6,22,19135,18230,905
2,10,0,6,22,21380,16253,5127
2,10,1,6,22,21597,15848,5749
2,10,2,6,22,21609,16330,5279
2,11,0,6,22,22280,14376,7904
2,11,1,6,22,22511,13919,8592
2,11,2,6,22,22487,14357,8130
2,12,0,6,22,21084,13139,7945
2,12,1,6,22,21266,12660,8606
2,12,2,6,22,21288,12996,8292
2,0,0,7,22,14629,19944,-5315
2,0,1,7,22,14643,20014,-5371
2,0,2,7,22,14582,20093,-5511
2,1,0,7,22,14292,21604,-7312
2,1,1,7,22,14287,21743,-7456
2,1,2,7,22,14231,21807,-7576
2,2,0,7,22,14643,22532,-7889
2,2,1,7,22,14622,22719,-8097
2,2,2,7,22,14565,22765,-8200
2,3,0,7,22,13377,24864,-11487
2,3,1,7,22,13317,25090,-11773
2,3,2,7,22,13303,25128,-11825
2,4,0,7,22,13898,25202,-11304
2,4,1,7,22,13834,25418,-11584
2,4,2,7,22,13888,25474,-11586
2,5,0,7,22,16168,23670,-7502
2,5,1,7,22,16139,23811,-7672
2,5,2,7,22,16236,23862,-7626
2,6,0,7,22,18090,22737,-4647
2,6,1,7,22,18105,22714,-4609
2,6,2,7,22,18200,22892,-4692
2,7,0,7,22,19944,21745,-1801
2,7,1,7,22,20014,21536,-1522
2,7,2,7,22,20093,21874,-1781
2,8,0,7,22,21604,19871,1733
2,8,1,7,22,21743,19506,2237
2,8,2,7,22,21807,19960,1847
2,9,0,7,22,22532,17860,4672
2,9,1,7,22,22719,17412,5307
2,9,2,7,22,22765,17876,4889
2,10,0,7,22,24864,16061,8803
2,10,1,7,22,25090,15567,9523
2,10,2,7,22,25128,15983,9145
2,0,0,8,22,16579,25222,-8643
2,0,1,8,22,16573,25401,-8828
2,0,2,8,22,16512,25437,-8925
2,1,0,8,22,16982,26016,-9034
2,1,1,8,22,16969,26212,-9243
2,1,2,8,22,16903,26284,-9381
2,2,0,8,22,15795,27786,-11991
2,2,1,8,22,15744,27997,-12253
2,2,2,8,22,15721,28115,-12394
2,3,0,8,22,15961,27788,-11827
2,3,1,8,22,15896,27963,-12067
2,3,2,8,22,15944,28048,-12104
2,4,0,8,22,18016,26542,-8526
2,4,1,8,22,17986,26567,-8581
2,4,2,8,22,18074,26729,-8655
2,5,0,8,22,19973,25390,-5417
2,5,1,8,22,19992,25232,-5240
2,5,2,8,22,20073,25545,-5472
2,6,0,8,22,21735,23481,-1746
2,6,1,8,22,21801,23165,-1364
2,6,2,8,22,21871,23604,-1733
2,7,0,8,22,23554,21478,2076
2,7,1,8,22,23673,21070,2603
2,7,2,8,22,23737,21506,2231
2,8,0,8,22,25222,19545,5677
2,8,1,8,22,25401,19060,6341
2,8,2,8,22,25437,19502,5935
2,0,0,9,22,19269,28938,-9669
2,0,1,9,22,19255,29119,-9864
2,0,2,9,22,19184,29271,-10087
2,1,0,9,22,18134,30372,-12238
2,1,1,9,22,18091,30542,-12451
2,1,2,9,22,18059,30689,-12630
2,2,0,9,22,18379,30660,-12281
2,2,1,9,22,18323,30719,-12396
2,2,2,9,22,18362,30915,-12553
2,3,0,9,22,20079,29195,-9116
2,3,1,9,22,20048,29085,-9037
2,3,2,9,22,20130,29382,-9252
2,4,0,9,22,21821,27126,-5305
2,4,1,9,22,21839,26861,-5022
2,4,2,9,22,21911,27275,-5364
2,5,0,9,22,23618,25088,-1470
2,5,1,9,22,23688,24729,-1041
2,5,2,9,22,23744,25150,-1406
2,6,0,9,22,25345,23163,2182
2,6,1,9,22,25460,22718,2742
2,6,2,9,22,25515,23132,2383
2,0,0,10,22,20421,33244,-12823
2,0,1,10,22,20377,33298,-12921
2,0,2,10,22,20340,33556,-13216
2,1,0,10,22,20718,33313,-12595
2,1,1,10,22,20670,33237,-12567
2,1,2,10,22,20700,33568,-12868
2,2,0,10,22,22497,30931,-8434
2,2,1,10,22,22475,30714,-8239
2,2,2,10,22,22548,31112,-8564
2,3,0,10,22,23884,28733,-4849
2,3,1,10,22,23901,28425,-4524
2,3,2,10,22,23967,28821,-4854
2,4,0,10,22,25466,26773,-1307
2,4,1,10,22,25535,26377,-842
2,4,2,10,22,25582,26776,-1194
2,0,0,11,22,23005,35049,-12044
2,0,1,11,22,22956,34866,-11910
2,0,2,11,22,22981,35298,-12317
2,1,0,11,22,24836,32538,-7702
2,1,1,11,22,24822,32278,-7456
2,1,2,11,22,24886,32658,-7772
2,2,0,11,22,26302,30418,-4116
2,2,1,11,22,26328,30073,-3745
2,2,2,11,22,26385,30447,-4062
2,0,0,12,22,27123,34223,-7100
2,0,1,12,22,27108,33926,-6818
2,0,2,12,22,27167,34284,-7117
2,0,0,1,23,2396,2453,-57
2,0,1,1,23,2388,2449,-61
2,1,0,1,23,2453,2533,-80
2,1,1,1,23,2449,2533,-84
2,2,0,1,23,2533,2174,359
2,2,1,1,23,2533,2173,360
2,3,0,1,23,2174,1961,213
2,3,1,1,23,2173,1957,216
2,4,0,1,23,1961,2001,-40
2,4,1,1,23,1957,1995,-38
2,5,0,1,23,2001,1907,94
2,5,1,1,23,1995,1902,93
2,6,0,1,23,1907,2060,-153
2,6,1,1,23,1902,2055,-153
2,7,0,1,23,2060,2808,-748
2,7,1,1,23,2055,2813,-758
2,8,0,1,23,2808,1228,1580
2,8,1,1,23,2813,1225,1588
2,9,0,1,23,1228,2683,-1455
2,9,1,1,23,1225,2685,-1460
2,10,0,1,23,2683,4291,-1608
2,10,1,1,23,2685,4286,-1601
2,11,0,1,23,4291,4004,287
2,11,1,1,23,4286,3984,302
2,12,0,1,23,4004,3842,162
2,12,1,1,23,3984,3830,154
2,13,0,1,23,3842,3811,31
2,13,1,1,23,3830,3813,17
2,14,0,1,23,3811,3804,7
2,14,1,1,23,3813,3799,14
2,15,0,1,23,3804,3601,203
2,15,1,1,23,3799,3633,166
2,16,0,1,23,3601,3015,586
2,16,1,1,23,3633,3062,571
2,17,0,1,23,3015,2667,348
2,17,1,1,23,3062,2666,396
2,18,0,1,23,2667,2946,-279
2,18,1,1,23,2666,2957,-291
2,19,0,1,23,2946,2708,238
2,19,1,1,23,2957,2729,228
2,20,0,1,23,2708,1832,876
2,20,1,1,23,2729,1802,927
2,21,0,1,23,1832,1661,171
2,21,1,1,23,1802,1620,182
2,22,0,1,23,1661,1759,-98
2,22,1,1,23,1620,1695,-75
2,0,0,2,23,4849,4707,142
2,0,1,2,23,4837,4706,131
2,1,0,2,23,4986,4135,851
2,1,1,2,23,4982,4130,852
2,2,0,2,23,4707,3962,745
2,2,1,2,23,4706,3952,754
2,3,0,2,23,4135,3908,227
2,3,1,2,23,4130,3897,233
2,4,0,2,23,3962,3967,-5
2,4,1,2,23,3952,3957,-5
2,5,0,2,23,3908,4868,-960
2,5,1,2,23,3897,4868,-971
2,6,0,2,23,3967,4036,-69
2,6,1,2,23,3957,4038,-81
2,7,0,2,23,4868,3911,957
2,7,1,2,23,4868,3910,958
2,8,0,2,23,4036,6974,-2938
2,8,1,2,23,4038,6971,-2933
2,9,0,2,23,3911,8295,-4384
2,9,1,2,23,3910,8270,-4360
2,10,0,2,23,6974,7846,-872
2,10,1,2,23,6971,7814,-843
2,11,0,2,23,8295,7653,642
2,11,1,2,23,8270,7643,627
2,12,0,2,23,7846,7615,231
2,12,1,2,23,7814,7612,202
2,13,0,2,23,7653,7405,248
2,13,1,2,23,7643,7432,211
2,14,0,2,23,7615,6616,999
2,14,1,2,23,7612,6695,917
2,15,0,2,23,7405,5682,1723
2,15,1,2,23,7432,5728,1704
2,16,0,2,23,6616,5613,1003
2,16,1,2,23,6695,5623,1072
2,17,0,2,23,5682,5654,28
2,17,1,2,23,5728,5686,42
2,18,0,2,23,5613,4540,1073
2,18,1,2,23,5623,4531,1092
2,19,0,2,23,5654,3493,2161
2,19,1,2,23,5686,3422,2264
2,20,0,2,23,4540,3420,1120
2,20,1,2,23,4531,3315,1216
2,0,0,3,23,7382,6136,1246
2,0,1,3,23,7370,6125,1245
2,1,0,3,23,7160,5869,1291
2,1,1,3,23,7155,5854,1301
2,2,0,3,23,6668,5968,700
2,2,1,3,23,6663,5952,711
2,3,0,3,23,6136,6775,-639
2,3,1,3,23,6125,6770,-645
2,4,0,3,23,5869,6096,-227
2,4,1,3,23,5854,6093,-239
2,5,0,3,23,5968,6719,-751
2,5,1,3,23,5952,6723,-771
2,6,0,3,23,6775,8202,-1427
2,6,1,3,23,6770,8196,-1426
2,7,0,3,23,6096,10978,-4882
2,7,1,3,23,6093,10955,-4862
2,8,0,3,23,6719,12137,-5418
2,8,1,3,23,6723,12100,-5377
2,9,0,3,23,8202,11657,-3455
2,9,1,3,23,8196,11627,-3431
2,10,0,3,23,10978,11457,-479
2,10,1,3,23,10955,11442,-487
2,11,0,3,23,12137,11216,921
2,11,1,3,23,12100,11245,855
2,12,0,3,23,11657,10420,1237
2,12,1,3,23,11627,10494,1133
2,13,0,3,23,11457,9283,2174
2,13,1,3,23,11442,9361,2081
2,14,0,3,23,11216,8628,2588
2,14,1,3,23,11245,8685,2560
2,15,0,3,23,10420,8321,2099
2,15,1,3,23,10494,8352,2142
2,16,0,3,23,9283,7486,1797
2,16,1,3,23,9361,7488,1873
2,17,0,3,23,8628,6201,2427
2,17,1,3,23,8685,6151,2534
2,18,0,3,23,8321,5252,3069
2,18,1,3,23,8352,5117,3235
2,0,0,4,23,9556,7929,1627
2,0,1,4,23,9543,7909,1634
2,1,0,4,23,9121,8776,345
2,1,1,4,23,9112,8765,347
2,2,0,4,23,8669,8003,666
2,2,1,4,23,8658,7995,663
2,3,0,4,23,8043,8779,-736
2,3,1,4,23,8027,8778,-751
2,4,0,4,23,7929,11010,-3081
2,4,1,4,23,7909,11009,-3100
2,5,0,4,23,8776,12206,-3430
2,5,1,4,23,8765,12180,-3415
2,6,0,4,23,8003,14820,-6817
2,6,1,4,23,7995,14785,-6790
2,7,0,4,23,8779,15948,-7169
2,7,1,4,23,8778,15913,-7135
2,8,0,4,23,11010,15461,-4451
2,8,1,4,23,11009,15426,-4417
2,9,0,4,23,12206,15058,-2852
2,9,1,4,23,12180,15075,-2895
2,10,0,4,23,14820,14231,589
2,10,1,4,23,14785,14307,478
2,11,0,4,23,15948,13087,2861
2,11,1,4,23,15913,13160,2753
2,12,0,4,23,15461,12229,3232
2,12,1,4,23,15426,12318,3108
2,13,0,4,23,15058,11336,3722
2,13,1,4,23,15075,11414,3661
2,14,0,4,23,14231,10153,4078
2,14,1,4,23,14307,10154,4153
2,15,0,4,23,13087,9147,3940
2,15,1,4,23,13160,9108,4052
2,16,0,4,23,12229,7960,4269
2,16,1,4,23,12318,7846,4472
2,0,0,5,23,11517,10004,1513
2,0,1,5,23,11500,9990,1510
2,1,0,5,23,11122,10686,436
2,1,1,5,23,11107,10680,427
2,2,0,5,23,10576,13070,-2494
2,2,1,5,23,10560,13064,-2504
2,3,0,5,23,10103,15014,-4911
2,3,1,5,23,10082,14993,-4911
2,4,0,5,23,10737,16048,-5311
2,4,1,5,23,10722,16010,-5288
2,5,0,5,23,10004,18631,-8627
2,5,1,5,23,9990,18598,-8608
2,6,0,5,23,10686,19752,-9066
2,6,1,5,23,10680,19712,-9032
2,7,0,5,23,13070,19062,-5992
2,7,1,5,23,13064,19059,-5995
2,8,0,5,23,15014,18073,-3059
2,8,1,5,23,14993,18137,-3144
2,9,0,5,23,16048,16898,-850
2,9,1,5,23,16010,16973,-963
2,10,0,5,23,18631,16033,2598
2,10,1,5,23,18598,16117,2481
2,11,0,5,23,19752,14937,4815
2,11,1,5,23,19712,15047,4665
2,12,0,5,23,19062,13168,5894
2,12,1,5,23,19059,13216,5843
2,13,0,5,23,18073,11814,6259
2,13,1,5,23,18137,11774,6363
2,14,0,5,23,16898,10906,5992
2,14,1,5,23,16973,10803,6170
2,0,0,6,23,13518,14977,-1459
2,0,1,6,23,13495,14966,-1471
2,1,0,6,23,13029,17074,-4045
2,1,1,6,23,13009,17048,-4039
2,2,0,6,23,12636,18856,-6220
2,2,1,6,23,12615,18823,-6208
2,3,0,6,23,12911,19859,-6948
2,3,1,6,23,12895,19823,-6928
2,4,0,6,23,11965,22435,-10470
2,4,1,6,23,11947,22397,-10450
2,5,0,6,23,12687,23353,-10666
2,5,1,6,23,12675,23345,-10670
2,6,0,6,23,14977,22077,-7100
2,6,1,6,23,14966,22121,-7155
2,7,0,6,23,17074,20740,-3666
2,7,1,6,23,17048,20803,-3755
2,8,0,6,23,18856,19844,-988
2,8,1,6,23,18823,19930,-1107
2,9,0,6,23,19859,18741,1118
2,9,1,6,23,19823,18846,977
2,10,0,6,23,22435,16769,5666
2,10,1,6,23,22397,16849,5548
2,11,0,6,23,23353,14829,8524
2,11,1,6,23,23345,14836,8509
2,12,0,6,23,22077,13573,8504
2,12,1,6,23,22121,13469,8652
2,0,0,7,23,15425,20916,-5491
2,0,1,7,23,15397,20878,-5481
2,1,0,7,23,15089,22667,-7578
2,1,1,7,23,15064,22636,-7572
2,2,0,7,23,15444,23663,-8219
2,2,1,7,23,15428,23622,-8194
2,3,0,7,23,14139,26036,-11897
2,3,1,7,23,14120,26030,-11910
2,4,0,7,23,14648,26368,-11720
2,4,1,7,23,14632,26407,-11775
2,5,0,7,23,16978,24744,-7766
2,5,1,7,23,16961,24787,-7826
2,6,0,7,23,18981,23686,-4705
2,6,1,7,23,18950,23760,-4810
2,7,0,7,23,20916,22552,-1636
2,7,1,7,23,20878,22659,-1781
2,8,0,7,23,22667,20573,2094
2,8,1,7,23,22636,20648,1988
2,9,0,7,23,23663,18430,5233
2,9,1,7,23,23622,18469,5153
2,10,0,7,23,26036,16588,9448
2,10,1,7,23,26030,16531,9499
2,0,0,8,23,17485,26471,-8986
2,0,1,8,23,17452,26435,-8983
2,1,0,8,23,17897,27264,-9367
2,1,1,8,23,17877,27255,-9378
2,2,0,8,23,16672,29051,-12379
2,2,1,8,23,16653,29092,-12439
2,3,0,8,23,16822,29035,-12213
2,3,1,8,23,16805,29073,-12268
2,4,0,8,23,18939,27690,-8751
2,4,1,8,23,18918,27744,-8826
2,5,0,8,23,20982,26394,-5412
2,5,1,8,23,20945,26489,-5544
2,6,0,8,23,22823,24384,-1561
2,6,1,8,23,22780,24461,-1681
2,7,0,8,23,24727,22234,2493
2,7,1,8,23,24691,22268,2423
2,8,0,8,23,26471,20189,6282
2,8,1,8,23,26435,20164,6271
2,0,0,9,23,20293,30279,-9986
2,0,1,9,23,20265,30317,-10052
2,1,0,9,23,19125,31718,-12593
2,1,1,9,23,19102,31758,-12656
2,2,0,9,23,19355,31981,-12626
2,2,1,9,23,19338,32030,-12692
2,3,0,9,23,21113,30398,-9285
2,3,1,9,23,21091,30473,-9382
2,4,0,9,23,22943,28226,-5283
2,4,1,9,23,22902,28291,-5389
2,5,0,9,23,24824,26045,-1221
2,5,1,9,23,24775,26081,-1306
2,6,0,9,23,26634,23993,2641
2,6,1,9,23,26593,23963,2630
2,0,0,10,23,21521,34664,-13143
2,0,1,10,23,21490,34715,-13225
2,1,0,10,23,21808,34689,-12881
2,1,1,10,23,21787,34759,-12972
2,2,0,10,23,23646,32230,-8584
2,2,1,10,23,23624,32275,-8651
2,3,0,10,23,25117,29887,-4770
2,3,1,10,23,25075,29911,-4836
2,4,0,10,23,26785,27804,-1019
2,4,1,10,23,26732,27776,-1044
2,0,0,11,23,24204,36521,-12317
2,0,1,11,23,24175,36561,-12386
2,1,0,11,23,26099,33891,-7792
2,1,1,11,23,26073,33895,-7822
2,2,0,11,23,27650,31646,-3996
2,2,1,11,23,27608,31606,-3998
2,0,0,12,23,28495,35650,-7155
2,0,1,12,23,28461,35590,-7129
2,0,0,1,24,2498,2555,-57
2,1,0,1,24,2555,2639,-84
2,2,0,1,24,2639,2285,354
2,3,0,1,24,2285,2071,214
2,4,0,1,24,2071,2109,-38
2,5,0,1,24,2109,2022,87
2,6,0,1,24,2022,2185,-163
2,7,0,1,24,2185,2939,-754
2,8,0,1,24,2939,1331,1608
2,9,0,1,24,1331,2789,-1458
2,10,0,1,24,2789,4425,-1636
2,11,0,1,24,4425,4135,290
2,12,0,1,24,4135,3976,159
2,13,0,1,24,3976,3965,11
2,14,0,1,24,3965,3945,20
2,15,0,1,24,3945,3741,204
2,16,0,1,24,3741,3170,571
2,17,0,1,24,3170,2788,382
2,18,0,1,24,2788,3147,-359
2,19,0,1,24,3147,2919,228
2,20,0,1,24,2919,2005,914
2,21,0,1,24,2005,1717,288
2,22,0,1,24,1717,1806,-89
2,0,0,2,24,5053,4924,129
2,1,0,2,24,5194,4356,838
2,2,0,2,24,4924,4180,744
2,3,0,2,24,4356,4131,225
2,4,0,2,24,4180,4207,-27
2,5,0,2,24,4131,5124,-993
2,6,0,2,24,4207,4270,-63
2,7,0,2,24,5124,4120,1004
2,8,0,2,24,4270,7214,-2944
2,9,0,2,24,4120,8560,-4440
2,10,0,2,24,7214,8111,-897
2,11,0,2,24,8560,7941,619
2,12,0,2,24,8111,7910,201
2,13,0,2,24,7941,7686,255
2,14,0,2,24,7910,6911,999
2,15,0,2,24,7686,5958,1728
2,16,0,2,24,6911,5935,976
2,17,0,2,24,5958,6066,-108
2,18,0,2,24,5935,4924,1011
2,19,0,2,24,6066,3722,2344
2,20,0,2,24,4924,3523,1401
2,0,0,3,24,7692,6465,1227
2,1,0,3,24,7479,6202,1277
2,2,0,3,24,6995,6316,679
2,3,0,3,24,6465,7146,-681
2,4,0,3,24,6202,6455,-253
2,5,0,3,24,6316,7059,-743
2,6,0,3,24,7146,8545,-1399
2,7,0,3,24,6455,11349,-4894
2,8,0,3,24,7059,12536,-5477
2,9,0,3,24,8545,12076,-3531
2,10,0,3,24,11349,11886,-537
2,11,0,3,24,12536,11651,885
2,12,0,3,24,12076,10856,1220
2,13,0,3,24,11886,9699,2187
2,14,0,3,24,11651,9105,2546
2,15,0,3,24,10856,8854,2002
2,16,0,3,24,9699,8071,1628
2,17,0,3,24,9105,6641,2464
2,18,0,3,24,8854,5528,3326
2,0,0,4,24,9977,8387,1590
2,1,0,4,24,9550,9255,295
2,2,0,4,24,9104,8477,627
2,3,0,4,24,8487,9244,-757
2,4,0,4,24,8387,11484,-3097
2,5,0,4,24,9255,12680,-3425
2,6,0,4,24,8477,15325,-6848
2,7,0,4,24,9244,16501,-7257
2,8,0,4,24,11484,16021,-4537
2,9,0,4,24,12680,15627,-2947
2,10,0,4,24,15325,14821,504
2,11,0,4,24,16501,13644,2857
2,12,0,4,24,16021,12846,3175
2,13,0,4,24,15627,12024,3603
2,14,0,4,24,14821,10859,3962
2,15,0,4,24,13644,9788,3856
2,16,0,4,24,12846,8447,4399
2,0,0,5,24,12048,10586,1462
2,1,0,5,24,11659,11266,393
2,2,0,5,24,11126,13669,-2543
2,3,0,5,24,10672,15619,-4947
2,4,0,5,24,11326,16656,-5330
2,5,0,5,24,10586,19290,-8704
2,6,0,5,24,11266,20446,-9180
2,7,0,5,24,13669,19762,-6093
2,8,0,5,24,15619,18797,-3178
2,9,0,5,24,16656,17609,-953
2,10,0,5,24,19290,16791,2499
2,11,0,5,24,20446,15765,4681
2,12,0,5,24,19762,14029,5733
2,13,0,5,24,18797,12576,6221
2,14,0,5,24,17609,11594,6015
2,0,0,6,24,14157,15691,-1534
2,1,0,6,24,13681,17804,-4123
2,2,0,6,24,13311,19595,-6284
2,3,0,6,24,13611,20621,-7010
2,4,0,6,24,12657,23235,-10578
2,5,0,6,24,13375,24187,-10812
2,6,0,6,24,15691,22932,-7241
2,7,0,6,24,17804,21585,-3781
2,8,0,6,24,19595,20756,-1161
2,9,0,6,24,20621,19710,911
2,10,0,6,24,23235,17770,5465
2,11,0,6,24,24187,15746,8441
2,12,0,6,24,22932,14382,8550
2,0,0,7,24,16179,21780,-5601
2,1,0,7,24,15866,23560,-7694
2,2,0,7,24,16250,24566,-8316
2,3,0,7,24,14942,26976,-12034
2,4,0,7,24,15446,27357,-11911
2,5,0,7,24,17800,25720,-7920
2,6,0,7,24,19826,24732,-4906
2,7,0,7,24,21780,23675,-1895
2,8,0,7,24,23560,21715,1845
2,9,0,7,24,24566,19487,5079
2,10,0,7,24,26976,17552,9424
2,0,0,8,24,18364,27505,-9141
2,1,0,8,24,18805,28307,-9502
2,2,0,8,24,17581,30146,-12565
2,3,0,8,24,17731,30145,-12414
2,4,0,8,24,19871,28867,-8996
2,5,0,8,24,21935,27651,-5716
2,6,0,8,24,23802,25680,-1878
2,7,0,8,24,25745,23432,2313
2,8,0,8,24,27505,21293,6212
2,0,0,9,24,21303,31477,-10174
2,1,0,9,24,20136,32934,-12798
2,2,0,9,24,20370,33292,-12922
2,3,0,9,24,22156,31786,-9630
2,4,0,9,24,24006,29656,-5650
2,5,0,9,24,25911,27397,-1486
2,6,0,9,24,27767,25238,2529
2,0,0,10,24,22634,36081,-13447
2,1,0,10,24,22925,36211,-13286
2,2,0,10,24,24795,33791,-8996
2,3,0,10,24,26291,31373,-5082
2,4,0,10,24,27982,29203,-1221
2,0,0,11,24,25423,38216,-12793
2,1,0,11,24,27350,35508,-8158
2,2,0,11,24,28930,33179,-4249
2,0,0,12,24,29848,37314,-7466
3,0,0,1,1
3,0,1,1,1
3,0,2,1,1
3,0,3,1,1
3,0,4,1,1
3,0,5,1,1
3,0,6,1,1
3,0,7,1,1
3,0,8,1,1
3,0,9,1,1
3,0,10,1,1
3,0,11,1,1
3,0,12,1,1
3,0,13,1,1
3,0,14,1,1
3,0,15,1,1
3,0,16,1,1
3,0,17,1,1
3,0,18,1,1
3,0,19,1,1
3,0,20,1,1
3,0,21,1,1
3,1,0,1,1
3,1,1,1,1
3,1,2,1,1
3,1,3,1,1
3,1,4,1,1
3,1,5,1,1
3,1,6,1,1
3,1,7,1,1
3,1,8,1,1
3,1,9,1,1
3,1,10,1,1
3,1,11,1,1
3,1,12,1,1
3,1,13,1,1
3,1,14,1,1
3,1,15,1,1
3,1,16,1,1
3,1,17,1,1
3,1,18,1,1
3,1,19,1,1
3,1,20,1,1
3,1,21,1,1
3,2,0,1,1
3,2,1,1,1
3,2,2,1,1
3,2,3,1,1
3,2,4,1,1
3,2,5,1,1
3,2,6,1,1
3,2,7,1,1
3,2,8,1,1
3,2,9,1,1
3,2,10,1,1
3,2,11,1,1
3,2,12,1,1
3,2,13,1,1
3,2,14,1,1
3,2,15,1,1
3,2,16,1,1
3,2,17,1,1
3,2,18,1,1
3,2,19,1,1
3,2,20,1,1
3,2,21,1,1
3,3,0,1,1
3,3,1,1,1
3,3,2,1,1
3,3,3,1,1
3,3,4,1,1
3,3,5,1,1
3,3,6,1,1
3,3,7,1,1
3,3,8,1,1
3,3,9,1,1
3,3,10,1,1
3,3,11,1,1
3,3,12,1,1
3,3,13,1,1
3,3,14,1,1
3,3,15,1,1
3,3,16,1,1
3,3,17,1,1
3,3,18,1,1
3,3,19,1,1
3,3,20,1,1
3,3,21,1,1
3,4,0,1,1
3,4,1,1,1
3,4,2,1,1
3,4,3,1,1
3,4,4,1,1
3,4,5,1,1
3,4,6,1,1
3,4,7,1,1
3,4,8,1,1
3,4,9,1,1
3,4,10,1,1
3,4,11,1,1
3,4,12,1,1
3,4,13,1,1
3,4,14,1,1
3,4,15,1,1
3,4,16,1,1
3,4,17,1,1
3,4,18,1,1
3,4,19,1,1
3,4,20,1,1
3,4,21,1,1
3,5,0,1,1
3,5,1,1,1
3,5,2,1,1
3,5,3,1,1
3,5,4,1,1
3,5,5,1,1
3,5,6,1,1
3,5,7,1,1
3,5,8,1,1
3,5,9,1,1
3,5,10,1,1
3,5,11,1,1
3,5,12,1,1
3,5,13,1,1
3,5,14,1,1
3,5,15,1,1
3,5,16,1,1
3,5,17,1,1
3,5,18,1,1
3,5,19,1,1
3,5,20,1,1
3,5,21,1,1
3,6,0,1,1
3,6,1,1,1
3,6,2,1,1
3,6,3,1,1
3,6,4,1,1
3,6,5,1,1
3,6,6,1,1
3,6,7,1,1
3,6,8,1,1
3,6,9,1,1
3,6,10,1,1
3,6,11,1,1
3,6,12,1,1
3,6,13,1,1
3,6,14,1,1
3,6,15,1,1
3,6,16,1,1
3,6,17,1,1
3,6,18,1,1
3,6,19,1,1
3,6,20,1,1
3,6,21,1,1
3,7,0,1,1
3,7,1,1,1
3,7,2,1,1
3,7,3,1,1
3,7,4,1,1
3,7,5,1,1
3,7,6,1,1
3,7,7,1,1
3,7,8,1,1
3,7,9,1,1
3,7,10,1,1
3,7,11,1,1
3,7,12,1,1
3,7,13,1,1
3,7,14,1,1
3,7,15,1,1
3,7,16,1,1
3,7,17,1,1
3,7,18,1,1
3,7,19,1,1
3,7,20,1,1
3,7,21,1,1
3,8,0,1,1
3,8,1,1,1
3,8,2,1,1
3,8,3,1,1
3,8,4,1,1
3,8,5,1,1
3,8,6,1,1
3,8,7,1,1
3,8,8,1,1
3,8,9,1,1
3,8,10,1,1
3,8,11,1,1
3,8,12,1,1
3,8,13,1,1
3,8,14,1,1
3,8,15,1,1
3,8,16,1,1
3,8,17,1,1
3,8,18,1,1
3,8,19,1,1
3,8,20,1,1
3,8,21,1,1
3,9,0,1,1
3,9,1,1,1
3,9,2,1,1
3,9,3,1,1
3,9,4,1,1
3,9,5,1,1
3,9,6,1,1
3,9,7,1,1
3,9,8,1,1
3,9,9,1,1
3,9,10,1,1
3,9,11,1,1
3,9,12,1,1
3,9,13,1,1
3,9,14,1,1
3,9,15,1,1
3,9,16,1,1
3,9,17,1,1
3,9,18,1,1
3,9,19,1,1
3,9,20,1,1
3,9,21,1,1
3,10,0,1,1
3,10,1,1,1
3,10,2,1,1
3,10,3,1,1
3,10,4,1,1
3,10,5,1,1
3,10,6,1,1
3,10,7,1,1
3,10,8,1,1
3,10,9,1,1
3,10,10,1,1
3,10,11,1,1
3,10,12,1,1
3,10,13,1,1
3,10,14,1,1
3,10,15,1,1
3,10,16,1,1
3,10,17,1,1
3,10,18,1,1
3,10,19,1,1
3,10,20,1,1
3,10,21,1,1
3,11,0,1,1
3,11,1,1,1
3,11,2,1,1
3,11,3,1,1
3,11,4,1,1
3,11,5,1,1
3,11,6,1,1
3,11,7,1,1
3,11,8,1,1
3,11,9,1,1
3,11,10,1,1
3,11,11,1,1
3,11,12,1,1
3,11,13,1,1
3,11,14,1,1
3,11,15,1,1
3,11,16,1,1
3,11,17,1,1
3,11,18,1,1
3,11,19,1,1
3,11,20,1,1
3,11,21,1,1
3,12,0,1,1
3,12,1,1,1
3,12,2,1,1
3,12,3,1,1
3,12,4,1,1
3,12,5,1,1
3,12,6,1,1
3,12,7,1,1
3,12,8,1,1
3,12,9,1,1
3,12,10,1,1
3,12,11,1,1
3,12,12,1,1
3,12,13,1,1
3,12,14,1,1
3,12,15,1,1
3,12,16,1,1
3,12,17,1,1
3,12,18,1,1
3,12,19,1,1
3,12,20,1,1
3,12,21,1,1
3,13,0,1,1
3,13,1,1,1
3,13,2,1,1
3,13,3,1,1
3,13,4,1,1
3,13,5,1,1
3,13,6,1,1
3,13,7,1,1
3,13,8,1,1
3,13,9,1,1
3,13,10,1,1
3,13,11,1,1
3,13,12,1,1
3,13,13,1,1
3,13,14,1,1
3,13,15,1,1
3,13,16,1,1
3,13,17,1,1
3,13,18,1,1
3,13,19,1,1
3,13,20,1,1
3,13,21,1,1
3,14,0,1,1
3,14,1,1,1
3,14,2,1,1
3,14,3,1,1
3,14,4,1,1
3,14,5,1,1
3,14,6,1,1
3,14,7,1,1
3,14,8,1,1
3,14,9,1,1
3,14,10,1,1
3,14,11,1,1
3,14,12,1,1
3,14,13,1,1
3,14,14,1,1
3,14,15,1,1
3,14,16,1,1
3,14,17,1,1
3,14,18,1,1
3,14,19,1,1
3,14,20,1,1
3,14,21,1,1
3,15,0,1,1
3,15,1,1,1
3,15,2,1,1
3,15,3,1,1
3,15,4,1,1
3,15,5,1,1
3,15,6,1,1
3,15,7,1,1
3,15,8,1,1
3,15,9,1,1
3,15,10,1,1
3,15,11,1,1
3,15,12,1,1
3,15,13,1,1
3,15,14,1,1
3,15,15,1,1
3,15,16,1,1
3,15,17,1,1
3,15,18,1,1
3,15,19,1,1
3,15,20,1,1
3,15,21,1,1
3,16,0,1,1
3,16,1,1,1
3,16,2,1,1
3,16,3,1,1
3,16,4,1,1
3,16,5,1,1
3,16,6,1,1
3,16,7,1,1
3,16,8,1,1
3,16,9,1,1
3,16,10,1,1
3,16,11,1,1
3,16,12,1,1
3,16,13,1,1
3,16,14,1,1
3,16,15,1,1
3,16,16,1,1
3,16,17,1,1
3,16,18,1,1
3,16,19,1,1
3,16,20,1,1
3,16,21,1,1
3,17,0,1,1
3,17,1,1,1
3,17,2,1,1
3,17,3,1,1
3,17,4,1,1
3,17,5,1,1
3,17,6,1,1
3,17,7,1,1
3,17,8,1,1
3,17,9,1,1
3,17,10,1,1
3,17,11,1,1
3,17,12,1,1
3,17,13,1,1
3,17,14,1,1
3,17,15,1,1
3,17,16,1,1
3,17,17,1,1
3,17,18,1,1
3,17,19,1,1
3,17,20,1,1
3,17,21,1,1
3,18,0,1,1
3,18,1,1,1
3,18,2,1,1
3,18,3,1,1
3,18,4,1,1
3,18,5,1,1
3,18,6,1,1
3,18,7,1,1
3,18,8,1,1
3,18,9,1,1
3,18,10,1,1
3,18,11,1,1
3,18,12,1,1
3,18,13,1,1
3,18,14,1,1
3,18,15,1,1
3,18,16,1,1
3,18,17,1,1
3,18,18,1,1
3,18,19,1,1
3,18,20,1,1
3,18,21,1,1
3,19,0,1,1
3,19,1,1,1
3,19,2,1,1
3,19,3,1,1
3,19,4,1,1
3,19,5,1,1
3,19,6,1,1
3,19,7,1,1
3,19,8,1,1
3,19,9,1,1
3,19,10,1,1
3,19,11,1,1
3,19,12,1,1
3,19,13,1,1
3,19,14,1,1
3,19,15,1,1
3,19,16,1,1
3,19,17,1,1
3,19,18,1,1
3,19,19,1,1
3,19,20,1,1
3,19,21,1,1
3,20,0,1,1
3,20,1,1,1
3,20,2,1,1
3,20,3,1,1
3,20,4,1,1
3,20,5,1,1
3,20,6,1,1
3,20,7,1,1
3,20,8,1,1
3,20,9,1,1
3,20,10,1,1
3,20,11,1,1
3,20,12,1,1
3,20,13,1,1
3,20,14,1,1
3,20,15,1,1
3,20,16,1,1
3,20,17,1,1
3,20,18,1,1
3,20,19,1,1
3,20,20,1,1
3,20,21,1,1
3,21,0,1,1
3,21,1,1,1
3,21,2,1,1
3,21,3,1,1
3,21,4,1,1
3,21,5,1,1
3,21,6,1,1
3,21,7,1,1
3,21,8,1,1
3,21,9,1,1
3,21,10,1,1
3,21,11,1,1
3,21,12,1,1
3,21,13,1,1
3,21,14,1,1
3,21,15,1,1
3,21,16,1,1
3,21,17,1,1
3,21,18,1,1
3,21,19,1,1
3,21,20,1,1
3,21,21,1,1
3,22,0,1,1
3,22,1,1,1
3,22,2,1,1
3,22,3,1,1
3,22,4,1,1
3,22,5,1,1
3,22,6,1,1
3,22,7,1,1
3,22,8,1,1
3,22,9,1,1
3,22,10,1,1
3,22,11,1,1
3,22,12,1,1
3,22,13,1,1
3,22,14,1,1
3,22,15,1,1
3,22,16,1,1
3,22,17,1,1
3,22,18,1,1
3,22,19,1,1
3,22,20,1,1
3,22,21,1,1
3,23,0,1,1
3,23,1,1,1
3,23,2,1,1
3,23,3,1,1
3,23,4,1,1
3,23,5,1,1
3,23,6,1,1
3,23,7,1,1
3,23,8,1,1
3,23,9,1,1
3,23,10,1,1
3,23,11,1,1
3,23,12,1,1
3,23,13,1,1
3,23,14,1,1
3,23,15,1,1
3,23,16,1,1
3,23,17,1,1
3,23,18,1,1
3,23,19,1,1
3,23,20,1,1
3,23,21,1,1
3,0,0,2,1
3,0,1,2,1
3,0,2,2,1
3,0,3,2,1
3,0,4,2,1
3,0,5,2,1
3,0,6,2,1
3,0,7,2,1
3,0,8,2,1
3,0,9,2,1
3,0,10,2,1
3,0,11,2,1
3,0,12,2,1
3,0,13,2,1
3,0,14,2,1
3,0,15,2,1
3,0,16,2,1
3,0,17,2,1
3,0,18,2,1
3,0,19,2,1
3,0,20,2,1
3,0,21,2,1
3,1,0,2,1
3,1,1,2,1
3,1,2,2,1
3,1,3,2,1
3,1,4,2,1
3,1,5,2,1
3,1,6,2,1
3,1,7,2,1
3,1,8,2,1
3,1,9,2,1
3,1,10,2,1
3,1,11,2,1
3,1,12,2,1
3,1,13,2,1
3,1,14,2,1
3,1,15,2,1
3,1,16,2,1
3,1,17,2,1
3,1,18,2,1
3,1,19,2,1
3,1,20,2,1
3,1,21,2,1
3,2,0,2,1
3,2,1,2,1
3,2,2,2,1
3,2,3,2,1
3,2,4,2,1
3,2,5,2,1
3,2,6,2,1
3,2,7,2,1
3,2,8,2,1
3,2,9,2,1
3,2,10,2,1
3,2,11,2,1
3,2,12,2,1
3,2,13,2,1
3,2,14,2,1
3,2,15,2,1
3,2,16,2,1
3,2,17,2,1
3,2,18,2,1
3,2,19,2,1
3,2,20,2,1
3,2,21,2,1
3,3,0,2,1
3,3,1,2,1
3,3,2,2,1
3,3,3,2,1
3,3,4,2,1
3,3,5,2,1
3,3,6,2,1
3,3,7,2,1
3,3,8,2,1
3,3,9,2,1
3,3,10,2,1
3,3,11,2,1
3,3,12,2,1
3,3,13,2,1
3,3,14,2,1
3,3,15,2,1
3,3,16,2,1
3,3,17,2,1
3,3,18,2,1
3,3,19,2,1
3,3,20,2,1
3,3,21,2,1
3,4,0,2,1
3,4,1,2,1
3,4,2,2,1
3,4,3,2,1
3,4,4,2,1
3,4,5,2,1
3,4,6,2,1
3,4,7,2,1
3,4,8,2,1
3,4,9,2,1
3,4,10,2,1
3,4,11,2,1
3,4,12,2,1
3,4,13,2,1
3,4,14,2,1
3,4,15,2,1
3,4,16,2,1
3,4,17,2,1
3,4,18,2,1
3,4,19,2,1
3,4,20,2,1
3,4,21,2,1
3,5,0,2,1
3,5,1,2,1
3,5,2,2,1
3,5,3,2,1
3,5,4,2,1
3,5,5,2,1
3,5,6,2,1
3,5,7,2,1
3,5,8,2,1
3,5,9,2,1
3,5,10,2,1
3,5,11,2,1
3,5,12,2,1
3,5,13,2,1
3,5,14,2,1
3,5,15,2,1
3,5,16,2,1
3,5,17,2,1
3,5,18,2,1
3,5,19,2,1
3,5,20,2,1
3,5,21,2,1
3,6,0,2,1
3,6,1,2,1
3,6,2,2,1
3,6,3,2,1
3,6,4,2,1
3,6,5,2,1
3,6,6,2,1
3,6,7,2,1
3,6,8,2,1
3,6,9,2,1
3,6,10,2,1
3,6,11,2,1
3,6,12,2,1
3,6,13,2,1
3,6,14,2,1
3,6,15,2,1
3,6,16,2,1
3,6,17,2,1
3,6,18,2,1
3,6,19,2,1
3,6,20,2,1
3,6,21,2,1
3,7,0,2,1
3,7,1,2,1
3,7,2,2,1
3,7,3,2,1
3,7,4,2,1
3,7,5,2,1
3,7,6,2,1
3,7,7,2,1
3,7,8,2,1
3,7,9,2,1
3,7,10,2,1
3,7,11,2,1
3,7,12,2,1
3,7,13,2,1
3,7,14,2,1
3,7,15,2,1
3,7,16,2,1
3,7,17,2,1
3,7,18,2,1
3,7,19,2,1
3,7,20,2,1
3,7,21,2,1
3,8,0,2,1
3,8,1,2,1
3,8,2,2,1
3,8,3,2,1
3,8,4,2,1
3,8,5,2,1
3,8,6,2,1
3,8,7,2,1
3,8,8,2,1
3,8,9,2,1
3,8,10,2,1
3,8,11,2,1
3,8,12,2,1
3,8,13,2,1
3,8,14,2,1
3,8,15,2,1
3,8,16,2,1
3,8,17,2,1
3,8,18,2,1
3,8,19,2,1
3,8,20,2,1
3,8,21,2,1
3,9,0,2,1
3,9,1,2,1
3,9,2,2,1
3,9,3,2,1
3,9,4,2,1
3,9,5,2,1
3,9,6,2,1
3,9,7,2,1
3,9,8,2,1
3,9,9,2,1
3,9,10,2,1
3,9,11,2,1
3,9,12,2,1
3,9,13,2,1
3,9,14,2,1
3,9,15,2,1
3,9,16,2,1
3,9,17,2,1
3,9,18,2,1
3,9,19,2,1
3,9,20,2,1
3,9,21,2,1
3,10,0,2,1
3,10,1,2,1
3,10,2,2,1
3,10,3,2,1
3,10,4,2,1
3,10,5,2,1
3,10,6,2,1
3,10,7,2,1
3,10,8,2,1
3,10,9,2,1
3,10,10,2,1
3,10,11,2,1
3,10,12,2,1
3,10,13,2,1
3,10,14,2,1
3,10,15,2,1
3,10,16,2,1
3,10,17,2,1
3,10,18,2,1
3,10,19,2,1
3,10,20,2,1
3,10,21,2,1
3,11,0,2,1
3,11,1,2,1
3,11,2,2,1
3,11,3,2,1
3,11,4,2,1
3,11,5,2,1
3,11,6,2,1
3,11,7,2,1
3,11,8,2,1
3,11,9,2,1
3,11,10,2,1
3,11,11,2,1
3,11,12,2,1
3,11,13,2,1
3,11,14,2,1
3,11,15,2,1
3,11,16,2,1
3,11,17,2,1
3,11,18,2,1
3,11,19,2,1
3,11,20,2,1
3,11,21,2,1
3,12,0,2,1
3,12,1,2,1
3,12,2,2,1
3,12,3,2,1
3,12,4,2,1
3,12,5,2,1
3,12,6,2,1
3,12,7,2,1
3,12,8,2,1
3,12,9,2,1
3,12,10,2,1
3,12,11,2,1
3,12,12,2,1
3,12,13,2,1
3,12,14,2,1
3,12,15,2,1
3,12,16,2,1
3,12,17,2,1
3,12,18,2,1
3,12,19,2,1
3,12,20,2,1
3,12,21,2,1
3,13,0,2,1
3,13,1,2,1
3,13,2,2,1
3,13,3,2,1
3,13,4,2,1
3,13,5,2,1
3,13,6,2,1
3,13,7,2,1
3,13,8,2,1
3,13,9,2,1
3,13,10,2,1
3,13,11,2,1
3,13,12,2,1
3,13,13,2,1
3,13,14,2,1
3,13,15,2,1
3,13,16,2,1
3,13,17,2,1
3,13,18,2,1
3,13,19,2,1
3,13,20,2,1
3,13,21,2,1
3,14,0,2,1
3,14,1,2,1
3,14,2,2,1
3,14,3,2,1
3,14,4,2,1
3,14,5,2,1
3,14,6,2,1
3,14,7,2,1
3,14,8,2,1
3,14,9,2,1
3,14,10,2,1
3,14,11,2,1
3,14,12,2,1
3,14,13,2,1
3,14,14,2,1
3,14,15,2,1
3,14,16,2,1
3,14,17,2,1
3,14,18,2,1
3,14,19,2,1
3,14,20,2,1
3,14,21,2,1
3,15,0,2,1
3,15,1,2,1
3,15,2,2,1
3,15,3,2,1
3,15,4,2,1
3,15,5,2,1
3,15,6,2,1
3,15,7,2,1
3,15,8,2,1
3,15,9,2,1
3,15,10,2,1
3,15,11,2,1
3,15,12,2,1
3,15,13,2,1
3,15,14,2,1
3,15,15,2,1
3,15,16,2,1
3,15,17,2,1
3,15,18,2,1
3,15,19,2,1
3,15,20,2,1
3,15,21,2,1
3,16,0,2,1
3,16,1,2,1
3,16,2,2,1
3,16,3,2,1
3,16,4,2,1
3,16,5,2,1
3,16,6,2,1
3,16,7,2,1
3,16,8,2,1
3,16,9,2,1
3,16,10,2,1
3,16,11,2,1
3,16,12,2,1
3,16,13,2,1
3,16,14,2,1
3,16,15,2,1
3,16,16,2,1
3,16,17,2,1
3,16,18,2,1
3,16,19,2,1
3,16,20,2,1
3,16,21,2,1
3,17,0,2,1
3,17,1,2,1
3,17,2,2,1
3,17,3,2,1
3,17,4,2,1
3,17,5,2,1
3,17,6,2,1
3,17,7,2,1
3,17,8,2,1
3,17,9,2,1
3,17,10,2,1
3,17,11,2,1
3,17,12,2,1
3,17,13,2,1
3,17,14,2,1
3,17,15,2,1
3,17,16,2,1
3,17,17,2,1
3,17,18,2,1
3,17,19,2,1
3,17,20,2,1
3,17,21,2,1
3,18,0,2,1
3,18,1,2,1
3,18,2,2,1
3,18,3,2,1
3,18,4,2,1
3,18,5,2,1
3,18,6,2,1
3,18,7,2,1
3,18,8,2,1
3,18,9,2,1
3,18,10,2,1
3,18,11,2,1
3,18,12,2,1
3,18,13,2,1
3,18,14,2,1
3,18,15,2,1
3,18,16,2,1
3,18,17,2,1
3,18,18,2,1
3,18,19,2,1
3,18,20,2,1
3,18,21,2,1
3,19,0,2,1
3,19,1,2,1
3,19,2,2,1
3,19,3,2,1
3,19,4,2,1
3,19,5,2,1
3,19,6,2,1
3,19,7,2,1
3,19,8,2,1
3,19,9,2,1
3,19,10,2,1
3,19,11,2,1
3,19,12,2,1
3,19,13,2,1
3,19,14,2,1
3,19,15,2,1
3,19,16,2,1
3,19,17,2,1
3,19,18,2,1
3,19,19,2,1
3,19,20,2,1
3,19,21,2,1
3,20,0,2,1
3,20,1,2,1
3,20,2,2,1
3,20,3,2,1
3,20,4,2,1
3,20,5,2,1
3,20,6,2,1
3,20,7,2,1
3,20,8,2,1
3,20,9,2,1
3,20,10,2,1
3,20,11,2,1
3,20,12,2,1
3,20,13,2,1
3,20,14,2,1
3,20,15,2,1
3,20,16,2,1
3,20,17,2,1
3,20,18,2,1
3,20,19,2,1
3,20,20,2,1
3,20,21,2,1
3,21,0,2,1
3,21,1,2,1
3,21,2,2,1
3,21,3,2,1
3,21,4,2,1
3,21,5,2,1
3,21,6,2,1
3,21,7,2,1
3,21,8,2,1
3,21,9,2,1
3,21,10,2,1
3,21,11,2,1
3,21,12,2,1
3,21,13,2,1
3,21,14,2,1
3,21,15,2,1
3,21,16,2,1
3,21,17,2,1
3,21,18,2,1
3,21,19,2,1
3,21,20,2,1
3,21,21,2,1
3,22,0,2,1
3,22,1,2,1
3,22,2,2,1
3,22,3,2,1
3,22,4,2,1
3,22,5,2,1
3,22,6,2,1
3,22,7,2,1
3,22,8,2,1
3,22,9,2,1
3,22,10,2,1
3,22,11,2,1
3,22,12,2,1
3,22,13,2,1
3,22,14,2,1
3,22,15,2,1
3,22,16,2,1
3,22,17,2,1
3,22,18,2,1
3,22,19,2,1
3,22,20,2,1
3,22,21,2,1
3,0,0,3,1
3,0,1,3,1
3,0,2,3,1
3,0,3,3,1
3,0,4,3,1
3,0,5,3,1
3,0,6,3,1
3,0,7,3,1
3,0,8,3,1
3,0,9,3,1
3,0,10,3,1
3,0,11,3,1
3,0,12,3,1
3,0,13,3,1
3,0,14,3,1
3,0,15,3,1
3,0,16,3,1
3,0,17,3,1
3,0,18,3,1
3,0,19,3,1
3,0,20,3,1
3,0,21,3,1
3,1,0,3,1
3,1,1,3,1
3,1,2,3,1
3,1,3,3,1
3,1,4,3,1
3,1,5,3,1
3,1,6,3,1
3,1,7,3,1
3,1,8,3,1
3,1,9,3,1
3,1,10,3,1
3,1,11,3,1
3,1,12,3,1
3,1,13,3,1
3,1,14,3,1
3,1,15,3,1
3,1,16,3,1
3,1,17,3,1
3,1,18,3,1
3,1,19,3,1
3,1,20,3,1
3,1,21,3,1
3,2,0,3,1
3,2,1,3,1
3,2,2,3,1
3,2,3,3,1
3,2,4,3,1
3,2,5,3,1
3,2,6,3,1
3,2,7,3,1
3,2,8,3,1
3,2,9,3,1
3,2,10,3,1
3,2,11,3,1
3,2,12,3,1
3,2,13,3,1
3,2,14,3,1
3,2,15,3,1
3,2,16,3,1
3,2,17,3,1
3,2,18,3,1
3,2,19,3,1
3,2,20,3,1
3,2,21,3,1
3,3,0,3,1
3,3,1,3,1
3,3,2,3,1
3,3,3,3,1
3,3,4,3,1
3,3,5,3,1
3,3,6,3,1
3,3,7,3,1
3,3,8,3,1
3,3,9,3,1
3,3,10,3,1
3,3,11,3,1
3,3,12,3,1
3,3,13,3,1
3,3,14,3,1
3,3,15,3,1
3,3,16,3,1
3,3,17,3,1
3,3,18,3,1
3,3,19,3,1
3,3,20,3,1
3,3,21,3,1
3,4,0,3,1
3,4,1,3,1
3,4,2,3,1
3,4,3,3,1
3,4,4,3,1
3,4,5,3,1
3,4,6,3,1
3,4,7,3,1
3,4,8,3,1
3,4,9,3,1
3,4,10,3,1
3,4,11,3,1
3,4,12,3,1
3,4,13,3,1
3,4,14,3,1
3,4,15,3,1
3,4,16,3,1
3,4,17,3,1
3,4,18,3,1
3,4,19,3,1
3,4,20,3,1
3,4,21,3,1
3,5,0,3,1
3,5,1,3,1
3,5,2,3,1
3,5,3,3,1
3,5,4,3,1
3,5,5,3,1
3,5,6,3,1
3,5,7,3,1
3,5,8,3,1
3,5,9,3,1
3,5,10,3,1
3,5,11,3,1
3,5,12,3,1
3,5,13,3,1
3,5,14,3,1
3,5,15,3,1
3,5,16,3,1
3,5,17,3,1
3,5,18,3,1
3,5,19,3,1
3,5,20,3,1
3,5,21,3,1
3,6,0,3,1
3,6,1,3,1
3,6,2,3,1
3,6,3,3,1
3,6,4,3,1
3,6,5,3,1
3,6,6,3,1
3,6,7,3,1
3,6,8,3,1
3,6,9,3,1
3,6,10,3,1
3,6,11,3,1
3,6,12,3,1
3,6,13,3,1
3,6,14,3,1
3,6,15,3,1
3,6,16,3,1
3,6,17,3,1
3,6,18,3,1
3,6,19,3,1
3,6,20,3,1
3,6,21,3,1
3,7,0,3,1
3,7,1,3,1
3,7,2,3,1
3,7,3,3,1
3,7,4,3,1
3,7,5,3,1
3,7,6,3,1
3,7,7,3,1
3,7,8,3,1
3,7,9,3,1
3,7,10,3,1
3,7,11,3,1
3,7,12,3,1
3,7,13,3,1
3,7,14,3,1
3,7,15,3,1
3,7,16,3,1
3,7,17,3,1
3,7,18,3,1
3,7,19,3,1
3,7,20,3,1
3,7,21,3,1
3,8,0,3,1
3,8,1,3,1
3,8,2,3,1
3,8,3,3,1
3,8,4,3,1
3,8,5,3,1
3,8,6,3,1
3,8,7,3,1
3,8,8,3,1
3,8,9,3,1
3,8,10,3,1
3,8,11,3,1
3,8,12,3,1
3,8,13,3,1
3,8,14,3,1
3,8,15,3,1
3,8,16,3,1
3,8,17,3,1
3,8,18,3,1
3,8,19,3,1
3,8,20,3,1
3,8,21,3,1
3,9,0,3,1
3,9,1,3,1
3,9,2,3,1
3,9,3,3,1
3,9,4,3,1
3,9,5,3,1
3,9,6,3,1
3,9,7,3,1
3,9,8,3,1
3,9,9,3,1
3,9,10,3,1
3,9,11,3,1
3,9,12,3,1
3,9,13,3,1
3,9,14,3,1
3,9,15,3,1
3,9,16,3,1
3,9,17,3,1
3,9,18,3,1
3,9,19,3,1
3,9,20,3,1
3,9,21,3,1
3,10,0,3,1
3,10,1,3,1
3,10,2,3,1
3,10,3,3,1
3,10,4,3,1
3,10,5,3,1
3,10,6,3,1
3,10,7,3,1
3,10,8,3,1
3,10,9,3,1
3,10,10,3,1
3,10,11,3,1
3,10,12,3,1
3,10,13,3,1
3,10,14,3,1
3,10,15,3,1
3,10,16,3,1
3,10,17,3,1
3,10,18,3,1
3,10,19,3,1
3,10,20,3,1
3,10,21,3,1
3,11,0,3,1
3,11,1,3,1
3,11,2,3,1
3,11,3,3,1
3,11,4,3,1
3,11,5,3,1
3,11,6,3,1
3,11,7,3,1
3,11,8,3,1
3,11,9,3,1
3,11,10,3,1
3,11,11,3,1
3,11,12,3,1
3,11,13,3,1
3,11,14,3,1
3,11,15,3,1
3,11,16,3,1
3,11,17,3,1
3,11,18,3,1
3,11,19,3,1
3,11,20,3,1
3,11,21,3,1
3,12,0,3,1
3,12,1,3,1
3,12,2,3,1
3,12,3,3,1
3,12,4,3,1
3,12,5,3,1
3,12,6,3,1
3,12,7,3,1
3,12,8,3,1
3,12,9,3,1
3,12,10,3,1
3,12,11,3,1
3,12,12,3,1
3,12,13,3,1
3,12,14,3,1
3,12,15,3,1
3,12,16,3,1
3,12,17,3,1
3,12,18,3,1
3,12,19,3,1
3,12,20,3,1
3,12,21,3,1
3,13,0,3,1
3,13,1,3,1
3,13,2,3,1
3,13,3,3,1
3,13,4,3,1
3,13,5,3,1
3,13,6,3,1
3,13,7,3,1
3,13,8,3,1
3,13,9,3,1
3,13,10,3,1
3,13,11,3,1
3,13,12,3,1
3,13,13,3,1
3,13,14,3,1
3,13,15,3,1
3,13,16,3,1
3,13,17,3,1
3,13,18,3,1
3,13,19,3,1
3,13,20,3,1
3,13,21,3,1
3,14,0,3,1
3,14,1,3,1
3,14,2,3,1
3,14,3,3,1
3,14,4,3,1
3,14,5,3,1
3,14,6,3,1
3,14,7,3,1
3,14,8,3,1
3,14,9,3,1
3,14,10,3,1
3,14,11,3,1
3,14,12,3,1
3,14,13,3,1
3,14,14,3,1
3,14,15,3,1
3,14,16,3,1
3,14,17,3,1
3,14,18,3,1
3,14,19,3,1
3,14,20,3,1
3,14,21,3,1
3,15,0,3,1
3,15,1,3,1
3,15,2,3,1
3,15,3,3,1
3,15,4,3,1
3,15,5,3,1
3,15,6,3,1
3,15,7,3,1
3,15,8,3,1
3,15,9,3,1
3,15,10,3,1
3,15,11,3,1
3,15,12,3,1
3,15,13,3,1
3,15,14,3,1
3,15,15,3,1
3,15,16,3,1
3,15,17,3,1
3,15,18,3,1
3,15,19,3,1
3,15,20,3,1
3,15,21,3,1
3,16,0,3,1
3,16,1,3,1
3,16,2,3,1
3,16,3,3,1
3,16,4,3,1
3,16,5,3,1
3,16,6,3,1
3,16,7,3,1
3,16,8,3,1
3,16,9,3,1
3,16,10,3,1
3,16,11,3,1
3,16,12,3,1
3,16,13,3,1
3,16,14,3,1
3,16,15,3,1
3,16,16,3,1
3,16,17,3,1
3,16,18,3,1
3,16,19,3,1
3,16,20,3,1
3,16,21,3,1
3,17,0,3,1
3,17,1,3,1
3,17,2,3,1
3,17,3,3,1
3,17,4,3,1
3,17,5,3,1
3,17,6,3,1
3,17,7,3,1
3,17,8,3,1
3,17,9,3,1
3,17,10,3,1
3,17,11,3,1
3,17,12,3,1
3,17,13,3,1
3,17,14,3,1
3,17,15,3,1
3,17,16,3,1
3,17,17,3,1
3,17,18,3,1
3,17,19,3,1
3,17,20,3,1
3,17,21,3,1
3,18,0,3,1
3,18,1,3,1
3,18,2,3,1
3,18,3,3,1
3,18,4,3,1
3,18,5,3,1
3,18,6,3,1
3,18,7,3,1
3,18,8,3,1
3,18,9,3,1
3,18,10,3,1
3,18,11,3,1
3,18,12,3,1
3,18,13,3,1
3,18,14,3,1
3,18,15,3,1
3,18,16,3,1
3,18,17,3,1
3,18,18,3,1
3,18,19,3,1
3,18,20,3,1
3,18,21,3,1
3,19,0,3,1
3,19,1,3,1
3,19,2,3,1
3,19,3,3,1
3,19,4,3,1
3,19,5,3,1
3,19,6,3,1
3,19,7,3,1
3,19,8,3,1
3,19,9,3,1
3,19,10,3,1
3,19,11,3,1
3,19,12,3,1
3,19,13,3,1
3,19,14,3,1
3,19,15,3,1
3,19,16,3,1
3,19,17,3,1
3,19,18,3,1
3,19,19,3,1
3,19,20,3,1
3,19,21,3,1
3,20,0,3,1
3,20,1,3,1
3,20,2,3,1
3,20,3,3,1
3,20,4,3,1
3,20,5,3,1
3,20,6,3,1
3,20,7,3,1
3,20,8,3,1
3,20,9,3,1
3,20,10,3,1
3,20,11,3,1
3,20,12,3,1
3,20,13,3,1
3,20,14,3,1
3,20,15,3,1
3,20,16,3,1
3,20,17,3,1
3,20,18,3,1
3,20,19,3,1
3,20,20,3,1
3,20,21,3,1
3,21,0,3,1
3,21,1,3,1
3,21,2,3,1
3,21,3,3,1
3,21,4,3,1
3,21,5,3,1
3,21,6,3,1
3,21,7,3,1
3,21,8,3,1
3,21,9,3,1
3,21,10,3,1
3,21,11,3,1
3,21,12,3,1
3,21,13,3,1
3,21,14,3,1
3,21,15,3,1
3,21,16,3,1
3,21,17,3,1
3,21,18,3,1
3,21,19,3,1
3,21,20,3,1
3,21,21,3,1
3,0,0,4,1
3,0,1,4,1
3,0,2,4,1
3,0,3,4,1
3,0,4,4,1
3,0,5,4,1
3,0,6,4,1
3,0,7,4,1
3,0,8,4,1
3,0,9,4,1
3,0,10,4,1
3,0,11,4,1
3,0,12,4,1
3,0,13,4,1
3,0,14,4,1
3,0,15,4,1
3,0,16,4,1
3,0,17,4,1
3,0,18,4,1
3,0,19,4,1
3,0,20,4,1
3,0,21,4,1
3,1,0,4,1
3,1,1,4,1
3,1,2,4,1
3,1,3,4,1
3,1,4,4,1
3,1,5,4,1
3,1,6,4,1
3,1,7,4,1
3,1,8,4,1
3,1,9,4,1
3,1,10,4,1
3,1,11,4,1
3,1,12,4,1
3,1,13,4,1
3,1,14,4,1
3,1,15,4,1
3,1,16,4,1
3,1,17,4,1
3,1,18,4,1
3,1,19,4,1
3,1,20,4,1
3,1,21,4,1
3,2,0,4,1
3,2,1,4,1
3,2,2,4,1
3,2,3,4,1
3,2,4,4,1
3,2,5,4,1
3,2,6,4,1
3,2,7,4,1
3,2,8,4,1
3,2,9,4,1
3,2,10,4,1
3,2,11,4,1
3,2,12,4,1
3,2,13,4,1
3,2,14,4,1
3,2,15,4,1
3,2,16,4,1
3,2,17,4,1
3,2,18,4,1
3,2,19,4,1
3,2,20,4,1
3,2,21,4,1
3,3,0,4,1
3,3,1,4,1
3,3,2,4,1
3,3,3,4,1
3,3,4,4,1
3,3,5,4,1
3,3,6,4,1
3,3,7,4,1
3,3,8,4,1
3,3,9,4,1
3,3,10,4,1
3,3,11,4,1
3,3,12,4,1
3,3,13,4,1
3,3,14,4,1
3,3,15,4,1
3,3,16,4,1
3,3,17,4,1
3,3,18,4,1
3,3,19,4,1
3,3,20,4,1
3,3,21,4,1
3,4,0,4,1
3,4,1,4,1
3,4,2,4,1
3,4,3,4,1
3,4,4,4,1
3,4,5,4,1
3,4,6,4,1
3,4,7,4,1
3,4,8,4,1
3,4,9,4,1
3,4,10,4,1
3,4,11,4,1
3,4,12,4,1
3,4,13,4,1
3,4,14,4,1
3,4,15,4,1
3,4,16,4,1
3,4,17,4,1
3,4,18,4,1
3,4,19,4,1
3,4,20,4,1
3,4,21,4,1
3,5,0,4,1
3,5,1,4,1
3,5,2,4,1
3,5,3,4,1
3,5,4,4,1
3,5,5,4,1
3,5,6,4,1
3,5,7,4,1
3,5,8,4,1
3,5,9,4,1
3,5,10,4,1
3,5,11,4,1
3,5,12,4,1
3,5,13,4,1
3,5,14,4,1
3,5,15,4,1
3,5,16,4,1
3,5,17,4,1
3,5,18,4,1
3,5,19,4,1
3,5,20,4,1
3,5,21,4,1
3,6,0,4,1
3,6,1,4,1
3,6,2,4,1
3,6,3,4,1
3,6,4,4,1
3,6,5,4,1
3,6,6,4,1
3,6,7,4,1
3,6,8,4,1
3,6,9,4,1
3,6,10,4,1
3,6,11,4,1
3,6,12,4,1
3,6,13,4,1
3,6,14,4,1
3,6,15,4,1
3,6,16,4,1
3,6,17,4,1
3,6,18,4,1
3,6,19,4,1
3,6,20,4,1
3,6,21,4,1
3,7,0,4,1
3,7,1,4,1
3,7,2,4,1
3,7,3,4,1
3,7,4,4,1
3,7,5,4,1
3,7,6,4,1
3,7,7,4,1
3,7,8,4,1
3,7,9,4,1
3,7,10,4,1
3,7,11,4,1
3,7,12,4,1
3,7,13,4,1
3,7,14,4,1
3,7,15,4,1
3,7,16,4,1
3,7,17,4,1
3,7,18,4,1
3,7,19,4,1
3,7,20,4,1
3,7,21,4,1
3,8,0,4,1
3,8,1,4,1
3,8,2,4,1
3,8,3,4,1
3,8,4,4,1
3,8,5,4,1
3,8,6,4,1
3,8,7,4,1
3,8,8,4,1
3,8,9,4,1
3,8,10,4,1
3,8,11,4,1
3,8,12,4,1
3,8,13,4,1
3,8,14,4,1
3,8,15,4,1
3,8,16,4,1
3,8,17,4,1
3,8,18,4,1
3,8,19,4,1
3,8,20,4,1
3,8,21,4,1
3,9,0,4,1
3,9,1,4,1
3,9,2,4,1
3,9,3,4,1
3,9,4,4,1
3,9,5,4,1
3,9,6,4,1
3,9,7,4,1
3,9,8,4,1
3,9,9,4,1
3,9,10,4,1
3,9,11,4,1
3,9,12,4,1
3,9,13,4,1
3,9,14,4,1
3,9,15,4,1
3,9,16,4,1
3,9,17,4,1
3,9,18,4,1
3,9,19,4,1
3,9,20,4,1
3,9,21,4,1
3,10,0,4,1
3,10,1,4,1
3,10,2,4,1
3,10,3,4,1
3,10,4,4,1
3,10,5,4,1
3,10,6,4,1
3,10,7,4,1
3,10,8,4,1
3,10,9,4,1
3,10,10,4,1
3,10,11,4,1
3,10,12,4,1
3,10,13,4,1
3,10,14,4,1
3,10,15,4,1
3,10,16,4,1
3,10,17,4,1
3,10,18,4,1
3,10,19,4,1
3,10,20,4,1
3,10,21,4,1
3,11,0,4,1
3,11,1,4,1
3,11,2,4,1
3,11,3,4,1
3,11,4,4,1
3,11,5,4,1
3,11,6,4,1
3,11,7,4,1
3,11,8,4,1
3,11,9,4,1
3,11,10,4,1
3,11,11,4,1
3,11,12,4,1
3,11,13,4,1
3,11,14,4,1
3,11,15,4,1
3,11,16,4,1
3,11,17,4,1
3,11,18,4,1
3,11,19,4,1
3,11,20,4,1
3,11,21,4,1
3,12,0,4,1
3,12,1,4,1
3,12,2,4,1
3,12,3,4,1
3,12,4,4,1
3,12,5,4,1
3,12,6,4,1
3,12,7,4,1
3,12,8,4,1
3,12,9,4,1
3,12,10,4,1
3,12,11,4,1
3,12,12,4,1
3,12,13,4,1
3,12,14,4,1
3,12,15,4,1
3,12,16,4,1
3,12,17,4,1
3,12,18,4,1
3,12,19,4,1
3,12,20,4,1
3,12,21,4,1
3,13,0,4,1
3,13,1,4,1
3,13,2,4,1
3,13,3,4,1
3,13,4,4,1
3,13,5,4,1
3,13,6,4,1
3,13,7,4,1
3,13,8,4,1
3,13,9,4,1
3,13,10,4,1
3,13,11,4,1
3,13,12,4,1
3,13,13,4,1
3,13,14,4,1
3,13,15,4,1
3,13,16,4,1
3,13,17,4,1
3,13,18,4,1
3,13,19,4,1
3,13,20,4,1
3,13,21,4,1
3,14,0,4,1
3,14,1,4,1
3,14,2,4,1
3,14,3,4,1
3,14,4,4,1
3,14,5,4,1
3,14,6,4,1
3,14,7,4,1
3,14,8,4,1
3,14,9,4,1
3,14,10,4,1
3,14,11,4,1
3,14,12,4,1
3,14,13,4,1
3,14,14,4,1
3,14,15,4,1
3,14,16,4,1
3,14,17,4,1
3,14,18,4,1
3,14,19,4,1
3,14,20,4,1
3,14,21,4,1
3,15,0,4,1
3,15,1,4,1
3,15,2,4,1
3,15,3,4,1
3,15,4,4,1
3,15,5,4,1
3,15,6,4,1
3,15,7,4,1
3,15,8,4,1
3,15,9,4,1
3,15,10,4,1
3,15,11,4,1
3,15,12,4,1
3,15,13,4,1
3,15,14,4,1
3,15,15,4,1
3,15,16,4,1
3,15,17,4,1
3,15,18,4,1
3,15,19,4,1
3,15,20,4,1
3,15,21,4,1
3,16,0,4,1
3,16,1,4,1
3,16,2,4,1
3,16,3,4,1
3,16,4,4,1
3,16,5,4,1
3,16,6,4,1
3,16,7,4,1
3,16,8,4,1
3,16,9,4,1
3,16,10,4,1
3,16,11,4,1
3,16,12,4,1
3,16,13,4,1
3,16,14,4,1
3,16,15,4,1
3,16,16,4,1
3,16,17,4,1
3,16,18,4,1
3,16,19,4,1
3,16,20,4,1
3,16,21,4,1
3,17,0,4,1
3,17,1,4,1
3,17,2,4,1
3,17,3,4,1
3,17,4,4,1
3,17,5,4,1
3,17,6,4,1
3,17,7,4,1
3,17,8,4,1
3,17,9,4,1
3,17,10,4,1
3,17,11,4,1
3,17,12,4,1
3,17,13,4,1
3,17,14,4,1
3,17,15,4,1
3,17,16,4,1
3,17,17,4,1
3,17,18,4,1
3,17,19,4,1
3,17,20,4,1
3,17,21,4,1
3,18,0,4,1
3,18,1,4,1
3,18,2,4,1
3,18,3,4,1
3,18,4,4,1
3,18,5,4,1
3,18,6,4,1
3,18,7,4,1
3,18,8,4,1
3,18,9,4,1
3,18,10,4,1
3,18,11,4,1
3,18,12,4,1
3,18,13,4,1
3,18,14,4,1
3,18,15,4,1
3,18,16,4,1
3,18,17,4,1
3,18,18,4,1
3,18,19,4,1
3,18,20,4,1
3,18,21,4,1
3,19,0,4,1
3,19,1,4,1
3,19,2,4,1
3,19,3,4,1
3,19,4,4,1
3,19,5,4,1
3,19,6,4,1
3,19,7,4,1
3,19,8,4,1
3,19,9,4,1
3,19,10,4,1
3,19,11,4,1
3,19,12,4,1
3,19,13,4,1
3,19,14,4,1
3,19,15,4,1
3,19,16,4,1
3,19,17,4,1
3,19,18,4,1
3,19,19,4,1
3,19,20,4,1
3,19,21,4,1
3,20,0,4,1
3,20,1,4,1
3,20,2,4,1
3,20,3,4,1
3,20,4,4,1
3,20,5,4,1
3,20,6,4,1
3,20,7,4,1
3,20,8,4,1
3,20,9,4,1
3,20,10,4,1
3,20,11,4,1
3,20,12,4,1
3,20,13,4,1
3,20,14,4,1
3,20,15,4,1
3,20,16,4,1
3,20,17,4,1
3,20,18,4,1
3,20,19,4,1
3,20,20,4,1
3,20,21,4,1
3,0,0,5,1
3,0,1,5,1
3,0,2,5,1
3,0,3,5,1
3,0,4,5,1
3,0,5,5,1
3,0,6,5,1
3,0,7,5,1
3,0,8,5,1
3,0,9,5,1
3,0,10,5,1
3,0,11,5,1
3,0,12,5,1
3,0,13,5,1
3,0,14,5,1
3,0,15,5,1
3,0,16,5,1
3,0,17,5,1
3,0,18,5,1
3,0,19,5,1
3,0,20,5,1
3,0,21,5,1
3,1,0,5,1
3,1,1,5,1
3,1,2,5,1
3,1,3,5,1
3,1,4,5,1
3,1,5,5,1
3,1,6,5,1
3,1,7,5,1
3,1,8,5,1
3,1,9,5,1
3,1,10,5,1
3,1,11,5,1
3,1,12,5,1
3,1,13,5,1
3,1,14,5,1
3,1,15,5,1
3,1,16,5,1
3,1,17,5,1
3,1,18,5,1
3,1,19,5,1
3,1,20,5,1
3,1,21,5,1
3,2,0,5,1
3,2,1,5,1
3,2,2,5,1
3,2,3,5,1
3,2,4,5,1
3,2,5,5,1
3,2,6,5,1
3,2,7,5,1
3,2,8,5,1
3,2,9,5,1
3,2,10,5,1
3,2,11,5,1
3,2,12,5,1
3,2,13,5,1
3,2,14,5,1
3,2,15,5,1
3,2,16,5,1
3,2,17,5,1
3,2,18,5,1
3,2,19,5,1
3,2,20,5,1
3,2,21,5,1
3,3,0,5,1
3,3,1,5,1
3,3,2,5,1
3,3,3,5,1
3,3,4,5,1
3,3,5,5,1
3,3,6,5,1
3,3,7,5,1
3,3,8,5,1
3,3,9,5,1
3,3,10,5,1
3,3,11,5,1
3,3,12,5,1
3,3,13,5,1
3,3,14,5,1
3,3,15,5,1
3,3,16,5,1
3,3,17,5,1
3,3,18,5,1
3,3,19,5,1
3,3,20,5,1
3,3,21,5,1
3,4,0,5,1
3,4,1,5,1
3,4,2,5,1
3,4,3,5,1
3,4,4,5,1
3,4,5,5,1
3,4,6,5,1
3,4,7,5,1
3,4,8,5,1
3,4,9,5,1
3,4,10,5,1
3,4,11,5,1
3,4,12,5,1
3,4,13,5,1
3,4,14,5,1
3,4,15,5,1
3,4,16,5,1
3,4,17,5,1
3,4,18,5,1
3,4,19,5,1
3,4,20,5,1
3,4,21,5,1
3,5,0,5,1
3,5,1,5,1
3,5,2,5,1
3,5,3,5,1
3,5,4,5,1
3,5,5,5,1
3,5,6,5,1
3,5,7,5,1
3,5,8,5,1
3,5,9,5,1
3,5,10,5,1
3,5,11,5,1
3,5,12,5,1
3,5,13,5,1
3,5,14,5,1
3,5,15,5,1
3,5,16,5,1
3,5,17,5,1
3,5,18,5,1
3,5,19,5,1
3,5,20,5,1
3,5,21,5,1
3,6,0,5,1
3,6,1,5,1
3,6,2,5,1
3,6,3,5,1
3,6,4,5,1
3,6,5,5,1
3,6,6,5,1
3,6,7,5,1
3,6,8,5,1
3,6,9,5,1
3,6,10,5,1
3,6,11,5,1
3,6,12,5,1
3,6,13,5,1
3,6,14,5,1
3,6,15,5,1
3,6,16,5,1
3,6,17,5,1
3,6,18,5,1
3,6,19,5,1
3,6,20,5,1
3,6,21,5,1
3,7,0,5,1
3,7,1,5,1
3,7,2,5,1
3,7,3,5,1
3,7,4,5,1
3,7,5,5,1
3,7,6,5,1
3,7,7,5,1
3,7,8,5,1
3,7,9,5,1
3,7,10,5,1
3,7,11,5,1
3,7,12,5,1
3,7,13,5,1
3,7,14,5,1
3,7,15,5,1
3,7,16,5,1
3,7,17,5,1
3,7,18,5,1
3,7,19,5,1
3,7,20,5,1
3,7,21,5,1
3,8,0,5,1
3,8,1,5,1
3,8,2,5,1
3,8,3,5,1
3,8,4,5,1
3,8,5,5,1
3,8,6,5,1
3,8,7,5,1
3,8,8,5,1
3,8,9,5,1
3,8,10,5,1
3,8,11,5,1
3,8,12,5,1
3,8,13,5,1
3,8,14,5,1
3,8,15,5,1
3,8,16,5,1
3,8,17,5,1
3,8,18,5,1
3,8,19,5,1
3,8,20,5,1
3,8,21,5,1
3,9,0,5,1
3,9,1,5,1
3,9,2,5,1
3,9,3,5,1
3,9,4,5,1
3,9,5,5,1
3,9,6,5,1
3,9,7,5,1
3,9,8,5,1
3,9,9,5,1
3,9,10,5,1
3,9,11,5,1
3,9,12,5,1
3,9,13,5,1
3,9,14,5,1
3,9,15,5,1
3,9,16,5,1
3,9,17,5,1
3,9,18,5,1
3,9,19,5,1
3,9,20,5,1
3,9,21,5,1
3,10,0,5,1
3,10,1,5,1
3,10,2,5,1
3,10,3,5,1
3,10,4,5,1
3,10,5,5,1
3,10,6,5,1
3,10,7,5,1
3,10,8,5,1
3,10,9,5,1
3,10,10,5,1
3,10,11,5,1
3,10,12,5,1
3,10,13,5,1
3,10,14,5,1
3,10,15,5,1
3,10,16,5,1
3,10,17,5,1
3,10,18,5,1
3,10,19,5,1
3,10,20,5,1
3,10,21,5,1
3,11,0,5,1
3,11,1,5,1
3,11,2,5,1
3,11,3,5,1
3,11,4,5,1
3,11,5,5,1
3,11,6,5,1
3,11,7,5,1
3,11,8,5,1
3,11,9,5,1
3,11,10,5,1
3,11,11,5,1
3,11,12,5,1
3,11,13,5,1
3,11,14,5,1
3,11,15,5,1
3,11,16,5,1
3,11,17,5,1
3,11,18,5,1
3,11,19,5,1
3,11,20,5,1
3,11,21,5,1
3,12,0,5,1
3,12,1,5,1
3,12,2,5,1
3,12,3,5,1
3,12,4,5,1
3,12,5,5,1
3,12,6,5,1
3,12,7,5,1
3,12,8,5,1
3,12,9,5,1
3,12,10,5,1
3,12,11,5,1
3,12,12,5,1
3,12,13,5,1
3,12,14,5,1
3,12,15,5,1
3,12,16,5,1
3,12,17,5,1
3,12,18,5,1
3,12,19,5,1
3,12,20,5,1
3,12,21,5,1
3,13,0,5,1
3,13,1,5,1
3,13,2,5,1
3,13,3,5,1
3,13,4,5,1
3,13,5,5,1
3,13,6,5,1
3,13,7,5,1
3,13,8,5,1
3,13,9,5,1
3,13,10,5,1
3,13,11,5,1
3,13,12,5,1
3,13,13,5,1
3,13,14,5,1
3,13,15,5,1
3,13,16,5,1
3,13,17,5,1
3,13,18,5,1
3,13,19,5,1
3,13,20,5,1
3,13,21,5,1
3,14,0,5,1
3,14,1,5,1
3,14,2,5,1
3,14,3,5,1
3,14,4,5,1
3,14,5,5,1
3,14,6,5,1
3,14,7,5,1
3,14,8,5,1
3,14,9,5,1
3,14,10,5,1
3,14,11,5,1
3,14,12,5,1
3,14,13,5,1
3,14,14,5,1
3,14,15,5,1
3,14,16,5,1
3,14,17,5,1
3,14,18,5,1
3,14,19,5,1
3,14,20,5,1
3,14,21,5,1
3,15,0,5,1
3,15,1,5,1
3,15,2,5,1
3,15,3,5,1
3,15,4,5,1
3,15,5,5,1
3,15,6,5,1
3,15,7,5,1
3,15,8,5,1
3,15,9,5,1
3,15,10,5,1
3,15,11,5,1
3,15,12,5,1
3,15,13,5,1
3,15,14,5,1
3,15,15,5,1
3,15,16,5,1
3,15,17,5,1
3,15,18,5,1
3,15,19,5,1
3,15,20,5,1
3,15,21,5,1
3,16,0,5,1
3,16,1,5,1
3,16,2,5,1
3,16,3,5,1
3,16,4,5,1
3,16,5,5,1
3,16,6,5,1
3,16,7,5,1
3,16,8,5,1
3,16,9,5,1
3,16,10,5,1
3,16,11,5,1
3,16,12,5,1
3,16,13,5,1
3,16,14,5,1
3,16,15,5,1
3,16,16,5,1
3,16,17,5,1
3,16,18,5,1
3,16,19,5,1
3,16,20,5,1
3,16,21,5,1
3,17,0,5,1
3,17,1,5,1
3,17,2,5,1
3,17,3,5,1
3,17,4,5,1
3,17,5,5,1
3,17,6,5,1
3,17,7,5,1
3,17,8,5,1
3,17,9,5,1
3,17,10,5,1
3,17,11,5,1
3,17,12,5,1
3,17,13,5,1
3,17,14,5,1
3,17,15,5,1
3,17,16,5,1
3,17,17,5,1
3,17,18,5,1
3,17,19,5,1
3,17,20,5,1
3,17,21,5,1
3,18,0,5,1
3,18,1,5,1
3,18,2,5,1
3,18,3,5,1
3,18,4,5,1
3,18,5,5,1
3,18,6,5,1
3,18,7,5,1
3,18,8,5,1
3,18,9,5,1
3,18,10,5,1
3,18,11,5,1
3,18,12,5,1
3,18,13,5,1
3,18,14,5,1
3,18,15,5,1
3,18,16,5,1
3,18,17,5,1
3,18,18,5,1
3,18,19,5,1
3,18,20,5,1
3,18,21,5,1
3,19,0,5,1
3,19,1,5,1
3,19,2,5,1
3,19,3,5,1
3,19,4,5,1
3,19,5,5,1
3,19,6,5,1
3,19,7,5,1
3,19,8,5,1
3,19,9,5,1
3,19,10,5,1
3,19,11,5,1
3,19,12,5,1
3,19,13,5,1
3,19,14,5,1
3,19,15,5,1
3,19,16,5,1
3,19,17,5,1
3,19,18,5,1
3,19,19,5,1
3,19,20,5,1
3,19,21,5,1
3,0,0,6,1
3,0,1,6,1
3,0,2,6,1
3,0,3,6,1
3,0,4,6,1
3,0,5,6,1
3,0,6,6,1
3,0,7,6,1
3,0,8,6,1
3,0,9,6,1
3,0,10,6,1
3,0,11,6,1
3,0,12,6,1
3,0,13,6,1
3,0,14,6,1
3,0,15,6,1
3,0,16,6,1
3,0,17,6,1
3,0,18,6,1
3,0,19,6,1
3,0,20,6,1
3,0,21,6,1
3,1,0,6,1
3,1,1,6,1
3,1,2,6,1
3,1,3,6,1
3,1,4,6,1
3,1,5,6,1
3,1,6,6,1
3,1,7,6,1
3,1,8,6,1
3,1,9,6,1
3,1,10,6,1
3,1,11,6,1
3,1,12,6,1
3,1,13,6,1
3,1,14,6,1
3,1,15,6,1
3,1,16,6,1
3,1,17,6,1
3,1,18,6,1
3,1,19,6,1
3,1,20,6,1
3,1,21,6,1
3,2,0,6,1
3,2,1,6,1
3,2,2,6,1
3,2,3,6,1
3,2,4,6,1
3,2,5,6,1
3,2,6,6,1
3,2,7,6,1
3,2,8,6,1
3,2,9,6,1
3,2,10,6,1
3,2,11,6,1
3,2,12,6,1
3,2,13,6,1
3,2,14,6,1
3,2,15,6,1
3,2,16,6,1
3,2,17,6,1
3,2,18,6,1
3,2,19,6,1
3,2,20,6,1
3,2,21,6,1
3,3,0,6,1
3,3,1,6,1
3,3,2,6,1
3,3,3,6,1
3,3,4,6,1
3,3,5,6,1
3,3,6,6,1
3,3,7,6,1
3,3,8,6,1
3,3,9,6,1
3,3,10,6,1
3,3,11,6,1
3,3,12,6,1
3,3,13,6,1
3,3,14,6,1
3,3,15,6,1
3,3,16,6,1
3,3,17,6,1
3,3,18,6,1
3,3,19,6,1
3,3,20,6,1
3,3,21,6,1
3,4,0,6,1
3,4,1,6,1
3,4,2,6,1
3,4,3,6,1
3,4,4,6,1
3,4,5,6,1
3,4,6,6,1
3,4,7,6,1
3,4,8,6,1
3,4,9,6,1
3,4,10,6,1
3,4,11,6,1
3,4,12,6,1
3,4,13,6,1
3,4,14,6,1
3,4,15,6,1
3,4,16,6,1
3,4,17,6,1
3,4,18,6,1
3,4,19,6,1
3,4,20,6,1
3,4,21,6,1
3,5,0,6,1
3,5,1,6,1
3,5,2,6,1
3,5,3,6,1
3,5,4,6,1
3,5,5,6,1
3,5,6,6,1
3,5,7,6,1
3,5,8,6,1
3,5,9,6,1
3,5,10,6,1
3,5,11,6,1
3,5,12,6,1
3,5,13,6,1
3,5,14,6,1
3,5,15,6,1
3,5,16,6,1
3,5,17,6,1
3,5,18,6,1
3,5,19,6,1
3,5,20,6,1
3,5,21,6,1
3,6,0,6,1
3,6,1,6,1
3,6,2,6,1
3,6,3,6,1
3,6,4,6,1
3,6,5,6,1
3,6,6,6,1
3,6,7,6,1
3,6,8,6,1
3,6,9,6,1
3,6,10,6,1
3,6,11,6,1
3,6,12,6,1
3,6,13,6,1
3,6,14,6,1
3,6,15,6,1
3,6,16,6,1
3,6,17,6,1
3,6,18,6,1
3,6,19,6,1
3,6,20,6,1
3,6,21,6,1
3,7,0,6,1
3,7,1,6,1
3,7,2,6,1
3,7,3,6,1
3,7,4,6,1
3,7,5,6,1
3,7,6,6,1
3,7,7,6,1
3,7,8,6,1
3,7,9,6,1
3,7,10,6,1
3,7,11,6,1
3,7,12,6,1
3,7,13,6,1
3,7,14,6,1
3,7,15,6,1
3,7,16,6,1
3,7,17,6,1
3,7,18,6,1
3,7,19,6,1
3,7,20,6,1
3,7,21,6,1
3,8,0,6,1
3,8,1,6,1
3,8,2,6,1
3,8,3,6,1
3,8,4,6,1
3,8,5,6,1
3,8,6,6,1
3,8,7,6,1
3,8,8,6,1
3,8,9,6,1
3,8,10,6,1
3,8,11,6,1
3,8,12,6,1
3,8,13,6,1
3,8,14,6,1
3,8,15,6,1
3,8,16,6,1
3,8,17,6,1
3,8,18,6,1
3,8,19,6,1
3,8,20,6,1
3,8,21,6,1
3,9,0,6,1
3,9,1,6,1
3,9,2,6,1
3,9,3,6,1
3,9,4,6,1
3,9,5,6,1
3,9,6,6,1
3,9,7,6,1
3,9,8,6,1
3,9,9,6,1
3,9,10,6,1
3,9,11,6,1
3,9,12,6,1
3,9,13,6,1
3,9,14,6,1
3,9,15,6,1
3,9,16,6,1
3,9,17,6,1
3,9,18,6,1
3,9,19,6,1
3,9,20,6,1
3,9,21,6,1
3,10,0,6,1
3,10,1,6,1
3,10,2,6,1
3,10,3,6,1
3,10,4,6,1
3,10,5,6,1
3,10,6,6,1
3,10,7,6,1
3,10,8,6,1
3,10,9,6,1
3,10,10,6,1
3,10,11,6,1
3,10,12,6,1
3,10,13,6,1
3,10,14,6,1
3,10,15,6,1
3,10,16,6,1
3,10,17,6,1
3,10,18,6,1
3,10,19,6,1
3,10,20,6,1
3,10,21,6,1
3,11,0,6,1
3,11,1,6,1
3,11,2,6,1
3,11,3,6,1
3,11,4,6,1
3,11,5,6,1
3,11,6,6,1
3,11,7,6,1
3,11,8,6,1
3,11,9,6,1
3,11,10,6,1
3,11,11,6,1
3,11,12,6,1
3,11,13,6,1
3,11,14,6,1
3,11,15,6,1
3,11,16,6,1
3,11,17,6,1
3,11,18,6,1
3,11,19,6,1
3,11,20,6,1
3,11,21,6,1
3,12,0,6,1
3,12,1,6,1
3,12,2,6,1
3,12,3,6,1
3,12,4,6,1
3,12,5,6,1
3,12,6,6,1
3,12,7,6,1
3,12,8,6,1
3,12,9,6,1
3,12,10,6,1
3,12,11,6,1
3,12,12,6,1
3,12,13,6,1
3,12,14,6,1
3,12,15,6,1
3,12,16,6,1
3,12,17,6,1
3,12,18,6,1
3,12,19,6,1
3,12,20,6,1
3,12,21,6,1
3,13,0,6,1
3,13,1,6,1
3,13,2,6,1
3,13,3,6,1
3,13,4,6,1
3,13,5,6,1
3,13,6,6,1
3,13,7,6,1
3,13,8,6,1
3,13,9,6,1
3,13,10,6,1
3,13,11,6,1
3,13,12,6,1
3,13,13,6,1
3,13,14,6,1
3,13,15,6,1
3,13,16,6,1
3,13,17,6,1
3,13,18,6,1
3,13,19,6,1
3,13,20,6,1
3,13,21,6,1
3,14,0,6,1
3,14,1,6,1
3,14,2,6,1
3,14,3,6,1
3,14,4,6,1
3,14,5,6,1
3,14,6,6,1
3,14,7,6,1
3,14,8,6,1
3,14,9,6,1
3,14,10,6,1
3,14,11,6,1
3,14,12,6,1
3,14,13,6,1
3,14,14,6,1
3,14,15,6,1
3,14,16,6,1
3,14,17,6,1
3,14,18,6,1
3,14,19,6,1
3,14,20,6,1
3,14,21,6,1
3,15,0,6,1
3,15,1,6,1
3,15,2,6,1
3,15,3,6,1
3,15,4,6,1
3,15,5,6,1
3,15,6,6,1
3,15,7,6,1
3,15,8,6,1
3,15,9,6,1
3,15,10,6,1
3,15,11,6,1
3,15,12,6,1
3,15,13,6,1
3,15,14,6,1
3,15,15,6,1
3,15,16,6,1
3,15,17,6,1
3,15,18,6,1
3,15,19,6,1
3,15,20,6,1
3,15,21,6,1
3,16,0,6,1
3,16,1,6,1
3,16,2,6,1
3,16,3,6,1
3,16,4,6,1
3,16,5,6,1
3,16,6,6,1
3,16,7,6,1
3,16,8,6,1
3,16,9,6,1
3,16,10,6,1
3,16,11,6,1
3,16,12,6,1
3,16,13,6,1
3,16,14,6,1
3,16,15,6,1
3,16,16,6,1
3,16,17,6,1
3,16,18,6,1
3,16,19,6,1
3,16,20,6,1
3,16,21,6,1
3,17,0,6,1
3,17,1,6,1
3,17,2,6,1
3,17,3,6,1
3,17,4,6,1
3,17,5,6,1
3,17,6,6,1
3,17,7,6,1
3,17,8,6,1
3,17,9,6,1
3,17,10,6,1
3,17,11,6,1
3,17,12,6,1
3,17,13,6,1
3,17,14,6,1
3,17,15,6,1
3,17,16,6,1
3,17,17,6,1
3,17,18,6,1
3,17,19,6,1
3,17,20,6,1
3,17,21,6,1
3,18,0,6,1
3,18,1,6,1
3,18,2,6,1
3,18,3,6,1
3,18,4,6,1
3,18,5,6,1
3,18,6,6,1
3,18,7,6,1
3,18,8,6,1
3,18,9,6,1
3,18,10,6,1
3,18,11,6,1
3,18,12,6,1
3,18,13,6,1
3,18,14,6,1
3,18,15,6,1
3,18,16,6,1
3,18,17,6,1
3,18,18,6,1
3,18,19,6,1
3,18,20,6,1
3,18,21,6,1
3,0,0,7,1
3,0,1,7,1
3,0,2,7,1
3,0,3,7,1
3,0,4,7,1
3,0,5,7,1
3,0,6,7,1
3,0,7,7,1
3,0,8,7,1
3,0,9,7,1
3,0,10,7,1
3,0,11,7,1
3,0,12,7,1
3,0,13,7,1
3,0,14,7,1
3,0,15,7,1
3,0,16,7,1
3,0,17,7,1
3,0,18,7,1
3,0,19,7,1
3,0,20,7,1
3,0,21,7,1
3,1,0,7,1
3,1,1,7,1
3,1,2,7,1
3,1,3,7,1
3,1,4,7,1
3,1,5,7,1
3,1,6,7,1
3,1,7,7,1
3,1,8,7,1
3,1,9,7,1
3,1,10,7,1
3,1,11,7,1
3,1,12,7,1
3,1,13,7,1
3,1,14,7,1
3,1,15,7,1
3,1,16,7,1
3,1,17,7,1
3,1,18,7,1
3,1,19,7,1
3,1,20,7,1
3,1,21,7,1
3,2,0,7,1
3,2,1,7,1
3,2,2,7,1
3,2,3,7,1
3,2,4,7,1
3,2,5,7,1
3,2,6,7,1
3,2,7,7,1
3,2,8,7,1
3,2,9,7,1
3,2,10,7,1
3,2,11,7,1
3,2,12,7,1
3,2,13,7,1
3,2,14,7,1
3,2,15,7,1
3,2,16,7,1
3,2,17,7,1
3,2,18,7,1
3,2,19,7,1
3,2,20,7,1
3,2,21,7,1
3,3,0,7,1
3,3,1,7,1
3,3,2,7,1
3,3,3,7,1
3,3,4,7,1
3,3,5,7,1
3,3,6,7,1
3,3,7,7,1
3,3,8,7,1
3,3,9,7,1
3,3,10,7,1
3,3,11,7,1
3,3,12,7,1
3,3,13,7,1
3,3,14,7,1
3,3,15,7,1
3,3,16,7,1
3,3,17,7,1
3,3,18,7,1
3,3,19,7,1
3,3,20,7,1
3,3,21,7,1
3,4,0,7,1
3,4,1,7,1
3,4,2,7,1
3,4,3,7,1
3,4,4,7,1
3,4,5,7,1
3,4,6,7,1
3,4,7,7,1
3,4,8,7,1
3,4,9,7,1
3,4,10,7,1
3,4,11,7,1
3,4,12,7,1
3,4,13,7,1
3,4,14,7,1
3,4,15,7,1
3,4,16,7,1
3,4,17,7,1
3,4,18,7,1
3,4,19,7,1
3,4,20,7,1
3,4,21,7,1
3,5,0,7,1
3,5,1,7,1
3,5,2,7,1
3,5,3,7,1
3,5,4,7,1
3,5,5,7,1
3,5,6,7,1
3,5,7,7,1
3,5,8,7,1
3,5,9,7,1
3,5,10,7,1
3,5,11,7,1
3,5,12,7,1
3,5,13,7,1
3,5,14,7,1
3,5,15,7,1
3,5,16,7,1
3,5,17,7,1
3,5,18,7,1
3,5,19,7,1
3,5,20,7,1
3,5,21,7,1
3,6,0,7,1
3,6,1,7,1
3,6,2,7,1
3,6,3,7,1
3,6,4,7,1
3,6,5,7,1
3,6,6,7,1
3,6,7,7,1
3,6,8,7,1
3,6,9,7,1
3,6,10,7,1
3,6,11,7,1
3,6,12,7,1
3,6,13,7,1
3,6,14,7,1
3,6,15,7,1
3,6,16,7,1
3,6,17,7,1
3,6,18,7,1
3,6,19,7,1
3,6,20,7,1
3,6,21,7,1
3,7,0,7,1
3,7,1,7,1
3,7,2,7,1
3,7,3,7,1
3,7,4,7,1
3,7,5,7,1
3,7,6,7,1
3,7,7,7,1
3,7,8,7,1
3,7,9,7,1
3,7,10,7,1
3,7,11,7,1
3,7,12,7,1
3,7,13,7,1
3,7,14,7,1
3,7,15,7,1
3,7,16,7,1
3,7,17,7,1
3,7,18,7,1
3,7,19,7,1
3,7,20,7,1
3,7,21,7,1
3,8,0,7,1
3,8,1,7,1
3,8,2,7,1
3,8,3,7,1
3,8,4,7,1
3,8,5,7,1
3,8,6,7,1
3,8,7,7,1
3,8,8,7,1
3,8,9,7,1
3,8,10,7,1
3,8,11,7,1
3,8,12,7,1
3,8,13,7,1
3,8,14,7,1
3,8,15,7,1
3,8,16,7,1
3,8,17,7,1
3,8,18,7,1
3,8,19,7,1
3,8,20,7,1
3,8,21,7,1
3,9,0,7,1
3,9,1,7,1
3,9,2,7,1
3,9,3,7,1
3,9,4,7,1
3,9,5,7,1
3,9,6,7,1
3,9,7,7,1
3,9,8,7,1
3,9,9,7,1
3,9,10,7,1
3,9,11,7,1
3,9,12,7,1
3,9,13,7,1
3,9,14,7,1
3,9,15,7,1
3,9,16,7,1
3,9,17,7,1
3,9,18,7,1
3,9,19,7,1
3,9,20,7,1
3,9,21,7,1
3,10,0,7,1
3,10,1,7,1
3,10,2,7,1
3,10,3,7,1
3,10,4,7,1
3,10,5,7,1
3,10,6,7,1
3,10,7,7,1
3,10,8,7,1
3,10,9,7,1
3,10,10,7,1
3,10,11,7,1
3,10,12,7,1
3,10,13,7,1
3,10,14,7,1
3,10,15,7,1
3,10,16,7,1
3,10,17,7,1
3,10,18,7,1
3,10,19,7,1
3,10,20,7,1
3,10,21,7,1
3,11,0,7,1
3,11,1,7,1
3,11,2,7,1
3,11,3,7,1
3,11,4,7,1
3,11,5,7,1
3,11,6,7,1
3,11,7,7,1
3,11,8,7,1
3,11,9,7,1
3,11,10,7,1
3,11,11,7,1
3,11,12,7,1
3,11,13,7,1
3,11,14,7,1
3,11,15,7,1
3,11,16,7,1
3,11,17,7,1
3,11,18,7,1
3,11,19,7,1
3,11,20,7,1
3,11,21,7,1
3,12,0,7,1
3,12,1,7,1
3,12,2,7,1
3,12,3,7,1
3,12,4,7,1
3,12,5,7,1
3,12,6,7,1
3,12,7,7,1
3,12,8,7,1
3,12,9,7,1
3,12,10,7,1
3,12,11,7,1
3,12,12,7,1
3,12,13,7,1
3,12,14,7,1
3,12,15,7,1
3,12,16,7,1
3,12,17,7,1
3,12,18,7,1
3,12,19,7,1
3,12,20,7,1
3,12,21,7,1
3,13,0,7,1
3,13,1,7,1
3,13,2,7,1
3,13,3,7,1
3,13,4,7,1
3,13,5,7,1
3,13,6,7,1
3,13,7,7,1
3,13,8,7,1
3,13,9,7,1
3,13,10,7,1
3,13,11,7,1
3,13,12,7,1
3,13,13,7,1
3,13,14,7,1
3,13,15,7,1
3,13,16,7,1
3,13,17,7,1
3,13,18,7,1
3,13,19,7,1
3,13,20,7,1
3,13,21,7,1
3,14,0,7,1
3,14,1,7,1
3,14,2,7,1
3,14,3,7,1
3,14,4,7,1
3,14,5,7,1
3,14,6,7,1
3,14,7,7,1
3,14,8,7,1
3,14,9,7,1
3,14,10,7,1
3,14,11,7,1
3,14,12,7,1
3,14,13,7,1
3,14,14,7,1
3,14,15,7,1
3,14,16,7,1
3,14,17,7,1
3,14,18,7,1
3,14,19,7,1
3,14,20,7,1
3,14,21,7,1
3,15,0,7,1
3,15,1,7,1
3,15,2,7,1
3,15,3,7,1
3,15,4,7,1
3,15,5,7,1
3,15,6,7,1
3,15,7,7,1
3,15,8,7,1
3,15,9,7,1
3,15,10,7,1
3,15,11,7,1
3,15,12,7,1
3,15,13,7,1
3,15,14,7,1
3,15,15,7,1
3,15,16,7,1
3,15,17,7,1
3,15,18,7,1
3,15,19,7,1
3,15,20,7,1
3,15,21,7,1
3,16,0,7,1
3,16,1,7,1
3,16,2,7,1
3,16,3,7,1
3,16,4,7,1
3,16,5,7,1
3,16,6,7,1
3,16,7,7,1
3,16,8,7,1
3,16,9,7,1
3,16,10,7,1
3,16,11,7,1
3,16,12,7,1
3,16,13,7,1
3,16,14,7,1
3,16,15,7,1
3,16,16,7,1
3,16,17,7,1
3,16,18,7,1
3,16,19,7,1
3,16,20,7,1
3,16,21,7,1
3,17,0,7,1
3,17,1,7,1
3,17,2,7,1
3,17,3,7,1
3,17,4,7,1
3,17,5,7,1
3,17,6,7,1
3,17,7,7,1
3,17,8,7,1
3,17,9,7,1
3,17,10,7,1
3,17,11,7,1
3,17,12,7,1
3,17,13,7,1
3,17,14,7,1
3,17,15,7,1
3,17,16,7,1
3,17,17,7,1
3,17,18,7,1
3,17,19,7,1
3,17,20,7,1
3,17,21,7,1
3,0,0,8,1
3,0,1,8,1
3,0,2,8,1
3,0,3,8,1
3,0,4,8,1
3,0,5,8,1
3,0,6,8,1
3,0,7,8,1
3,0,8,8,1
3,0,9,8,1
3,0,10,8,1
3,0,11,8,1
3,0,12,8,1
3,0,13,8,1
3,0,14,8,1
3,0,15,8,1
3,0,16,8,1
3,0,17,8,1
3,0,18,8,1
3,0,19,8,1
3,0,20,8,1
3,0,21,8,1
3,1,0,8,1
3,1,1,8,1
3,1,2,8,1
3,1,3,8,1
3,1,4,8,1
3,1,5,8,1
3,1,6,8,1
3,1,7,8,1
3,1,8,8,1
3,1,9,8,1
3,1,10,8,1
3,1,11,8,1
3,1,12,8,1
3,1,13,8,1
3,1,14,8,1
3,1,15,8,1
3,1,16,8,1
3,1,17,8,1
3,1,18,8,1
3,1,19,8,1
3,1,20,8,1
3,1,21,8,1
3,2,0,8,1
3,2,1,8,1
3,2,2,8,1
3,2,3,8,1
3,2,4,8,1
3,2,5,8,1
3,2,6,8,1
3,2,7,8,1
3,2,8,8,1
3,2,9,8,1
3,2,10,8,1
3,2,11,8,1
3,2,12,8,1
3,2,13,8,1
3,2,14,8,1
3,2,15,8,1
3,2,16,8,1
3,2,17,8,1
3,2,18,8,1
3,2,19,8,1
3,2,20,8,1
3,2,21,8,1
3,3,0,8,1
3,3,1,8,1
3,3,2,8,1
3,3,3,8,1
3,3,4,8,1
3,3,5,8,1
3,3,6,8,1
3,3,7,8,1
3,3,8,8,1
3,3,9,8,1
3,3,10,8,1
3,3,11,8,1
3,3,12,8,1
3,3,13,8,1
3,3,14,8,1
3,3,15,8,1
3,3,16,8,1
3,3,17,8,1
3,3,18,8,1
3,3,19,8,1
3,3,20,8,1
3,3,21,8,1
3,4,0,8,1
3,4,1,8,1
3,4,2,8,1
3,4,3,8,1
3,4,4,8,1
3,4,5,8,1
3,4,6,8,1
3,4,7,8,1
3,4,8,8,1
3,4,9,8,1
3,4,10,8,1
3,4,11,8,1
3,4,12,8,1
3,4,13,8,1
3,4,14,8,1
3,4,15,8,1
3,4,16,8,1
3,4,17,8,1
3,4,18,8,1
3,4,19,8,1
3,4,20,8,1
3,4,21,8,1
3,5,0,8,1
3,5,1,8,1
3,5,2,8,1
3,5,3,8,1
3,5,4,8,1
3,5,5,8,1
3,5,6,8,1
3,5,7,8,1
3,5,8,8,1
3,5,9,8,1
3,5,10,8,1
3,5,11,8,1
3,5,12,8,1
3,5,13,8,1
3,5,14,8,1
3,5,15,8,1
3,5,16,8,1
3,5,17,8,1
3,5,18,8,1
3,5,19,8,1
3,5,20,8,1
3,5,21,8,1
3,6,0,8,1
3,6,1,8,1
3,6,2,8,1
3,6,3,8,1
3,6,4,8,1
3,6,5,8,1
3,6,6,8,1
3,6,7,8,1
3,6,8,8,1
3,6,9,8,1
3,6,10,8,1
3,6,11,8,1
3,6,12,8,1
3,6,13,8,1
3,6,14,8,1
3,6,15,8,1
3,6,16,8,1
3,6,17,8,1
3,6,18,8,1
3,6,19,8,1
3,6,20,8,1
3,6,21,8,1
3,7,0,8,1
3,7,1,8,1
3,7,2,8,1
3,7,3,8,1
3,7,4,8,1
3,7,5,8,1
3,7,6,8,1
3,7,7,8,1
3,7,8,8,1
3,7,9,8,1
3,7,10,8,1
3,7,11,8,1
3,7,12,8,1
3,7,13,8,1
3,7,14,8,1
3,7,15,8,1
3,7,16,8,1
3,7,17,8,1
3,7,18,8,1
3,7,19,8,1
3,7,20,8,1
3,7,21,8,1
3,8,0,8,1
3,8,1,8,1
3,8,2,8,1
3,8,3,8,1
3,8,4,8,1
3,8,5,8,1
3,8,6,8,1
3,8,7,8,1
3,8,8,8,1
3,8,9,8,1
3,8,10,8,1
3,8,11,8,1
3,8,12,8,1
3,8,13,8,1
3,8,14,8,1
3,8,15,8,1
3,8,16,8,1
3,8,17,8,1
3,8,18,8,1
3,8,19,8,1
3,8,20,8,1
3,8,21,8,1
3,9,0,8,1
3,9,1,8,1
3,9,2,8,1
3,9,3,8,1
3,9,4,8,1
3,9,5,8,1
3,9,6,8,1
3,9,7,8,1
3,9,8,8,1
3,9,9,8,1
3,9,10,8,1
3,9,11,8,1
3,9,12,8,1
3,9,13,8,1
3,9,14,8,1
3,9,15,8,1
3,9,16,8,1
3,9,17,8,1
3,9,18,8,1
3,9,19,8,1
3,9,20,8,1
3,9,21,8,1
3,10,0,8,1
3,10,1,8,1
3,10,2,8,1
3,10,3,8,1
3,10,4,8,1
3,10,5,8,1
3,10,6,8,1
3,10,7,8,1
3,10,8,8,1
3,10,9,8,1
3,10,10,8,1
3,10,11,8,1
3,10,12,8,1
3,10,13,8,1
3,10,14,8,1
3,10,15,8,1
3,10,16,8,1
3,10,17,8,1
3,10,18,8,1
3,10,19,8,1
3,10,20,8,1
3,10,21,8,1
3,11,0,8,1
3,11,1,8,1
3,11,2,8,1
3,11,3,8,1
3,11,4,8,1
3,11,5,8,1
3,11,6,8,1
3,11,7,8,1
3,11,8,8,1
3,11,9,8,1
3,11,10,8,1
3,11,11,8,1
3,11,12,8,1
3,11,13,8,1
3,11,14,8,1
3,11,15,8,1
3,11,16,8,1
3,11,17,8,1
3,11,18,8,1
3,11,19,8,1
3,11,20,8,1
3,11,21,8,1
3,12,0,8,1
3,12,1,8,1
3,12,2,8,1
3,12,3,8,1
3,12,4,8,1
3,12,5,8,1
3,12,6,8,1
3,12,7,8,1
3,12,8,8,1
3,12,9,8,1
3,12,10,8,1
3,12,11,8,1
3,12,12,8,1
3,12,13,8,1
3,12,14,8,1
3,12,15,8,1
3,12,16,8,1
3,12,17,8,1
3,12,18,8,1
3,12,19,8,1
3,12,20,8,1
3,12,21,8,1
3,13,0,8,1
3,13,1,8,1
3,13,2,8,1
3,13,3,8,1
3,13,4,8,1
3,13,5,8,1
3,13,6,8,1
3,13,7,8,1
3,13,8,8,1
3,13,9,8,1
3,13,10,8,1
3,13,11,8,1
3,13,12,8,1
3,13,13,8,1
3,13,14,8,1
3,13,15,8,1
3,13,16,8,1
3,13,17,8,1
3,13,18,8,1
3,13,19,8,1
3,13,20,8,1
3,13,21,8,1
3,14,0,8,1
3,14,1,8,1
3,14,2,8,1
3,14,3,8,1
3,14,4,8,1
3,14,5,8,1
3,14,6,8,1
3,14,7,8,1
3,14,8,8,1
3,14,9,8,1
3,14,10,8,1
3,14,11,8,1
3,14,12,8,1
3,14,13,8,1
3,14,14,8,1
3,14,15,8,1
3,14,16,8,1
3,14,17,8,1
3,14,18,8,1
3,14,19,8,1
3,14,20,8,1
3,14,21,8,1
3,15,0,8,1
3,15,1,8,1
3,15,2,8,1
3,15,3,8,1
3,15,4,8,1
3,15,5,8,1
3,15,6,8,1
3,15,7,8,1
3,15,8,8,1
3,15,9,8,1
3,15,10,8,1
3,15,11,8,1
3,15,12,8,1
3,15,13,8,1
3,15,14,8,1
3,15,15,8,1
3,15,16,8,1
3,15,17,8,1
3,15,18,8,1
3,15,19,8,1
3,15,20,8,1
3,15,21,8,1
3,16,0,8,1
3,16,1,8,1
3,16,2,8,1
3,16,3,8,1
3,16,4,8,1
3,16,5,8,1
3,16,6,8,1
3,16,7,8,1
3,16,8,8,1
3,16,9,8,1
3,16,10,8,1
3,16,11,8,1
3,16,12,8,1
3,16,13,8,1
3,16,14,8,1
3,16,15,8,1
3,16,16,8,1
3,16,17,8,1
3,16,18,8,1
3,16,19,8,1
3,16,20,8,1
3,16,21,8,1
3,0,0,9,1
3,0,1,9,1
3,0,2,9,1
3,0,3,9,1
3,0,4,9,1
3,0,5,9,1
3,0,6,9,1
3,0,7,9,1
3,0,8,9,1
3,0,9,9,1
3,0,10,9,1
3,0,11,9,1
3,0,12,9,1
3,0,13,9,1
3,0,14,9,1
3,0,15,9,1
3,0,16,9,1
3,0,17,9,1
3,0,18,9,1
3,0,19,9,1
3,0,20,9,1
3,0,21,9,1
3,1,0,9,1
3,1,1,9,1
3,1,2,9,1
3,1,3,9,1
3,1,4,9,1
3,1,5,9,1
3,1,6,9,1
3,1,7,9,1
3,1,8,9,1
3,1,9,9,1
3,1,10,9,1
3,1,11,9,1
3,1,12,9,1
3,1,13,9,1
3,1,14,9,1
3,1,15,9,1
3,1,16,9,1
3,1,17,9,1
3,1,18,9,1
3,1,19,9,1
3,1,20,9,1
3,1,21,9,1
3,2,0,9,1
3,2,1,9,1
3,2,2,9,1
3,2,3,9,1
3,2,4,9,1
3,2,5,9,1
3,2,6,9,1
3,2,7,9,1
3,2,8,9,1
3,2,9,9,1
3,2,10,9,1
3,2,11,9,1
3,2,12,9,1
3,2,13,9,1
3,2,14,9,1
3,2,15,9,1
3,2,16,9,1
3,2,17,9,1
3,2,18,9,1
3,2,19,9,1
3,2,20,9,1
3,2,21,9,1
3,3,0,9,1
3,3,1,9,1
3,3,2,9,1
3,3,3,9,1
3,3,4,9,1
3,3,5,9,1
3,3,6,9,1
3,3,7,9,1
3,3,8,9,1
3,3,9,9,1
3,3,10,9,1
3,3,11,9,1
3,3,12,9,1
3,3,13,9,1
3,3,14,9,1
3,3,15,9,1
3,3,16,9,1
3,3,17,9,1
3,3,18,9,1
3,3,19,9,1
3,3,20,9,1
3,3,21,9,1
3,4,0,9,1
3,4,1,9,1
3,4,2,9,1
3,4,3,9,1
3,4,4,9,1
3,4,5,9,1
3,4,6,9,1
3,4,7,9,1
3,4,8,9,1
3,4,9,9,1
3,4,10,9,1
3,4,11,9,1
3,4,12,9,1
3,4,13,9,1
3,4,14,9,1
3,4,15,9,1
3,4,16,9,1
3,4,17,9,1
3,4,18,9,1
3,4,19,9,1
3,4,20,9,1
3,4,21,9,1
3,5,0,9,1
3,5,1,9,1
3,5,2,9,1
3,5,3,9,1
3,5,4,9,1
3,5,5,9,1
3,5,6,9,1
3,5,7,9,1
3,5,8,9,1
3,5,9,9,1
3,5,10,9,1
3,5,11,9,1
3,5,12,9,1
3,5,13,9,1
3,5,14,9,1
3,5,15,9,1
3,5,16,9,1
3,5,17,9,1
3,5,18,9,1
3,5,19,9,1
3,5,20,9,1
3,5,21,9,1
3,6,0,9,1
3,6,1,9,1
3,6,2,9,1
3,6,3,9,1
3,6,4,9,1
3,6,5,9,1
3,6,6,9,1
3,6,7,9,1
3,6,8,9,1
3,6,9,9,1
3,6,10,9,1
3,6,11,9,1
3,6,12,9,1
3,6,13,9,1
3,6,14,9,1
3,6,15,9,1
3,6,16,9,1
3,6,17,9,1
3,6,18,9,1
3,6,19,9,1
3,6,20,9,1
3,6,21,9,1
3,7,0,9,1
3,7,1,9,1
3,7,2,9,1
3,7,3,9,1
3,7,4,9,1
3,7,5,9,1
3,7,6,9,1
3,7,7,9,1
3,7,8,9,1
3,7,9,9,1
3,7,10,9,1
3,7,11,9,1
3,7,12,9,1
3,7,13,9,1
3,7,14,9,1
3,7,15,9,1
3,7,16,9,1
3,7,17,9,1
3,7,18,9,1
3,7,19,9,1
3,7,20,9,1
3,7,21,9,1
3,8,0,9,1
3,8,1,9,1
3,8,2,9,1
3,8,3,9,1
3,8,4,9,1
3,8,5,9,1
3,8,6,9,1
3,8,7,9,1
3,8,8,9,1
3,8,9,9,1
3,8,10,9,1
3,8,11,9,1
3,8,12,9,1
3,8,13,9,1
3,8,14,9,1
3,8,15,9,1
3,8,16,9,1
3,8,17,9,1
3,8,18,9,1
3,8,19,9,1
3,8,20,9,1
3,8,21,9,1
3,9,0,9,1
3,9,1,9,1
3,9,2,9,1
3,9,3,9,1
3,9,4,9,1
3,9,5,9,1
3,9,6,9,1
3,9,7,9,1
3,9,8,9,1
3,9,9,9,1
3,9,10,9,1
3,9,11,9,1
3,9,12,9,1
3,9,13,9,1
3,9,14,9,1
3,9,15,9,1
3,9,16,9,1
3,9,17,9,1
3,9,18,9,1
3,9,19,9,1
3,9,20,9,1
3,9,21,9,1
3,10,0,9,1
3,10,1,9,1
3,10,2,9,1
3,10,3,9,1
3,10,4,9,1
3,10,5,9,1
3,10,6,9,1
3,10,7,9,1
3,10,8,9,1
3,10,9,9,1
3,10,10,9,1
3,10,11,9,1
3,10,12,9,1
3,10,13,9,1
3,10,14,9,1
3,10,15,9,1
3,10,16,9,1
3,10,17,9,1
3,10,18,9,1
3,10,19,9,1
3,10,20,9,1
3,10,21,9,1
3,11,0,9,1
3,11,1,9,1
3,11,2,9,1
3,11,3,9,1
3,11,4,9,1
3,11,5,9,1
3,11,6,9,1
3,11,7,9,1
3,11,8,9,1
3,11,9,9,1
3,11,10,9,1
3,11,11,9,1
3,11,12,9,1
3,11,13,9,1
3,11,14,9,1
3,11,15,9,1
3,11,16,9,1
3,11,17,9,1
3,11,18,9,1
3,11,19,9,1
3,11,20,9,1
3,11,21,9,1
3,12,0,9,1
3,12,1,9,1
3,12,2,9,1
3,12,3,9,1
3,12,4,9,1
3,12,5,9,1
3,12,6,9,1
3,12,7,9,1
3,12,8,9,1
3,12,9,9,1
3,12,10,9,1
3,12,11,9,1
3,12,12,9,1
3,12,13,9,1
3,12,14,9,1
3,12,15,9,1
3,12,16,9,1
3,12,17,9,1
3,12,18,9,1
3,12,19,9,1
3,12,20,9,1
3,12,21,9,1
3,13,0,9,1
3,13,1,9,1
3,13,2,9,1
3,13,3,9,1
3,13,4,9,1
3,13,5,9,1
3,13,6,9,1
3,13,7,9,1
3,13,8,9,1
3,13,9,9,1
3,13,10,9,1
3,13,11,9,1
3,13,12,9,1
3,13,13,9,1
3,13,14,9,1
3,13,15,9,1
3,13,16,9,1
3,13,17,9,1
3,13,18,9,1
3,13,19,9,1
3,13,20,9,1
3,13,21,9,1
3,14,0,9,1
3,14,1,9,1
3,14,2,9,1
3,14,3,9,1
3,14,4,9,1
3,14,5,9,1
3,14,6,9,1
3,14,7,9,1
3,14,8,9,1
3,14,9,9,1
3,14,10,9,1
3,14,11,9,1
3,14,12,9,1
3,14,13,9,1
3,14,14,9,1
3,14,15,9,1
3,14,16,9,1
3,14,17,9,1
3,14,18,9,1
3,14,19,9,1
3,14,20,9,1
3,14,21,9,1
3,15,0,9,1
3,15,1,9,1
3,15,2,9,1
3,15,3,9,1
3,15,4,9,1
3,15,5,9,1
3,15,6,9,1
3,15,7,9,1
3,15,8,9,1
3,15,9,9,1
3,15,10,9,1
3,15,11,9,1
3,15,12,9,1
3,15,13,9,1
3,15,14,9,1
3,15,15,9,1
3,15,16,9,1
3,15,17,9,1
3,15,18,9,1
3,15,19,9,1
3,15,20,9,1
3,15,21,9,1
3,0,0,10,1
3,0,1,10,1
3,0,2,10,1
3,0,3,10,1
3,0,4,10,1
3,0,5,10,1
3,0,6,10,1
3,0,7,10,1
3,0,8,10,1
3,0,9,10,1
3,0,10,10,1
3,0,11,10,1
3,0,12,10,1
3,0,13,10,1
3,0,14,10,1
3,0,15,10,1
3,0,16,10,1
3,0,17,10,1
3,0,18,10,1
3,0,19,10,1
3,0,20,10,1
3,0,21,10,1
3,1,0,10,1
3,1,1,10,1
3,1,2,10,1
3,1,3,10,1
3,1,4,10,1
3,1,5,10,1
3,1,6,10,1
3,1,7,10,1
3,1,8,10,1
3,1,9,10,1
3,1,10,10,1
3,1,11,10,1
3,1,12,10,1
3,1,13,10,1
3,1,14,10,1
3,1,15,10,1
3,1,16,10,1
3,1,17,10,1
3,1,18,10,1
3,1,19,10,1
3,1,20,10,1
3,1,21,10,1
3,2,0,10,1
3,2,1,10,1
3,2,2,10,1
3,2,3,10,1
3,2,4,10,1
3,2,5,10,1
3,2,6,10,1
3,2,7,10,1
3,2,8,10,1
3,2,9,10,1
3,2,10,10,1
3,2,11,10,1
3,2,12,10,1
3,2,13,10,1
3,2,14,10,1
3,2,15,10,1
3,2,16,10,1
3,2,17,10,1
3,2,18,10,1
3,2,19,10,1
3,2,20,10,1
3,2,21,10,1
3,3,0,10,1
3,3,1,10,1
3,3,2,10,1
3,3,3,10,1
3,3,4,10,1
3,3,5,10,1
3,3,6,10,1
3,3,7,10,1
3,3,8,10,1
3,3,9,10,1
3,3,10,10,1
3,3,11,10,1
3,3,12,10,1
3,3,13,10,1
3,3,14,10,1
3,3,15,10,1
3,3,16,10,1
3,3,17,10,1
3,3,18,10,1
3,3,19,10,1
3,3,20,10,1
3,3,21,10,1
3,4,0,10,1
3,4,1,10,1
3,4,2,10,1
3,4,3,10,1
3,4,4,10,1
3,4,5,10,1
3,4,6,10,1
3,4,7,10,1
3,4,8,10,1
3,4,9,10,1
3,4,10,10,1
3,4,11,10,1
3,4,12,10,1
3,4,13,10,1
3,4,14,10,1
3,4,15,10,1
3,4,16,10,1
3,4,17,10,1
3,4,18,10,1
3,4,19,10,1
3,4,20,10,1
3,4,21,10,1
3,5,0,10,1
3,5,1,10,1
3,5,2,10,1
3,5,3,10,1
3,5,4,10,1
3,5,5,10,1
3,5,6,10,1
3,5,7,10,1
3,5,8,10,1
3,5,9,10,1
3,5,10,10,1
3,5,11,10,1
3,5,12,10,1
3,5,13,10,1
3,5,14,10,1
3,5,15,10,1
3,5,16,10,1
3,5,17,10,1
3,5,18,10,1
3,5,19,10,1
3,5,20,10,1
3,5,21,10,1
3,6,0,10,1
3,6,1,10,1
3,6,2,10,1
3,6,3,10,1
3,6,4,10,1
3,6,5,10,1
3,6,6,10,1
3,6,7,10,1
3,6,8,10,1
3,6,9,10,1
3,6,10,10,1
3,6,11,10,1
3,6,12,10,1
3,6,13,10,1
3,6,14,10,1
3,6,15,10,1
3,6,16,10,1
3,6,17,10,1
3,6,18,10,1
3,6,19,10,1
3,6,20,10,1
3,6,21,10,1
3,7,0,10,1
3,7,1,10,1
3,7,2,10,1
3,7,3,10,1
3,7,4,10,1
3,7,5,10,1
3,7,6,10,1
3,7,7,10,1
3,7,8,10,1
3,7,9,10,1
3,7,10,10,1
3,7,11,10,1
3,7,12,10,1
3,7,13,10,1
3,7,14,10,1
3,7,15,10,1
3,7,16,10,1
3,7,17,10,1
3,7,18,10,1
3,7,19,10,1
3,7,20,10,1
3,7,21,10,1
3,8,0,10,1
3,8,1,10,1
3,8,2,10,1
3,8,3,10,1
3,8,4,10,1
3,8,5,10,1
3,8,6,10,1
3,8,7,10,1
3,8,8,10,1
3,8,9,10,1
3,8,10,10,1
3,8,11,10,1
3,8,12,10,1
3,8,13,10,1
3,8,14,10,1
3,8,15,10,1
3,8,16,10,1
3,8,17,10,1
3,8,18,10,1
3,8,19,10,1
3,8,20,10,1
3,8,21,10,1
3,9,0,10,1
3,9,1,10,1
3,9,2,10,1
3,9,3,10,1
3,9,4,10,1
3,9,5,10,1
3,9,6,10,1
3,9,7,10,1
3,9,8,10,1
3,9,9,10,1
3,9,10,10,1
3,9,11,10,1
3,9,12,10,1
3,9,13,10,1
3,9,14,10,1
3,9,15,10,1
3,9,16,10,1
3,9,17,10,1
3,9,18,10,1
3,9,19,10,1
3,9,20,10,1
3,9,21,10,1
3,10,0,10,1
3,10,1,10,1
3,10,2,10,1
3,10,3,10,1
3,10,4,10,1
3,10,5,10,1
3,10,6,10,1
3,10,7,10,1
3,10,8,10,1
3,10,9,10,1
3,10,10,10,1
3,10,11,10,1
3,10,12,10,1
3,10,13,10,1
3,10,14,10,1
3,10,15,10,1
3,10,16,10,1
3,10,17,10,1
3,10,18,10,1
3,10,19,10,1
3,10,20,10,1
3,10,21,10,1
3,11,0,10,1
3,11,1,10,1
3,11,2,10,1
3,11,3,10,1
3,11,4,10,1
3,11,5,10,1
3,11,6,10,1
3,11,7,10,1
3,11,8,10,1
3,11,9,10,1
3,11,10,10,1
3,11,11,10,1
3,11,12,10,1
3,11,13,10,1
3,11,14,10,1
3,11,15,10,1
3,11,16,10,1
3,11,17,10,1
3,11,18,10,1
3,11,19,10,1
3,11,20,10,1
3,11,21,10,1
3,12,0,10,1
3,12,1,10,1
3,12,2,10,1
3,12,3,10,1
3,12,4,10,1
3,12,5,10,1
3,12,6,10,1
3,12,7,10,1
3,12,8,10,1
3,12,9,10,1
3,12,10,10,1
3,12,11,10,1
3,12,12,10,1
3,12,13,10,1
3,12,14,10,1
3,12,15,10,1
3,12,16,10,1
3,12,17,10,1
3,12,18,10,1
3,12,19,10,1
3,12,20,10,1
3,12,21,10,1
3,13,0,10,1
3,13,1,10,1
3,13,2,10,1
3,13,3,10,1
3,13,4,10,1
3,13,5,10,1
3,13,6,10,1
3,13,7,10,1
3,13,8,10,1
3,13,9,10,1
3,13,10,10,1
3,13,11,10,1
3,13,12,10,1
3,13,13,10,1
3,13,14,10,1
3,13,15,10,1
3,13,16,10,1
3,13,17,10,1
3,13,18,10,1
3,13,19,10,1
3,13,20,10,1
3,13,21,10,1
3,14,0,10,1
3,14,1,10,1
3,14,2,10,1
3,14,3,10,1
3,14,4,10,1
3,14,5,10,1
3,14,6,10,1
3,14,7,10,1
3,14,8,10,1
3,14,9,10,1
3,14,10,10,1
3,14,11,10,1
3,14,12,10,1
3,14,13,10,1
3,14,14,10,1
3,14,15,10,1
3,14,16,10,1
3,14,17,10,1
3,14,18,10,1
3,14,19,10,1
3,14,20,10,1
3,14,21,10,1
3,0,0,11,1
3,0,1,11,1
3,0,2,11,1
3,0,3,11,1
3,0,4,11,1
3,0,5,11,1
3,0,6,11,1
3,0,7,11,1
3,0,8,11,1
3,0,9,11,1
3,0,10,11,1
3,0,11,11,1
3,0,12,11,1
3,0,13,11,1
3,0,14,11,1
3,0,15,11,1
3,0,16,11,1
3,0,17,11,1
3,0,18,11,1
3,0,19,11,1
3,0,20,11,1
3,0,21,11,1
3,1,0,11,1
3,1,1,11,1
3,1,2,11,1
3,1,3,11,1
3,1,4,11,1
3,1,5,11,1
3,1,6,11,1
3,1,7,11,1
3,1,8,11,1
3,1,9,11,1
3,1,10,11,1
3,1,11,11,1
3,1,12,11,1
3,1,13,11,1
3,1,14,11,1
3,1,15,11,1
3,1,16,11,1
3,1,17,11,1
3,1,18,11,1
3,1,19,11,1
3,1,20,11,1
3,1,21,11,1
3,2,0,11,1
3,2,1,11,1
3,2,2,11,1
3,2,3,11,1
3,2,4,11,1
3,2,5,11,1
3,2,6,11,1
3,2,7,11,1
3,2,8,11,1
3,2,9,11,1
3,2,10,11,1
3,2,11,11,1
3,2,12,11,1
3,2,13,11,1
3,2,14,11,1
3,2,15,11,1
3,2,16,11,1
3,2,17,11,1
3,2,18,11,1
3,2,19,11,1
3,2,20,11,1
3,2,21,11,1
3,3,0,11,1
3,3,1,11,1
3,3,2,11,1
3,3,3,11,1
3,3,4,11,1
3,3,5,11,1
3,3,6,11,1
3,3,7,11,1
3,3,8,11,1
3,3,9,11,1
3,3,10,11,1
3,3,11,11,1
3,3,12,11,1
3,3,13,11,1
3,3,14,11,1
3,3,15,11,1
3,3,16,11,1
3,3,17,11,1
3,3,18,11,1
3,3,19,11,1
3,3,20,11,1
3,3,21,11,1
3,4,0,11,1
3,4,1,11,1
3,4,2,11,1
3,4,3,11,1
3,4,4,11,1
3,4,5,11,1
3,4,6,11,1
3,4,7,11,1
3,4,8,11,1
3,4,9,11,1
3,4,10,11,1
3,4,11,11,1
3,4,12,11,1
3,4,13,11,1
3,4,14,11,1
3,4,15,11,1
3,4,16,11,1
3,4,17,11,1
3,4,18,11,1
3,4,19,11,1
3,4,20,11,1
3,4,21,11,1
3,5,0,11,1
3,5,1,11,1
3,5,2,11,1
3,5,3,11,1
3,5,4,11,1
3,5,5,11,1
3,5,6,11,1
3,5,7,11,1
3,5,8,11,1
3,5,9,11,1
3,5,10,11,1
3,5,11,11,1
3,5,12,11,1
3,5,13,11,1
3,5,14,11,1
3,5,15,11,1
3,5,16,11,1
3,5,17,11,1
3,5,18,11,1
3,5,19,11,1
3,5,20,11,1
3,5,21,11,1
3,6,0,11,1
3,6,1,11,1
3,6,2,11,1
3,6,3,11,1
3,6,4,11,1
3,6,5,11,1
3,6,6,11,1
3,6,7,11,1
3,6,8,11,1
3,6,9,11,1
3,6,10,11,1
3,6,11,11,1
3,6,12,11,1
3,6,13,11,1
3,6,14,11,1
3,6,15,11,1
3,6,16,11,1
3,6,17,11,1
3,6,18,11,1
3,6,19,11,1
3,6,20,11,1
3,6,21,11,1
3,7,0,11,1
3,7,1,11,1
3,7,2,11,1
3,7,3,11,1
3,7,4,11,1
3,7,5,11,1
3,7,6,11,1
3,7,7,11,1
3,7,8,11,1
3,7,9,11,1
3,7,10,11,1
3,7,11,11,1
3,7,12,11,1
3,7,13,11,1
3,7,14,11,1
3,7,15,11,1
3,7,16,11,1
3,7,17,11,1
3,7,18,11,1
3,7,19,11,1
3,7,20,11,1
3,7,21,11,1
3,8,0,11,1
3,8,1,11,1
3,8,2,11,1
3,8,3,11,1
3,8,4,11,1
3,8,5,11,1
3,8,6,11,1
3,8,7,11,1
3,8,8,11,1
3,8,9,11,1
3,8,10,11,1
3,8,11,11,1
3,8,12,11,1
3,8,13,11,1
3,8,14,11,1
3,8,15,11,1
3,8,16,11,1
3,8,17,11,1
3,8,18,11,1
3,8,19,11,1
3,8,20,11,1
3,8,21,11,1
3,9,0,11,1
3,9,1,11,1
3,9,2,11,1
3,9,3,11,1
3,9,4,11,1
3,9,5,11,1
3,9,6,11,1
3,9,7,11,1
3,9,8,11,1
3,9,9,11,1
3,9,10,11,1
3,9,11,11,1
3,9,12,11,1
3,9,13,11,1
3,9,14,11,1
3,9,15,11,1
3,9,16,11,1
3,9,17,11,1
3,9,18,11,1
3,9,19,11,1
3,9,20,11,1
3,9,21,11,1
3,10,0,11,1
3,10,1,11,1
3,10,2,11,1
3,10,3,11,1
3,10,4,11,1
3,10,5,11,1
3,10,6,11,1
3,10,7,11,1
3,10,8,11,1
3,10,9,11,1
3,10,10,11,1
3,10,11,11,1
3,10,12,11,1
3,10,13,11,1
3,10,14,11,1
3,10,15,11,1
3,10,16,11,1
3,10,17,11,1
3,10,18,11,1
3,10,19,11,1
3,10,20,11,1
3,10,21,11,1
3,11,0,11,1
3,11,1,11,1
3,11,2,11,1
3,11,3,11,1
3,11,4,11,1
3,11,5,11,1
3,11,6,11,1
3,11,7,11,1
3,11,8,11,1
3,11,9,11,1
3,11,10,11,1
3,11,11,11,1
3,11,12,11,1
3,11,13,11,1
3,11,14,11,1
3,11,15,11,1
3,11,16,11,1
3,11,17,11,1
3,11,18,11,1
3,11,19,11,1
3,11,20,11,1
3,11,21,11,1
3,12,0,11,1
3,12,1,11,1
3,12,2,11,1
3,12,3,11,1
3,12,4,11,1
3,12,5,11,1
3,12,6,11,1
3,12,7,11,1
3,12,8,11,1
3,12,9,11,1
3,12,10,11,1
3,12,11,11,1
3,12,12,11,1
3,12,13,11,1
3,12,14,11,1
3,12,15,11,1
3,12,16,11,1
3,12,17,11,1
3,12,18,11,1
3,12,19,11,1
3,12,20,11,1
3,12,21,11,1
3,13,0,11,1
3,13,1,11,1
3,13,2,11,1
3,13,3,11,1
3,13,4,11,1
3,13,5,11,1
3,13,6,11,1
3,13,7,11,1
3,13,8,11,1
3,13,9,11,1
3,13,10,11,1
3,13,11,11,1
3,13,12,11,1
3,13,13,11,1
3,13,14,11,1
3,13,15,11,1
3,13,16,11,1
3,13,17,11,1
3,13,18,11,1
3,13,19,11,1
3,13,20,11,1
3,13,21,11,1
3,0,0,12,1
3,0,1,12,1
3,0,2,12,1
3,0,3,12,1
3,0,4,12,1
3,0,5,12,1
3,0,6,12,1
3,0,7,12,1
3,0,8,12,1
3,0,9,12,1
3,0,10,12,1
3,0,11,12,1
3,0,12,12,1
3,0,13,12,1
3,0,14,12,1
3,0,15,12,1
3,0,16,12,1
3,0,17,12,1
3,0,18,12,1
3,0,19,12,1
3,0,20,12,1
3,0,21,12,1
3,1,0,12,1
3,1,1,12,1
3,1,2,12,1
3,1,3,12,1
3,1,4,12,1
3,1,5,12,1
3,1,6,12,1
3,1,7,12,1
3,1,8,12,1
3,1,9,12,1
3,1,10,12,1
3,1,11,12,1
3,1,12,12,1
3,1,13,12,1
3,1,14,12,1
3,1,15,12,1
3,1,16,12,1
3,1,17,12,1
3,1,18,12,1
3,1,19,12,1
3,1,20,12,1
3,1,21,12,1
3,2,0,12,1
3,2,1,12,1
3,2,2,12,1
3,2,3,12,1
3,2,4,12,1
3,2,5,12,1
3,2,6,12,1
3,2,7,12,1
3,2,8,12,1
3,2,9,12,1
3,2,10,12,1
3,2,11,12,1
3,2,12,12,1
3,2,13,12,1
3,2,14,12,1
3,2,15,12,1
3,2,16,12,1
3,2,17,12,1
3,2,18,12,1
3,2,19,12,1
3,2,20,12,1
3,2,21,12,1
3,3,0,12,1
3,3,1,12,1
3,3,2,12,1
3,3,3,12,1
3,3,4,12,1
3,3,5,12,1
3,3,6,12,1
3,3,7,12,1
3,3,8,12,1
3,3,9,12,1
3,3,10,12,1
3,3,11,12,1
3,3,12,12,1
3,3,13,12,1
3,3,14,12,1
3,3,15,12,1
3,3,16,12,1
3,3,17,12,1
3,3,18,12,1
3,3,19,12,1
3,3,20,12,1
3,3,21,12,1
3,4,0,12,1
3,4,1,12,1
3,4,2,12,1
3,4,3,12,1
3,4,4,12,1
3,4,5,12,1
3,4,6,12,1
3,4,7,12,1
3,4,8,12,1
3,4,9,12,1
3,4,10,12,1
3,4,11,12,1
3,4,12,12,1
3,4,13,12,1
3,4,14,12,1
3,4,15,12,1
3,4,16,12,1
3,4,17,12,1
3,4,18,12,1
3,4,19,12,1
3,4,20,12,1
3,4,21,12,1
3,5,0,12,1
3,5,1,12,1
3,5,2,12,1
3,5,3,12,1
3,5,4,12,1
3,5,5,12,1
3,5,6,12,1
3,5,7,12,1
3,5,8,12,1
3,5,9,12,1
3,5,10,12,1
3,5,11,12,1
3,5,12,12,1
3,5,13,12,1
3,5,14,12,1
3,5,15,12,1
3,5,16,12,1
3,5,17,12,1
3,5,18,12,1
3,5,19,12,1
3,5,20,12,1
3,5,21,12,1
3,6,0,12,1
3,6,1,12,1
3,6,2,12,1
3,6,3,12,1
3,6,4,12,1
3,6,5,12,1
3,6,6,12,1
3,6,7,12,1
3,6,8,12,1
3,6,9,12,1
3,6,10,12,1
3,6,11,12,1
3,6,12,12,1
3,6,13,12,1
3,6,14,12,1
3,6,15,12,1
3,6,16,12,1
3,6,17,12,1
3,6,18,12,1
3,6,19,12,1
3,6,20,12,1
3,6,21,12,1
3,7,0,12,1
3,7,1,12,1
3,7,2,12,1
3,7,3,12,1
3,7,4,12,1
3,7,5,12,1
3,7,6,12,1
3,7,7,12,1
3,7,8,12,1
3,7,9,12,1
3,7,10,12,1
3,7,11,12,1
3,7,12,12,1
3,7,13,12,1
3,7,14,12,1
3,7,15,12,1
3,7,16,12,1
3,7,17,12,1
3,7,18,12,1
3,7,19,12,1
3,7,20,12,1
3,7,21,12,1
3,8,0,12,1
3,8,1,12,1
3,8,2,12,1
3,8,3,12,1
3,8,4,12,1
3,8,5,12,1
3,8,6,12,1
3,8,7,12,1
3,8,8,12,1
3,8,9,12,1
3,8,10,12,1
3,8,11,12,1
3,8,12,12,1
3,8,13,12,1
3,8,14,12,1
3,8,15,12,1
3,8,16,12,1
3,8,17,12,1
3,8,18,12,1
3,8,19,12,1
3,8,20,12,1
3,8,21,12,1
3,9,0,12,1
3,9,1,12,1
3,9,2,12,1
3,9,3,12,1
3,9,4,12,1
3,9,5,12,1
3,9,6,12,1
3,9,7,12,1
3,9,8,12,1
3,9,9,12,1
3,9,10,12,1
3,9,11,12,1
3,9,12,12,1
3,9,13,12,1
3,9,14,12,1
3,9,15,12,1
3,9,16,12,1
3,9,17,12,1
3,9,18,12,1
3,9,19,12,1
3,9,20,12,1
3,9,21,12,1
3,10,0,12,1
3,10,1,12,1
3,10,2,12,1
3,10,3,12,1
3,10,4,12,1
3,10,5,12,1
3,10,6,12,1
3,10,7,12,1
3,10,8,12,1
3,10,9,12,1
3,10,10,12,1
3,10,11,12,1
3,10,12,12,1
3,10,13,12,1
3,10,14,12,1
3,10,15,12,1
3,10,16,12,1
3,10,17,12,1
3,10,18,12,1
3,10,19,12,1
3,10,20,12,1
3,10,21,12,1
3,11,0,12,1
3,11,1,12,1
3,11,2,12,1
3,11,3,12,1
3,11,4,12,1
3,11,5,12,1
3,11,6,12,1
3,11,7,12,1
3,11,8,12,1
3,11,9,12,1
3,11,10,12,1
3,11,11,12,1
3,11,12,12,1
3,11,13,12,1
3,11,14,12,1
3,11,15,12,1
3,11,16,12,1
3,11,17,12,1
3,11,18,12,1
3,11,19,12,1
3,11,20,12,1
3,11,21,12,1
3,12,0,12,1
3,12,1,12,1
3,12,2,12,1
3,12,3,12,1
3,12,4,12,1
3,12,5,12,1
3,12,6,12,1
3,12,7,12,1
3,12,8,12,1
3,12,9,12,1
3,12,10,12,1
3,12,11,12,1
3,12,12,12,1
3,12,13,12,1
3,12,14,12,1
3,12,15,12,1
3,12,16,12,1
3,12,17,12,1
3,12,18,12,1
3,12,19,12,1
3,12,20,12,1
3,12,21,12,1
3,0,0,13,1
3,0,1,13,1
3,0,2,13,1
3,0,3,13,1
3,0,4,13,1
3,0,5,13,1
3,0,6,13,1
3,0,7,13,1
3,0,8,13,1
3,0,9,13,1
3,0,10,13,1
3,0,11,13,1
3,0,12,13,1
3,0,13,13,1
3,0,14,13,1
3,0,15,13,1
3,0,16,13,1
3,0,17,13,1
3,0,18,13,1
3,0,19,13,1
3,0,20,13,1
3,0,21,13,1
3,1,0,13,1
3,1,1,13,1
3,1,2,13,1
3,1,3,13,1
3,1,4,13,1
3,1,5,13,1
3,1,6,13,1
3,1,7,13,1
3,1,8,13,1
3,1,9,13,1
3,1,10,13,1
3,1,11,13,1
3,1,12,13,1
3,1,13,13,1
3,1,14,13,1
3,1,15,13,1
3,1,16,13,1
3,1,17,13,1
3,1,18,13,1
3,1,19,13,1
3,1,20,13,1
3,1,21,13,1
3,2,0,13,1
3,2,1,13,1
3,2,2,13,1
3,2,3,13,1
3,2,4,13,1
3,2,5,13,1
3,2,6,13,1
3,2,7,13,1
3,2,8,13,1
3,2,9,13,1
3,2,10,13,1
3,2,11,13,1
3,2,12,13,1
3,2,13,13,1
3,2,14,13,1
3,2,15,13,1
3,2,16,13,1
3,2,17,13,1
3,2,18,13,1
3,2,19,13,1
3,2,20,13,1
3,2,21,13,1
3,3,0,13,1
3,3,1,13,1
3,3,2,13,1
3,3,3,13,1
3,3,4,13,1
3,3,5,13,1
3,3,6,13,1
3,3,7,13,1
3,3,8,13,1
3,3,9,13,1
3,3,10,13,1
3,3,11,13,1
3,3,12,13,1
3,3,13,13,1
3,3,14,13,1
3,3,15,13,1
3,3,16,13,1
3,3,17,13,1
3,3,18,13,1
3,3,19,13,1
3,3,20,13,1
3,3,21,13,1
3,4,0,13,1
3,4,1,13,1
3,4,2,13,1
3,4,3,13,1
3,4,4,13,1
3,4,5,13,1
3,4,6,13,1
3,4,7,13,1
3,4,8,13,1
3,4,9,13,1
3,4,10,13,1
3,4,11,13,1
3,4,12,13,1
3,4,13,13,1
3,4,14,13,1
3,4,15,13,1
3,4,16,13,1
3,4,17,13,1
3,4,18,13,1
3,4,19,13,1
3,4,20,13,1
3,4,21,13,1
3,5,0,13,1
3,5,1,13,1
3,5,2,13,1
3,5,3,13,1
3,5,4,13,1
3,5,5,13,1
3,5,6,13,1
3,5,7,13,1
3,5,8,13,1
3,5,9,13,1
3,5,10,13,1
3,5,11,13,1
3,5,12,13,1
3,5,13,13,1
3,5,14,13,1
3,5,15,13,1
3,5,16,13,1
3,5,17,13,1
3,5,18,13,1
3,5,19,13,1
3,5,20,13,1
3,5,21,13,1
3,6,0,13,1
3,6,1,13,1
3,6,2,13,1
3,6,3,13,1
3,6,4,13,1
3,6,5,13,1
3,6,6,13,1
3,6,7,13,1
3,6,8,13,1
3,6,9,13,1
3,6,10,13,1
3,6,11,13,1
3,6,12,13,1
3,6,13,13,1
3,6,14,13,1
3,6,15,13,1
3,6,16,13,1
3,6,17,13,1
3,6,18,13,1
3,6,19,13,1
3,6,20,13,1
3,6,21,13,1
3,7,0,13,1
3,7,1,13,1
3,7,2,13,1
3,7,3,13,1
3,7,4,13,1
3,7,5,13,1
3,7,6,13,1
3,7,7,13,1
3,7,8,13,1
3,7,9,13,1
3,7,10,13,1
3,7,11,13,1
3,7,12,13,1
3,7,13,13,1
3,7,14,13,1
3,7,15,13,1
3,7,16,13,1
3,7,17,13,1
3,7,18,13,1
3,7,19,13,1
3,7,20,13,1
3,7,21,13,1
3,8,0,13,1
3,8,1,13,1
3,8,2,13,1
3,8,3,13,1
3,8,4,13,1
3,8,5,13,1
3,8,6,13,1
3,8,7,13,1
3,8,8,13,1
3,8,9,13,1
3,8,10,13,1
3,8,11,13,1
3,8,12,13,1
3,8,13,13,1
3,8,14,13,1
3,8,15,13,1
3,8,16,13,1
3,8,17,13,1
3,8,18,13,1
3,8,19,13,1
3,8,20,13,1
3,8,21,13,1
3,9,0,13,1
3,9,1,13,1
3,9,2,13,1
3,9,3,13,1
3,9,4,13,1
3,9,5,13,1
3,9,6,13,1
3,9,7,13,1
3,9,8,13,1
3,9,9,13,1
3,9,10,13,1
3,9,11,13,1
3,9,12,13,1
3,9,13,13,1
3,9,14,13,1
3,9,15,13,1
3,9,16,13,1
3,9,17,13,1
3,9,18,13,1
3,9,19,13,1
3,9,20,13,1
3,9,21,13,1
3,10,0,13,1
3,10,1,13,1
3,10,2,13,1
3,10,3,13,1
3,10,4,13,1
3,10,5,13,1
3,10,6,13,1
3,10,7,13,1
3,10,8,13,1
3,10,9,13,1
3,10,10,13,1
3,10,11,13,1
3,10,12,13,1
3,10,13,13,1
3,10,14,13,1
3,10,15,13,1
3,10,16,13,1
3,10,17,13,1
3,10,18,13,1
3,10,19,13,1
3,10,20,13,1
3,10,21,13,1
3,11,0,13,1
3,11,1,13,1
3,11,2,13,1
3,11,3,13,1
3,11,4,13,1
3,11,5,13,1
3,11,6,13,1
3,11,7,13,1
3,11,8,13,1
3,11,9,13,1
3,11,10,13,1
3,11,11,13,1
3,11,12,13,1
3,11,13,13,1
3,11,14,13,1
3,11,15,13,1
3,11,16,13,1
3,11,17,13,1
3,11,18,13,1
3,11,19,13,1
3,11,20,13,1
3,11,21,13,1
3,0,0,14,1
3,0,1,14,1
3,0,2,14,1
3,0,3,14,1
3,0,4,14,1
3,0,5,14,1
3,0,6,14,1
3,0,7,14,1
3,0,8,14,1
3,0,9,14,1
3,0,10,14,1
3,0,11,14,1
3,0,12,14,1
3,0,13,14,1
3,0,14,14,1
3,0,15,14,1
3,0,16,14,1
3,0,17,14,1
3,0,18,14,1
3,0,19,14,1
3,0,20,14,1
3,0,21,14,1
3,1,0,14,1
3,1,1,14,1
3,1,2,14,1
3,1,3,14,1
3,1,4,14,1
3,1,5,14,1
3,1,6,14,1
3,1,7,14,1
3,1,8,14,1
3,1,9,14,1
3,1,10,14,1
3,1,11,14,1
3,1,12,14,1
3,1,13,14,1
3,1,14,14,1
3,1,15,14,1
3,1,16,14,1
3,1,17,14,1
3,1,18,14,1
3,1,19,14,1
3,1,20,14,1
3,1,21,14,1
3,2,0,14,1
3,2,1,14,1
3,2,2,14,1
3,2,3,14,1
3,2,4,14,1
3,2,5,14,1
3,2,6,14,1
3,2,7,14,1
3,2,8,14,1
3,2,9,14,1
3,2,10,14,1
3,2,11,14,1
3,2,12,14,1
3,2,13,14,1
3,2,14,14,1
3,2,15,14,1
3,2,16,14,1
3,2,17,14,1
3,2,18,14,1
3,2,19,14,1
3,2,20,14,1
3,2,21,14,1
3,3,0,14,1
3,3,1,14,1
3,3,2,14,1
3,3,3,14,1
3,3,4,14,1
3,3,5,14,1
3,3,6,14,1
3,3,7,14,1
3,3,8,14,1
3,3,9,14,1
3,3,10,14,1
3,3,11,14,1
3,3,12,14,1
3,3,13,14,1
3,3,14,14,1
3,3,15,14,1
3,3,16,14,1
3,3,17,14,1
3,3,18,14,1
3,3,19,14,1
3,3,20,14,1
3,3,21,14,1
3,4,0,14,1
3,4,1,14,1
3,4,2,14,1
3,4,3,14,1
3,4,4,14,1
3,4,5,14,1
3,4,6,14,1
3,4,7,14,1
3,4,8,14,1
3,4,9,14,1
3,4,10,14,1
3,4,11,14,1
3,4,12,14,1
3,4,13,14,1
3,4,14,14,1
3,4,15,14,1
3,4,16,14,1
3,4,17,14,1
3,4,18,14,1
3,4,19,14,1
3,4,20,14,1
3,4,21,14,1
3,5,0,14,1
3,5,1,14,1
3,5,2,14,1
3,5,3,14,1
3,5,4,14,1
3,5,5,14,1
3,5,6,14,1
3,5,7,14,1
3,5,8,14,1
3,5,9,14,1
3,5,10,14,1
3,5,11,14,1
3,5,12,14,1
3,5,13,14,1
3,5,14,14,1
3,5,15,14,1
3,5,16,14,1
3,5,17,14,1
3,5,18,14,1
3,5,19,14,1
3,5,20,14,1
3,5,21,14,1
3,6,0,14,1
3,6,1,14,1
3,6,2,14,1
3,6,3,14,1
3,6,4,14,1
3,6,5,14,1
3,6,6,14,1
3,6,7,14,1
3,6,8,14,1
3,6,9,14,1
3,6,10,14,1
3,6,11,14,1
3,6,12,14,1
3,6,13,14,1
3,6,14,14,1
3,6,15,14,1
3,6,16,14,1
3,6,17,14,1
3,6,18,14,1
3,6,19,14,1
3,6,20,14,1
3,6,21,14,1
3,7,0,14,1
3,7,1,14,1
3,7,2,14,1
3,7,3,14,1
3,7,4,14,1
3,7,5,14,1
3,7,6,14,1
3,7,7,14,1
3,7,8,14,1
3,7,9,14,1
3,7,10,14,1
3,7,11,14,1
3,7,12,14,1
3,7,13,14,1
3,7,14,14,1
3,7,15,14,1
3,7,16,14,1
3,7,17,14,1
3,7,18,14,1
3,7,19,14,1
3,7,20,14,1
3,7,21,14,1
3,8,0,14,1
3,8,1,14,1
3,8,2,14,1
3,8,3,14,1
3,8,4,14,1
3,8,5,14,1
3,8,6,14,1
3,8,7,14,1
3,8,8,14,1
3,8,9,14,1
3,8,10,14,1
3,8,11,14,1
3,8,12,14,1
3,8,13,14,1
3,8,14,14,1
3,8,15,14,1
3,8,16,14,1
3,8,17,14,1
3,8,18,14,1
3,8,19,14,1
3,8,20,14,1
3,8,21,14,1
3,9,0,14,1
3,9,1,14,1
3,9,2,14,1
3,9,3,14,1
3,9,4,14,1
3,9,5,14,1
3,9,6,14,1
3,9,7,14,1
3,9,8,14,1
3,9,9,14,1
3,9,10,14,1
3,9,11,14,1
3,9,12,14,1
3,9,13,14,1
3,9,14,14,1
3,9,15,14,1
3,9,16,14,1
3,9,17,14,1
3,9,18,14,1
3,9,19,14,1
3,9,20,14,1
3,9,21,14,1
3,10,0,14,1
3,10,1,14,1
3,10,2,14,1
3,10,3,14,1
3,10,4,14,1
3,10,5,14,1
3,10,6,14,1
3,10,7,14,1
3,10,8,14,1
3,10,9,14,1
3,10,10,14,1
3,10,11,14,1
3,10,12,14,1
3,10,13,14,1
3,10,14,14,1
3,10,15,14,1
3,10,16,14,1
3,10,17,14,1
3,10,18,14,1
3,10,19,14,1
3,10,20,14,1
3,10,21,14,1
3,0,0,15,1
3,0,1,15,1
3,0,2,15,1
3,0,3,15,1
3,0,4,15,1
3,0,5,15,1
3,0,6,15,1
3,0,7,15,1
3,0,8,15,1
3,0,9,15,1
3,0,10,15,1
3,0,11,15,1
3,0,12,15,1
3,0,13,15,1
3,0,14,15,1
3,0,15,15,1
3,0,16,15,1
3,0,17,15,1
3,0,18,15,1
3,0,19,15,1
3,0,20,15,1
3,0,21,15,1
3,1,0,15,1
3,1,1,15,1
3,1,2,15,1
3,1,3,15,1
3,1,4,15,1
3,1,5,15,1
3,1,6,15,1
3,1,7,15,1
3,1,8,15,1
3,1,9,15,1
3,1,10,15,1
3,1,11,15,1
3,1,12,15,1
3,1,13,15,1
3,1,14,15,1
3,1,15,15,1
3,1,16,15,1
3,1,17,15,1
3,1,18,15,1
3,1,19,15,1
3,1,20,15,1
3,1,21,15,1
3,2,0,15,1
3,2,1,15,1
3,2,2,15,1
3,2,3,15,1
3,2,4,15,1
3,2,5,15,1
3,2,6,15,1
3,2,7,15,1
3,2,8,15,1
3,2,9,15,1
3,2,10,15,1
3,2,11,15,1
3,2,12,15,1
3,2,13,15,1
3,2,14,15,1
3,2,15,15,1
3,2,16,15,1
3,2,17,15,1
3,2,18,15,1
3,2,19,15,1
3,2,20,15,1
3,2,21,15,1
3,3,0,15,1
3,3,1,15,1
3,3,2,15,1
3,3,3,15,1
3,3,4,15,1
3,3,5,15,1
3,3,6,15,1
3,3,7,15,1
3,3,8,15,1
3,3,9,15,1
3,3,10,15,1
3,3,11,15,1
3,3,12,15,1
3,3,13,15,1
3,3,14,15,1
3,3,15,15,1
3,3,16,15,1
3,3,17,15,1
3,3,18,15,1
3,3,19,15,1
3,3,20,15,1
3,3,21,15,1
3,4,0,15,1
3,4,1,15,1
3,4,2,15,1
3,4,3,15,1
3,4,4,15,1
3,4,5,15,1
3,4,6,15,1
3,4,7,15,1
3,4,8,15,1
3,4,9,15,1
3,4,10,15,1
3,4,11,15,1
3,4,12,15,1
3,4,13,15,1
3,4,14,15,1
3,4,15,15,1
3,4,16,15,1
3,4,17,15,1
3,4,18,15,1
3,4,19,15,1
3,4,20,15,1
3,4,21,15,1
3,5,0,15,1
3,5,1,15,1
3,5,2,15,1
3,5,3,15,1
3,5,4,15,1
3,5,5,15,1
3,5,6,15,1
3,5,7,15,1
3,5,8,15,1
3,5,9,15,1
3,5,10,15,1
3,5,11,15,1
3,5,12,15,1
3,5,13,15,1
3,5,14,15,1
3,5,15,15,1
3,5,16,15,1
3,5,17,15,1
3,5,18,15,1
3,5,19,15,1
3,5,20,15,1
3,5,21,15,1
3,6,0,15,1
3,6,1,15,1
3,6,2,15,1
3,6,3,15,1
3,6,4,15,1
3,6,5,15,1
3,6,6,15,1
3,6,7,15,1
3,6,8,15,1
3,6,9,15,1
3,6,10,15,1
3,6,11,15,1
3,6,12,15,1
3,6,13,15,1
3,6,14,15,1
3,6,15,15,1
3,6,16,15,1
3,6,17,15,1
3,6,18,15,1
3,6,19,15,1
3,6,20,15,1
3,6,21,15,1
3,7,0,15,1
3,7,1,15,1
3,7,2,15,1
3,7,3,15,1
3,7,4,15,1
3,7,5,15,1
3,7,6,15,1
3,7,7,15,1
3,7,8,15,1
3,7,9,15,1
3,7,10,15,1
3,7,11,15,1
3,7,12,15,1
3,7,13,15,1
3,7,14,15,1
3,7,15,15,1
3,7,16,15,1
3,7,17,15,1
3,7,18,15,1
3,7,19,15,1
3,7,20,15,1
3,7,21,15,1
3,8,0,15,1
3,8,1,15,1
3,8,2,15,1
3,8,3,15,1
3,8,4,15,1
3,8,5,15,1
3,8,6,15,1
3,8,7,15,1
3,8,8,15,1
3,8,9,15,1
3,8,10,15,1
3,8,11,15,1
3,8,12,15,1
3,8,13,15,1
3,8,14,15,1
3,8,15,15,1
3,8,16,15,1
3,8,17,15,1
3,8,18,15,1
3,8,19,15,1
3,8,20,15,1
3,8,21,15,1
3,9,0,15,1
3,9,1,15,1
3,9,2,15,1
3,9,3,15,1
3,9,4,15,1
3,9,5,15,1
3,9,6,15,1
3,9,7,15,1
3,9,8,15,1
3,9,9,15,1
3,9,10,15,1
3,9,11,15,1
3,9,12,15,1
3,9,13,15,1
3,9,14,15,1
3,9,15,15,1
3,9,16,15,1
3,9,17,15,1
3,9,18,15,1
3,9,19,15,1
3,9,20,15,1
3,9,21,15,1
3,0,0,16,1
3,0,1,16,1
3,0,2,16,1
3,0,3,16,1
3,0,4,16,1
3,0,5,16,1
3,0,6,16,1
3,0,7,16,1
3,0,8,16,1
3,0,9,16,1
3,0,10,16,1
3,0,11,16,1
3,0,12,16,1
3,0,13,16,1
3,0,14,16,1
3,0,15,16,1
3,0,16,16,1
3,0,17,16,1
3,0,18,16,1
3,0,19,16,1
3,0,20,16,1
3,0,21,16,1
3,1,0,16,1
3,1,1,16,1
3,1,2,16,1
3,1,3,16,1
3,1,4,16,1
3,1,5,16,1
3,1,6,16,1
3,1,7,16,1
3,1,8,16,1
3,1,9,16,1
3,1,10,16,1
3,1,11,16,1
3,1,12,16,1
3,1,13,16,1
3,1,14,16,1
3,1,15,16,1
3,1,16,16,1
3,1,17,16,1
3,1,18,16,1
3,1,19,16,1
3,1,20,16,1
3,1,21,16,1
3,2,0,16,1
3,2,1,16,1
3,2,2,16,1
3,2,3,16,1
3,2,4,16,1
3,2,5,16,1
3,2,6,16,1
3,2,7,16,1
3,2,8,16,1
3,2,9,16,1
3,2,10,16,1
3,2,11,16,1
3,2,12,16,1
3,2,13,16,1
3,2,14,16,1
3,2,15,16,1
3,2,16,16,1
3,2,17,16,1
3,2,18,16,1
3,2,19,16,1
3,2,20,16,1
3,2,21,16,1
3,3,0,16,1
3,3,1,16,1
3,3,2,16,1
3,3,3,16,1
3,3,4,16,1
3,3,5,16,1
3,3,6,16,1
3,3,7,16,1
3,3,8,16,1
3,3,9,16,1
3,3,10,16,1
3,3,11,16,1
3,3,12,16,1
3,3,13,16,1
3,3,14,16,1
3,3,15,16,1
3,3,16,16,1
3,3,17,16,1
3,3,18,16,1
3,3,19,16,1
3,3,20,16,1
3,3,21,16,1
3,4,0,16,1
3,4,1,16,1
3,4,2,16,1
3,4,3,16,1
3,4,4,16,1
3,4,5,16,1
3,4,6,16,1
3,4,7,16,1
3,4,8,16,1
3,4,9,16,1
3,4,10,16,1
3,4,11,16,1
3,4,12,16,1
3,4,13,16,1
3,4,14,16,1
3,4,15,16,1
3,4,16,16,1
3,4,17,16,1
3,4,18,16,1
3,4,19,16,1
3,4,20,16,1
3,4,21,16,1
3,5,0,16,1
3,5,1,16,1
3,5,2,16,1
3,5,3,16,1
3,5,4,16,1
3,5,5,16,1
3,5,6,16,1
3,5,7,16,1
3,5,8,16,1
3,5,9,16,1
3,5,10,16,1
3,5,11,16,1
3,5,12,16,1
3,5,13,16,1
3,5,14,16,1
3,5,15,16,1
3,5,16,16,1
3,5,17,16,1
3,5,18,16,1
3,5,19,16,1
3,5,20,16,1
3,5,21,16,1
3,6,0,16,1
3,6,1,16,1
3,6,2,16,1
3,6,3,16,1
3,6,4,16,1
3,6,5,16,1
3,6,6,16,1
3,6,7,16,1
3,6,8,16,1
3,6,9,16,1
3,6,10,16,1
3,6,11,16,1
3,6,12,16,1
3,6,13,16,1
3,6,14,16,1
3,6,15,16,1
3,6,16,16,1
3,6,17,16,1
3,6,18,16,1
3,6,19,16,1
3,6,20,16,1
3,6,21,16,1
3,7,0,16,1
3,7,1,16,1
3,7,2,16,1
3,7,3,16,1
3,7,4,16,1
3,7,5,16,1
3,7,6,16,1
3,7,7,16,1
3,7,8,16,1
3,7,9,16,1
3,7,10,16,1
3,7,11,16,1
3,7,12,16,1
3,7,13,16,1
3,7,14,16,1
3,7,15,16,1
3,7,16,16,1
3,7,17,16,1
3,7,18,16,1
3,7,19,16,1
3,7,20,16,1
3,7,21,16,1
3,8,0,16,1
3,8,1,16,1
3,8,2,16,1
3,8,3,16,1
3,8,4,16,1
3,8,5,16,1
3,8,6,16,1
3,8,7,16,1
3,8,8,16,1
3,8,9,16,1
3,8,10,16,1
3,8,11,16,1
3,8,12,16,1
3,8,13,16,1
3,8,14,16,1
3,8,15,16,1
3,8,16,16,1
3,8,17,16,1
3,8,18,16,1
3,8,19,16,1
3,8,20,16,1
3,8,21,16,1
3,0,0,17,1
3,0,1,17,1
3,0,2,17,1
3,0,3,17,1
3,0,4,17,1
3,0,5,17,1
3,0,6,17,1
3,0,7,17,1
3,0,8,17,1
3,0,9,17,1
3,0,10,17,1
3,0,11,17,1
3,0,12,17,1
3,0,13,17,1
3,0,14,17,1
3,0,15,17,1
3,0,16,17,1
3,0,17,17,1
3,0,18,17,1
3,0,19,17,1
3,0,20,17,1
3,0,21,17,1
3,1,0,17,1
3,1,1,17,1
3,1,2,17,1
3,1,3,17,1
3,1,4,17,1
3,1,5,17,1
3,1,6,17,1
3,1,7,17,1
3,1,8,17,1
3,1,9,17,1
3,1,10,17,1
3,1,11,17,1
3,1,12,17,1
3,1,13,17,1
3,1,14,17,1
3,1,15,17,1
3,1,16,17,1
3,1,17,17,1
3,1,18,17,1
3,1,19,17,1
3,1,20,17,1
3,1,21,17,1
3,2,0,17,1
3,2,1,17,1
3,2,2,17,1
3,2,3,17,1
3,2,4,17,1
3,2,5,17,1
3,2,6,17,1
3,2,7,17,1
3,2,8,17,1
3,2,9,17,1
3,2,10,17,1
3,2,11,17,1
3,2,12,17,1
3,2,13,17,1
3,2,14,17,1
3,2,15,17,1
3,2,16,17,1
3,2,17,17,1
3,2,18,17,1
3,2,19,17,1
3,2,20,17,1
3,2,21,17,1
3,3,0,17,1
3,3,1,17,1
3,3,2,17,1
3,3,3,17,1
3,3,4,17,1
3,3,5,17,1
3,3,6,17,1
3,3,7,17,1
3,3,8,17,1
3,3,9,17,1
3,3,10,17,1
3,3,11,17,1
3,3,12,17,1
3,3,13,17,1
3,3,14,17,1
3,3,15,17,1
3,3,16,17,1
3,3,17,17,1
3,3,18,17,1
3,3,19,17,1
3,3,20,17,1
3,3,21,17,1
3,4,0,17,1
3,4,1,17,1
3,4,2,17,1
3,4,3,17,1
3,4,4,17,1
3,4,5,17,1
3,4,6,17,1
3,4,7,17,1
3,4,8,17,1
3,4,9,17,1
3,4,10,17,1
3,4,11,17,1
3,4,12,17,1
3,4,13,17,1
3,4,14,17,1
3,4,15,17,1
3,4,16,17,1
3,4,17,17,1
3,4,18,17,1
3,4,19,17,1
3,4,20,17,1
3,4,21,17,1
3,5,0,17,1
3,5,1,17,1
3,5,2,17,1
3,5,3,17,1
3,5,4,17,1
3,5,5,17,1
3,5,6,17,1
3,5,7,17,1
3,5,8,17,1
3,5,9,17,1
3,5,10,17,1
3,5,11,17,1
3,5,12,17,1
3,5,13,17,1
3,5,14,17,1
3,5,15,17,1
3,5,16,17,1
3,5,17,17,1
3,5,18,17,1
3,5,19,17,1
3,5,20,17,1
3,5,21,17,1
3,6,0,17,1
3,6,1,17,1
3,6,2,17,1
3,6,3,17,1
3,6,4,17,1
3,6,5,17,1
3,6,6,17,1
3,6,7,17,1
3,6,8,17,1
3,6,9,17,1
3,6,10,17,1
3,6,11,17,1
3,6,12,17,1
3,6,13,17,1
3,6,14,17,1
3,6,15,17,1
3,6,16,17,1
3,6,17,17,1
3,6,18,17,1
3,6,19,17,1
3,6,20,17,1
3,6,21,17,1
3,7,0,17,1
3,7,1,17,1
3,7,2,17,1
3,7,3,17,1
3,7,4,17,1
3,7,5,17,1
3,7,6,17,1
3,7,7,17,1
3,7,8,17,1
3,7,9,17,1
3,7,10,17,1
3,7,11,17,1
3,7,12,17,1
3,7,13,17,1
3,7,14,17,1
3,7,15,17,1
3,7,16,17,1
3,7,17,17,1
3,7,18,17,1
3,7,19,17,1
3,7,20,17,1
3,7,21,17,1
3,0,0,18,1
3,0,1,18,1
3,0,2,18,1
3,0,3,18,1
3,0,4,18,1
3,0,5,18,1
3,0,6,18,1
3,0,7,18,1
3,0,8,18,1
3,0,9,18,1
3,0,10,18,1
3,0,11,18,1
3,0,12,18,1
3,0,13,18,1
3,0,14,18,1
3,0,15,18,1
3,0,16,18,1
3,0,17,18,1
3,0,18,18,1
3,0,19,18,1
3,0,20,18,1
3,0,21,18,1
3,1,0,18,1
3,1,1,18,1
3,1,2,18,1
3,1,3,18,1
3,1,4,18,1
3,1,5,18,1
3,1,6,18,1
3,1,7,18,1
3,1,8,18,1
3,1,9,18,1
3,1,10,18,1
3,1,11,18,1
3,1,12,18,1
3,1,13,18,1
3,1,14,18,1
3,1,15,18,1
3,1,16,18,1
3,1,17,18,1
3,1,18,18,1
3,1,19,18,1
3,1,20,18,1
3,1,21,18,1
3,2,0,18,1
3,2,1,18,1
3,2,2,18,1
3,2,3,18,1
3,2,4,18,1
3,2,5,18,1
3,2,6,18,1
3,2,7,18,1
3,2,8,18,1
3,2,9,18,1
3,2,10,18,1
3,2,11,18,1
3,2,12,18,1
3,2,13,18,1
3,2,14,18,1
3,2,15,18,1
3,2,16,18,1
3,2,17,18,1
3,2,18,18,1
3,2,19,18,1
3,2,20,18,1
3,2,21,18,1
3,3,0,18,1
3,3,1,18,1
3,3,2,18,1
3,3,3,18,1
3,3,4,18,1
3,3,5,18,1
3,3,6,18,1
3,3,7,18,1
3,3,8,18,1
3,3,9,18,1
3,3,10,18,1
3,3,11,18,1
3,3,12,18,1
3,3,13,18,1
3,3,14,18,1
3,3,15,18,1
3,3,16,18,1
3,3,17,18,1
3,3,18,18,1
3,3,19,18,1
3,3,20,18,1
3,3,21,18,1
3,4,0,18,1
3,4,1,18,1
3,4,2,18,1
3,4,3,18,1
3,4,4,18,1
3,4,5,18,1
3,4,6,18,1
3,4,7,18,1
3,4,8,18,1
3,4,9,18,1
3,4,10,18,1
3,4,11,18,1
3,4,12,18,1
3,4,13,18,1
3,4,14,18,1
3,4,15,18,1
3,4,16,18,1
3,4,17,18,1
3,4,18,18,1
3,4,19,18,1
3,4,20,18,1
3,4,21,18,1
3,5,0,18,1
3,5,1,18,1
3,5,2,18,1
3,5,3,18,1
3,5,4,18,1
3,5,5,18,1
3,5,6,18,1
3,5,7,18,1
3,5,8,18,1
3,5,9,18,1
3,5,10,18,1
3,5,11,18,1
3,5,12,18,1
3,5,13,18,1
3,5,14,18,1
3,5,15,18,1
3,5,16,18,1
3,5,17,18,1
3,5,18,18,1
3,5,19,18,1
3,5,20,18,1
3,5,21,18,1
3,6,0,18,1
3,6,1,18,1
3,6,2,18,1
3,6,3,18,1
3,6,4,18,1
3,6,5,18,1
3,6,6,18,1
3,6,7,18,1
3,6,8,18,1
3,6,9,18,1
3,6,10,18,1
3,6,11,18,1
3,6,12,18,1
3,6,13,18,1
3,6,14,18,1
3,6,15,18,1
3,6,16,18,1
3,6,17,18,1
3,6,18,18,1
3,6,19,18,1
3,6,20,18,1
3,6,21,18,1
3,0,0,19,1
3,0,1,19,1
3,0,2,19,1
3,0,3,19,1
3,0,4,19,1
3,0,5,19,1
3,0,6,19,1
3,0,7,19,1
3,0,8,19,1
3,0,9,19,1
3,0,10,19,1
3,0,11,19,1
3,0,12,19,1
3,0,13,19,1
3,0,14,19,1
3,0,15,19,1
3,0,16,19,1
3,0,17,19,1
3,0,18,19,1
3,0,19,19,1
3,0,20,19,1
3,0,21,19,1
3,1,0,19,1
3,1,1,19,1
3,1,2,19,1
3,1,3,19,1
3,1,4,19,1
3,1,5,19,1
3,1,6,19,1
3,1,7,19,1
3,1,8,19,1
3,1,9,19,1
3,1,10,19,1
3,1,11,19,1
3,1,12,19,1
3,1,13,19,1
3,1,14,19,1
3,1,15,19,1
3,1,16,19,1
3,1,17,19,1
3,1,18,19,1
3,1,19,19,1
3,1,20,19,1
3,1,21,19,1
3,2,0,19,1
3,2,1,19,1
3,2,2,19,1
3,2,3,19,1
3,2,4,19,1
3,2,5,19,1
3,2,6,19,1
3,2,7,19,1
3,2,8,19,1
3,2,9,19,1
3,2,10,19,1
3,2,11,19,1
3,2,12,19,1
3,2,13,19,1
3,2,14,19,1
3,2,15,19,1
3,2,16,19,1
3,2,17,19,1
3,2,18,19,1
3,2,19,19,1
3,2,20,19,1
3,2,21,19,1
3,3,0,19,1
3,3,1,19,1
3,3,2,19,1
3,3,3,19,1
3,3,4,19,1
3,3,5,19,1
3,3,6,19,1
3,3,7,19,1
3,3,8,19,1
3,3,9,19,1
3,3,10,19,1
3,3,11,19,1
3,3,12,19,1
3,3,13,19,1
3,3,14,19,1
3,3,15,19,1
3,3,16,19,1
3,3,17,19,1
3,3,18,19,1
3,3,19,19,1
3,3,20,19,1
3,3,21,19,1
3,4,0,19,1
3,4,1,19,1
3,4,2,19,1
3,4,3,19,1
3,4,4,19,1
3,4,5,19,1
3,4,6,19,1
3,4,7,19,1
3,4,8,19,1
3,4,9,19,1
3,4,10,19,1
3,4,11,19,1
3,4,12,19,1
3,4,13,19,1
3,4,14,19,1
3,4,15,19,1
3,4,16,19,1
3,4,17,19,1
3,4,18,19,1
3,4,19,19,1
3,4,20,19,1
3,4,21,19,1
3,5,0,19,1
3,5,1,19,1
3,5,2,19,1
3,5,3,19,1
3,5,4,19,1
3,5,5,19,1
3,5,6,19,1
3,5,7,19,1
3,5,8,19,1
3,5,9,19,1
3,5,10,19,1
3,5,11,19,1
3,5,12,19,1
3,5,13,19,1
3,5,14,19,1
3,5,15,19,1
3,5,16,19,1
3,5,17,19,1
3,5,18,19,1
3,5,19,19,1
3,5,20,19,1
3,5,21,19,1
3,0,0,20,1
3,0,1,20,1
3,0,2,20,1
3,0,3,20,1
3,0,4,20,1
3,0,5,20,1
3,0,6,20,1
3,0,7,20,1
3,0,8,20,1
3,0,9,20,1
3,0,10,20,1
3,0,11,20,1
3,0,12,20,1
3,0,13,20,1
3,0,14,20,1
3,0,15,20,1
3,0,16,20,1
3,0,17,20,1
3,0,18,20,1
3,0,19,20,1
3,0,20,20,1
3,0,21,20,1
3,1,0,20,1
3,1,1,20,1
3,1,2,20,1
3,1,3,20,1
3,1,4,20,1
3,1,5,20,1
3,1,6,20,1
3,1,7,20,1
3,1,8,20,1
3,1,9,20,1
3,1,10,20,1
3,1,11,20,1
3,1,12,20,1
3,1,13,20,1
3,1,14,20,1
3,1,15,20,1
3,1,16,20,1
3,1,17,20,1
3,1,18,20,1
3,1,19,20,1
3,1,20,20,1
3,1,21,20,1
3,2,0,20,1
3,2,1,20,1
3,2,2,20,1
3,2,3,20,1
3,2,4,20,1
3,2,5,20,1
3,2,6,20,1
3,2,7,20,1
3,2,8,20,1
3,2,9,20,1
3,2,10,20,1
3,2,11,20,1
3,2,12,20,1
3,2,13,20,1
3,2,14,20,1
3,2,15,20,1
3,2,16,20,1
3,2,17,20,1
3,2,18,20,1
3,2,19,20,1
3,2,20,20,1
3,2,21,20,1
3,3,0,20,1
3,3,1,20,1
3,3,2,20,1
3,3,3,20,1
3,3,4,20,1
3,3,5,20,1
3,3,6,20,1
3,3,7,20,1
3,3,8,20,1
3,3,9,20,1
3,3,10,20,1
3,3,11,20,1
3,3,12,20,1
3,3,13,20,1
3,3,14,20,1
3,3,15,20,1
3,3,16,20,1
3,3,17,20,1
3,3,18,20,1
3,3,19,20,1
3,3,20,20,1
3,3,21,20,1
3,4,0,20,1
3,4,1,20,1
3,4,2,20,1
3,4,3,20,1
3,4,4,20,1
3,4,5,20,1
3,4,6,20,1
3,4,7,20,1
3,4,8,20,1
3,4,9,20,1
3,4,10,20,1
3,4,11,20,1
3,4,12,20,1
3,4,13,20,1
3,4,14,20,1
3,4,15,20,1
3,4,16,20,1
3,4,17,20,1
3,4,18,20,1
3,4,19,20,1
3,4,20,20,1
3,4,21,20,1
3,0,0,21,1
3,0,1,21,1
3,0,2,21,1
3,0,3,21,1
3,0,4,21,1
3,0,5,21,1
3,0,6,21,1
3,0,7,21,1
3,0,8,21,1
3,0,9,21,1
3,0,10,21,1
3,0,11,21,1
3,0,12,21,1
3,0,13,21,1
3,0,14,21,1
3,0,15,21,1
3,0,16,21,1
3,0,17,21,1
3,0,18,21,1
3,0,19,21,1
3,0,20,21,1
3,0,21,21,1
3,1,0,21,1
3,1,1,21,1
3,1,2,21,1
3,1,3,21,1
3,1,4,21,1
3,1,5,21,1
3,1,6,21,1
3,1,7,21,1
3,1,8,21,1
3,1,9,21,1
3,1,10,21,1
3,1,11,21,1
3,1,12,21,1
3,1,13,21,1
3,1,14,21,1
3,1,15,21,1
3,1,16,21,1
3,1,17,21,1
3,1,18,21,1
3,1,19,21,1
3,1,20,21,1
3,1,21,21,1
3,2,0,21,1
3,2,1,21,1
3,2,2,21,1
3,2,3,21,1
3,2,4,21,1
3,2,5,21,1
3,2,6,21,1
3,2,7,21,1
3,2,8,21,1
3,2,9,21,1
3,2,10,21,1
3,2,11,21,1
3,2,12,21,1
3,2,13,21,1
3,2,14,21,1
3,2,15,21,1
3,2,16,21,1
3,2,17,21,1
3,2,18,21,1
3,2,19,21,1
3,2,20,21,1
3,2,21,21,1
3,3,0,21,1
3,3,1,21,1
3,3,2,21,1
3,3,3,21,1
3,3,4,21,1
3,3,5,21,1
3,3,6,21,1
3,3,7,21,1
3,3,8,21,1
3,3,9,21,1
3,3,10,21,1
3,3,11,21,1
3,3,12,21,1
3,3,13,21,1
3,3,14,21,1
3,3,15,21,1
3,3,16,21,1
3,3,17,21,1
3,3,18,21,1
3,3,19,21,1
3,3,20,21,1
3,3,21,21,1
3,0,0,22,1
3,0,1,22,1
3,0,2,22,1
3,0,3,22,1
3,0,4,22,1
3,0,5,22,1
3,0,6,22,1
3,0,7,22,1
3,0,8,22,1
3,0,9,22,1
3,0,10,22,1
3,0,11,22,1
3,0,12,22,1
3,0,13,22,1
3,0,14,22,1
3,0,15,22,1
3,0,16,22,1
3,0,17,22,1
3,0,18,22,1
3,0,19,22,1
3,0,20,22,1
3,0,21,22,1
3,1,0,22,1
3,1,1,22,1
3,1,2,22,1
3,1,3,22,1
3,1,4,22,1
3,1,5,22,1
3,1,6,22,1
3,1,7,22,1
3,1,8,22,1
3,1,9,22,1
3,1,10,22,1
3,1,11,22,1
3,1,12,22,1
3,1,13,22,1
3,1,14,22,1
3,1,15,22,1
3,1,16,22,1
3,1,17,22,1
3,1,18,22,1
3,1,19,22,1
3,1,20,22,1
3,1,21,22,1
3,2,0,22,1
3,2,1,22,1
3,2,2,22,1
3,2,3,22,1
3,2,4,22,1
3,2,5,22,1
3,2,6,22,1
3,2,7,22,1
3,2,8,22,1
3,2,9,22,1
3,2,10,22,1
3,2,11,22,1
3,2,12,22,1
3,2,13,22,1
3,2,14,22,1
3,2,15,22,1
3,2,16,22,1
3,2,17,22,1
3,2,18,22,1
3,2,19,22,1
3,2,20,22,1
3,2,21,22,1
3,0,0,23,1
3,0,1,23,1
3,0,2,23,1
3,0,3,23,1
3,0,4,23,1
3,0,5,23,1
3,0,6,23,1
3,0,7,23,1
3,0,8,23,1
3,0,9,23,1
3,0,10,23,1
3,0,11,23,1
3,0,12,23,1
3,0,13,23,1
3,0,14,23,1
3,0,15,23,1
3,0,16,23,1
3,0,17,23,1
3,0,18,23,1
3,0,19,23,1
3,0,20,23,1
3,0,21,23,1
3,1,0,23,1
3,1,1,23,1
3,1,2,23,1
3,1,3,23,1
3,1,4,23,1
3,1,5,23,1
3,1,6,23,1
3,1,7,23,1
3,1,8,23,1
3,1,9,23,1
3,1,10,23,1
3,1,11,23,1
3,1,12,23,1
3,1,13,23,1
3,1,14,23,1
3,1,15,23,1
3,1,16,23,1
3,1,17,23,1
3,1,18,23,1
3,1,19,23,1
3,1,20,23,1
3,1,21,23,1
3,0,0,24,1
3,0,1,24,1
3,0,2,24,1
3,0,3,24,1
3,0,4,24,1
3,0,5,24,1
3,0,6,24,1
3,0,7,24,1
3,0,8,24,1
3,0,9,24,1
3,0,10,24,1
3,0,11,24,1
3,0,12,24,1
3,0,13,24,1
3,0,14,24,1
3,0,15,24,1
3,0,16,24,1
3,0,17,24,1
3,0,18,24,1
3,0,19,24,1
3,0,20,24,1
3,0,21,24,1
3,0,0,1,2
3,0,1,1,2
3,0,2,1,2
3,0,3,1,2
3,0,4,1,2
3,0,5,1,2
3,0,6,1,2
3,0,7,1,2
3,0,8,1,2
3,0,9,1,2
3,0,10,1,2
3,0,11,1,2
3,0,12,1,2
3,0,13,1,2
3,0,14,1,2
3,0,15,1,2
3,0,16,1,2
3,0,17,1,2
3,0,18,1,2
3,1,0,1,2
3,1,1,1,2
3,1,2,1,2
3,1,3,1,2
3,1,4,1,2
3,1,5,1,2
3,1,6,1,2
3,1,7,1,2
3,1,8,1,2
3,1,9,1,2
3,1,10,1,2
3,1,11,1,2
3,1,12,1,2
3,1,13,1,2
3,1,14,1,2
3,1,15,1,2
3,1,16,1,2
3,1,17,1,2
3,1,18,1,2
3,2,0,1,2
3,2,1,1,2
3,2,2,1,2
3,2,3,1,2
3,2,4,1,2
3,2,5,1,2
3,2,6,1,2
3,2,7,1,2
3,2,8,1,2
3,2,9,1,2
3,2,10,1,2
3,2,11,1,2
3,2,12,1,2
3,2,13,1,2
3,2,14,1,2
3,2,15,1,2
3,2,16,1,2
3,2,17,1,2
3,2,18,1,2
3,3,0,1,2
3,3,1,1,2
3,3,2,1,2
3,3,3,1,2
3,3,4,1,2
3,3,5,1,2
3,3,6,1,2
3,3,7,1,2
3,3,8,1,2
3,3,9,1,2
3,3,10,1,2
3,3,11,1,2
3,3,12,1,2
3,3,13,1,2
3,3,14,1,2
3,3,15,1,2
3,3,16,1,2
3,3,17,1,2
3,3,18,1,2
3,4,0,1,2
3,4,1,1,2
3,4,2,1,2
3,4,3,1,2
3,4,4,1,2
3,4,5,1,2
3,4,6,1,2
3,4,7,1,2
3,4,8,1,2
3,4,9,1,2
3,4,10,1,2
3,4,11,1,2
3,4,12,1,2
3,4,13,1,2
3,4,14,1,2
3,4,15,1,2
3,4,16,1,2
3,4,17,1,2
3,4,18,1,2
3,5,0,1,2
3,5,1,1,2
3,5,2,1,2
3,5,3,1,2
3,5,4,1,2
3,5,5,1,2
3,5,6,1,2
3,5,7,1,2
3,5,8,1,2
3,5,9,1,2
3,5,10,1,2
3,5,11,1,2
3,5,12,1,2
3,5,13,1,2
3,5,14,1,2
3,5,15,1,2
3,5,16,1,2
3,5,17,1,2
3,5,18,1,2
3,6,0,1,2
3,6,1,1,2
3,6,2,1,2
3,6,3,1,2
3,6,4,1,2
3,6,5,1,2
3,6,6,1,2
3,6,7,1,2
3,6,8,1,2
3,6,9,1,2
3,6,10,1,2
3,6,11,1,2
3,6,12,1,2
3,6,13,1,2
3,6,14,1,2
3,6,15,1,2
3,6,16,1,2
3,6,17,1,2
3,6,18,1,2
3,7,0,1,2
3,7,1,1,2
3,7,2,1,2
3,7,3,1,2
3,7,4,1,2
3,7,5,1,2
3,7,6,1,2
3,7,7,1,2
3,7,8,1,2
3,7,9,1,2
3,7,10,1,2
3,7,11,1,2
3,7,12,1,2
3,7,13,1,2
3,7,14,1,2
3,7,15,1,2
3,7,16,1,2
3,7,17,1,2
3,7,18,1,2
3,8,0,1,2
3,8,1,1,2
3,8,2,1,2
3,8,3,1,2
3,8,4,1,2
3,8,5,1,2
3,8,6,1,2
3,8,7,1,2
3,8,8,1,2
3,8,9,1,2
3,8,10,1,2
3,8,11,1,2
3,8,12,1,2
3,8,13,1,2
3,8,14,1,2
3,8,15,1,2
3,8,16,1,2
3,8,17,1,2
3,8,18,1,2
3,9,0,1,2
3,9,1,1,2
3,9,2,1,2
3,9,3,1,2
3,9,4,1,2
3,9,5,1,2
3,9,6,1,2
3,9,7,1,2
3,9,8,1,2
3,9,9,1,2
3,9,10,1,2
3,9,11,1,2
3,9,12,1,2
3,9,13,1,2
3,9,14,1,2
3,9,15,1,2
3,9,16,1,2
3,9,17,1,2
3,9,18,1,2
3,10,0,1,2
3,10,1,1,2
3,10,2,1,2
3,10,3,1,2
3,10,4,1,2
3,10,5,1,2
3,10,6,1,2
3,10,7,1,2
3,10,8,1,2
3,10,9,1,2
3,10,10,1,2
3,10,11,1,2
3,10,12,1,2
3,10,13,1,2
3,10,14,1,2
3,10,15,1,2
3,10,16,1,2
3,10,17,1,2
3,10,18,1,2
3,11,0,1,2
3,11,1,1,2
3,11,2,1,2
3,11,3,1,2
3,11,4,1,2
3,11,5,1,2
3,11,6,1,2
3,11,7,1,2
3,11,8,1,2
3,11,9,1,2
3,11,10,1,2
3,11,11,1,2
3,11,12,1,2
3,11,13,1,2
3,11,14,1,2
3,11,15,1,2
3,11,16,1,2
3,11,17,1,2
3,11,18,1,2
3,12,0,1,2
3,12,1,1,2
3,12,2,1,2
3,12,3,1,2
3,12,4,1,2
3,12,5,1,2
3,12,6,1,2
3,12,7,1,2
3,12,8,1,2
3,12,9,1,2
3,12,10,1,2
3,12,11,1,2
3,12,12,1,2
3,12,13,1,2
3,12,14,1,2
3,12,15,1,2
3,12,16,1,2
3,12,17,1,2
3,12,18,1,2
3,13,0,1,2
3,13,1,1,2
3,13,2,1,2
3,13,3,1,2
3,13,4,1,2
3,13,5,1,2
3,13,6,1,2
3,13,7,1,2
3,13,8,1,2
3,13,9,1,2
3,13,10,1,2
3,13,11,1,2
3,13,12,1,2
3,13,13,1,2
3,13,14,1,2
3,13,15,1,2
3,13,16,1,2
3,13,17,1,2
3,13,18,1,2
3,14,0,1,2
3,14,1,1,2
3,14,2,1,2
3,14,3,1,2
3,14,4,1,2
3,14,5,1,2
3,14,6,1,2
3,14,7,1,2
3,14,8,1,2
3,14,9,1,2
3,14,10,1,2
3,14,11,1,2
3,14,12,1,2
3,14,13,1,2
3,14,14,1,2
3,14,15,1,2
3,14,16,1,2
3,14,17,1,2
3,14,18,1,2
3,15,0,1,2
3,15,1,1,2
3,15,2,1,2
3,15,3,1,2
3,15,4,1,2
3,15,5,1,2
3,15,6,1,2
3,15,7,1,2
3,15,8,1,2
3,15,9,1,2
3,15,10,1,2
3,15,11,1,2
3,15,12,1,2
3,15,13,1,2
3,15,14,1,2
3,15,15,1,2
3,15,16,1,2
3,15,17,1,2
3,15,18,1,2
3,16,0,1,2
3,16,1,1,2
3,16,2,1,2
3,16,3,1,2
3,16,4,1,2
3,16,5,1,2
3,16,6,1,2
3,16,7,1,2
3,16,8,1,2
3,16,9,1,2
3,16,10,1,2
3,16,11,1,2
3,16,12,1,2
3,16,13,1,2
3,16,14,1,2
3,16,15,1,2
3,16,16,1,2
3,16,17,1,2
3,16,18,1,2
3,17,0,1,2
3,17,1,1,2
3,17,2,1,2
3,17,3,1,2
3,17,4,1,2
3,17,5,1,2
3,17,6,1,2
3,17,7,1,2
3,17,8,1,2
3,17,9,1,2
3,17,10,1,2
3,17,11,1,2
3,17,12,1,2
3,17,13,1,2
3,17,14,1,2
3,17,15,1,2
3,17,16,1,2
3,17,17,1,2
3,17,18,1,2
3,18,0,1,2
3,18,1,1,2
3,18,2,1,2
3,18,3,1,2
3,18,4,1,2
3,18,5,1,2
3,18,6,1,2
3,18,7,1,2
3,18,8,1,2
3,18,9,1,2
3,18,10,1,2
3,18,11,1,2
3,18,12,1,2
3,18,13,1,2
3,18,14,1,2
3,18,15,1,2
3,18,16,1,2
3,18,17,1,2
3,18,18,1,2
3,19,0,1,2
3,19,1,1,2
3,19,2,1,2
3,19,3,1,2
3,19,4,1,2
3,19,5,1,2
3,19,6,1,2
3,19,7,1,2
3,19,8,1,2
3,19,9,1,2
3,19,10,1,2
3,19,11,1,2
3,19,12,1,2
3,19,13,1,2
3,19,14,1,2
3,19,15,1,2
3,19,16,1,2
3,19,17,1,2
3,19,18,1,2
3,20,0,1,2
3,20,1,1,2
3,20,2,1,2
3,20,3,1,2
3,20,4,1,2
3,20,5,1,2
3,20,6,1,2
3,20,7,1,2
3,20,8,1,2
3,20,9,1,2
3,20,10,1,2
3,20,11,1,2
3,20,12,1,2
3,20,13,1,2
3,20,14,1,2
3,20,15,1,2
3,20,16,1,2
3,20,17,1,2
3,20,18,1,2
3,21,0,1,2
3,21,1,1,2
3,21,2,1,2
3,21,3,1,2
3,21,4,1,2
3,21,5,1,2
3,21,6,1,2
3,21,7,1,2
3,21,8,1,2
3,21,9,1,2
3,21,10,1,2
3,21,11,1,2
3,21,12,1,2
3,21,13,1,2
3,21,14,1,2
3,21,15,1,2
3,21,16,1,2
3,21,17,1,2
3,21,18,1,2
3,22,0,1,2
3,22,1,1,2
3,22,2,1,2
3,22,3,1,2
3,22,4,1,2
3,22,5,1,2
3,22,6,1,2
3,22,7,1,2
3,22,8,1,2
3,22,9,1,2
3,22,10,1,2
3,22,11,1,2
3,22,12,1,2
3,22,13,1,2
3,22,14,1,2
3,22,15,1,2
3,22,16,1,2
3,22,17,1,2
3,22,18,1,2
3,23,0,1,2
3,23,1,1,2
3,23,2,1,2
3,23,3,1,2
3,23,4,1,2
3,23,5,1,2
3,23,6,1,2
3,23,7,1,2
3,23,8,1,2
3,23,9,1,2
3,23,10,1,2
3,23,11,1,2
3,23,12,1,2
3,23,13,1,2
3,23,14,1,2
3,23,15,1,2
3,23,16,1,2
3,23,17,1,2
3,23,18,1,2
3,0,0,2,2
3,0,1,2,2
3,0,2,2,2
3,0,3,2,2
3,0,4,2,2
3,0,5,2,2
3,0,6,2,2
3,0,7,2,2
3,0,8,2,2
3,0,9,2,2
3,0,10,2,2
3,0,11,2,2
3,0,12,2,2
3,0,13,2,2
3,0,14,2,2
3,0,15,2,2
3,0,16,2,2
3,0,17,2,2
3,0,18,2,2
3,1,0,2,2
3,1,1,2,2
3,1,2,2,2
3,1,3,2,2
3,1,4,2,2
3,1,5,2,2
3,1,6,2,2
3,1,7,2,2
3,1,8,2,2
3,1,9,2,2
3,1,10,2,2
3,1,11,2,2
3,1,12,2,2
3,1,13,2,2
3,1,14,2,2
3,1,15,2,2
3,1,16,2,2
3,1,17,2,2
3,1,18,2,2
3,2,0,2,2
3,2,1,2,2
3,2,2,2,2
3,2,3,2,2
3,2,4,2,2
3,2,5,2,2
3,2,6,2,2
3,2,7,2,2
3,2,8,2,2
3,2,9,2,2
3,2,10,2,2
3,2,11,2,2
3,2,12,2,2
3,2,13,2,2
3,2,14,2,2
3,2,15,2,2
3,2,16,2,2
3,2,17,2,2
3,2,18,2,2
3,3,0,2,2
3,3,1,2,2
3,3,2,2,2
3,3,3,2,2
3,3,4,2,2
3,3,5,2,2
3,3,6,2,2
3,3,7,2,2
3,3,8,2,2
3,3,9,2,2
3,3,10,2,2
3,3,11,2,2
3,3,12,2,2
3,3,13,2,2
3,3,14,2,2
3,3,15,2,2
3,3,16,2,2
3,3,17,2,2
3,3,18,2,2
3,4,0,2,2
3,4,1,2,2
3,4,2,2,2
3,4,3,2,2
3,4,4,2,2
3,4,5,2,2
3,4,6,2,2
3,4,7,2,2
3,4,8,2,2
3,4,9,2,2
3,4,10,2,2
3,4,11,2,2
3,4,12,2,2
3,4,13,2,2
3,4,14,2,2
3,4,15,2,2
3,4,16,2,2
3,4,17,2,2
3,4,18,2,2
3,5,0,2,2
3,5,1,2,2
3,5,2,2,2
3,5,3,2,2
3,5,4,2,2
3,5,5,2,2
3,5,6,2,2
3,5,7,2,2
3,5,8,2,2
3,5,9,2,2
3,5,10,2,2
3,5,11,2,2
3,5,12,2,2
3,5,13,2,2
3,5,14,2,2
3,5,15,2,2
3,5,16,2,2
3,5,17,2,2
3,5,18,2,2
3,6,0,2,2
3,6,1,2,2
3,6,2,2,2
3,6,3,2,2
3,6,4,2,2
3,6,5,2,2
3,6,6,2,2
3,6,7,2,2
3,6,8,2,2
3,6,9,2,2
3,6,10,2,2
3,6,11,2,2
3,6,12,2,2
3,6,13,2,2
3,6,14,2,2
3,6,15,2,2
3,6,16,2,2
3,6,17,2,2
3,6,18,2,2
3,7,0,2,2
3,7,1,2,2
3,7,2,2,2
3,7,3,2,2
3,7,4,2,2
3,7,5,2,2
3,7,6,2,2
3,7,7,2,2
3,7,8,2,2
3,7,9,2,2
3,7,10,2,2
3,7,11,2,2
3,7,12,2,2
3,7,13,2,2
3,7,14,2,2
3,7,15,2,2
3,7,16,2,2
3,7,17,2,2
3,7,18,2,2
3,8,0,2,2
3,8,1,2,2
3,8,2,2,2
3,8,3,2,2
3,8,4,2,2
3,8,5,2,2
3,8,6,2,2
3,8,7,2,2
3,8,8,2,2
3,8,9,2,2
3,8,10,2,2
3,8,11,2,2
3,8,12,2,2
3,8,13,2,2
3,8,14,2,2
3,8,15,2,2
3,8,16,2,2
3,8,17,2,2
3,8,18,2,2
3,9,0,2,2
3,9,1,2,2
3,9,2,2,2
3,9,3,2,2
3,9,4,2,2
3,9,5,2,2
3,9,6,2,2
3,9,7,2,2
3,9,8,2,2
3,9,9,2,2
3,9,10,2,2
3,9,11,2,2
3,9,12,2,2
3,9,13,2,2
3,9,14,2,2
3,9,15,2,2
3,9,16,2,2
3,9,17,2,2
3,9,18,2,2
3,10,0,2,2
3,10,1,2,2
3,10,2,2,2
3,10,3,2,2
3,10,4,2,2
3,10,5,2,2
3,10,6,2,2
3,10,7,2,2
3,10,8,2,2
3,10,9,2,2
3,10,10,2,2
3,10,11,2,2
3,10,12,2,2
3,10,13,2,2
3,10,14,2,2
3,10,15,2,2
3,10,16,2,2
3,10,17,2,2
3,10,18,2,2
3,11,0,2,2
3,11,1,2,2
3,11,2,2,2
3,11,3,2,2
3,11,4,2,2
3,11,5,2,2
3,11,6,2,2
3,11,7,2,2
3,11,8,2,2
3,11,9,2,2
3,11,10,2,2
3,11,11,2,2
3,11,12,2,2
3,11,13,2,2
3,11,14,2,2
3,11,15,2,2
3,11,16,2,2
3,11,17,2,2
3,11,18,2,2
3,12,0,2,2
3,12,1,2,2
3,12,2,2,2
3,12,3,2,2
3,12,4,2,2
3,12,5,2,2
3,12,6,2,2
3,12,7,2,2
3,12,8,2,2
3,12,9,2,2
3,12,10,2,2
3,12,11,2,2
3,12,12,2,2
3,12,13,2,2
3,12,14,2,2
3,12,15,2,2
3,12,16,2,2
3,12,17,2,2
3,12,18,2,2
3,13,0,2,2
3,13,1,2,2
3,13,2,2,2
3,13,3,2,2
3,13,4,2,2
3,13,5,2,2
3,13,6,2,2
3,13,7,2,2
3,13,8,2,2
3,13,9,2,2
3,13,10,2,2
3,13,11,2,2
3,13,12,2,2
3,13,13,2,2
3,13,14,2,2
3,13,15,2,2
3,13,16,2,2
3,13,17,2,2
3,13,18,2,2
3,14,0,2,2
3,14,1,2,2
3,14,2,2,2
3,14,3,2,2
3,14,4,2,2
3,14,5,2,2
3,14,6,2,2
3,14,7,2,2
3,14,8,2,2
3,14,9,2,2
3,14,10,2,2
3,14,11,2,2
3,14,12,2,2
3,14,13,2,2
3,14,14,2,2
3,14,15,2,2
3,14,16,2,2
3,14,17,2,2
3,14,18,2,2
3,15,0,2,2
3,15,1,2,2
3,15,2,2,2
3,15,3,2,2
3,15,4,2,2
3,15,5,2,2
3,15,6,2,2
3,15,7,2,2
3,15,8,2,2
3,15,9,2,2
3,15,10,2,2
3,15,11,2,2
3,15,12,2,2
3,15,13,2,2
3,15,14,2,2
3,15,15,2,2
3,15,16,2,2
3,15,17,2,2
3,15,18,2,2
3,16,0,2,2
3,16,1,2,2
3,16,2,2,2
3,16,3,2,2
3,16,4,2,2
3,16,5,2,2
3,16,6,2,2
3,16,7,2,2
3,16,8,2,2
3,16,9,2,2
3,16,10,2,2
3,16,11,2,2
3,16,12,2,2
3,16,13,2,2
3,16,14,2,2
3,16,15,2,2
3,16,16,2,2
3,16,17,2,2
3,16,18,2,2
3,17,0,2,2
3,17,1,2,2
3,17,2,2,2
3,17,3,2,2
3,17,4,2,2
3,17,5,2,2
3,17,6,2,2
3,17,7,2,2
3,17,8,2,2
3,17,9,2,2
3,17,10,2,2
3,17,11,2,2
3,17,12,2,2
3,17,13,2,2
3,17,14,2,2
3,17,15,2,2
3,17,16,2,2
3,17,17,2,2
3,17,18,2,2
3,18,0,2,2
3,18,1,2,2
3,18,2,2,2
3,18,3,2,2
3,18,4,2,2
3,18,5,2,2
3,18,6,2,2
3,18,7,2,2
3,18,8,2,2
3,18,9,2,2
3,18,10,2,2
3,18,11,2,2
3,18,12,2,2
3,18,13,2,2
3,18,14,2,2
3,18,15,2,2
3,18,16,2,2
3,18,17,2,2
3,18,18,2,2
3,19,0,2,2
3,19,1,2,2
3,19,2,2,2
3,19,3,2,2
3,19,4,2,2
3,19,5,2,2
3,19,6,2,2
3,19,7,2,2
3,19,8,2,2
3,19,9,2,2
3,19,10,2,2
3,19,11,2,2
3,19,12,2,2
3,19,13,2,2
3,19,14,2,2
3,19,15,2,2
3,19,16,2,2
3,19,17,2,2
3,19,18,2,2
3,20,0,2,2
3,20,1,2,2
3,20,2,2,2
3,20,3,2,2
3,20,4,2,2
3,20,5,2,2
3,20,6,2,2
3,20,7,2,2
3,20,8,2,2
3,20,9,2,2
3,20,10,2,2
3,20,11,2,2
3,20,12,2,2
3,20,13,2,2
3,20,14,2,2
3,20,15,2,2
3,20,16,2,2
3,20,17,2,2
3,20,18,2,2
3,21,0,2,2
3,21,1,2,2
3,21,2,2,2
3,21,3,2,2
3,21,4,2,2
3,21,5,2,2
3,21,6,2,2
3,21,7,2,2
3,21,8,2,2
3,21,9,2,2
3,21,10,2,2
3,21,11,2,2
3,21,12,2,2
3,21,13,2,2
3,21,14,2,2
3,21,15,2,2
3,21,16,2,2
3,21,17,2,2
3,21,18,2,2
3,22,0,2,2
3,22,1,2,2
3,22,2,2,2
3,22,3,2,2
3,22,4,2,2
3,22,5,2,2
3,22,6,2,2
3,22,7,2,2
3,22,8,2,2
3,22,9,2,2
3,22,10,2,2
3,22,11,2,2
3,22,12,2,2
3,22,13,2,2
3,22,14,2,2
3,22,15,2,2
3,22,16,2,2
3,22,17,2,2
3,22,18,2,2
3,0,0,3,2
3,0,1,3,2
3,0,2,3,2
3,0,3,3,2
3,0,4,3,2
3,0,5,3,2
3,0,6,3,2
3,0,7,3,2
3,0,8,3,2
3,0,9,3,2
3,0,10,3,2
3,0,11,3,2
3,0,12,3,2
3,0,13,3,2
3,0,14,3,2
3,0,15,3,2
3,0,16,3,2
3,0,17,3,2
3,0,18,3,2
3,1,0,3,2
3,1,1,3,2
3,1,2,3,2
3,1,3,3,2
3,1,4,3,2
3,1,5,3,2
3,1,6,3,2
3,1,7,3,2
3,1,8,3,2
3,1,9,3,2
3,1,10,3,2
3,1,11,3,2
3,1,12,3,2
3,1,13,3,2
3,1,14,3,2
3,1,15,3,2
3,1,16,3,2
3,1,17,3,2
3,1,18,3,2
3,2,0,3,2
3,2,1,3,2
3,2,2,3,2
3,2,3,3,2
3,2,4,3,2
3,2,5,3,2
3,2,6,3,2
3,2,7,3,2
3,2,8,3,2
3,2,9,3,2
3,2,10,3,2
3,2,11,3,2
3,2,12,3,2
3,2,13,3,2
3,2,14,3,2
3,2,15,3,2
3,2,16,3,2
3,2,17,3,2
3,2,18,3,2
3,3,0,3,2
3,3,1,3,2
3,3,2,3,2
3,3,3,3,2
3,3,4,3,2
3,3,5,3,2
3,3,6,3,2
3,3,7,3,2
3,3,8,3,2
3,3,9,3,2
3,3,10,3,2
3,3,11,3,2
3,3,12,3,2
3,3,13,3,2
3,3,14,3,2
3,3,15,3,2
3,3,16,3,2
3,3,17,3,2
3,3,18,3,2
3,4,0,3,2
3,4,1,3,2
3,4,2,3,2
3,4,3,3,2
3,4,4,3,2
3,4,5,3,2
3,4,6,3,2
3,4,7,3,2
3,4,8,3,2
3,4,9,3,2
3,4,10,3,2
3,4,11,3,2
3,4,12,3,2
3,4,13,3,2
3,4,14,3,2
3,4,15,3,2
3,4,16,3,2
3,4,17,3,2
3,4,18,3,2
3,5,0,3,2
3,5,1,3,2
3,5,2,3,2
3,5,3,3,2
3,5,4,3,2
3,5,5,3,2
3,5,6,3,2
3,5,7,3,2
3,5,8,3,2
3,5,9,3,2
3,5,10,3,2
3,5,11,3,2
3,5,12,3,2
3,5,13,3,2
3,5,14,3,2
3,5,15,3,2
3,5,16,3,2
3,5,17,3,2
3,5,18,3,2
3,6,0,3,2
3,6,1,3,2
3,6,2,3,2
3,6,3,3,2
3,6,4,3,2
3,6,5,3,2
3,6,6,3,2
3,6,7,3,2
3,6,8,3,2
3,6,9,3,2
3,6,10,3,2
3,6,11,3,2
3,6,12,3,2
3,6,13,3,2
3,6,14,3,2
3,6,15,3,2
3,6,16,3,2
3,6,17,3,2
3,6,18,3,2
3,7,0,3,2
3,7,1,3,2
3,7,2,3,2
3,7,3,3,2
3,7,4,3,2
3,7,5,3,2
3,7,6,3,2
3,7,7,3,2
3,7,8,3,2
3,7,9,3,2
3,7,10,3,2
3,7,11,3,2
3,7,12,3,2
3,7,13,3,2
3,7,14,3,2
3,7,15,3,2
3,7,16,3,2
3,7,17,3,2
3,7,18,3,2
3,8,0,3,2
3,8,1,3,2
3,8,2,3,2
3,8,3,3,2
3,8,4,3,2
3,8,5,3,2
3,8,6,3,2
3,8,7,3,2
3,8,8,3,2
3,8,9,3,2
3,8,10,3,2
3,8,11,3,2
3,8,12,3,2
3,8,13,3,2
3,8,14,3,2
3,8,15,3,2
3,8,16,3,2
3,8,17,3,2
3,8,18,3,2
3,9,0,3,2
3,9,1,3,2
3,9,2,3,2
3,9,3,3,2
3,9,4,3,2
3,9,5,3,2
3,9,6,3,2
3,9,7,3,2
3,9,8,3,2
3,9,9,3,2
3,9,10,3,2
3,9,11,3,2
3,9,12,3,2
3,9,13,3,2
3,9,14,3,2
3,9,15,3,2
3,9,16,3,2
3,9,17,3,2
3,9,18,3,2
3,10,0,3,2
3,10,1,3,2
3,10,2,3,2
3,10,3,3,2
3,10,4,3,2
3,10,5,3,2
3,10,6,3,2
3,10,7,3,2
3,10,8,3,2
3,10,9,3,2
3,10,10,3,2
3,10,11,3,2
3,10,12,3,2
3,10,13,3,2
3,10,14,3,2
3,10,15,3,2
3,10,16,3,2
3,10,17,3,2
3,10,18,3,2
3,11,0,3,2
3,11,1,3,2
3,11,2,3,2
3,11,3,3,2
3,11,4,3,2
3,11,5,3,2
3,11,6,3,2
3,11,7,3,2
3,11,8,3,2
3,11,9,3,2
3,11,10,3,2
3,11,11,3,2
3,11,12,3,2
3,11,13,3,2
3,11,14,3,2
3,11,15,3,2
3,11,16,3,2
3,11,17,3,2
3,11,18,3,2
3,12,0,3,2
3,12,1,3,2
3,12,2,3,2
3,12,3,3,2
3,12,4,3,2
3,12,5,3,2
3,12,6,3,2
3,12,7,3,2
3,12,8,3,2
3,12,9,3,2
3,12,10,3,2
3,12,11,3,2
3,12,12,3,2
3,12,13,3,2
3,12,14,3,2
3,12,15,3,2
3,12,16,3,2
3,12,17,3,2
3,12,18,3,2
3,13,0,3,2
3,13,1,3,2
3,13,2,3,2
3,13,3,3,2
3,13,4,3,2
3,13,5,3,2
3,13,6,3,2
3,13,7,3,2
3,13,8,3,2
3,13,9,3,2
3,13,10,3,2
3,13,11,3,2
3,13,12,3,2
3,13,13,3,2
3,13,14,3,2
3,13,15,3,2
3,13,16,3,2
3,13,17,3,2
3,13,18,3,2
3,14,0,3,2
3,14,1,3,2
3,14,2,3,2
3,14,3,3,2
3,14,4,3,2
3,14,5,3,2
3,14,6,3,2
3,14,7,3,2
3,14,8,3,2
3,14,9,3,2
3,14,10,3,2
3,14,11,3,2
3,14,12,3,2
3,14,13,3,2
3,14,14,3,2
3,14,15,3,2
3,14,16,3,2
3,14,17,3,2
3,14,18,3,2
3,15,0,3,2
3,15,1,3,2
3,15,2,3,2
3,15,3,3,2
3,15,4,3,2
3,15,5,3,2
3,15,6,3,2
3,15,7,3,2
3,15,8,3,2
3,15,9,3,2
3,15,10,3,2
3,15,11,3,2
3,15,12,3,2
3,15,13,3,2
3,15,14,3,2
3,15,15,3,2
3,15,16,3,2
3,15,17,3,2
3,15,18,3,2
3,16,0,3,2
3,16,1,3,2
3,16,2,3,2
3,16,3,3,2
3,16,4,3,2
3,16,5,3,2
3,16,6,3,2
3,16,7,3,2
3,16,8,3,2
3,16,9,3,2
3,16,10,3,2
3,16,11,3,2
3,16,12,3,2
3,16,13,3,2
3,16,14,3,2
3,16,15,3,2
3,16,16,3,2
3,16,17,3,2
3,16,18,3,2
3,17,0,3,2
3,17,1,3,2
3,17,2,3,2
3,17,3,3,2
3,17,4,3,2
3,17,5,3,2
3,17,6,3,2
3,17,7,3,2
3,17,8,3,2
3,17,9,3,2
3,17,10,3,2
3,17,11,3,2
3,17,12,3,2
3,17,13,3,2
3,17,14,3,2
3,17,15,3,2
3,17,16,3,2
3,17,17,3,2
3,17,18,3,2
3,18,0,3,2
3,18,1,3,2
3,18,2,3,2
3,18,3,3,2
3,18,4,3,2
3,18,5,3,2
3,18,6,3,2
3,18,7,3,2
3,18,8,3,2
3,18,9,3,2
3,18,10,3,2
3,18,11,3,2
3,18,12,3,2
3,18,13,3,2
3,18,14,3,2
3,18,15,3,2
3,18,16,3,2
3,18,17,3,2
3,18,18,3,2
3,19,0,3,2
3,19,1,3,2
3,19,2,3,2
3,19,3,3,2
3,19,4,3,2
3,19,5,3,2
3,19,6,3,2
3,19,7,3,2
3,19,8,3,2
3,19,9,3,2
3,19,10,3,2
3,19,11,3,2
3,19,12,3,2
3,19,13,3,2
3,19,14,3,2
3,19,15,3,2
3,19,16,3,2
3,19,17,3,2
3,19,18,3,2
3,20,0,3,2
3,20,1,3,2
3,20,2,3,2
3,20,3,3,2
3,20,4,3,2
3,20,5,3,2
3,20,6,3,2
3,20,7,3,2
3,20,8,3,2
3,20,9,3,2
3,20,10,3,2
3,20,11,3,2
3,20,12,3,2
3,20,13,3,2
3,20,14,3,2
3,20,15,3,2
3,20,16,3,2
3,20,17,3,2
3,20,18,3,2
3,21,0,3,2
3,21,1,3,2
3,21,2,3,2
3,21,3,3,2
3,21,4,3,2
3,21,5,3,2
3,21,6,3,2
3,21,7,3,2
3,21,8,3,2
3,21,9,3,2
3,21,10,3,2
3,21,11,3,2
3,21,12,3,2
3,21,13,3,2
3,21,14,3,2
3,21,15,3,2
3,21,16,3,2
3,21,17,3,2
3,21,18,3,2
3,0,0,4,2
3,0,1,4,2
3,0,2,4,2
3,0,3,4,2
3,0,4,4,2
3,0,5,4,2
3,0,6,4,2
3,0,7,4,2
3,0,8,4,2
3,0,9,4,2
3,0,10,4,2
3,0,11,4,2
3,0,12,4,2
3,0,13,4,2
3,0,14,4,2
3,0,15,4,2
3,0,16,4,2
3,0,17,4,2
3,0,18,4,2
3,1,0,4,2
3,1,1,4,2
3,1,2,4,2
3,1,3,4,2
3,1,4,4,2
3,1,5,4,2
3,1,6,4,2
3,1,7,4,2
3,1,8,4,2
3,1,9,4,2
3,1,10,4,2
3,1,11,4,2
3,1,12,4,2
3,1,13,4,2
3,1,14,4,2
3,1,15,4,2
3,1,16,4,2
3,1,17,4,2
3,1,18,4,2
3,2,0,4,2
3,2,1,4,2
3,2,2,4,2
3,2,3,4,2
3,2,4,4,2
3,2,5,4,2
3,2,6,4,2
3,2,7,4,2
3,2,8,4,2
3,2,9,4,2
3,2,10,4,2
3,2,11,4,2
3,2,12,4,2
3,2,13,4,2
3,2,14,4,2
3,2,15,4,2
3,2,16,4,2
3,2,17,4,2
3,2,18,4,2
3,3,0,4,2
3,3,1,4,2
3,3,2,4,2
3,3,3,4,2
3,3,4,4,2
3,3,5,4,2
3,3,6,4,2
3,3,7,4,2
3,3,8,4,2
3,3,9,4,2
3,3,10,4,2
3,3,11,4,2
3,3,12,4,2
3,3,13,4,2
3,3,14,4,2
3,3,15,4,2
3,3,16,4,2
3,3,17,4,2
3,3,18,4,2
3,4,0,4,2
3,4,1,4,2
3,4,2,4,2
3,4,3,4,2
3,4,4,4,2
3,4,5,4,2
3,4,6,4,2
3,4,7,4,2
3,4,8,4,2
3,4,9,4,2
3,4,10,4,2
3,4,11,4,2
3,4,12,4,2
3,4,13,4,2
3,4,14,4,2
3,4,15,4,2
3,4,16,4,2
3,4,17,4,2
3,4,18,4,2
3,5,0,4,2
3,5,1,4,2
3,5,2,4,2
3,5,3,4,2
3,5,4,4,2
3,5,5,4,2
3,5,6,4,2
3,5,7,4,2
3,5,8,4,2
3,5,9,4,2
3,5,10,4,2
3,5,11,4,2
3,5,12,4,2
3,5,13,4,2
3,5,14,4,2
3,5,15,4,2
3,5,16,4,2
3,5,17,4,2
3,5,18,4,2
3,6,0,4,2
3,6,1,4,2
3,6,2,4,2
3,6,3,4,2
3,6,4,4,2
3,6,5,4,2
3,6,6,4,2
3,6,7,4,2
3,6,8,4,2
3,6,9,4,2
3,6,10,4,2
3,6,11,4,2
3,6,12,4,2
3,6,13,4,2
3,6,14,4,2
3,6,15,4,2
3,6,16,4,2
3,6,17,4,2
3,6,18,4,2
3,7,0,4,2
3,7,1,4,2
3,7,2,4,2
3,7,3,4,2
3,7,4,4,2
3,7,5,4,2
3,7,6,4,2
3,7,7,4,2
3,7,8,4,2
3,7,9,4,2
3,7,10,4,2
3,7,11,4,2
3,7,12,4,2
3,7,13,4,2
3,7,14,4,2
3,7,15,4,2
3,7,16,4,2
3,7,17,4,2
3,7,18,4,2
3,8,0,4,2
3,8,1,4,2
3,8,2,4,2
3,8,3,4,2
3,8,4,4,2
3,8,5,4,2
3,8,6,4,2
3,8,7,4,2
3,8,8,4,2
3,8,9,4,2
3,8,10,4,2
3,8,11,4,2
3,8,12,4,2
3,8,13,4,2
3,8,14,4,2
3,8,15,4,2
3,8,16,4,2
3,8,17,4,2
3,8,18,4,2
3,9,0,4,2
3,9,1,4,2
3,9,2,4,2
3,9,3,4,2
3,9,4,4,2
3,9,5,4,2
3,9,6,4,2
3,9,7,4,2
3,9,8,4,2
3,9,9,4,2
3,9,10,4,2
3,9,11,4,2
3,9,12,4,2
3,9,13,4,2
3,9,14,4,2
3,9,15,4,2
3,9,16,4,2
3,9,17,4,2
3,9,18,4,2
3,10,0,4,2
3,10,1,4,2
3,10,2,4,2
3,10,3,4,2
3,10,4,4,2
3,10,5,4,2
3,10,6,4,2
3,10,7,4,2
3,10,8,4,2
3,10,9,4,2
3,10,10,4,2
3,10,11,4,2
3,10,12,4,2
3,10,13,4,2
3,10,14,4,2
3,10,15,4,2
3,10,16,4,2
3,10,17,4,2
3,10,18,4,2
3,11,0,4,2
3,11,1,4,2
3,11,2,4,2
3,11,3,4,2
3,11,4,4,2
3,11,5,4,2
3,11,6,4,2
3,11,7,4,2
3,11,8,4,2
3,11,9,4,2
3,11,10,4,2
3,11,11,4,2
3,11,12,4,2
3,11,13,4,2
3,11,14,4,2
3,11,15,4,2
3,11,16,4,2
3,11,17,4,2
3,11,18,4,2
3,12,0,4,2
3,12,1,4,2
3,12,2,4,2
3,12,3,4,2
3,12,4,4,2
3,12,5,4,2
3,12,6,4,2
3,12,7,4,2
3,12,8,4,2
3,12,9,4,2
3,12,10,4,2
3,12,11,4,2
3,12,12,4,2
3,12,13,4,2
3,12,14,4,2
3,12,15,4,2
3,12,16,4,2
3,12,17,4,2
3,12,18,4,2
3,13,0,4,2
3,13,1,4,2
3,13,2,4,2
3,13,3,4,2
3,13,4,4,2
3,13,5,4,2
3,13,6,4,2
3,13,7,4,2
3,13,8,4,2
3,13,9,4,2
3,13,10,4,2
3,13,11,4,2
3,13,12,4,2
3,13,13,4,2
3,13,14,4,2
3,13,15,4,2
3,13,16,4,2
3,13,17,4,2
3,13,18,4,2
3,14,0,4,2
3,14,1,4,2
3,14,2,4,2
3,14,3,4,2
3,14,4,4,2
3,14,5,4,2
3,14,6,4,2
3,14,7,4,2
3,14,8,4,2
3,14,9,4,2
3,14,10,4,2
3,14,11,4,2
3,14,12,4,2
3,14,13,4,2
3,14,14,4,2
3,14,15,4,2
3,14,16,4,2
3,14,17,4,2
3,14,18,4,2
3,15,0,4,2
3,15,1,4,2
3,15,2,4,2
3,15,3,4,2
3,15,4,4,2
3,15,5,4,2
3,15,6,4,2
3,15,7,4,2
3,15,8,4,2
3,15,9,4,2
3,15,10,4,2
3,15,11,4,2
3,15,12,4,2
3,15,13,4,2
3,15,14,4,2
3,15,15,4,2
3,15,16,4,2
3,15,17,4,2
3,15,18,4,2
3,16,0,4,2
3,16,1,4,2
3,16,2,4,2
3,16,3,4,2
3,16,4,4,2
3,16,5,4,2
3,16,6,4,2
3,16,7,4,2
3,16,8,4,2
3,16,9,4,2
3,16,10,4,2
3,16,11,4,2
3,16,12,4,2
3,16,13,4,2
3,16,14,4,2
3,16,15,4,2
3,16,16,4,2
3,16,17,4,2
3,16,18,4,2
3,17,0,4,2
3,17,1,4,2
3,17,2,4,2
3,17,3,4,2
3,17,4,4,2
3,17,5,4,2
3,17,6,4,2
3,17,7,4,2
3,17,8,4,2
3,17,9,4,2
3,17,10,4,2
3,17,11,4,2
3,17,12,4,2
3,17,13,4,2
3,17,14,4,2
3,17,15,4,2
3,17,16,4,2
3,17,17,4,2
3,17,18,4,2
3,18,0,4,2
3,18,1,4,2
3,18,2,4,2
3,18,3,4,2
3,18,4,4,2
3,18,5,4,2
3,18,6,4,2
3,18,7,4,2
3,18,8,4,2
3,18,9,4,2
3,18,10,4,2
3,18,11,4,2
3,18,12,4,2
3,18,13,4,2
3,18,14,4,2
3,18,15,4,2
3,18,16,4,2
3,18,17,4,2
3,18,18,4,2
3,19,0,4,2
3,19,1,4,2
3,19,2,4,2
3,19,3,4,2
3,19,4,4,2
3,19,5,4,2
3,19,6,4,2
3,19,7,4,2
3,19,8,4,2
3,19,9,4,2
3,19,10,4,2
3,19,11,4,2
3,19,12,4,2
3,19,13,4,2
3,19,14,4,2
3,19,15,4,2
3,19,16,4,2
3,19,17,4,2
3,19,18,4,2
3,20,0,4,2
3,20,1,4,2
3,20,2,4,2
3,20,3,4,2
3,20,4,4,2
3,20,5,4,2
3,20,6,4,2
3,20,7,4,2
3,20,8,4,2
3,20,9,4,2
3,20,10,4,2
3,20,11,4,2
3,20,12,4,2
3,20,13,4,2
3,20,14,4,2
3,20,15,4,2
3,20,16,4,2
3,20,17,4,2
3,20,18,4,2
3,0,0,5,2
3,0,1,5,2
3,0,2,5,2
3,0,3,5,2
3,0,4,5,2
3,0,5,5,2
3,0,6,5,2
3,0,7,5,2
3,0,8,5,2
3,0,9,5,2
3,0,10,5,2
3,0,11,5,2
3,0,12,5,2
3,0,13,5,2
3,0,14,5,2
3,0,15,5,2
3,0,16,5,2
3,0,17,5,2
3,0,18,5,2
3,1,0,5,2
3,1,1,5,2
3,1,2,5,2
3,1,3,5,2
3,1,4,5,2
3,1,5,5,2
3,1,6,5,2
3,1,7,5,2
3,1,8,5,2
3,1,9,5,2
3,1,10,5,2
3,1,11,5,2
3,1,12,5,2
3,1,13,5,2
3,1,14,5,2
3,1,15,5,2
3,1,16,5,2
3,1,17,5,2
3,1,18,5,2
3,2,0,5,2
3,2,1,5,2
3,2,2,5,2
3,2,3,5,2
3,2,4,5,2
3,2,5,5,2
3,2,6,5,2
3,2,7,5,2
3,2,8,5,2
3,2,9,5,2
3,2,10,5,2
3,2,11,5,2
3,2,12,5,2
3,2,13,5,2
3,2,14,5,2
3,2,15,5,2
3,2,16,5,2
3,2,17,5,2
3,2,18,5,2
3,3,0,5,2
3,3,1,5,2
3,3,2,5,2
3,3,3,5,2
3,3,4,5,2
3,3,5,5,2
3,3,6,5,2
3,3,7,5,2
3,3,8,5,2
3,3,9,5,2
3,3,10,5,2
3,3,11,5,2
3,3,12,5,2
3,3,13,5,2
3,3,14,5,2
3,3,15,5,2
3,3,16,5,2
3,3,17,5,2
3,3,18,5,2
3,4,0,5,2
3,4,1,5,2
3,4,2,5,2
3,4,3,5,2
3,4,4,5,2
3,4,5,5,2
3,4,6,5,2
3,4,7,5,2
3,4,8,5,2
3,4,9,5,2
3,4,10,5,2
3,4,11,5,2
3,4,12,5,2
3,4,13,5,2
3,4,14,5,2
3,4,15,5,2
3,4,16,5,2
3,4,17,5,2
3,4,18,5,2
3,5,0,5,2
3,5,1,5,2
3,5,2,5,2
3,5,3,5,2
3,5,4,5,2
3,5,5,5,2
3,5,6,5,2
3,5,7,5,2
3,5,8,5,2
3,5,9,5,2
3,5,10,5,2
3,5,11,5,2
3,5,12,5,2
3,5,13,5,2
3,5,14,5,2
3,5,15,5,2
3,5,16,5,2
3,5,17,5,2
3,5,18,5,2
3,6,0,5,2
3,6,1,5,2
3,6,2,5,2
3,6,3,5,2
3,6,4,5,2
3,6,5,5,2
3,6,6,5,2
3,6,7,5,2
3,6,8,5,2
3,6,9,5,2
3,6,10,5,2
3,6,11,5,2
3,6,12,5,2
3,6,13,5,2
3,6,14,5,2
3,6,15,5,2
3,6,16,5,2
3,6,17,5,2
3,6,18,5,2
3,7,0,5,2
3,7,1,5,2
3,7,2,5,2
3,7,3,5,2
3,7,4,5,2
3,7,5,5,2
3,7,6,5,2
3,7,7,5,2
3,7,8,5,2
3,7,9,5,2
3,7,10,5,2
3,7,11,5,2
3,7,12,5,2
3,7,13,5,2
3,7,14,5,2
3,7,15,5,2
3,7,16,5,2
3,7,17,5,2
3,7,18,5,2
3,8,0,5,2
3,8,1,5,2
3,8,2,5,2
3,8,3,5,2
3,8,4,5,2
3,8,5,5,2
3,8,6,5,2
3,8,7,5,2
3,8,8,5,2
3,8,9,5,2
3,8,10,5,2
3,8,11,5,2
3,8,12,5,2
3,8,13,5,2
3,8,14,5,2
3,8,15,5,2
3,8,16,5,2
3,8,17,5,2
3,8,18,5,2
3,9,0,5,2
3,9,1,5,2
3,9,2,5,2
3,9,3,5,2
3,9,4,5,2
3,9,5,5,2
3,9,6,5,2
3,9,7,5,2
3,9,8,5,2
3,9,9,5,2
3,9,10,5,2
3,9,11,5,2
3,9,12,5,2
3,9,13,5,2
3,9,14,5,2
3,9,15,5,2
3,9,16,5,2
3,9,17,5,2
3,9,18,5,2
3,10,0,5,2
3,10,1,5,2
3,10,2,5,2
3,10,3,5,2
3,10,4,5,2
3,10,5,5,2
3,10,6,5,2
3,10,7,5,2
3,10,8,5,2
3,10,9,5,2
3,10,10,5,2
3,10,11,5,2
3,10,12,5,2
3,10,13,5,2
3,10,14,5,2
3,10,15,5,2
3,10,16,5,2
3,10,17,5,2
3,10,18,5,2
3,11,0,5,2
3,11,1,5,2
3,11,2,5,2
3,11,3,5,2
3,11,4,5,2
3,11,5,5,2
3,11,6,5,2
3,11,7,5,2
3,11,8,5,2
3,11,9,5,2
3,11,10,5,2
3,11,11,5,2
3,11,12,5,2
3,11,13,5,2
3,11,14,5,2
3,11,15,5,2
3,11,16,5,2
3,11,17,5,2
3,11,18,5,2
3,12,0,5,2
3,12,1,5,2
3,12,2,5,2
3,12,3,5,2
3,12,4,5,2
3,12,5,5,2
3,12,6,5,2
3,12,7,5,2
3,12,8,5,2
3,12,9,5,2
3,12,10,5,2
3,12,11,5,2
3,12,12,5,2
3,12,13,5,2
3,12,14,5,2
3,12,15,5,2
3,12,16,5,2
3,12,17,5,2
3,12,18,5,2
3,13,0,5,2
3,13,1,5,2
3,13,2,5,2
3,13,3,5,2
3,13,4,5,2
3,13,5,5,2
3,13,6,5,2
3,13,7,5,2
3,13,8,5,2
3,13,9,5,2
3,13,10,5,2
3,13,11,5,2
3,13,12,5,2
3,13,13,5,2
3,13,14,5,2
3,13,15,5,2
3,13,16,5,2
3,13,17,5,2
3,13,18,5,2
3,14,0,5,2
3,14,1,5,2
3,14,2,5,2
3,14,3,5,2
3,14,4,5,2
3,14,5,5,2
3,14,6,5,2
3,14,7,5,2
3,14,8,5,2
3,14,9,5,2
3,14,10,5,2
3,14,11,5,2
3,14,12,5,2
3,14,13,5,2
3,14,14,5,2
3,14,15,5,2
3,14,16,5,2
3,14,17,5,2
3,14,18,5,2
3,15,0,5,2
3,15,1,5,2
3,15,2,5,2
3,15,3,5,2
3,15,4,5,2
3,15,5,5,2
3,15,6,5,2
3,15,7,5,2
3,15,8,5,2
3,15,9,5,2
3,15,10,5,2
3,15,11,5,2
3,15,12,5,2
3,15,13,5,2
3,15,14,5,2
3,15,15,5,2
3,15,16,5,2
3,15,17,5,2
3,15,18,5,2
3,16,0,5,2
3,16,1,5,2
3,16,2,5,2
3,16,3,5,2
3,16,4,5,2
3,16,5,5,2
3,16,6,5,2
3,16,7,5,2
3,16,8,5,2
3,16,9,5,2
3,16,10,5,2
3,16,11,5,2
3,16,12,5,2
3,16,13,5,2
3,16,14,5,2
3,16,15,5,2
3,16,16,5,2
3,16,17,5,2
3,16,18,5,2
3,17,0,5,2
3,17,1,5,2
3,17,2,5,2
3,17,3,5,2
3,17,4,5,2
3,17,5,5,2
3,17,6,5,2
3,17,7,5,2
3,17,8,5,2
3,17,9,5,2
3,17,10,5,2
3,17,11,5,2
3,17,12,5,2
3,17,13,5,2
3,17,14,5,2
3,17,15,5,2
3,17,16,5,2
3,17,17,5,2
3,17,18,5,2
3,18,0,5,2
3,18,1,5,2
3,18,2,5,2
3,18,3,5,2
3,18,4,5,2
3,18,5,5,2
3,18,6,5,2
3,18,7,5,2
3,18,8,5,2
3,18,9,5,2
3,18,10,5,2
3,18,11,5,2
3,18,12,5,2
3,18,13,5,2
3,18,14,5,2
3,18,15,5,2
3,18,16,5,2
3,18,17,5,2
3,18,18,5,2
3,19,0,5,2
3,19,1,5,2
3,19,2,5,2
3,19,3,5,2
3,19,4,5,2
3,19,5,5,2
3,19,6,5,2
3,19,7,5,2
3,19,8,5,2
3,19,9,5,2
3,19,10,5,2
3,19,11,5,2
3,19,12,5,2
3,19,13,5,2
3,19,14,5,2
3,19,15,5,2
3,19,16,5,2
3,19,17,5,2
3,19,18,5,2
3,0,0,6,2
3,0,1,6,2
3,0,2,6,2
3,0,3,6,2
3,0,4,6,2
3,0,5,6,2
3,0,6,6,2
3,0,7,6,2
3,0,8,6,2
3,0,9,6,2
3,0,10,6,2
3,0,11,6,2
3,0,12,6,2
3,0,13,6,2
3,0,14,6,2
3,0,15,6,2
3,0,16,6,2
3,0,17,6,2
3,0,18,6,2
3,1,0,6,2
3,1,1,6,2
3,1,2,6,2
3,1,3,6,2
3,1,4,6,2
3,1,5,6,2
3,1,6,6,2
3,1,7,6,2
3,1,8,6,2
3,1,9,6,2
3,1,10,6,2
3,1,11,6,2
3,1,12,6,2
3,1,13,6,2
3,1,14,6,2
3,1,15,6,2
3,1,16,6,2
3,1,17,6,2
3,1,18,6,2
3,2,0,6,2
3,2,1,6,2
3,2,2,6,2
3,2,3,6,2
3,2,4,6,2
3,2,5,6,2
3,2,6,6,2
3,2,7,6,2
3,2,8,6,2
3,2,9,6,2
3,2,10,6,2
3,2,11,6,2
3,2,12,6,2
3,2,13,6,2
3,2,14,6,2
3,2,15,6,2
3,2,16,6,2
3,2,17,6,2
3,2,18,6,2
3,3,0,6,2
3,3,1,6,2
3,3,2,6,2
3,3,3,6,2
3,3,4,6,2
3,3,5,6,2
3,3,6,6,2
3,3,7,6,2
3,3,8,6,2
3,3,9,6,2
3,3,10,6,2
3,3,11,6,2
3,3,12,6,2
3,3,13,6,2
3,3,14,6,2
3,3,15,6,2
3,3,16,6,2
3,3,17,6,2
3,3,18,6,2
3,4,0,6,2
3,4,1,6,2
3,4,2,6,2
3,4,3,6,2
3,4,4,6,2
3,4,5,6,2
3,4,6,6,2
3,4,7,6,2
3,4,8,6,2
3,4,9,6,2
3,4,10,6,2
3,4,11,6,2
3,4,12,6,2
3,4,13,6,2
3,4,14,6,2
3,4,15,6,2
3,4,16,6,2
3,4,17,6,2
3,4,18,6,2
3,5,0,6,2
3,5,1,6,2
3,5,2,6,2
3,5,3,6,2
3,5,4,6,2
3,5,5,6,2
3,5,6,6,2
3,5,7,6,2
3,5,8,6,2
3,5,9,6,2
3,5,10,6,2
3,5,11,6,2
3,5,12,6,2
3,5,13,6,2
3,5,14,6,2
3,5,15,6,2
3,5,16,6,2
3,5,17,6,2
3,5,18,6,2
3,6,0,6,2
3,6,1,6,2
3,6,2,6,2
3,6,3,6,2
3,6,4,6,2
3,6,5,6,2
3,6,6,6,2
3,6,7,6,2
3,6,8,6,2
3,6,9,6,2
3,6,10,6,2
3,6,11,6,2
3,6,12,6,2
3,6,13,6,2
3,6,14,6,2
3,6,15,6,2
3,6,16,6,2
3,6,17,6,2
3,6,18,6,2
3,7,0,6,2
3,7,1,6,2
3,7,2,6,2
3,7,3,6,2
3,7,4,6,2
3,7,5,6,2
3,7,6,6,2
3,7,7,6,2
3,7,8,6,2
3,7,9,6,2
3,7,10,6,2
3,7,11,6,2
3,7,12,6,2
3,7,13,6,2
3,7,14,6,2
3,7,15,6,2
3,7,16,6,2
3,7,17,6,2
3,7,18,6,2
3,8,0,6,2
3,8,1,6,2
3,8,2,6,2
3,8,3,6,2
3,8,4,6,2
3,8,5,6,2
3,8,6,6,2
3,8,7,6,2
3,8,8,6,2
3,8,9,6,2
3,8,10,6,2
3,8,11,6,2
3,8,12,6,2
3,8,13,6,2
3,8,14,6,2
3,8,15,6,2
3,8,16,6,2
3,8,17,6,2
3,8,18,6,2
3,9,0,6,2
3,9,1,6,2
3,9,2,6,2
3,9,3,6,2
3,9,4,6,2
3,9,5,6,2
3,9,6,6,2
3,9,7,6,2
3,9,8,6,2
3,9,9,6,2
3,9,10,6,2
3,9,11,6,2
3,9,12,6,2
3,9,13,6,2
3,9,14,6,2
3,9,15,6,2
3,9,16,6,2
3,9,17,6,2
3,9,18,6,2
3,10,0,6,2
3,10,1,6,2
3,10,2,6,2
3,10,3,6,2
3,10,4,6,2
3,10,5,6,2
3,10,6,6,2
3,10,7,6,2
3,10,8,6,2
3,10,9,6,2
3,10,10,6,2
3,10,11,6,2
3,10,12,6,2
3,10,13,6,2
3,10,14,6,2
3,10,15,6,2
3,10,16,6,2
3,10,17,6,2
3,10,18,6,2
3,11,0,6,2
3,11,1,6,2
3,11,2,6,2
3,11,3,6,2
3,11,4,6,2
3,11,5,6,2
3,11,6,6,2
3,11,7,6,2
3,11,8,6,2
3,11,9,6,2
3,11,10,6,2
3,11,11,6,2
3,11,12,6,2
3,11,13,6,2
3,11,14,6,2
3,11,15,6,2
3,11,16,6,2
3,11,17,6,2
3,11,18,6,2
3,12,0,6,2
3,12,1,6,2
3,12,2,6,2
3,12,3,6,2
3,12,4,6,2
3,12,5,6,2
3,12,6,6,2
3,12,7,6,2
3,12,8,6,2
3,12,9,6,2
3,12,10,6,2
3,12,11,6,2
3,12,12,6,2
3,12,13,6,2
3,12,14,6,2
3,12,15,6,2
3,12,16,6,2
3,12,17,6,2
3,12,18,6,2
3,13,0,6,2
3,13,1,6,2
3,13,2,6,2
3,13,3,6,2
3,13,4,6,2
3,13,5,6,2
3,13,6,6,2
3,13,7,6,2
3,13,8,6,2
3,13,9,6,2
3,13,10,6,2
3,13,11,6,2
3,13,12,6,2
3,13,13,6,2
3,13,14,6,2
3,13,15,6,2
3,13,16,6,2
3,13,17,6,2
3,13,18,6,2
3,14,0,6,2
3,14,1,6,2
3,14,2,6,2
3,14,3,6,2
3,14,4,6,2
3,14,5,6,2
3,14,6,6,2
3,14,7,6,2
3,14,8,6,2
3,14,9,6,2
3,14,10,6,2
3,14,11,6,2
3,14,12,6,2
3,14,13,6,2
3,14,14,6,2
3,14,15,6,2
3,14,16,6,2
3,14,17,6,2
3,14,18,6,2
3,15,0,6,2
3,15,1,6,2
3,15,2,6,2
3,15,3,6,2
3,15,4,6,2
3,15,5,6,2
3,15,6,6,2
3,15,7,6,2
3,15,8,6,2
3,15,9,6,2
3,15,10,6,2
3,15,11,6,2
3,15,12,6,2
3,15,13,6,2
3,15,14,6,2
3,15,15,6,2
3,15,16,6,2
3,15,17,6,2
3,15,18,6,2
3,16,0,6,2
3,16,1,6,2
3,16,2,6,2
3,16,3,6,2
3,16,4,6,2
3,16,5,6,2
3,16,6,6,2
3,16,7,6,2
3,16,8,6,2
3,16,9,6,2
3,16,10,6,2
3,16,11,6,2
3,16,12,6,2
3,16,13,6,2
3,16,14,6,2
3,16,15,6,2
3,16,16,6,2
3,16,17,6,2
3,16,18,6,2
3,17,0,6,2
3,17,1,6,2
3,17,2,6,2
3,17,3,6,2
3,17,4,6,2
3,17,5,6,2
3,17,6,6,2
3,17,7,6,2
3,17,8,6,2
3,17,9,6,2
3,17,10,6,2
3,17,11,6,2
3,17,12,6,2
3,17,13,6,2
3,17,14,6,2
3,17,15,6,2
3,17,16,6,2
3,17,17,6,2
3,17,18,6,2
3,18,0,6,2
3,18,1,6,2
3,18,2,6,2
3,18,3,6,2
3,18,4,6,2
3,18,5,6,2
3,18,6,6,2
3,18,7,6,2
3,18,8,6,2
3,18,9,6,2
3,18,10,6,2
3,18,11,6,2
3,18,12,6,2
3,18,13,6,2
3,18,14,6,2
3,18,15,6,2
3,18,16,6,2
3,18,17,6,2
3,18,18,6,2
3,0,0,7,2
3,0,1,7,2
3,0,2,7,2
3,0,3,7,2
3,0,4,7,2
3,0,5,7,2
3,0,6,7,2
3,0,7,7,2
3,0,8,7,2
3,0,9,7,2
3,0,10,7,2
3,0,11,7,2
3,0,12,7,2
3,0,13,7,2
3,0,14,7,2
3,0,15,7,2
3,0,16,7,2
3,0,17,7,2
3,0,18,7,2
3,1,0,7,2
3,1,1,7,2
3,1,2,7,2
3,1,3,7,2
3,1,4,7,2
3,1,5,7,2
3,1,6,7,2
3,1,7,7,2
3,1,8,7,2
3,1,9,7,2
3,1,10,7,2
3,1,11,7,2
3,1,12,7,2
3,1,13,7,2
3,1,14,7,2
3,1,15,7,2
3,1,16,7,2
3,1,17,7,2
3,1,18,7,2
3,2,0,7,2
3,2,1,7,2
3,2,2,7,2
3,2,3,7,2
3,2,4,7,2
3,2,5,7,2
3,2,6,7,2
3,2,7,7,2
3,2,8,7,2
3,2,9,7,2
3,2,10,7,2
3,2,11,7,2
3,2,12,7,2
3,2,13,7,2
3,2,14,7,2
3,2,15,7,2
3,2,16,7,2
3,2,17,7,2
3,2,18,7,2
3,3,0,7,2
3,3,1,7,2
3,3,2,7,2
3,3,3,7,2
3,3,4,7,2
3,3,5,7,2
3,3,6,7,2
3,3,7,7,2
3,3,8,7,2
3,3,9,7,2
3,3,10,7,2
3,3,11,7,2
3,3,12,7,2
3,3,13,7,2
3,3,14,7,2
3,3,15,7,2
3,3,16,7,2
3,3,17,7,2
3,3,18,7,2
3,4,0,7,2
3,4,1,7,2
3,4,2,7,2
3,4,3,7,2
3,4,4,7,2
3,4,5,7,2
3,4,6,7,2
3,4,7,7,2
3,4,8,7,2
3,4,9,7,2
3,4,10,7,2
3,4,11,7,2
3,4,12,7,2
3,4,13,7,2
3,4,14,7,2
3,4,15,7,2
3,4,16,7,2
3,4,17,7,2
3,4,18,7,2
3,5,0,7,2
3,5,1,7,2
3,5,2,7,2
3,5,3,7,2
3,5,4,7,2
3,5,5,7,2
3,5,6,7,2
3,5,7,7,2
3,5,8,7,2
3,5,9,7,2
3,5,10,7,2
3,5,11,7,2
3,5,12,7,2
3,5,13,7,2
3,5,14,7,2
3,5,15,7,2
3,5,16,7,2
3,5,17,7,2
3,5,18,7,2
3,6,0,7,2
3,6,1,7,2
3,6,2,7,2
3,6,3,7,2
3,6,4,7,2
3,6,5,7,2
3,6,6,7,2
3,6,7,7,2
3,6,8,7,2
3,6,9,7,2
3,6,10,7,2
3,6,11,7,2
3,6,12,7,2
3,6,13,7,2
3,6,14,7,2
3,6,15,7,2
3,6,16,7,2
3,6,17,7,2
3,6,18,7,2
3,7,0,7,2
3,7,1,7,2
3,7,2,7,2
3,7,3,7,2
3,7,4,7,2
3,7,5,7,2
3,7,6,7,2
3,7,7,7,2
3,7,8,7,2
3,7,9,7,2
3,7,10,7,2
3,7,11,7,2
3,7,12,7,2
3,7,13,7,2
3,7,14,7,2
3,7,15,7,2
3,7,16,7,2
3,7,17,7,2
3,7,18,7,2
3,8,0,7,2
3,8,1,7,2
3,8,2,7,2
3,8,3,7,2
3,8,4,7,2
3,8,5,7,2
3,8,6,7,2
3,8,7,7,2
3,8,8,7,2
3,8,9,7,2
3,8,10,7,2
3,8,11,7,2
3,8,12,7,2
3,8,13,7,2
3,8,14,7,2
3,8,15,7,2
3,8,16,7,2
3,8,17,7,2
3,8,18,7,2
3,9,0,7,2
3,9,1,7,2
3,9,2,7,2
3,9,3,7,2
3,9,4,7,2
3,9,5,7,2
3,9,6,7,2
3,9,7,7,2
3,9,8,7,2
3,9,9,7,2
3,9,10,7,2
3,9,11,7,2
3,9,12,7,2
3,9,13,7,2
3,9,14,7,2
3,9,15,7,2
3,9,16,7,2
3,9,17,7,2
3,9,18,7,2
3,10,0,7,2
3,10,1,7,2
3,10,2,7,2
3,10,3,7,2
3,10,4,7,2
3,10,5,7,2
3,10,6,7,2
3,10,7,7,2
3,10,8,7,2
3,10,9,7,2
3,10,10,7,2
3,10,11,7,2
3,10,12,7,2
3,10,13,7,2
3,10,14,7,2
3,10,15,7,2
3,10,16,7,2
3,10,17,7,2
3,10,18,7,2
3,11,0,7,2
3,11,1,7,2
3,11,2,7,2
3,11,3,7,2
3,11,4,7,2
3,11,5,7,2
3,11,6,7,2
3,11,7,7,2
3,11,8,7,2
3,11,9,7,2
3,11,10,7,2
3,11,11,7,2
3,11,12,7,2
3,11,13,7,2
3,11,14,7,2
3,11,15,7,2
3,11,16,7,2
3,11,17,7,2
3,11,18,7,2
3,12,0,7,2
3,12,1,7,2
3,12,2,7,2
3,12,3,7,2
3,12,4,7,2
3,12,5,7,2
3,12,6,7,2
3,12,7,7,2
3,12,8,7,2
3,12,9,7,2
3,12,10,7,2
3,12,11,7,2
3,12,12,7,2
3,12,13,7,2
3,12,14,7,2
3,12,15,7,2
3,12,16,7,2
3,12,17,7,2
3,12,18,7,2
3,13,0,7,2
3,13,1,7,2
3,13,2,7,2
3,13,3,7,2
3,13,4,7,2
3,13,5,7,2
3,13,6,7,2
3,13,7,7,2
3,13,8,7,2
3,13,9,7,2
3,13,10,7,2
3,13,11,7,2
3,13,12,7,2
3,13,13,7,2
3,13,14,7,2
3,13,15,7,2
3,13,16,7,2
3,13,17,7,2
3,13,18,7,2
3,14,0,7,2
3,14,1,7,2
3,14,2,7,2
3,14,3,7,2
3,14,4,7,2
3,14,5,7,2
3,14,6,7,2
3,14,7,7,2
3,14,8,7,2
3,14,9,7,2
3,14,10,7,2
3,14,11,7,2
3,14,12,7,2
3,14,13,7,2
3,14,14,7,2
3,14,15,7,2
3,14,16,7,2
3,14,17,7,2
3,14,18,7,2
3,15,0,7,2
3,15,1,7,2
3,15,2,7,2
3,15,3,7,2
3,15,4,7,2
3,15,5,7,2
3,15,6,7,2
3,15,7,7,2
3,15,8,7,2
3,15,9,7,2
3,15,10,7,2
3,15,11,7,2
3,15,12,7,2
3,15,13,7,2
3,15,14,7,2
3,15,15,7,2
3,15,16,7,2
3,15,17,7,2
3,15,18,7,2
3,16,0,7,2
3,16,1,7,2
3,16,2,7,2
3,16,3,7,2
3,16,4,7,2
3,16,5,7,2
3,16,6,7,2
3,16,7,7,2
3,16,8,7,2
3,16,9,7,2
3,16,10,7,2
3,16,11,7,2
3,16,12,7,2
3,16,13,7,2
3,16,14,7,2
3,16,15,7,2
3,16,16,7,2
3,16,17,7,2
3,16,18,7,2
3,17,0,7,2
3,17,1,7,2
3,17,2,7,2
3,17,3,7,2
3,17,4,7,2
3,17,5,7,2
3,17,6,7,2
3,17,7,7,2
3,17,8,7,2
3,17,9,7,2
3,17,10,7,2
3,17,11,7,2
3,17,12,7,2
3,17,13,7,2
3,17,14,7,2
3,17,15,7,2
3,17,16,7,2
3,17,17,7,2
3,17,18,7,2
3,0,0,8,2
3,0,1,8,2
3,0,2,8,2
3,0,3,8,2
3,0,4,8,2
3,0,5,8,2
3,0,6,8,2
3,0,7,8,2
3,0,8,8,2
3,0,9,8,2
3,0,10,8,2
3,0,11,8,2
3,0,12,8,2
3,0,13,8,2
3,0,14,8,2
3,0,15,8,2
3,0,16,8,2
3,0,17,8,2
3,0,18,8,2
3,1,0,8,2
3,1,1,8,2
3,1,2,8,2
3,1,3,8,2
3,1,4,8,2
3,1,5,8,2
3,1,6,8,2
3,1,7,8,2
3,1,8,8,2
3,1,9,8,2
3,1,10,8,2
3,1,11,8,2
3,1,12,8,2
3,1,13,8,2
3,1,14,8,2
3,1,15,8,2
3,1,16,8,2
3,1,17,8,2
3,1,18,8,2
3,2,0,8,2
3,2,1,8,2
3,2,2,8,2
3,2,3,8,2
3,2,4,8,2
3,2,5,8,2
3,2,6,8,2
3,2,7,8,2
3,2,8,8,2
3,2,9,8,2
3,2,10,8,2
3,2,11,8,2
3,2,12,8,2
3,2,13,8,2
3,2,14,8,2
3,2,15,8,2
3,2,16,8,2
3,2,17,8,2
3,2,18,8,2
3,3,0,8,2
3,3,1,8,2
3,3,2,8,2
3,3,3,8,2
3,3,4,8,2
3,3,5,8,2
3,3,6,8,2
3,3,7,8,2
3,3,8,8,2
3,3,9,8,2
3,3,10,8,2
3,3,11,8,2
3,3,12,8,2
3,3,13,8,2
3,3,14,8,2
3,3,15,8,2
3,3,16,8,2
3,3,17,8,2
3,3,18,8,2
3,4,0,8,2
3,4,1,8,2
3,4,2,8,2
3,4,3,8,2
3,4,4,8,2
3,4,5,8,2
3,4,6,8,2
3,4,7,8,2
3,4,8,8,2
3,4,9,8,2
3,4,10,8,2
3,4,11,8,2
3,4,12,8,2
3,4,13,8,2
3,4,14,8,2
3,4,15,8,2
3,4,16,8,2
3,4,17,8,2
3,4,18,8,2
3,5,0,8,2
3,5,1,8,2
3,5,2,8,2
3,5,3,8,2
3,5,4,8,2
3,5,5,8,2
3,5,6,8,2
3,5,7,8,2
3,5,8,8,2
3,5,9,8,2
3,5,10,8,2
3,5,11,8,2
3,5,12,8,2
3,5,13,8,2
3,5,14,8,2
3,5,15,8,2
3,5,16,8,2
3,5,17,8,2
3,5,18,8,2
3,6,0,8,2
3,6,1,8,2
3,6,2,8,2
3,6,3,8,2
3,6,4,8,2
3,6,5,8,2
3,6,6,8,2
3,6,7,8,2
3,6,8,8,2
3,6,9,8,2
3,6,10,8,2
3,6,11,8,2
3,6,12,8,2
3,6,13,8,2
3,6,14,8,2
3,6,15,8,2
3,6,16,8,2
3,6,17,8,2
3,6,18,8,2
3,7,0,8,2
3,7,1,8,2
3,7,2,8,2
3,7,3,8,2
3,7,4,8,2
3,7,5,8,2
3,7,6,8,2
3,7,7,8,2
3,7,8,8,2
3,7,9,8,2
3,7,10,8,2
3,7,11,8,2
3,7,12,8,2
3,7,13,8,2
3,7,14,8,2
3,7,15,8,2
3,7,16,8,2
3,7,17,8,2
3,7,18,8,2
3,8,0,8,2
3,8,1,8,2
3,8,2,8,2
3,8,3,8,2
3,8,4,8,2
3,8,5,8,2
3,8,6,8,2
3,8,7,8,2
3,8,8,8,2
3,8,9,8,2
3,8,10,8,2
3,8,11,8,2
3,8,12,8,2
3,8,13,8,2
3,8,14,8,2
3,8,15,8,2
3,8,16,8,2
3,8,17,8,2
3,8,18,8,2
3,9,0,8,2
3,9,1,8,2
3,9,2,8,2
3,9,3,8,2
3,9,4,8,2
3,9,5,8,2
3,9,6,8,2
3,9,7,8,2
3,9,8,8,2
3,9,9,8,2
3,9,10,8,2
3,9,11,8,2
3,9,12,8,2
3,9,13,8,2
3,9,14,8,2
3,9,15,8,2
3,9,16,8,2
3,9,17,8,2
3,9,18,8,2
3,10,0,8,2
3,10,1,8,2
3,10,2,8,2
3,10,3,8,2
3,10,4,8,2
3,10,5,8,2
3,10,6,8,2
3,10,7,8,2
3,10,8,8,2
3,10,9,8,2
3,10,10,8,2
3,10,11,8,2
3,10,12,8,2
3,10,13,8,2
3,10,14,8,2
3,10,15,8,2
3,10,16,8,2
3,10,17,8,2
3,10,18,8,2
3,11,0,8,2
3,11,1,8,2
3,11,2,8,2
3,11,3,8,2
3,11,4,8,2
3,11,5,8,2
3,11,6,8,2
3,11,7,8,2
3,11,8,8,2
3,11,9,8,2
3,11,10,8,2
3,11,11,8,2
3,11,12,8,2
3,11,13,8,2
3,11,14,8,2
3,11,15,8,2
3,11,16,8,2
3,11,17,8,2
3,11,18,8,2
3,12,0,8,2
3,12,1,8,2
3,12,2,8,2
3,12,3,8,2
3,12,4,8,2
3,12,5,8,2
3,12,6,8,2
3,12,7,8,2
3,12,8,8,2
3,12,9,8,2
3,12,10,8,2
3,12,11,8,2
3,12,12,8,2
3,12,13,8,2
3,12,14,8,2
3,12,15,8,2
3,12,16,8,2
3,12,17,8,2
3,12,18,8,2
3,13,0,8,2
3,13,1,8,2
3,13,2,8,2
3,13,3,8,2
3,13,4,8,2
3,13,5,8,2
3,13,6,8,2
3,13,7,8,2
3,13,8,8,2
3,13,9,8,2
3,13,10,8,2
3,13,11,8,2
3,13,12,8,2
3,13,13,8,2
3,13,14,8,2
3,13,15,8,2
3,13,16,8,2
3,13,17,8,2
3,13,18,8,2
3,14,0,8,2
3,14,1,8,2
3,14,2,8,2
3,14,3,8,2
3,14,4,8,2
3,14,5,8,2
3,14,6,8,2
3,14,7,8,2
3,14,8,8,2
3,14,9,8,2
3,14,10,8,2
3,14,11,8,2
3,14,12,8,2
3,14,13,8,2
3,14,14,8,2
3,14,15,8,2
3,14,16,8,2
3,14,17,8,2
3,14,18,8,2
3,15,0,8,2
3,15,1,8,2
3,15,2,8,2
3,15,3,8,2
3,15,4,8,2
3,15,5,8,2
3,15,6,8,2
3,15,7,8,2
3,15,8,8,2
3,15,9,8,2
3,15,10,8,2
3,15,11,8,2
3,15,12,8,2
3,15,13,8,2
3,15,14,8,2
3,15,15,8,2
3,15,16,8,2
3,15,17,8,2
3,15,18,8,2
3,16,0,8,2
3,16,1,8,2
3,16,2,8,2
3,16,3,8,2
3,16,4,8,2
3,16,5,8,2
3,16,6,8,2
3,16,7,8,2
3,16,8,8,2
3,16,9,8,2
3,16,10,8,2
3,16,11,8,2
3,16,12,8,2
3,16,13,8,2
3,16,14,8,2
3,16,15,8,2
3,16,16,8,2
3,16,17,8,2
3,16,18,8,2
3,0,0,9,2
3,0,1,9,2
3,0,2,9,2
3,0,3,9,2
3,0,4,9,2
3,0,5,9,2
3,0,6,9,2
3,0,7,9,2
3,0,8,9,2
3,0,9,9,2
3,0,10,9,2
3,0,11,9,2
3,0,12,9,2
3,0,13,9,2
3,0,14,9,2
3,0,15,9,2
3,0,16,9,2
3,0,17,9,2
3,0,18,9,2
3,1,0,9,2
3,1,1,9,2
3,1,2,9,2
3,1,3,9,2
3,1,4,9,2
3,1,5,9,2
3,1,6,9,2
3,1,7,9,2
3,1,8,9,2
3,1,9,9,2
3,1,10,9,2
3,1,11,9,2
3,1,12,9,2
3,1,13,9,2
3,1,14,9,2
3,1,15,9,2
3,1,16,9,2
3,1,17,9,2
3,1,18,9,2
3,2,0,9,2
3,2,1,9,2
3,2,2,9,2
3,2,3,9,2
3,2,4,9,2
3,2,5,9,2
3,2,6,9,2
3,2,7,9,2
3,2,8,9,2
3,2,9,9,2
3,2,10,9,2
3,2,11,9,2
3,2,12,9,2
3,2,13,9,2
3,2,14,9,2
3,2,15,9,2
3,2,16,9,2
3,2,17,9,2
3,2,18,9,2
3,3,0,9,2
3,3,1,9,2
3,3,2,9,2
3,3,3,9,2
3,3,4,9,2
3,3,5,9,2
3,3,6,9,2
3,3,7,9,2
3,3,8,9,2
3,3,9,9,2
3,3,10,9,2
3,3,11,9,2
3,3,12,9,2
3,3,13,9,2
3,3,14,9,2
3,3,15,9,2
3,3,16,9,2
3,3,17,9,2
3,3,18,9,2
3,4,0,9,2
3,4,1,9,2
3,4,2,9,2
3,4,3,9,2
3,4,4,9,2
3,4,5,9,2
3,4,6,9,2
3,4,7,9,2
3,4,8,9,2
3,4,9,9,2
3,4,10,9,2
3,4,11,9,2
3,4,12,9,2
3,4,13,9,2
3,4,14,9,2
3,4,15,9,2
3,4,16,9,2
3,4,17,9,2
3,4,18,9,2
3,5,0,9,2
3,5,1,9,2
3,5,2,9,2
3,5,3,9,2
3,5,4,9,2
3,5,5,9,2
3,5,6,9,2
3,5,7,9,2
3,5,8,9,2
3,5,9,9,2
3,5,10,9,2
3,5,11,9,2
3,5,12,9,2
3,5,13,9,2
3,5,14,9,2
3,5,15,9,2
3,5,16,9,2
3,5,17,9,2
3,5,18,9,2
3,6,0,9,2
3,6,1,9,2
3,6,2,9,2
3,6,3,9,2
3,6,4,9,2
3,6,5,9,2
3,6,6,9,2
3,6,7,9,2
3,6,8,9,2
3,6,9,9,2
3,6,10,9,2
3,6,11,9,2
3,6,12,9,2
3,6,13,9,2
3,6,14,9,2
3,6,15,9,2
3,6,16,9,2
3,6,17,9,2
3,6,18,9,2
3,7,0,9,2
3,7,1,9,2
3,7,2,9,2
3,7,3,9,2
3,7,4,9,2
3,7,5,9,2
3,7,6,9,2
3,7,7,9,2
3,7,8,9,2
3,7,9,9,2
3,7,10,9,2
3,7,11,9,2
3,7,12,9,2
3,7,13,9,2
3,7,14,9,2
3,7,15,9,2
3,7,16,9,2
3,7,17,9,2
3,7,18,9,2
3,8,0,9,2
3,8,1,9,2
3,8,2,9,2
3,8,3,9,2
3,8,4,9,2
3,8,5,9,2
3,8,6,9,2
3,8,7,9,2
3,8,8,9,2
3,8,9,9,2
3,8,10,9,2
3,8,11,9,2
3,8,12,9,2
3,8,13,9,2
3,8,14,9,2
3,8,15,9,2
3,8,16,9,2
3,8,17,9,2
3,8,18,9,2
3,9,0,9,2
3,9,1,9,2
3,9,2,9,2
3,9,3,9,2
3,9,4,9,2
3,9,5,9,2
3,9,6,9,2
3,9,7,9,2
3,9,8,9,2
3,9,9,9,2
3,9,10,9,2
3,9,11,9,2
3,9,12,9,2
3,9,13,9,2
3,9,14,9,2
3,9,15,9,2
3,9,16,9,2
3,9,17,9,2
3,9,18,9,2
3,10,0,9,2
3,10,1,9,2
3,10,2,9,2
3,10,3,9,2
3,10,4,9,2
3,10,5,9,2
3,10,6,9,2
3,10,7,9,2
3,10,8,9,2
3,10,9,9,2
3,10,10,9,2
3,10,11,9,2
3,10,12,9,2
3,10,13,9,2
3,10,14,9,2
3,10,15,9,2
3,10,16,9,2
3,10,17,9,2
3,10,18,9,2
3,11,0,9,2
3,11,1,9,2
3,11,2,9,2
3,11,3,9,2
3,11,4,9,2
3,11,5,9,2
3,11,6,9,2
3,11,7,9,2
3,11,8,9,2
3,11,9,9,2
3,11,10,9,2
3,11,11,9,2
3,11,12,9,2
3,11,13,9,2
3,11,14,9,2
3,11,15,9,2
3,11,16,9,2
3,11,17,9,2
3,11,18,9,2
3,12,0,9,2
3,12,1,9,2
3,12,2,9,2
3,12,3,9,2
3,12,4,9,2
3,12,5,9,2
3,12,6,9,2
3,12,7,9,2
3,12,8,9,2
3,12,9,9,2
3,12,10,9,2
3,12,11,9,2
3,12,12,9,2
3,12,13,9,2
3,12,14,9,2
3,12,15,9,2
3,12,16,9,2
3,12,17,9,2
3,12,18,9,2
3,13,0,9,2
3,13,1,9,2
3,13,2,9,2
3,13,3,9,2
3,13,4,9,2
3,13,5,9,2
3,13,6,9,2
3,13,7,9,2
3,13,8,9,2
3,13,9,9,2
3,13,10,9,2
3,13,11,9,2
3,13,12,9,2
3,13,13,9,2
3,13,14,9,2
3,13,15,9,2
3,13,16,9,2
3,13,17,9,2
3,13,18,9,2
3,14,0,9,2
3,14,1,9,2
3,14,2,9,2
3,14,3,9,2
3,14,4,9,2
3,14,5,9,2
3,14,6,9,2
3,14,7,9,2
3,14,8,9,2
3,14,9,9,2
3,14,10,9,2
3,14,11,9,2
3,14,12,9,2
3,14,13,9,2
3,14,14,9,2
3,14,15,9,2
3,14,16,9,2
3,14,17,9,2
3,14,18,9,2
3,15,0,9,2
3,15,1,9,2
3,15,2,9,2
3,15,3,9,2
3,15,4,9,2
3,15,5,9,2
3,15,6,9,2
3,15,7,9,2
3,15,8,9,2
3,15,9,9,2
3,15,10,9,2
3,15,11,9,2
3,15,12,9,2
3,15,13,9,2
3,15,14,9,2
3,15,15,9,2
3,15,16,9,2
3,15,17,9,2
3,15,18,9,2
3,0,0,10,2
3,0,1,10,2
3,0,2,10,2
3,0,3,10,2
3,0,4,10,2
3,0,5,10,2
3,0,6,10,2
3,0,7,10,2
3,0,8,10,2
3,0,9,10,2
3,0,10,10,2
3,0,11,10,2
3,0,12,10,2
3,0,13,10,2
3,0,14,10,2
3,0,15,10,2
3,0,16,10,2
3,0,17,10,2
3,0,18,10,2
3,1,0,10,2
3,1,1,10,2
3,1,2,10,2
3,1,3,10,2
3,1,4,10,2
3,1,5,10,2
3,1,6,10,2
3,1,7,10,2
3,1,8,10,2
3,1,9,10,2
3,1,10,10,2
3,1,11,10,2
3,1,12,10,2
3,1,13,10,2
3,1,14,10,2
3,1,15,10,2
3,1,16,10,2
3,1,17,10,2
3,1,18,10,2
3,2,0,10,2
3,2,1,10,2
3,2,2,10,2
3,2,3,10,2
3,2,4,10,2
3,2,5,10,2
3,2,6,10,2
3,2,7,10,2
3,2,8,10,2
3,2,9,10,2
3,2,10,10,2
3,2,11,10,2
3,2,12,10,2
3,2,13,10,2
3,2,14,10,2
3,2,15,10,2
3,2,16,10,2
3,2,17,10,2
3,2,18,10,2
3,3,0,10,2
3,3,1,10,2
3,3,2,10,2
3,3,3,10,2
3,3,4,10,2
3,3,5,10,2
3,3,6,10,2
3,3,7,10,2
3,3,8,10,2
3,3,9,10,2
3,3,10,10,2
3,3,11,10,2
3,3,12,10,2
3,3,13,10,2
3,3,14,10,2
3,3,15,10,2
3,3,16,10,2
3,3,17,10,2
3,3,18,10,2
3,4,0,10,2
3,4,1,10,2
3,4,2,10,2
3,4,3,10,2
3,4,4,10,2
3,4,5,10,2
3,4,6,10,2
3,4,7,10,2
3,4,8,10,2
3,4,9,10,2
3,4,10,10,2
3,4,11,10,2
3,4,12,10,2
3,4,13,10,2
3,4,14,10,2
3,4,15,10,2
3,4,16,10,2
3,4,17,10,2
3,4,18,10,2
3,5,0,10,2
3,5,1,10,2
3,5,2,10,2
3,5,3,10,2
3,5,4,10,2
3,5,5,10,2
3,5,6,10,2
3,5,7,10,2
3,5,8,10,2
3,5,9,10,2
3,5,10,10,2
3,5,11,10,2
3,5,12,10,2
3,5,13,10,2
3,5,14,10,2
3,5,15,10,2
3,5,16,10,2
3,5,17,10,2
3,5,18,10,2
3,6,0,10,2
3,6,1,10,2
3,6,2,10,2
3,6,3,10,2
3,6,4,10,2
3,6,5,10,2
3,6,6,10,2
3,6,7,10,2
3,6,8,10,2
3,6,9,10,2
3,6,10,10,2
3,6,11,10,2
3,6,12,10,2
3,6,13,10,2
3,6,14,10,2
3,6,15,10,2
3,6,16,10,2
3,6,17,10,2
3,6,18,10,2
3,7,0,10,2
3,7,1,10,2
3,7,2,10,2
3,7,3,10,2
3,7,4,10,2
3,7,5,10,2
3,7,6,10,2
3,7,7,10,2
3,7,8,10,2
3,7,9,10,2
3,7,10,10,2
3,7,11,10,2
3,7,12,10,2
3,7,13,10,2
3,7,14,10,2
3,7,15,10,2
3,7,16,10,2
3,7,17,10,2
3,7,18,10,2
3,8,0,10,2
3,8,1,10,2
3,8,2,10,2
3,8,3,10,2
3,8,4,10,2
3,8,5,10,2
3,8,6,10,2
3,8,7,10,2
3,8,8,10,2
3,8,9,10,2
3,8,10,10,2
3,8,11,10,2
3,8,12,10,2
3,8,13,10,2
3,8,14,10,2
3,8,15,10,2
3,8,16,10,2
3,8,17,10,2
3,8,18,10,2
3,9,0,10,2
3,9,1,10,2
3,9,2,10,2
3,9,3,10,2
3,9,4,10,2
3,9,5,10,2
3,9,6,10,2
3,9,7,10,2
3,9,8,10,2
3,9,9,10,2
3,9,10,10,2
3,9,11,10,2
3,9,12,10,2
3,9,13,10,2
3,9,14,10,2
3,9,15,10,2
3,9,16,10,2
3,9,17,10,2
3,9,18,10,2
3,10,0,10,2
3,10,1,10,2
3,10,2,10,2
3,10,3,10,2
3,10,4,10,2
3,10,5,10,2
3,10,6,10,2
3,10,7,10,2
3,10,8,10,2
3,10,9,10,2
3,10,10,10,2
3,10,11,10,2
3,10,12,10,2
3,10,13,10,2
3,10,14,10,2
3,10,15,10,2
3,10,16,10,2
3,10,17,10,2
3,10,18,10,2
3,11,0,10,2
3,11,1,10,2
3,11,2,10,2
3,11,3,10,2
3,11,4,10,2
3,11,5,10,2
3,11,6,10,2
3,11,7,10,2
3,11,8,10,2
3,11,9,10,2
3,11,10,10,2
3,11,11,10,2
3,11,12,10,2
3,11,13,10,2
3,11,14,10,2
3,11,15,10,2
3,11,16,10,2
3,11,17,10,2
3,11,18,10,2
3,12,0,10,2
3,12,1,10,2
3,12,2,10,2
3,12,3,10,2
3,12,4,10,2
3,12,5,10,2
3,12,6,10,2
3,12,7,10,2
3,12,8,10,2
3,12,9,10,2
3,12,10,10,2
3,12,11,10,2
3,12,12,10,2
3,12,13,10,2
3,12,14,10,2
3,12,15,10,2
3,12,16,10,2
3,12,17,10,2
3,12,18,10,2
3,13,0,10,2
3,13,1,10,2
3,13,2,10,2
3,13,3,10,2
3,13,4,10,2
3,13,5,10,2
3,13,6,10,2
3,13,7,10,2
3,13,8,10,2
3,13,9,10,2
3,13,10,10,2
3,13,11,10,2
3,13,12,10,2
3,13,13,10,2
3,13,14,10,2
3,13,15,10,2
3,13,16,10,2
3,13,17,10,2
3,13,18,10,2
3,14,0,10,2
3,14,1,10,2
3,14,2,10,2
3,14,3,10,2
3,14,4,10,2
3,14,5,10,2
3,14,6,10,2
3,14,7,10,2
3,14,8,10,2
3,14,9,10,2
3,14,10,10,2
3,14,11,10,2
3,14,12,10,2
3,14,13,10,2
3,14,14,10,2
3,14,15,10,2
3,14,16,10,2
3,14,17,10,2
3,14,18,10,2
3,0,0,11,2
3,0,1,11,2
3,0,2,11,2
3,0,3,11,2
3,0,4,11,2
3,0,5,11,2
3,0,6,11,2
3,0,7,11,2
3,0,8,11,2
3,0,9,11,2
3,0,10,11,2
3,0,11,11,2
3,0,12,11,2
3,0,13,11,2
3,0,14,11,2
3,0,15,11,2
3,0,16,11,2
3,0,17,11,2
3,0,18,11,2
3,1,0,11,2
3,1,1,11,2
3,1,2,11,2
3,1,3,11,2
3,1,4,11,2
3,1,5,11,2
3,1,6,11,2
3,1,7,11,2
3,1,8,11,2
3,1,9,11,2
3,1,10,11,2
3,1,11,11,2
3,1,12,11,2
3,1,13,11,2
3,1,14,11,2
3,1,15,11,2
3,1,16,11,2
3,1,17,11,2
3,1,18,11,2
3,2,0,11,2
3,2,1,11,2
3,2,2,11,2
3,2,3,11,2
3,2,4,11,2
3,2,5,11,2
3,2,6,11,2
3,2,7,11,2
3,2,8,11,2
3,2,9,11,2
3,2,10,11,2
3,2,11,11,2
3,2,12,11,2
3,2,13,11,2
3,2,14,11,2
3,2,15,11,2
3,2,16,11,2
3,2,17,11,2
3,2,18,11,2
3,3,0,11,2
3,3,1,11,2
3,3,2,11,2
3,3,3,11,2
3,3,4,11,2
3,3,5,11,2
3,3,6,11,2
3,3,7,11,2
3,3,8,11,2
3,3,9,11,2
3,3,10,11,2
3,3,11,11,2
3,3,12,11,2
3,3,13,11,2
3,3,14,11,2
3,3,15,11,2
3,3,16,11,2
3,3,17,11,2
3,3,18,11,2
3,4,0,11,2
3,4,1,11,2
3,4,2,11,2
3,4,3,11,2
3,4,4,11,2
3,4,5,11,2
3,4,6,11,2
3,4,7,11,2
3,4,8,11,2
3,4,9,11,2
3,4,10,11,2
3,4,11,11,2
3,4,12,11,2
3,4,13,11,2
3,4,14,11,2
3,4,15,11,2
3,4,16,11,2
3,4,17,11,2
3,4,18,11,2
3,5,0,11,2
3,5,1,11,2
3,5,2,11,2
3,5,3,11,2
3,5,4,11,2
3,5,5,11,2
3,5,6,11,2
3,5,7,11,2
3,5,8,11,2
3,5,9,11,2
3,5,10,11,2
3,5,11,11,2
3,5,12,11,2
3,5,13,11,2
3,5,14,11,2
3,5,15,11,2
3,5,16,11,2
3,5,17,11,2
3,5,18,11,2
3,6,0,11,2
3,6,1,11,2
3,6,2,11,2
3,6,3,11,2
3,6,4,11,2
3,6,5,11,2
3,6,6,11,2
3,6,7,11,2
3,6,8,11,2
3,6,9,11,2
3,6,10,11,2
3,6,11,11,2
3,6,12,11,2
3,6,13,11,2
3,6,14,11,2
3,6,15,11,2
3,6,16,11,2
3,6,17,11,2
3,6,18,11,2
3,7,0,11,2
3,7,1,11,2
3,7,2,11,2
3,7,3,11,2
3,7,4,11,2
3,7,5,11,2
3,7,6,11,2
3,7,7,11,2
3,7,8,11,2
3,7,9,11,2
3,7,10,11,2
3,7,11,11,2
3,7,12,11,2
3,7,13,11,2
3,7,14,11,2
3,7,15,11,2
3,7,16,11,2
3,7,17,11,2
3,7,18,11,2
3,8,0,11,2
3,8,1,11,2
3,8,2,11,2
3,8,3,11,2
3,8,4,11,2
3,8,5,11,2
3,8,6,11,2
3,8,7,11,2
3,8,8,11,2
3,8,9,11,2
3,8,10,11,2
3,8,11,11,2
3,8,12,11,2
3,8,13,11,2
3,8,14,11,2
3,8,15,11,2
3,8,16,11,2
3,8,17,11,2
3,8,18,11,2
3,9,0,11,2
3,9,1,11,2
3,9,2,11,2
3,9,3,11,2
3,9,4,11,2
3,9,5,11,2
3,9,6,11,2
3,9,7,11,2
3,9,8,11,2
3,9,9,11,2
3,9,10,11,2
3,9,11,11,2
3,9,12,11,2
3,9,13,11,2
3,9,14,11,2
3,9,15,11,2
3,9,16,11,2
3,9,17,11,2
3,9,18,11,2
3,10,0,11,2
3,10,1,11,2
3,10,2,11,2
3,10,3,11,2
3,10,4,11,2
3,10,5,11,2
3,10,6,11,2
3,10,7,11,2
3,10,8,11,2
3,10,9,11,2
3,10,10,11,2
3,10,11,11,2
3,10,12,11,2
3,10,13,11,2
3,10,14,11,2
3,10,15,11,2
3,10,16,11,2
3,10,17,11,2
3,10,18,11,2
3,11,0,11,2
3,11,1,11,2
3,11,2,11,2
3,11,3,11,2
3,11,4,11,2
3,11,5,11,2
3,11,6,11,2
3,11,7,11,2
3,11,8,11,2
3,11,9,11,2
3,11,10,11,2
3,11,11,11,2
3,11,12,11,2
3,11,13,11,2
3,11,14,11,2
3,11,15,11,2
3,11,16,11,2
3,11,17,11,2
3,11,18,11,2
3,12,0,11,2
3,12,1,11,2
3,12,2,11,2
3,12,3,11,2
3,12,4,11,2
3,12,5,11,2
3,12,6,11,2
3,12,7,11,2
3,12,8,11,2
3,12,9,11,2
3,12,10,11,2
3,12,11,11,2
3,12,12,11,2
3,12,13,11,2
3,12,14,11,2
3,12,15,11,2
3,12,16,11,2
3,12,17,11,2
3,12,18,11,2
3,13,0,11,2
3,13,1,11,2
3,13,2,11,2
3,13,3,11,2
3,13,4,11,2
3,13,5,11,2
3,13,6,11,2
3,13,7,11,2
3,13,8,11,2
3,13,9,11,2
3,13,10,11,2
3,13,11,11,2
3,13,12,11,2
3,13,13,11,2
3,13,14,11,2
3,13,15,11,2
3,13,16,11,2
3,13,17,11,2
3,13,18,11,2
3,0,0,12,2
3,0,1,12,2
3,0,2,12,2
3,0,3,12,2
3,0,4,12,2
3,0,5,12,2
3,0,6,12,2
3,0,7,12,2
3,0,8,12,2
3,0,9,12,2
3,0,10,12,2
3,0,11,12,2
3,0,12,12,2
3,0,13,12,2
3,0,14,12,2
3,0,15,12,2
3,0,16,12,2
3,0,17,12,2
3,0,18,12,2
3,1,0,12,2
3,1,1,12,2
3,1,2,12,2
3,1,3,12,2
3,1,4,12,2
3,1,5,12,2
3,1,6,12,2
3,1,7,12,2
3,1,8,12,2
3,1,9,12,2
3,1,10,12,2
3,1,11,12,2
3,1,12,12,2
3,1,13,12,2
3,1,14,12,2
3,1,15,12,2
3,1,16,12,2
3,1,17,12,2
3,1,18,12,2
3,2,0,12,2
3,2,1,12,2
3,2,2,12,2
3,2,3,12,2
3,2,4,12,2
3,2,5,12,2
3,2,6,12,2
3,2,7,12,2
3,2,8,12,2
3,2,9,12,2
3,2,10,12,2
3,2,11,12,2
3,2,12,12,2
3,2,13,12,2
3,2,14,12,2
3,2,15,12,2
3,2,16,12,2
3,2,17,12,2
3,2,18,12,2
3,3,0,12,2
3,3,1,12,2
3,3,2,12,2
3,3,3,12,2
3,3,4,12,2
3,3,5,12,2
3,3,6,12,2
3,3,7,12,2
3,3,8,12,2
3,3,9,12,2
3,3,10,12,2
3,3,11,12,2
3,3,12,12,2
3,3,13,12,2
3,3,14,12,2
3,3,15,12,2
3,3,16,12,2
3,3,17,12,2
3,3,18,12,2
3,4,0,12,2
3,4,1,12,2
3,4,2,12,2
3,4,3,12,2
3,4,4,12,2
3,4,5,12,2
3,4,6,12,2
3,4,7,12,2
3,4,8,12,2
3,4,9,12,2
3,4,10,12,2
3,4,11,12,2
3,4,12,12,2
3,4,13,12,2
3,4,14,12,2
3,4,15,12,2
3,4,16,12,2
3,4,17,12,2
3,4,18,12,2
3,5,0,12,2
3,5,1,12,2
3,5,2,12,2
3,5,3,12,2
3,5,4,12,2
3,5,5,12,2
3,5,6,12,2
3,5,7,12,2
3,5,8,12,2
3,5,9,12,2
3,5,10,12,2
3,5,11,12,2
3,5,12,12,2
3,5,13,12,2
3,5,14,12,2
3,5,15,12,2
3,5,16,12,2
3,5,17,12,2
3,5,18,12,2
3,6,0,12,2
3,6,1,12,2
3,6,2,12,2
3,6,3,12,2
3,6,4,12,2
3,6,5,12,2
3,6,6,12,2
3,6,7,12,2
3,6,8,12,2
3,6,9,12,2
3,6,10,12,2
3,6,11,12,2
3,6,12,12,2
3,6,13,12,2
3,6,14,12,2
3,6,15,12,2
3,6,16,12,2
3,6,17,12,2
3,6,18,12,2
3,7,0,12,2
3,7,1,12,2
3,7,2,12,2
3,7,3,12,2
3,7,4,12,2
3,7,5,12,2
3,7,6,12,2
3,7,7,12,2
3,7,8,12,2
3,7,9,12,2
3,7,10,12,2
3,7,11,12,2
3,7,12,12,2
3,7,13,12,2
3,7,14,12,2
3,7,15,12,2
3,7,16,12,2
3,7,17,12,2
3,7,18,12,2
3,8,0,12,2
3,8,1,12,2
3,8,2,12,2
3,8,3,12,2
3,8,4,12,2
3,8,5,12,2
3,8,6,12,2
3,8,7,12,2
3,8,8,12,2
3,8,9,12,2
3,8,10,12,2
3,8,11,12,2
3,8,12,12,2
3,8,13,12,2
3,8,14,12,2
3,8,15,12,2
3,8,16,12,2
3,8,17,12,2
3,8,18,12,2
3,9,0,12,2
3,9,1,12,2
3,9,2,12,2
3,9,3,12,2
3,9,4,12,2
3,9,5,12,2
3,9,6,12,2
3,9,7,12,2
3,9,8,12,2
3,9,9,12,2
3,9,10,12,2
3,9,11,12,2
3,9,12,12,2
3,9,13,12,2
3,9,14,12,2
3,9,15,12,2
3,9,16,12,2
3,9,17,12,2
3,9,18,12,2
3,10,0,12,2
3,10,1,12,2
3,10,2,12,2
3,10,3,12,2
3,10,4,12,2
3,10,5,12,2
3,10,6,12,2
3,10,7,12,2
3,10,8,12,2
3,10,9,12,2
3,10,10,12,2
3,10,11,12,2
3,10,12,12,2
3,10,13,12,2
3,10,14,12,2
3,10,15,12,2
3,10,16,12,2
3,10,17,12,2
3,10,18,12,2
3,11,0,12,2
3,11,1,12,2
3,11,2,12,2
3,11,3,12,2
3,11,4,12,2
3,11,5,12,2
3,11,6,12,2
3,11,7,12,2
3,11,8,12,2
3,11,9,12,2
3,11,10,12,2
3,11,11,12,2
3,11,12,12,2
3,11,13,12,2
3,11,14,12,2
3,11,15,12,2
3,11,16,12,2
3,11,17,12,2
3,11,18,12,2
3,12,0,12,2
3,12,1,12,2
3,12,2,12,2
3,12,3,12,2
3,12,4,12,2
3,12,5,12,2
3,12,6,12,2
3,12,7,12,2
3,12,8,12,2
3,12,9,12,2
3,12,10,12,2
3,12,11,12,2
3,12,12,12,2
3,12,13,12,2
3,12,14,12,2
3,12,15,12,2
3,12,16,12,2
3,12,17,12,2
3,12,18,12,2
3,0,0,13,2
3,0,1,13,2
3,0,2,13,2
3,0,3,13,2
3,0,4,13,2
3,0,5,13,2
3,0,6,13,2
3,0,7,13,2
3,0,8,13,2
3,0,9,13,2
3,0,10,13,2
3,0,11,13,2
3,0,12,13,2
3,0,13,13,2
3,0,14,13,2
3,0,15,13,2
3,0,16,13,2
3,0,17,13,2
3,0,18,13,2
3,1,0,13,2
3,1,1,13,2
3,1,2,13,2
3,1,3,13,2
3,1,4,13,2
3,1,5,13,2
3,1,6,13,2
3,1,7,13,2
3,1,8,13,2
3,1,9,13,2
3,1,10,13,2
3,1,11,13,2
3,1,12,13,2
3,1,13,13,2
3,1,14,13,2
3,1,15,13,2
3,1,16,13,2
3,1,17,13,2
3,1,18,13,2
3,2,0,13,2
3,2,1,13,2
3,2,2,13,2
3,2,3,13,2
3,2,4,13,2
3,2,5,13,2
3,2,6,13,2
3,2,7,13,2
3,2,8,13,2
3,2,9,13,2
3,2,10,13,2
3,2,11,13,2
3,2,12,13,2
3,2,13,13,2
3,2,14,13,2
3,2,15,13,2
3,2,16,13,2
3,2,17,13,2
3,2,18,13,2
3,3,0,13,2
3,3,1,13,2
3,3,2,13,2
3,3,3,13,2
3,3,4,13,2
3,3,5,13,2
3,3,6,13,2
3,3,7,13,2
3,3,8,13,2
3,3,9,13,2
3,3,10,13,2
3,3,11,13,2
3,3,12,13,2
3,3,13,13,2
3,3,14,13,2
3,3,15,13,2
3,3,16,13,2
3,3,17,13,2
3,3,18,13,2
3,4,0,13,2
3,4,1,13,2
3,4,2,13,2
3,4,3,13,2
3,4,4,13,2
3,4,5,13,2
3,4,6,13,2
3,4,7,13,2
3,4,8,13,2
3,4,9,13,2
3,4,10,13,2
3,4,11,13,2
3,4,12,13,2
3,4,13,13,2
3,4,14,13,2
3,4,15,13,2
3,4,16,13,2
3,4,17,13,2
3,4,18,13,2
3,5,0,13,2
3,5,1,13,2
3,5,2,13,2
3,5,3,13,2
3,5,4,13,2
3,5,5,13,2
3,5,6,13,2
3,5,7,13,2
3,5,8,13,2
3,5,9,13,2
3,5,10,13,2
3,5,11,13,2
3,5,12,13,2
3,5,13,13,2
3,5,14,13,2
3,5,15,13,2
3,5,16,13,2
3,5,17,13,2
3,5,18,13,2
3,6,0,13,2
3,6,1,13,2
3,6,2,13,2
3,6,3,13,2
3,6,4,13,2
3,6,5,13,2
3,6,6,13,2
3,6,7,13,2
3,6,8,13,2
3,6,9,13,2
3,6,10,13,2
3,6,11,13,2
3,6,12,13,2
3,6,13,13,2
3,6,14,13,2
3,6,15,13,2
3,6,16,13,2
3,6,17,13,2
3,6,18,13,2
3,7,0,13,2
3,7,1,13,2
3,7,2,13,2
3,7,3,13,2
3,7,4,13,2
3,7,5,13,2
3,7,6,13,2
3,7,7,13,2
3,7,8,13,2
3,7,9,13,2
3,7,10,13,2
3,7,11,13,2
3,7,12,13,2
3,7,13,13,2
3,7,14,13,2
3,7,15,13,2
3,7,16,13,2
3,7,17,13,2
3,7,18,13,2
3,8,0,13,2
3,8,1,13,2
3,8,2,13,2
3,8,3,13,2
3,8,4,13,2
3,8,5,13,2
3,8,6,13,2
3,8,7,13,2
3,8,8,13,2
3,8,9,13,2
3,8,10,13,2
3,8,11,13,2
3,8,12,13,2
3,8,13,13,2
3,8,14,13,2
3,8,15,13,2
3,8,16,13,2
3,8,17,13,2
3,8,18,13,2
3,9,0,13,2
3,9,1,13,2
3,9,2,13,2
3,9,3,13,2
3,9,4,13,2
3,9,5,13,2
3,9,6,13,2
3,9,7,13,2
3,9,8,13,2
3,9,9,13,2
3,9,10,13,2
3,9,11,13,2
3,9,12,13,2
3,9,13,13,2
3,9,14,13,2
3,9,15,13,2
3,9,16,13,2
3,9,17,13,2
3,9,18,13,2
3,10,0,13,2
3,10,1,13,2
3,10,2,13,2
3,10,3,13,2
3,10,4,13,2
3,10,5,13,2
3,10,6,13,2
3,10,7,13,2
3,10,8,13,2
3,10,9,13,2
3,10,10,13,2
3,10,11,13,2
3,10,12,13,2
3,10,13,13,2
3,10,14,13,2
3,10,15,13,2
3,10,16,13,2
3,10,17,13,2
3,10,18,13,2
3,11,0,13,2
3,11,1,13,2
3,11,2,13,2
3,11,3,13,2
3,11,4,13,2
3,11,5,13,2
3,11,6,13,2
3,11,7,13,2
3,11,8,13,2
3,11,9,13,2
3,11,10,13,2
3,11,11,13,2
3,11,12,13,2
3,11,13,13,2
3,11,14,13,2
3,11,15,13,2
3,11,16,13,2
3,11,17,13,2
3,11,18,13,2
3,0,0,14,2
3,0,1,14,2
3,0,2,14,2
3,0,3,14,2
3,0,4,14,2
3,0,5,14,2
3,0,6,14,2
3,0,7,14,2
3,0,8,14,2
3,0,9,14,2
3,0,10,14,2
3,0,11,14,2
3,0,12,14,2
3,0,13,14,2
3,0,14,14,2
3,0,15,14,2
3,0,16,14,2
3,0,17,14,2
3,0,18,14,2
3,1,0,14,2
3,1,1,14,2
3,1,2,14,2
3,1,3,14,2
3,1,4,14,2
3,1,5,14,2
3,1,6,14,2
3,1,7,14,2
3,1,8,14,2
3,1,9,14,2
3,1,10,14,2
3,1,11,14,2
3,1,12,14,2
3,1,13,14,2
3,1,14,14,2
3,1,15,14,2
3,1,16,14,2
3,1,17,14,2
3,1,18,14,2
3,2,0,14,2
3,2,1,14,2
3,2,2,14,2
3,2,3,14,2
3,2,4,14,2
3,2,5,14,2
3,2,6,14,2
3,2,7,14,2
3,2,8,14,2
3,2,9,14,2
3,2,10,14,2
3,2,11,14,2
3,2,12,14,2
3,2,13,14,2
3,2,14,14,2
3,2,15,14,2
3,2,16,14,2
3,2,17,14,2
3,2,18,14,2
3,3,0,14,2
3,3,1,14,2
3,3,2,14,2
3,3,3,14,2
3,3,4,14,2
3,3,5,14,2
3,3,6,14,2
3,3,7,14,2
3,3,8,14,2
3,3,9,14,2
3,3,10,14,2
3,3,11,14,2
3,3,12,14,2
3,3,13,14,2
3,3,14,14,2
3,3,15,14,2
3,3,16,14,2
3,3,17,14,2
3,3,18,14,2
3,4,0,14,2
3,4,1,14,2
3,4,2,14,2
3,4,3,14,2
3,4,4,14,2
3,4,5,14,2
3,4,6,14,2
3,4,7,14,2
3,4,8,14,2
3,4,9,14,2
3,4,10,14,2
3,4,11,14,2
3,4,12,14,2
3,4,13,14,2
3,4,14,14,2
3,4,15,14,2
3,4,16,14,2
3,4,17,14,2
3,4,18,14,2
3,5,0,14,2
3,5,1,14,2
3,5,2,14,2
3,5,3,14,2
3,5,4,14,2
3,5,5,14,2
3,5,6,14,2
3,5,7,14,2
3,5,8,14,2
3,5,9,14,2
3,5,10,14,2
3,5,11,14,2
3,5,12,14,2
3,5,13,14,2
3,5,14,14,2
3,5,15,14,2
3,5,16,14,2
3,5,17,14,2
3,5,18,14,2
3,6,0,14,2
3,6,1,14,2
3,6,2,14,2
3,6,3,14,2
3,6,4,14,2
3,6,5,14,2
3,6,6,14,2
3,6,7,14,2
3,6,8,14,2
3,6,9,14,2
3,6,10,14,2
3,6,11,14,2
3,6,12,14,2
3,6,13,14,2
3,6,14,14,2
3,6,15,14,2
3,6,16,14,2
3,6,17,14,2
3,6,18,14,2
3,7,0,14,2
3,7,1,14,2
3,7,2,14,2
3,7,3,14,2
3,7,4,14,2
3,7,5,14,2
3,7,6,14,2
3,7,7,14,2
3,7,8,14,2
3,7,9,14,2
3,7,10,14,2
3,7,11,14,2
3,7,12,14,2
3,7,13,14,2
3,7,14,14,2
3,7,15,14,2
3,7,16,14,2
3,7,17,14,2
3,7,18,14,2
3,8,0,14,2
3,8,1,14,2
3,8,2,14,2
3,8,3,14,2
3,8,4,14,2
3,8,5,14,2
3,8,6,14,2
3,8,7,14,2
3,8,8,14,2
3,8,9,14,2
3,8,10,14,2
3,8,11,14,2
3,8,12,14,2
3,8,13,14,2
3,8,14,14,2
3,8,15,14,2
3,8,16,14,2
3,8,17,14,2
3,8,18,14,2
3,9,0,14,2
3,9,1,14,2
3,9,2,14,2
3,9,3,14,2
3,9,4,14,2
3,9,5,14,2
3,9,6,14,2
3,9,7,14,2
3,9,8,14,2
3,9,9,14,2
3,9,10,14,2
3,9,11,14,2
3,9,12,14,2
3,9,13,14,2
3,9,14,14,2
3,9,15,14,2
3,9,16,14,2
3,9,17,14,2
3,9,18,14,2
3,10,0,14,2
3,10,1,14,2
3,10,2,14,2
3,10,3,14,2
3,10,4,14,2
3,10,5,14,2
3,10,6,14,2
3,10,7,14,2
3,10,8,14,2
3,10,9,14,2
3,10,10,14,2
3,10,11,14,2
3,10,12,14,2
3,10,13,14,2
3,10,14,14,2
3,10,15,14,2
3,10,16,14,2
3,10,17,14,2
3,10,18,14,2
3,0,0,15,2
3,0,1,15,2
3,0,2,15,2
3,0,3,15,2
3,0,4,15,2
3,0,5,15,2
3,0,6,15,2
3,0,7,15,2
3,0,8,15,2
3,0,9,15,2
3,0,10,15,2
3,0,11,15,2
3,0,12,15,2
3,0,13,15,2
3,0,14,15,2
3,0,15,15,2
3,0,16,15,2
3,0,17,15,2
3,0,18,15,2
3,1,0,15,2
3,1,1,15,2
3,1,2,15,2
3,1,3,15,2
3,1,4,15,2
3,1,5,15,2
3,1,6,15,2
3,1,7,15,2
3,1,8,15,2
3,1,9,15,2
3,1,10,15,2
3,1,11,15,2
3,1,12,15,2
3,1,13,15,2
3,1,14,15,2
3,1,15,15,2
3,1,16,15,2
3,1,17,15,2
3,1,18,15,2
3,2,0,15,2
3,2,1,15,2
3,2,2,15,2
3,2,3,15,2
3,2,4,15,2
3,2,5,15,2
3,2,6,15,2
3,2,7,15,2
3,2,8,15,2
3,2,9,15,2
3,2,10,15,2
3,2,11,15,2
3,2,12,15,2
3,2,13,15,2
3,2,14,15,2
3,2,15,15,2
3,2,16,15,2
3,2,17,15,2
3,2,18,15,2
3,3,0,15,2
3,3,1,15,2
3,3,2,15,2
3,3,3,15,2
3,3,4,15,2
3,3,5,15,2
3,3,6,15,2
3,3,7,15,2
3,3,8,15,2
3,3,9,15,2
3,3,10,15,2
3,3,11,15,2
3,3,12,15,2
3,3,13,15,2
3,3,14,15,2
3,3,15,15,2
3,3,16,15,2
3,3,17,15,2
3,3,18,15,2
3,4,0,15,2
3,4,1,15,2
3,4,2,15,2
3,4,3,15,2
3,4,4,15,2
3,4,5,15,2
3,4,6,15,2
3,4,7,15,2
3,4,8,15,2
3,4,9,15,2
3,4,10,15,2
3,4,11,15,2
3,4,12,15,2
3,4,13,15,2
3,4,14,15,2
3,4,15,15,2
3,4,16,15,2
3,4,17,15,2
3,4,18,15,2
3,5,0,15,2
3,5,1,15,2
3,5,2,15,2
3,5,3,15,2
3,5,4,15,2
3,5,5,15,2
3,5,6,15,2
3,5,7,15,2
3,5,8,15,2
3,5,9,15,2
3,5,10,15,2
3,5,11,15,2
3,5,12,15,2
3,5,13,15,2
3,5,14,15,2
3,5,15,15,2
3,5,16,15,2
3,5,17,15,2
3,5,18,15,2
3,6,0,15,2
3,6,1,15,2
3,6,2,15,2
3,6,3,15,2
3,6,4,15,2
3,6,5,15,2
3,6,6,15,2
3,6,7,15,2
3,6,8,15,2
3,6,9,15,2
3,6,10,15,2
3,6,11,15,2
3,6,12,15,2
3,6,13,15,2
3,6,14,15,2
3,6,15,15,2
3,6,16,15,2
3,6,17,15,2
3,6,18,15,2
3,7,0,15,2
3,7,1,15,2
3,7,2,15,2
3,7,3,15,2
3,7,4,15,2
3,7,5,15,2
3,7,6,15,2
3,7,7,15,2
3,7,8,15,2
3,7,9,15,2
3,7,10,15,2
3,7,11,15,2
3,7,12,15,2
3,7,13,15,2
3,7,14,15,2
3,7,15,15,2
3,7,16,15,2
3,7,17,15,2
3,7,18,15,2
3,8,0,15,2
3,8,1,15,2
3,8,2,15,2
3,8,3,15,2
3,8,4,15,2
3,8,5,15,2
3,8,6,15,2
3,8,7,15,2
3,8,8,15,2
3,8,9,15,2
3,8,10,15,2
3,8,11,15,2
3,8,12,15,2
3,8,13,15,2
3,8,14,15,2
3,8,15,15,2
3,8,16,15,2
3,8,17,15,2
3,8,18,15,2
3,9,0,15,2
3,9,1,15,2
3,9,2,15,2
3,9,3,15,2
3,9,4,15,2
3,9,5,15,2
3,9,6,15,2
3,9,7,15,2
3,9,8,15,2
3,9,9,15,2
3,9,10,15,2
3,9,11,15,2
3,9,12,15,2
3,9,13,15,2
3,9,14,15,2
3,9,15,15,2
3,9,16,15,2
3,9,17,15,2
3,9,18,15,2
3,0,0,16,2
3,0,1,16,2
3,0,2,16,2
3,0,3,16,2
3,0,4,16,2
3,0,5,16,2
3,0,6,16,2
3,0,7,16,2
3,0,8,16,2
3,0,9,16,2
3,0,10,16,2
3,0,11,16,2
3,0,12,16,2
3,0,13,16,2
3,0,14,16,2
3,0,15,16,2
3,0,16,16,2
3,0,17,16,2
3,0,18,16,2
3,1,0,16,2
3,1,1,16,2
3,1,2,16,2
3,1,3,16,2
3,1,4,16,2
3,1,5,16,2
3,1,6,16,2
3,1,7,16,2
3,1,8,16,2
3,1,9,16,2
3,1,10,16,2
3,1,11,16,2
3,1,12,16,2
3,1,13,16,2
3,1,14,16,2
3,1,15,16,2
3,1,16,16,2
3,1,17,16,2
3,1,18,16,2
3,2,0,16,2
3,2,1,16,2
3,2,2,16,2
3,2,3,16,2
3,2,4,16,2
3,2,5,16,2
3,2,6,16,2
3,2,7,16,2
3,2,8,16,2
3,2,9,16,2
3,2,10,16,2
3,2,11,16,2
3,2,12,16,2
3,2,13,16,2
3,2,14,16,2
3,2,15,16,2
3,2,16,16,2
3,2,17,16,2
3,2,18,16,2
3,3,0,16,2
3,3,1,16,2
3,3,2,16,2
3,3,3,16,2
3,3,4,16,2
3,3,5,16,2
3,3,6,16,2
3,3,7,16,2
3,3,8,16,2
3,3,9,16,2
3,3,10,16,2
3,3,11,16,2
3,3,12,16,2
3,3,13,16,2
3,3,14,16,2
3,3,15,16,2
3,3,16,16,2
3,3,17,16,2
3,3,18,16,2
3,4,0,16,2
3,4,1,16,2
3,4,2,16,2
3,4,3,16,2
3,4,4,16,2
3,4,5,16,2
3,4,6,16,2
3,4,7,16,2
3,4,8,16,2
3,4,9,16,2
3,4,10,16,2
3,4,11,16,2
3,4,12,16,2
3,4,13,16,2
3,4,14,16,2
3,4,15,16,2
3,4,16,16,2
3,4,17,16,2
3,4,18,16,2
3,5,0,16,2
3,5,1,16,2
3,5,2,16,2
3,5,3,16,2
3,5,4,16,2
3,5,5,16,2
3,5,6,16,2
3,5,7,16,2
3,5,8,16,2
3,5,9,16,2
3,5,10,16,2
3,5,11,16,2
3,5,12,16,2
3,5,13,16,2
3,5,14,16,2
3,5,15,16,2
3,5,16,16,2
3,5,17,16,2
3,5,18,16,2
3,6,0,16,2
3,6,1,16,2
3,6,2,16,2
3,6,3,16,2
3,6,4,16,2
3,6,5,16,2
3,6,6,16,2
3,6,7,16,2
3,6,8,16,2
3,6,9,16,2
3,6,10,16,2
3,6,11,16,2
3,6,12,16,2
3,6,13,16,2
3,6,14,16,2
3,6,15,16,2
3,6,16,16,2
3,6,17,16,2
3,6,18,16,2
3,7,0,16,2
3,7,1,16,2
3,7,2,16,2
3,7,3,16,2
3,7,4,16,2
3,7,5,16,2
3,7,6,16,2
3,7,7,16,2
3,7,8,16,2
3,7,9,16,2
3,7,10,16,2
3,7,11,16,2
3,7,12,16,2
3,7,13,16,2
3,7,14,16,2
3,7,15,16,2
3,7,16,16,2
3,7,17,16,2
3,7,18,16,2
3,8,0,16,2
3,8,1,16,2
3,8,2,16,2
3,8,3,16,2
3,8,4,16,2
3,8,5,16,2
3,8,6,16,2
3,8,7,16,2
3,8,8,16,2
3,8,9,16,2
3,8,10,16,2
3,8,11,16,2
3,8,12,16,2
3,8,13,16,2
3,8,14,16,2
3,8,15,16,2
3,8,16,16,2
3,8,17,16,2
3,8,18,16,2
3,0,0,17,2
3,0,1,17,2
3,0,2,17,2
3,0,3,17,2
3,0,4,17,2
3,0,5,17,2
3,0,6,17,2
3,0,7,17,2
3,0,8,17,2
3,0,9,17,2
3,0,10,17,2
3,0,11,17,2
3,0,12,17,2
3,0,13,17,2
3,0,14,17,2
3,0,15,17,2
3,0,16,17,2
3,0,17,17,2
3,0,18,17,2
3,1,0,17,2
3,1,1,17,2
3,1,2,17,2
3,1,3,17,2
3,1,4,17,2
3,1,5,17,2
3,1,6,17,2
3,1,7,17,2
3,1,8,17,2
3,1,9,17,2
3,1,10,17,2
3,1,11,17,2
3,1,12,17,2
3,1,13,17,2
3,1,14,17,2
3,1,15,17,2
3,1,16,17,2
3,1,17,17,2
3,1,18,17,2
3,2,0,17,2
3,2,1,17,2
3,2,2,17,2
3,2,3,17,2
3,2,4,17,2
3,2,5,17,2
3,2,6,17,2
3,2,7,17,2
3,2,8,17,2
3,2,9,17,2
3,2,10,17,2
3,2,11,17,2
3,2,12,17,2
3,2,13,17,2
3,2,14,17,2
3,2,15,17,2
3,2,16,17,2
3,2,17,17,2
3,2,18,17,2
3,3,0,17,2
3,3,1,17,2
3,3,2,17,2
3,3,3,17,2
3,3,4,17,2
3,3,5,17,2
3,3,6,17,2
3,3,7,17,2
3,3,8,17,2
3,3,9,17,2
3,3,10,17,2
3,3,11,17,2
3,3,12,17,2
3,3,13,17,2
3,3,14,17,2
3,3,15,17,2
3,3,16,17,2
3,3,17,17,2
3,3,18,17,2
3,4,0,17,2
3,4,1,17,2
3,4,2,17,2
3,4,3,17,2
3,4,4,17,2
3,4,5,17,2
3,4,6,17,2
3,4,7,17,2
3,4,8,17,2
3,4,9,17,2
3,4,10,17,2
3,4,11,17,2
3,4,12,17,2
3,4,13,17,2
3,4,14,17,2
3,4,15,17,2
3,4,16,17,2
3,4,17,17,2
3,4,18,17,2
3,5,0,17,2
3,5,1,17,2
3,5,2,17,2
3,5,3,17,2
3,5,4,17,2
3,5,5,17,2
3,5,6,17,2
3,5,7,17,2
3,5,8,17,2
3,5,9,17,2
3,5,10,17,2
3,5,11,17,2
3,5,12,17,2
3,5,13,17,2
3,5,14,17,2
3,5,15,17,2
3,5,16,17,2
3,5,17,17,2
3,5,18,17,2
3,6,0,17,2
3,6,1,17,2
3,6,2,17,2
3,6,3,17,2
3,6,4,17,2
3,6,5,17,2
3,6,6,17,2
3,6,7,17,2
3,6,8,17,2
3,6,9,17,2
3,6,10,17,2
3,6,11,17,2
3,6,12,17,2
3,6,13,17,2
3,6,14,17,2
3,6,15,17,2
3,6,16,17,2
3,6,17,17,2
3,6,18,17,2
3,7,0,17,2
3,7,1,17,2
3,7,2,17,2
3,7,3,17,2
3,7,4,17,2
3,7,5,17,2
3,7,6,17,2
3,7,7,17,2
3,7,8,17,2
3,7,9,17,2
3,7,10,17,2
3,7,11,17,2
3,7,12,17,2
3,7,13,17,2
3,7,14,17,2
3,7,15,17,2
3,7,16,17,2
3,7,17,17,2
3,7,18,17,2
3,0,0,18,2
3,0,1,18,2
3,0,2,18,2
3,0,3,18,2
3,0,4,18,2
3,0,5,18,2
3,0,6,18,2
3,0,7,18,2
3,0,8,18,2
3,0,9,18,2
3,0,10,18,2
3,0,11,18,2
3,0,12,18,2
3,0,13,18,2
3,0,14,18,2
3,0,15,18,2
3,0,16,18,2
3,0,17,18,2
3,0,18,18,2
3,1,0,18,2
3,1,1,18,2
3,1,2,18,2
3,1,3,18,2
3,1,4,18,2
3,1,5,18,2
3,1,6,18,2
3,1,7,18,2
3,1,8,18,2
3,1,9,18,2
3,1,10,18,2
3,1,11,18,2
3,1,12,18,2
3,1,13,18,2
3,1,14,18,2
3,1,15,18,2
3,1,16,18,2
3,1,17,18,2
3,1,18,18,2
3,2,0,18,2
3,2,1,18,2
3,2,2,18,2
3,2,3,18,2
3,2,4,18,2
3,2,5,18,2
3,2,6,18,2
3,2,7,18,2
3,2,8,18,2
3,2,9,18,2
3,2,10,18,2
3,2,11,18,2
3,2,12,18,2
3,2,13,18,2
3,2,14,18,2
3,2,15,18,2
3,2,16,18,2
3,2,17,18,2
3,2,18,18,2
3,3,0,18,2
3,3,1,18,2
3,3,2,18,2
3,3,3,18,2
3,3,4,18,2
3,3,5,18,2
3,3,6,18,2
3,3,7,18,2
3,3,8,18,2
3,3,9,18,2
3,3,10,18,2
3,3,11,18,2
3,3,12,18,2
3,3,13,18,2
3,3,14,18,2
3,3,15,18,2
3,3,16,18,2
3,3,17,18,2
3,3,18,18,2
3,4,0,18,2
3,4,1,18,2
3,4,2,18,2
3,4,3,18,2
3,4,4,18,2
3,4,5,18,2
3,4,6,18,2
3,4,7,18,2
3,4,8,18,2
3,4,9,18,2
3,4,10,18,2
3,4,11,18,2
3,4,12,18,2
3,4,13,18,2
3,4,14,18,2
3,4,15,18,2
3,4,16,18,2
3,4,17,18,2
3,4,18,18,2
3,5,0,18,2
3,5,1,18,2
3,5,2,18,2
3,5,3,18,2
3,5,4,18,2
3,5,5,18,2
3,5,6,18,2
3,5,7,18,2
3,5,8,18,2
3,5,9,18,2
3,5,10,18,2
3,5,11,18,2
3,5,12,18,2
3,5,13,18,2
3,5,14,18,2
3,5,15,18,2
3,5,16,18,2
3,5,17,18,2
3,5,18,18,2
3,6,0,18,2
3,6,1,18,2
3,6,2,18,2
3,6,3,18,2
3,6,4,18,2
3,6,5,18,2
3,6,6,18,2
3,6,7,18,2
3,6,8,18,2
3,6,9,18,2
3,6,10,18,2
3,6,11,18,2
3,6,12,18,2
3,6,13,18,2
3,6,14,18,2
3,6,15,18,2
3,6,16,18,2
3,6,17,18,2
3,6,18,18,2
3,0,0,19,2
3,0,1,19,2
3,0,2,19,2
3,0,3,19,2
3,0,4,19,2
3,0,5,19,2
3,0,6,19,2
3,0,7,19,2
3,0,8,19,2
3,0,9,19,2
3,0,10,19,2
3,0,11,19,2
3,0,12,19,2
3,0,13,19,2
3,0,14,19,2
3,0,15,19,2
3,0,16,19,2
3,0,17,19,2
3,0,18,19,2
3,1,0,19,2
3,1,1,19,2
3,1,2,19,2
3,1,3,19,2
3,1,4,19,2
3,1,5,19,2
3,1,6,19,2
3,1,7,19,2
3,1,8,19,2
3,1,9,19,2
3,1,10,19,2
3,1,11,19,2
3,1,12,19,2
3,1,13,19,2
3,1,14,19,2
3,1,15,19,2
3,1,16,19,2
3,1,17,19,2
3,1,18,19,2
3,2,0,19,2
3,2,1,19,2
3,2,2,19,2
3,2,3,19,2
3,2,4,19,2
3,2,5,19,2
3,2,6,19,2
3,2,7,19,2
3,2,8,19,2
3,2,9,19,2
3,2,10,19,2
3,2,11,19,2
3,2,12,19,2
3,2,13,19,2
3,2,14,19,2
3,2,15,19,2
3,2,16,19,2
3,2,17,19,2
3,2,18,19,2
3,3,0,19,2
3,3,1,19,2
3,3,2,19,2
3,3,3,19,2
3,3,4,19,2
3,3,5,19,2
3,3,6,19,2
3,3,7,19,2
3,3,8,19,2
3,3,9,19,2
3,3,10,19,2
3,3,11,19,2
3,3,12,19,2
3,3,13,19,2
3,3,14,19,2
3,3,15,19,2
3,3,16,19,2
3,3,17,19,2
3,3,18,19,2
3,4,0,19,2
3,4,1,19,2
3,4,2,19,2
3,4,3,19,2
3,4,4,19,2
3,4,5,19,2
3,4,6,19,2
3,4,7,19,2
3,4,8,19,2
3,4,9,19,2
3,4,10,19,2
3,4,11,19,2
3,4,12,19,2
3,4,13,19,2
3,4,14,19,2
3,4,15,19,2
3,4,16,19,2
3,4,17,19,2
3,4,18,19,2
3,5,0,19,2
3,5,1,19,2
3,5,2,19,2
3,5,3,19,2
3,5,4,19,2
3,5,5,19,2
3,5,6,19,2
3,5,7,19,2
3,5,8,19,2
3,5,9,19,2
3,5,10,19,2
3,5,11,19,2
3,5,12,19,2
3,5,13,19,2
3,5,14,19,2
3,5,15,19,2
3,5,16,19,2
3,5,17,19,2
3,5,18,19,2
3,0,0,20,2
3,0,1,20,2
3,0,2,20,2
3,0,3,20,2
3,0,4,20,2
3,0,5,20,2
3,0,6,20,2
3,0,7,20,2
3,0,8,20,2
3,0,9,20,2
3,0,10,20,2
3,0,11,20,2
3,0,12,20,2
3,0,13,20,2
3,0,14,20,2
3,0,15,20,2
3,0,16,20,2
3,0,17,20,2
3,0,18,20,2
3,1,0,20,2
3,1,1,20,2
3,1,2,20,2
3,1,3,20,2
3,1,4,20,2
3,1,5,20,2
3,1,6,20,2
3,1,7,20,2
3,1,8,20,2
3,1,9,20,2
3,1,10,20,2
3,1,11,20,2
3,1,12,20,2
3,1,13,20,2
3,1,14,20,2
3,1,15,20,2
3,1,16,20,2
3,1,17,20,2
3,1,18,20,2
3,2,0,20,2
3,2,1,20,2
3,2,2,20,2
3,2,3,20,2
3,2,4,20,2
3,2,5,20,2
3,2,6,20,2
3,2,7,20,2
3,2,8,20,2
3,2,9,20,2
3,2,10,20,2
3,2,11,20,2
3,2,12,20,2
3,2,13,20,2
3,2,14,20,2
3,2,15,20,2
3,2,16,20,2
3,2,17,20,2
3,2,18,20,2
3,3,0,20,2
3,3,1,20,2
3,3,2,20,2
3,3,3,20,2
3,3,4,20,2
3,3,5,20,2
3,3,6,20,2
3,3,7,20,2
3,3,8,20,2
3,3,9,20,2
3,3,10,20,2
3,3,11,20,2
3,3,12,20,2
3,3,13,20,2
3,3,14,20,2
3,3,15,20,2
3,3,16,20,2
3,3,17,20,2
3,3,18,20,2
3,4,0,20,2
3,4,1,20,2
3,4,2,20,2
3,4,3,20,2
3,4,4,20,2
3,4,5,20,2
3,4,6,20,2
3,4,7,20,2
3,4,8,20,2
3,4,9,20,2
3,4,10,20,2
3,4,11,20,2
3,4,12,20,2
3,4,13,20,2
3,4,14,20,2
3,4,15,20,2
3,4,16,20,2
3,4,17,20,2
3,4,18,20,2
3,0,0,21,2
3,0,1,21,2
3,0,2,21,2
3,0,3,21,2
3,0,4,21,2
3,0,5,21,2
3,0,6,21,2
3,0,7,21,2
3,0,8,21,2
3,0,9,21,2
3,0,10,21,2
3,0,11,21,2
3,0,12,21,2
3,0,13,21,2
3,0,14,21,2
3,0,15,21,2
3,0,16,21,2
3,0,17,21,2
3,0,18,21,2
3,1,0,21,2
3,1,1,21,2
3,1,2,21,2
3,1,3,21,2
3,1,4,21,2
3,1,5,21,2
3,1,6,21,2
3,1,7,21,2
3,1,8,21,2
3,1,9,21,2
3,1,10,21,2
3,1,11,21,2
3,1,12,21,2
3,1,13,21,2
3,1,14,21,2
3,1,15,21,2
3,1,16,21,2
3,1,17,21,2
3,1,18,21,2
3,2,0,21,2
3,2,1,21,2
3,2,2,21,2
3,2,3,21,2
3,2,4,21,2
3,2,5,21,2
3,2,6,21,2
3,2,7,21,2
3,2,8,21,2
3,2,9,21,2
3,2,10,21,2
3,2,11,21,2
3,2,12,21,2
3,2,13,21,2
3,2,14,21,2
3,2,15,21,2
3,2,16,21,2
3,2,17,21,2
3,2,18,21,2
3,3,0,21,2
3,3,1,21,2
3,3,2,21,2
3,3,3,21,2
3,3,4,21,2
3,3,5,21,2
3,3,6,21,2
3,3,7,21,2
3,3,8,21,2
3,3,9,21,2
3,3,10,21,2
3,3,11,21,2
3,3,12,21,2
3,3,13,21,2
3,3,14,21,2
3,3,15,21,2
3,3,16,21,2
3,3,17,21,2
3,3,18,21,2
3,0,0,22,2
3,0,1,22,2
3,0,2,22,2
3,0,3,22,2
3,0,4,22,2
3,0,5,22,2
3,0,6,22,2
3,0,7,22,2
3,0,8,22,2
3,0,9,22,2
3,0,10,22,2
3,0,11,22,2
3,0,12,22,2
3,0,13,22,2
3,0,14,22,2
3,0,15,22,2
3,0,16,22,2
3,0,17,22,2
3,0,18,22,2
3,1,0,22,2
3,1,1,22,2
3,1,2,22,2
3,1,3,22,2
3,1,4,22,2
3,1,5,22,2
3,1,6,22,2
3,1,7,22,2
3,1,8,22,2
3,1,9,22,2
3,1,10,22,2
3,1,11,22,2
3,1,12,22,2
3,1,13,22,2
3,1,14,22,2
3,1,15,22,2
3,1,16,22,2
3,1,17,22,2
3,1,18,22,2
3,2,0,22,2
3,2,1,22,2
3,2,2,22,2
3,2,3,22,2
3,2,4,22,2
3,2,5,22,2
3,2,6,22,2
3,2,7,22,2
3,2,8,22,2
3,2,9,22,2
3,2,10,22,2
3,2,11,22,2
3,2,12,22,2
3,2,13,22,2
3,2,14,22,2
3,2,15,22,2
3,2,16,22,2
3,2,17,22,2
3,2,18,22,2
3,0,0,23,2
3,0,1,23,2
3,0,2,23,2
3,0,3,23,2
3,0,4,23,2
3,0,5,23,2
3,0,6,23,2
3,0,7,23,2
3,0,8,23,2
3,0,9,23,2
3,0,10,23,2
3,0,11,23,2
3,0,12,23,2
3,0,13,23,2
3,0,14,23,2
3,0,15,23,2
3,0,16,23,2
3,0,17,23,2
3,0,18,23,2
3,1,0,23,2
3,1,1,23,2
3,1,2,23,2
3,1,3,23,2
3,1,4,23,2
3,1,5,23,2
3,1,6,23,2
3,1,7,23,2
3,1,8,23,2
3,1,9,23,2
3,1,10,23,2
3,1,11,23,2
3,1,12,23,2
3,1,13,23,2
3,1,14,23,2
3,1,15,23,2
3,1,16,23,2
3,1,17,23,2
3,1,18,23,2
3,0,0,24,2
3,0,1,24,2
3,0,2,24,2
3,0,3,24,2
3,0,4,24,2
3,0,5,24,2
3,0,6,24,2
3,0,7,24,2
3,0,8,24,2
3,0,9,24,2
3,0,10,24,2
3,0,11,24,2
3,0,12,24,2
3,0,13,24,2
3,0,14,24,2
3,0,15,24,2
3,0,16,24,2
3,0,17,24,2
3,0,18,24,2
3,0,0,1,3
3,0,1,1,3
3,0,2,1,3
3,0,3,1,3
3,0,4,1,3
3,0,5,1,3
3,0,6,1,3
3,0,7,1,3
3,0,8,1,3
3,0,9,1,3
3,0,10,1,3
3,0,11,1,3
3,0,12,1,3
3,0,13,1,3
3,0,14,1,3
3,0,15,1,3
3,1,0,1,3
3,1,1,1,3
3,1,2,1,3
3,1,3,1,3
3,1,4,1,3
3,1,5,1,3
3,1,6,1,3
3,1,7,1,3
3,1,8,1,3
3,1,9,1,3
3,1,10,1,3
3,1,11,1,3
3,1,12,1,3
3,1,13,1,3
3,1,14,1,3
3,1,15,1,3
3,2,0,1,3
3,2,1,1,3
3,2,2,1,3
3,2,3,1,3
3,2,4,1,3
3,2,5,1,3
3,2,6,1,3
3,2,7,1,3
3,2,8,1,3
3,2,9,1,3
3,2,10,1,3
3,2,11,1,3
3,2,12,1,3
3,2,13,1,3
3,2,14,1,3
3,2,15,1,3
3,3,0,1,3
3,3,1,1,3
3,3,2,1,3
3,3,3,1,3
3,3,4,1,3
3,3,5,1,3
3,3,6,1,3
3,3,7,1,3
3,3,8,1,3
3,3,9,1,3
3,3,10,1,3
3,3,11,1,3
3,3,12,1,3
3,3,13,1,3
3,3,14,1,3
3,3,15,1,3
3,4,0,1,3
3,4,1,1,3
3,4,2,1,3
3,4,3,1,3
3,4,4,1,3
3,4,5,1,3
3,4,6,1,3
3,4,7,1,3
3,4,8,1,3
3,4,9,1,3
3,4,10,1,3
3,4,11,1,3
3,4,12,1,3
3,4,13,1,3
3,4,14,1,3
3,4,15,1,3
3,5,0,1,3
3,5,1,1,3
3,5,2,1,3
3,5,3,1,3
3,5,4,1,3
3,5,5,1,3
3,5,6,1,3
3,5,7,1,3
3,5,8,1,3
3,5,9,1,3
3,5,10,1,3
3,5,11,1,3
3,5,12,1,3
3,5,13,1,3
3,5,14,1,3
3,5,15,1,3
3,6,0,1,3
3,6,1,1,3
3,6,2,1,3
3,6,3,1,3
3,6,4,1,3
3,6,5,1,3
3,6,6,1,3
3,6,7,1,3
3,6,8,1,3
3,6,9,1,3
3,6,10,1,3
3,6,11,1,3
3,6,12,1,3
3,6,13,1,3
3,6,14,1,3
3,6,15,1,3
3,7,0,1,3
3,7,1,1,3
3,7,2,1,3
3,7,3,1,3
3,7,4,1,3
3,7,5,1,3
3,7,6,1,3
3,7,7,1,3
3,7,8,1,3
3,7,9,1,3
3,7,10,1,3
3,7,11,1,3
3,7,12,1,3
3,7,13,1,3
3,7,14,1,3
3,7,15,1,3
3,8,0,1,3
3,8,1,1,3
3,8,2,1,3
3,8,3,1,3
3,8,4,1,3
3,8,5,1,3
3,8,6,1,3
3,8,7,1,3
3,8,8,1,3
3,8,9,1,3
3,8,10,1,3
3,8,11,1,3
3,8,12,1,3
3,8,13,1,3
3,8,14,1,3
3,8,15,1,3
3,9,0,1,3
3,9,1,1,3
3,9,2,1,3
3,9,3,1,3
3,9,4,1,3
3,9,5,1,3
3,9,6,1,3
3,9,7,1,3
3,9,8,1,3
3,9,9,1,3
3,9,10,1,3
3,9,11,1,3
3,9,12,1,3
3,9,13,1,3
3,9,14,1,3
3,9,15,1,3
3,10,0,1,3
3,10,1,1,3
3,10,2,1,3
3,10,3,1,3
3,10,4,1,3
3,10,5,1,3
3,10,6,1,3
3,10,7,1,3
3,10,8,1,3
3,10,9,1,3
3,10,10,1,3
3,10,11,1,3
3,10,12,1,3
3,10,13,1,3
3,10,14,1,3
3,10,15,1,3
3,11,0,1,3
3,11,1,1,3
3,11,2,1,3
3,11,3,1,3
3,11,4,1,3
3,11,5,1,3
3,11,6,1,3
3,11,7,1,3
3,11,8,1,3
3,11,9,1,3
3,11,10,1,3
3,11,11,1,3
3,11,12,1,3
3,11,13,1,3
3,11,14,1,3
3,11,15,1,3
3,12,0,1,3
3,12,1,1,3
3,12,2,1,3
3,12,3,1,3
3,12,4,1,3
3,12,5,1,3
3,12,6,1,3
3,12,7,1,3
3,12,8,1,3
3,12,9,1,3
3,12,10,1,3
3,12,11,1,3
3,12,12,1,3
3,12,13,1,3
3,12,14,1,3
3,12,15,1,3
3,13,0,1,3
3,13,1,1,3
3,13,2,1,3
3,13,3,1,3
3,13,4,1,3
3,13,5,1,3
3,13,6,1,3
3,13,7,1,3
3,13,8,1,3
3,13,9,1,3
3,13,10,1,3
3,13,11,1,3
3,13,12,1,3
3,13,13,1,3
3,13,14,1,3
3,13,15,1,3
3,14,0,1,3
3,14,1,1,3
3,14,2,1,3
3,14,3,1,3
3,14,4,1,3
3,14,5,1,3
3,14,6,1,3
3,14,7,1,3
3,14,8,1,3
3,14,9,1,3
3,14,10,1,3
3,14,11,1,3
3,14,12,1,3
3,14,13,1,3
3,14,14,1,3
3,14,15,1,3
3,15,0,1,3
3,15,1,1,3
3,15,2,1,3
3,15,3,1,3
3,15,4,1,3
3,15,5,1,3
3,15,6,1,3
3,15,7,1,3
3,15,8,1,3
3,15,9,1,3
3,15,10,1,3
3,15,11,1,3
3,15,12,1,3
3,15,13,1,3
3,15,14,1,3
3,15,15,1,3
3,16,0,1,3
3,16,1,1,3
3,16,2,1,3
3,16,3,1,3
3,16,4,1,3
3,16,5,1,3
3,16,6,1,3
3,16,7,1,3
3,16,8,1,3
3,16,9,1,3
3,16,10,1,3
3,16,11,1,3
3,16,12,1,3
3,16,13,1,3
3,16,14,1,3
3,16,15,1,3
3,17,0,1,3
3,17,1,1,3
3,17,2,1,3
3,17,3,1,3
3,17,4,1,3
3,17,5,1,3
3,17,6,1,3
3,17,7,1,3
3,17,8,1,3
3,17,9,1,3
3,17,10,1,3
3,17,11,1,3
3,17,12,1,3
3,17,13,1,3
3,17,14,1,3
3,17,15,1,3
3,18,0,1,3
3,18,1,1,3
3,18,2,1,3
3,18,3,1,3
3,18,4,1,3
3,18,5,1,3
3,18,6,1,3
3,18,7,1,3
3,18,8,1,3
3,18,9,1,3
3,18,10,1,3
3,18,11,1,3
3,18,12,1,3
3,18,13,1,3
3,18,14,1,3
3,18,15,1,3
3,19,0,1,3
3,19,1,1,3
3,19,2,1,3
3,19,3,1,3
3,19,4,1,3
3,19,5,1,3
3,19,6,1,3
3,19,7,1,3
3,19,8,1,3
3,19,9,1,3
3,19,10,1,3
3,19,11,1,3
3,19,12,1,3
3,19,13,1,3
3,19,14,1,3
3,19,15,1,3
3,20,0,1,3
3,20,1,1,3
3,20,2,1,3
3,20,3,1,3
3,20,4,1,3
3,20,5,1,3
3,20,6,1,3
3,20,7,1,3
3,20,8,1,3
3,20,9,1,3
3,20,10,1,3
3,20,11,1,3
3,20,12,1,3
3,20,13,1,3
3,20,14,1,3
3,20,15,1,3
3,21,0,1,3
3,21,1,1,3
3,21,2,1,3
3,21,3,1,3
3,21,4,1,3
3,21,5,1,3
3,21,6,1,3
3,21,7,1,3
3,21,8,1,3
3,21,9,1,3
3,21,10,1,3
3,21,11,1,3
3,21,12,1,3
3,21,13,1,3
3,21,14,1,3
3,21,15,1,3
3,22,0,1,3
3,22,1,1,3
3,22,2,1,3
3,22,3,1,3
3,22,4,1,3
3,22,5,1,3
3,22,6,1,3
3,22,7,1,3
3,22,8,1,3
3,22,9,1,3
3,22,10,1,3
3,22,11,1,3
3,22,12,1,3
3,22,13,1,3
3,22,14,1,3
3,22,15,1,3
3,23,0,1,3
3,23,1,1,3
3,23,2,1,3
3,23,3,1,3
3,23,4,1,3
3,23,5,1,3
3,23,6,1,3
3,23,7,1,3
3,23,8,1,3
3,23,9,1,3
3,23,10,1,3
3,23,11,1,3
3,23,12,1,3
3,23,13,1,3
3,23,14,1,3
3,23,15,1,3
3,0,0,2,3
3,0,1,2,3
3,0,2,2,3
3,0,3,2,3
3,0,4,2,3
3,0,5,2,3
3,0,6,2,3
3,0,7,2,3
3,0,8,2,3
3,0,9,2,3
3,0,10,2,3
3,0,11,2,3
3,0,12,2,3
3,0,13,2,3
3,0,14,2,3
3,0,15,2,3
3,1,0,2,3
3,1,1,2,3
3,1,2,2,3
3,1,3,2,3
3,1,4,2,3
3,1,5,2,3
3,1,6,2,3
3,1,7,2,3
3,1,8,2,3
3,1,9,2,3
3,1,10,2,3
3,1,11,2,3
3,1,12,2,3
3,1,13,2,3
3,1,14,2,3
3,1,15,2,3
3,2,0,2,3
3,2,1,2,3
3,2,2,2,3
3,2,3,2,3
3,2,4,2,3
3,2,5,2,3
3,2,6,2,3
3,2,7,2,3
3,2,8,2,3
3,2,9,2,3
3,2,10,2,3
3,2,11,2,3
3,2,12,2,3
3,2,13,2,3
3,2,14,2,3
3,2,15,2,3
3,3,0,2,3
3,3,1,2,3
3,3,2,2,3
3,3,3,2,3
3,3,4,2,3
3,3,5,2,3
3,3,6,2,3
3,3,7,2,3
3,3,8,2,3
3,3,9,2,3
3,3,10,2,3
3,3,11,2,3
3,3,12,2,3
3,3,13,2,3
3,3,14,2,3
3,3,15,2,3
3,4,0,2,3
3,4,1,2,3
3,4,2,2,3
3,4,3,2,3
3,4,4,2,3
3,4,5,2,3
3,4,6,2,3
3,4,7,2,3
3,4,8,2,3
3,4,9,2,3
3,4,10,2,3
3,4,11,2,3
3,4,12,2,3
3,4,13,2,3
3,4,14,2,3
3,4,15,2,3
3,5,0,2,3
3,5,1,2,3
3,5,2,2,3
3,5,3,2,3
3,5,4,2,3
3,5,5,2,3
3,5,6,2,3
3,5,7,2,3
3,5,8,2,3
3,5,9,2,3
3,5,10,2,3
3,5,11,2,3
3,5,12,2,3
3,5,13,2,3
3,5,14,2,3
3,5,15,2,3
3,6,0,2,3
3,6,1,2,3
3,6,2,2,3
3,6,3,2,3
3,6,4,2,3
3,6,5,2,3
3,6,6,2,3
3,6,7,2,3
3,6,8,2,3
3,6,9,2,3
3,6,10,2,3
3,6,11,2,3
3,6,12,2,3
3,6,13,2,3
3,6,14,2,3
3,6,15,2,3
3,7,0,2,3
3,7,1,2,3
3,7,2,2,3
3,7,3,2,3
3,7,4,2,3
3,7,5,2,3
3,7,6,2,3
3,7,7,2,3
3,7,8,2,3
3,7,9,2,3
3,7,10,2,3
3,7,11,2,3
3,7,12,2,3
3,7,13,2,3
3,7,14,2,3
3,7,15,2,3
3,8,0,2,3
3,8,1,2,3
3,8,2,2,3
3,8,3,2,3
3,8,4,2,3
3,8,5,2,3
3,8,6,2,3
3,8,7,2,3
3,8,8,2,3
3,8,9,2,3
3,8,10,2,3
3,8,11,2,3
3,8,12,2,3
3,8,13,2,3
3,8,14,2,3
3,8,15,2,3
3,9,0,2,3
3,9,1,2,3
3,9,2,2,3
3,9,3,2,3
3,9,4,2,3
3,9,5,2,3
3,9,6,2,3
3,9,7,2,3
3,9,8,2,3
3,9,9,2,3
3,9,10,2,3
3,9,11,2,3
3,9,12,2,3
3,9,13,2,3
3,9,14,2,3
3,9,15,2,3
3,10,0,2,3
3,10,1,2,3
3,10,2,2,3
3,10,3,2,3
3,10,4,2,3
3,10,5,2,3
3,10,6,2,3
3,10,7,2,3
3,10,8,2,3
3,10,9,2,3
3,10,10,2,3
3,10,11,2,3
3,10,12,2,3
3,10,13,2,3
3,10,14,2,3
3,10,15,2,3
3,11,0,2,3
3,11,1,2,3
3,11,2,2,3
3,11,3,2,3
3,11,4,2,3
3,11,5,2,3
3,11,6,2,3
3,11,7,2,3
3,11,8,2,3
3,11,9,2,3
3,11,10,2,3
3,11,11,2,3
3,11,12,2,3
3,11,13,2,3
3,11,14,2,3
3,11,15,2,3
3,12,0,2,3
3,12,1,2,3
3,12,2,2,3
3,12,3,2,3
3,12,4,2,3
3,12,5,2,3
3,12,6,2,3
3,12,7,2,3
3,12,8,2,3
3,12,9,2,3
3,12,10,2,3
3,12,11,2,3
3,12,12,2,3
3,12,13,2,3
3,12,14,2,3
3,12,15,2,3
3,13,0,2,3
3,13,1,2,3
3,13,2,2,3
3,13,3,2,3
3,13,4,2,3
3,13,5,2,3
3,13,6,2,3
3,13,7,2,3
3,13,8,2,3
3,13,9,2,3
3,13,10,2,3
3,13,11,2,3
3,13,12,2,3
3,13,13,2,3
3,13,14,2,3
3,13,15,2,3
3,14,0,2,3
3,14,1,2,3
3,14,2,2,3
3,14,3,2,3
3,14,4,2,3
3,14,5,2,3
3,14,6,2,3
3,14,7,2,3
3,14,8,2,3
3,14,9,2,3
3,14,10,2,3
3,14,11,2,3
3,14,12,2,3
3,14,13,2,3
3,14,14,2,3
3,14,15,2,3
3,15,0,2,3
3,15,1,2,3
3,15,2,2,3
3,15,3,2,3
3,15,4,2,3
3,15,5,2,3
3,15,6,2,3
3,15,7,2,3
3,15,8,2,3
3,15,9,2,3
3,15,10,2,3
3,15,11,2,3
3,15,12,2,3
3,15,13,2,3
3,15,14,2,3
3,15,15,2,3
3,16,0,2,3
3,16,1,2,3
3,16,2,2,3
3,16,3,2,3
3,16,4,2,3
3,16,5,2,3
3,16,6,2,3
3,16,7,2,3
3,16,8,2,3
3,16,9,2,3
3,16,10,2,3
3,16,11,2,3
3,16,12,2,3
3,16,13,2,3
3,16,14,2,3
3,16,15,2,3
3,17,0,2,3
3,17,1,2,3
3,17,2,2,3
3,17,3,2,3
3,17,4,2,3
3,17,5,2,3
3,17,6,2,3
3,17,7,2,3
3,17,8,2,3
3,17,9,2,3
3,17,10,2,3
3,17,11,2,3
3,17,12,2,3
3,17,13,2,3
3,17,14,2,3
3,17,15,2,3
3,18,0,2,3
3,18,1,2,3
3,18,2,2,3
3,18,3,2,3
3,18,4,2,3
3,18,5,2,3
3,18,6,2,3
3,18,7,2,3
3,18,8,2,3
3,18,9,2,3
3,18,10,2,3
3,18,11,2,3
3,18,12,2,3
3,18,13,2,3
3,18,14,2,3
3,18,15,2,3
3,19,0,2,3
3,19,1,2,3
3,19,2,2,3
3,19,3,2,3
3,19,4,2,3
3,19,5,2,3
3,19,6,2,3
3,19,7,2,3
3,19,8,2,3
3,19,9,2,3
3,19,10,2,3
3,19,11,2,3
3,19,12,2,3
3,19,13,2,3
3,19,14,2,3
3,19,15,2,3
3,20,0,2,3
3,20,1,2,3
3,20,2,2,3
3,20,3,2,3
3,20,4,2,3
3,20,5,2,3
3,20,6,2,3
3,20,7,2,3
3,20,8,2,3
3,20,9,2,3
3,20,10,2,3
3,20,11,2,3
3,20,12,2,3
3,20,13,2,3
3,20,14,2,3
3,20,15,2,3
3,21,0,2,3
3,21,1,2,3
3,21,2,2,3
3,21,3,2,3
3,21,4,2,3
3,21,5,2,3
3,21,6,2,3
3,21,7,2,3
3,21,8,2,3
3,21,9,2,3
3,21,10,2,3
3,21,11,2,3
3,21,12,2,3
3,21,13,2,3
3,21,14,2,3
3,21,15,2,3
3,22,0,2,3
3,22,1,2,3
3,22,2,2,3
3,22,3,2,3
3,22,4,2,3
3,22,5,2,3
3,22,6,2,3
3,22,7,2,3
3,22,8,2,3
3,22,9,2,3
3,22,10,2,3
3,22,11,2,3
3,22,12,2,3
3,22,13,2,3
3,22,14,2,3
3,22,15,2,3
3,0,0,3,3
3,0,1,3,3
3,0,2,3,3
3,0,3,3,3
3,0,4,3,3
3,0,5,3,3
3,0,6,3,3
3,0,7,3,3
3,0,8,3,3
3,0,9,3,3
3,0,10,3,3
3,0,11,3,3
3,0,12,3,3
3,0,13,3,3
3,0,14,3,3
3,0,15,3,3
3,1,0,3,3
3,1,1,3,3
3,1,2,3,3
3,1,3,3,3
3,1,4,3,3
3,1,5,3,3
3,1,6,3,3
3,1,7,3,3
3,1,8,3,3
3,1,9,3,3
3,1,10,3,3
3,1,11,3,3
3,1,12,3,3
3,1,13,3,3
3,1,14,3,3
3,1,15,3,3
3,2,0,3,3
3,2,1,3,3
3,2,2,3,3
3,2,3,3,3
3,2,4,3,3
3,2,5,3,3
3,2,6,3,3
3,2,7,3,3
3,2,8,3,3
3,2,9,3,3
3,2,10,3,3
3,2,11,3,3
3,2,12,3,3
3,2,13,3,3
3,2,14,3,3
3,2,15,3,3
3,3,0,3,3
3,3,1,3,3
3,3,2,3,3
3,3,3,3,3
3,3,4,3,3
3,3,5,3,3
3,3,6,3,3
3,3,7,3,3
3,3,8,3,3
3,3,9,3,3
3,3,10,3,3
3,3,11,3,3
3,3,12,3,3
3,3,13,3,3
3,3,14,3,3
3,3,15,3,3
3,4,0,3,3
3,4,1,3,3
3,4,2,3,3
3,4,3,3,3
3,4,4,3,3
3,4,5,3,3
3,4,6,3,3
3,4,7,3,3
3,4,8,3,3
3,4,9,3,3
3,4,10,3,3
3,4,11,3,3
3,4,12,3,3
3,4,13,3,3
3,4,14,3,3
3,4,15,3,3
3,5,0,3,3
3,5,1,3,3
3,5,2,3,3
3,5,3,3,3
3,5,4,3,3
3,5,5,3,3
3,5,6,3,3
3,5,7,3,3
3,5,8,3,3
3,5,9,3,3
3,5,10,3,3
3,5,11,3,3
3,5,12,3,3
3,5,13,3,3
3,5,14,3,3
3,5,15,3,3
3,6,0,3,3
3,6,1,3,3
3,6,2,3,3
3,6,3,3,3
3,6,4,3,3
3,6,5,3,3
3,6,6,3,3
3,6,7,3,3
3,6,8,3,3
3,6,9,3,3
3,6,10,3,3
3,6,11,3,3
3,6,12,3,3
3,6,13,3,3
3,6,14,3,3
3,6,15,3,3
3,7,0,3,3
3,7,1,3,3
3,7,2,3,3
3,7,3,3,3
3,7,4,3,3
3,7,5,3,3
3,7,6,3,3
3,7,7,3,3
3,7,8,3,3
3,7,9,3,3
3,7,10,3,3
3,7,11,3,3
3,7,12,3,3
3,7,13,3,3
3,7,14,3,3
3,7,15,3,3
3,8,0,3,3
3,8,1,3,3
3,8,2,3,3
3,8,3,3,3
3,8,4,3,3
3,8,5,3,3
3,8,6,3,3
3,8,7,3,3
3,8,8,3,3
3,8,9,3,3
3,8,10,3,3
3,8,11,3,3
3,8,12,3,3
3,8,13,3,3
3,8,14,3,3
3,8,15,3,3
3,9,0,3,3
3,9,1,3,3
3,9,2,3,3
3,9,3,3,3
3,9,4,3,3
3,9,5,3,3
3,9,6,3,3
3,9,7,3,3
3,9,8,3,3
3,9,9,3,3
3,9,10,3,3
3,9,11,3,3
3,9,12,3,3
3,9,13,3,3
3,9,14,3,3
3,9,15,3,3
3,10,0,3,3
3,10,1,3,3
3,10,2,3,3
3,10,3,3,3
3,10,4,3,3
3,10,5,3,3
3,10,6,3,3
3,10,7,3,3
3,10,8,3,3
3,10,9,3,3
3,10,10,3,3
3,10,11,3,3
3,10,12,3,3
3,10,13,3,3
3,10,14,3,3
3,10,15,3,3
3,11,0,3,3
3,11,1,3,3
3,11,2,3,3
3,11,3,3,3
3,11,4,3,3
3,11,5,3,3
3,11,6,3,3
3,11,7,3,3
3,11,8,3,3
3,11,9,3,3
3,11,10,3,3
3,11,11,3,3
3,11,12,3,3
3,11,13,3,3
3,11,14,3,3
3,11,15,3,3
3,12,0,3,3
3,12,1,3,3
3,12,2,3,3
3,12,3,3,3
3,12,4,3,3
3,12,5,3,3
3,12,6,3,3
3,12,7,3,3
3,12,8,3,3
3,12,9,3,3
3,12,10,3,3
3,12,11,3,3
3,12,12,3,3
3,12,13,3,3
3,12,14,3,3
3,12,15,3,3
3,13,0,3,3
3,13,1,3,3
3,13,2,3,3
3,13,3,3,3
3,13,4,3,3
3,13,5,3,3
3,13,6,3,3
3,13,7,3,3
3,13,8,3,3
3,13,9,3,3
3,13,10,3,3
3,13,11,3,3
3,13,12,3,3
3,13,13,3,3
3,13,14,3,3
3,13,15,3,3
3,14,0,3,3
3,14,1,3,3
3,14,2,3,3
3,14,3,3,3
3,14,4,3,3
3,14,5,3,3
3,14,6,3,3
3,14,7,3,3
3,14,8,3,3
3,14,9,3,3
3,14,10,3,3
3,14,11,3,3
3,14,12,3,3
3,14,13,3,3
3,14,14,3,3
3,14,15,3,3
3,15,0,3,3
3,15,1,3,3
3,15,2,3,3
3,15,3,3,3
3,15,4,3,3
3,15,5,3,3
3,15,6,3,3
3,15,7,3,3
3,15,8,3,3
3,15,9,3,3
3,15,10,3,3
3,15,11,3,3
3,15,12,3,3
3,15,13,3,3
3,15,14,3,3
3,15,15,3,3
3,16,0,3,3
3,16,1,3,3
3,16,2,3,3
3,16,3,3,3
3,16,4,3,3
3,16,5,3,3
3,16,6,3,3
3,16,7,3,3
3,16,8,3,3
3,16,9,3,3
3,16,10,3,3
3,16,11,3,3
3,16,12,3,3
3,16,13,3,3
3,16,14,3,3
3,16,15,3,3
3,17,0,3,3
3,17,1,3,3
3,17,2,3,3
3,17,3,3,3
3,17,4,3,3
3,17,5,3,3
3,17,6,3,3
3,17,7,3,3
3,17,8,3,3
3,17,9,3,3
3,17,10,3,3
3,17,11,3,3
3,17,12,3,3
3,17,13,3,3
3,17,14,3,3
3,17,15,3,3
3,18,0,3,3
3,18,1,3,3
3,18,2,3,3
3,18,3,3,3
3,18,4,3,3
3,18,5,3,3
3,18,6,3,3
3,18,7,3,3
3,18,8,3,3
3,18,9,3,3
3,18,10,3,3
3,18,11,3,3
3,18,12,3,3
3,18,13,3,3
3,18,14,3,3
3,18,15,3,3
3,19,0,3,3
3,19,1,3,3
3,19,2,3,3
3,19,3,3,3
3,19,4,3,3
3,19,5,3,3
3,19,6,3,3
3,19,7,3,3
3,19,8,3,3
3,19,9,3,3
3,19,10,3,3
3,19,11,3,3
3,19,12,3,3
3,19,13,3,3
3,19,14,3,3
3,19,15,3,3
3,20,0,3,3
3,20,1,3,3
3,20,2,3,3
3,20,3,3,3
3,20,4,3,3
3,20,5,3,3
3,20,6,3,3
3,20,7,3,3
3,20,8,3,3
3,20,9,3,3
3,20,10,3,3
3,20,11,3,3
3,20,12,3,3
3,20,13,3,3
3,20,14,3,3
3,20,15,3,3
3,21,0,3,3
3,21,1,3,3
3,21,2,3,3
3,21,3,3,3
3,21,4,3,3
3,21,5,3,3
3,21,6,3,3
3,21,7,3,3
3,21,8,3,3
3,21,9,3,3
3,21,10,3,3
3,21,11,3,3
3,21,12,3,3
3,21,13,3,3
3,21,14,3,3
3,21,15,3,3
3,0,0,4,3
3,0,1,4,3
3,0,2,4,3
3,0,3,4,3
3,0,4,4,3
3,0,5,4,3
3,0,6,4,3
3,0,7,4,3
3,0,8,4,3
3,0,9,4,3
3,0,10,4,3
3,0,11,4,3
3,0,12,4,3
3,0,13,4,3
3,0,14,4,3
3,0,15,4,3
3,1,0,4,3
3,1,1,4,3
3,1,2,4,3
3,1,3,4,3
3,1,4,4,3
3,1,5,4,3
3,1,6,4,3
3,1,7,4,3
3,1,8,4,3
3,1,9,4,3
3,1,10,4,3
3,1,11,4,3
3,1,12,4,3
3,1,13,4,3
3,1,14,4,3
3,1,15,4,3
3,2,0,4,3
3,2,1,4,3
3,2,2,4,3
3,2,3,4,3
3,2,4,4,3
3,2,5,4,3
3,2,6,4,3
3,2,7,4,3
3,2,8,4,3
3,2,9,4,3
3,2,10,4,3
3,2,11,4,3
3,2,12,4,3
3,2,13,4,3
3,2,14,4,3
3,2,15,4,3
3,3,0,4,3
3,3,1,4,3
3,3,2,4,3
3,3,3,4,3
3,3,4,4,3
3,3,5,4,3
3,3,6,4,3
3,3,7,4,3
3,3,8,4,3
3,3,9,4,3
3,3,10,4,3
3,3,11,4,3
3,3,12,4,3
3,3,13,4,3
3,3,14,4,3
3,3,15,4,3
3,4,0,4,3
3,4,1,4,3
3,4,2,4,3
3,4,3,4,3
3,4,4,4,3
3,4,5,4,3
3,4,6,4,3
3,4,7,4,3
3,4,8,4,3
3,4,9,4,3
3,4,10,4,3
3,4,11,4,3
3,4,12,4,3
3,4,13,4,3
3,4,14,4,3
3,4,15,4,3
3,5,0,4,3
3,5,1,4,3
3,5,2,4,3
3,5,3,4,3
3,5,4,4,3
3,5,5,4,3
3,5,6,4,3
3,5,7,4,3
3,5,8,4,3
3,5,9,4,3
3,5,10,4,3
3,5,11,4,3
3,5,12,4,3
3,5,13,4,3
3,5,14,4,3
3,5,15,4,3
3,6,0,4,3
3,6,1,4,3
3,6,2,4,3
3,6,3,4,3
3,6,4,4,3
3,6,5,4,3
3,6,6,4,3
3,6,7,4,3
3,6,8,4,3
3,6,9,4,3
3,6,10,4,3
3,6,11,4,3
3,6,12,4,3
3,6,13,4,3
3,6,14,4,3
3,6,15,4,3
3,7,0,4,3
3,7,1,4,3
3,7,2,4,3
3,7,3,4,3
3,7,4,4,3
3,7,5,4,3
3,7,6,4,3
3,7,7,4,3
3,7,8,4,3
3,7,9,4,3
3,7,10,4,3
3,7,11,4,3
3,7,12,4,3
3,7,13,4,3
3,7,14,4,3
3,7,15,4,3
3,8,0,4,3
3,8,1,4,3
3,8,2,4,3
3,8,3,4,3
3,8,4,4,3
3,8,5,4,3
3,8,6,4,3
3,8,7,4,3
3,8,8,4,3
3,8,9,4,3
3,8,10,4,3
3,8,11,4,3
3,8,12,4,3
3,8,13,4,3
3,8,14,4,3
3,8,15,4,3
3,9,0,4,3
3,9,1,4,3
3,9,2,4,3
3,9,3,4,3
3,9,4,4,3
3,9,5,4,3
3,9,6,4,3
3,9,7,4,3
3,9,8,4,3
3,9,9,4,3
3,9,10,4,3
3,9,11,4,3
3,9,12,4,3
3,9,13,4,3
3,9,14,4,3
3,9,15,4,3
3,10,0,4,3
3,10,1,4,3
3,10,2,4,3
3,10,3,4,3
3,10,4,4,3
3,10,5,4,3
3,10,6,4,3
3,10,7,4,3
3,10,8,4,3
3,10,9,4,3
3,10,10,4,3
3,10,11,4,3
3,10,12,4,3
3,10,13,4,3
3,10,14,4,3
3,10,15,4,3
3,11,0,4,3
3,11,1,4,3
3,11,2,4,3
3,11,3,4,3
3,11,4,4,3
3,11,5,4,3
3,11,6,4,3
3,11,7,4,3
3,11,8,4,3
3,11,9,4,3
3,11,10,4,3
3,11,11,4,3
3,11,12,4,3
3,11,13,4,3
3,11,14,4,3
3,11,15,4,3
3,12,0,4,3
3,12,1,4,3
3,12,2,4,3
3,12,3,4,3
3,12,4,4,3
3,12,5,4,3
3,12,6,4,3
3,12,7,4,3
3,12,8,4,3
3,12,9,4,3
3,12,10,4,3
3,12,11,4,3
3,12,12,4,3
3,12,13,4,3
3,12,14,4,3
3,12,15,4,3
3,13,0,4,3
3,13,1,4,3
3,13,2,4,3
3,13,3,4,3
3,13,4,4,3
3,13,5,4,3
3,13,6,4,3
3,13,7,4,3
3,13,8,4,3
3,13,9,4,3
3,13,10,4,3
3,13,11,4,3
3,13,12,4,3
3,13,13,4,3
3,13,14,4,3
3,13,15,4,3
3,14,0,4,3
3,14,1,4,3
3,14,2,4,3
3,14,3,4,3
3,14,4,4,3
3,14,5,4,3
3,14,6,4,3
3,14,7,4,3
3,14,8,4,3
3,14,9,4,3
3,14,10,4,3
3,14,11,4,3
3,14,12,4,3
3,14,13,4,3
3,14,14,4,3
3,14,15,4,3
3,15,0,4,3
3,15,1,4,3
3,15,2,4,3
3,15,3,4,3
3,15,4,4,3
3,15,5,4,3
3,15,6,4,3
3,15,7,4,3
3,15,8,4,3
3,15,9,4,3
3,15,10,4,3
3,15,11,4,3
3,15,12,4,3
3,15,13,4,3
3,15,14,4,3
3,15,15,4,3
3,16,0,4,3
3,16,1,4,3
3,16,2,4,3
3,16,3,4,3
3,16,4,4,3
3,16,5,4,3
3,16,6,4,3
3,16,7,4,3
3,16,8,4,3
3,16,9,4,3
3,16,10,4,3
3,16,11,4,3
3,16,12,4,3
3,16,13,4,3
3,16,14,4,3
3,16,15,4,3
3,17,0,4,3
3,17,1,4,3
3,17,2,4,3
3,17,3,4,3
3,17,4,4,3
3,17,5,4,3
3,17,6,4,3
3,17,7,4,3
3,17,8,4,3
3,17,9,4,3
3,17,10,4,3
3,17,11,4,3
3,17,12,4,3
3,17,13,4,3
3,17,14,4,3
3,17,15,4,3
3,18,0,4,3
3,18,1,4,3
3,18,2,4,3
3,18,3,4,3
3,18,4,4,3
3,18,5,4,3
3,18,6,4,3
3,18,7,4,3
3,18,8,4,3
3,18,9,4,3
3,18,10,4,3
3,18,11,4,3
3,18,12,4,3
3,18,13,4,3
3,18,14,4,3
3,18,15,4,3
3,19,0,4,3
3,19,1,4,3
3,19,2,4,3
3,19,3,4,3
3,19,4,4,3
3,19,5,4,3
3,19,6,4,3
3,19,7,4,3
3,19,8,4,3
3,19,9,4,3
3,19,10,4,3
3,19,11,4,3
3,19,12,4,3
3,19,13,4,3
3,19,14,4,3
3,19,15,4,3
3,20,0,4,3
3,20,1,4,3
3,20,2,4,3
3,20,3,4,3
3,20,4,4,3
3,20,5,4,3
3,20,6,4,3
3,20,7,4,3
3,20,8,4,3
3,20,9,4,3
3,20,10,4,3
3,20,11,4,3
3,20,12,4,3
3,20,13,4,3
3,20,14,4,3
3,20,15,4,3
3,0,0,5,3
3,0,1,5,3
3,0,2,5,3
3,0,3,5,3
3,0,4,5,3
3,0,5,5,3
3,0,6,5,3
3,0,7,5,3
3,0,8,5,3
3,0,9,5,3
3,0,10,5,3
3,0,11,5,3
3,0,12,5,3
3,0,13,5,3
3,0,14,5,3
3,0,15,5,3
3,1,0,5,3
3,1,1,5,3
3,1,2,5,3
3,1,3,5,3
3,1,4,5,3
3,1,5,5,3
3,1,6,5,3
3,1,7,5,3
3,1,8,5,3
3,1,9,5,3
3,1,10,5,3
3,1,11,5,3
3,1,12,5,3
3,1,13,5,3
3,1,14,5,3
3,1,15,5,3
3,2,0,5,3
3,2,1,5,3
3,2,2,5,3
3,2,3,5,3
3,2,4,5,3
3,2,5,5,3
3,2,6,5,3
3,2,7,5,3
3,2,8,5,3
3,2,9,5,3
3,2,10,5,3
3,2,11,5,3
3,2,12,5,3
3,2,13,5,3
3,2,14,5,3
3,2,15,5,3
3,3,0,5,3
3,3,1,5,3
3,3,2,5,3
3,3,3,5,3
3,3,4,5,3
3,3,5,5,3
3,3,6,5,3
3,3,7,5,3
3,3,8,5,3
3,3,9,5,3
3,3,10,5,3
3,3,11,5,3
3,3,12,5,3
3,3,13,5,3
3,3,14,5,3
3,3,15,5,3
3,4,0,5,3
3,4,1,5,3
3,4,2,5,3
3,4,3,5,3
3,4,4,5,3
3,4,5,5,3
3,4,6,5,3
3,4,7,5,3
3,4,8,5,3
3,4,9,5,3
3,4,10,5,3
3,4,11,5,3
3,4,12,5,3
3,4,13,5,3
3,4,14,5,3
3,4,15,5,3
3,5,0,5,3
3,5,1,5,3
3,5,2,5,3
3,5,3,5,3
3,5,4,5,3
3,5,5,5,3
3,5,6,5,3
3,5,7,5,3
3,5,8,5,3
3,5,9,5,3
3,5,10,5,3
3,5,11,5,3
3,5,12,5,3
3,5,13,5,3
3,5,14,5,3
3,5,15,5,3
3,6,0,5,3
3,6,1,5,3
3,6,2,5,3
3,6,3,5,3
3,6,4,5,3
3,6,5,5,3
3,6,6,5,3
3,6,7,5,3
3,6,8,5,3
3,6,9,5,3
3,6,10,5,3
3,6,11,5,3
3,6,12,5,3
3,6,13,5,3
3,6,14,5,3
3,6,15,5,3
3,7,0,5,3
3,7,1,5,3
3,7,2,5,3
3,7,3,5,3
3,7,4,5,3
3,7,5,5,3
3,7,6,5,3
3,7,7,5,3
3,7,8,5,3
3,7,9,5,3
3,7,10,5,3
3,7,11,5,3
3,7,12,5,3
3,7,13,5,3
3,7,14,5,3
3,7,15,5,3
3,8,0,5,3
3,8,1,5,3
3,8,2,5,3
3,8,3,5,3
3,8,4,5,3
3,8,5,5,3
3,8,6,5,3
3,8,7,5,3
3,8,8,5,3
3,8,9,5,3
3,8,10,5,3
3,8,11,5,3
3,8,12,5,3
3,8,13,5,3
3,8,14,5,3
3,8,15,5,3
3,9,0,5,3
3,9,1,5,3
3,9,2,5,3
3,9,3,5,3
3,9,4,5,3
3,9,5,5,3
3,9,6,5,3
3,9,7,5,3
3,9,8,5,3
3,9,9,5,3
3,9,10,5,3
3,9,11,5,3
3,9,12,5,3
3,9,13,5,3
3,9,14,5,3
3,9,15,5,3
3,10,0,5,3
3,10,1,5,3
3,10,2,5,3
3,10,3,5,3
3,10,4,5,3
3,10,5,5,3
3,10,6,5,3
3,10,7,5,3
3,10,8,5,3
3,10,9,5,3
3,10,10,5,3
3,10,11,5,3
3,10,12,5,3
3,10,13,5,3
3,10,14,5,3
3,10,15,5,3
3,11,0,5,3
3,11,1,5,3
3,11,2,5,3
3,11,3,5,3
3,11,4,5,3
3,11,5,5,3
3,11,6,5,3
3,11,7,5,3
3,11,8,5,3
3,11,9,5,3
3,11,10,5,3
3,11,11,5,3
3,11,12,5,3
3,11,13,5,3
3,11,14,5,3
3,11,15,5,3
3,12,0,5,3
3,12,1,5,3
3,12,2,5,3
3,12,3,5,3
3,12,4,5,3
3,12,5,5,3
3,12,6,5,3
3,12,7,5,3
3,12,8,5,3
3,12,9,5,3
3,12,10,5,3
3,12,11,5,3
3,12,12,5,3
3,12,13,5,3
3,12,14,5,3
3,12,15,5,3
3,13,0,5,3
3,13,1,5,3
3,13,2,5,3
3,13,3,5,3
3,13,4,5,3
3,13,5,5,3
3,13,6,5,3
3,13,7,5,3
3,13,8,5,3
3,13,9,5,3
3,13,10,5,3
3,13,11,5,3
3,13,12,5,3
3,13,13,5,3
3,13,14,5,3
3,13,15,5,3
3,14,0,5,3
3,14,1,5,3
3,14,2,5,3
3,14,3,5,3
3,14,4,5,3
3,14,5,5,3
3,14,6,5,3
3,14,7,5,3
3,14,8,5,3
3,14,9,5,3
3,14,10,5,3
3,14,11,5,3
3,14,12,5,3
3,14,13,5,3
3,14,14,5,3
3,14,15,5,3
3,15,0,5,3
3,15,1,5,3
3,15,2,5,3
3,15,3,5,3
3,15,4,5,3
3,15,5,5,3
3,15,6,5,3
3,15,7,5,3
3,15,8,5,3
3,15,9,5,3
3,15,10,5,3
3,15,11,5,3
3,15,12,5,3
3,15,13,5,3
3,15,14,5,3
3,15,15,5,3
3,16,0,5,3
3,16,1,5,3
3,16,2,5,3
3,16,3,5,3
3,16,4,5,3
3,16,5,5,3
3,16,6,5,3
3,16,7,5,3
3,16,8,5,3
3,16,9,5,3
3,16,10,5,3
3,16,11,5,3
3,16,12,5,3
3,16,13,5,3
3,16,14,5,3
3,16,15,5,3
3,17,0,5,3
3,17,1,5,3
3,17,2,5,3
3,17,3,5,3
3,17,4,5,3
3,17,5,5,3
3,17,6,5,3
3,17,7,5,3
3,17,8,5,3
3,17,9,5,3
3,17,10,5,3
3,17,11,5,3
3,17,12,5,3
3,17,13,5,3
3,17,14,5,3
3,17,15,5,3
3,18,0,5,3
3,18,1,5,3
3,18,2,5,3
3,18,3,5,3
3,18,4,5,3
3,18,5,5,3
3,18,6,5,3
3,18,7,5,3
3,18,8,5,3
3,18,9,5,3
3,18,10,5,3
3,18,11,5,3
3,18,12,5,3
3,18,13,5,3
3,18,14,5,3
3,18,15,5,3
3,19,0,5,3
3,19,1,5,3
3,19,2,5,3
3,19,3,5,3
3,19,4,5,3
3,19,5,5,3
3,19,6,5,3
3,19,7,5,3
3,19,8,5,3
3,19,9,5,3
3,19,10,5,3
3,19,11,5,3
3,19,12,5,3
3,19,13,5,3
3,19,14,5,3
3,19,15,5,3
3,0,0,6,3
3,0,1,6,3
3,0,2,6,3
3,0,3,6,3
3,0,4,6,3
3,0,5,6,3
3,0,6,6,3
3,0,7,6,3
3,0,8,6,3
3,0,9,6,3
3,0,10,6,3
3,0,11,6,3
3,0,12,6,3
3,0,13,6,3
3,0,14,6,3
3,0,15,6,3
3,1,0,6,3
3,1,1,6,3
3,1,2,6,3
3,1,3,6,3
3,1,4,6,3
3,1,5,6,3
3,1,6,6,3
3,1,7,6,3
3,1,8,6,3
3,1,9,6,3
3,1,10,6,3
3,1,11,6,3
3,1,12,6,3
3,1,13,6,3
3,1,14,6,3
3,1,15,6,3
3,2,0,6,3
3,2,1,6,3
3,2,2,6,3
3,2,3,6,3
3,2,4,6,3
3,2,5,6,3
3,2,6,6,3
3,2,7,6,3
3,2,8,6,3
3,2,9,6,3
3,2,10,6,3
3,2,11,6,3
3,2,12,6,3
3,2,13,6,3
3,2,14,6,3
3,2,15,6,3
3,3,0,6,3
3,3,1,6,3
3,3,2,6,3
3,3,3,6,3
3,3,4,6,3
3,3,5,6,3
3,3,6,6,3
3,3,7,6,3
3,3,8,6,3
3,3,9,6,3
3,3,10,6,3
3,3,11,6,3
3,3,12,6,3
3,3,13,6,3
3,3,14,6,3
3,3,15,6,3
3,4,0,6,3
3,4,1,6,3
3,4,2,6,3
3,4,3,6,3
3,4,4,6,3
3,4,5,6,3
3,4,6,6,3
3,4,7,6,3
3,4,8,6,3
3,4,9,6,3
3,4,10,6,3
3,4,11,6,3
3,4,12,6,3
3,4,13,6,3
3,4,14,6,3
3,4,15,6,3
3,5,0,6,3
3,5,1,6,3
3,5,2,6,3
3,5,3,6,3
3,5,4,6,3
3,5,5,6,3
3,5,6,6,3
3,5,7,6,3
3,5,8,6,3
3,5,9,6,3
3,5,10,6,3
3,5,11,6,3
3,5,12,6,3
3,5,13,6,3
3,5,14,6,3
3,5,15,6,3
3,6,0,6,3
3,6,1,6,3
3,6,2,6,3
3,6,3,6,3
3,6,4,6,3
3,6,5,6,3
3,6,6,6,3
3,6,7,6,3
3,6,8,6,3
3,6,9,6,3
3,6,10,6,3
3,6,11,6,3
3,6,12,6,3
3,6,13,6,3
3,6,14,6,3
3,6,15,6,3
3,7,0,6,3
3,7,1,6,3
3,7,2,6,3
3,7,3,6,3
3,7,4,6,3
3,7,5,6,3
3,7,6,6,3
3,7,7,6,3
3,7,8,6,3
3,7,9,6,3
3,7,10,6,3
3,7,11,6,3
3,7,12,6,3
3,7,13,6,3
3,7,14,6,3
3,7,15,6,3
3,8,0,6,3
3,8,1,6,3
3,8,2,6,3
3,8,3,6,3
3,8,4,6,3
3,8,5,6,3
3,8,6,6,3
3,8,7,6,3
3,8,8,6,3
3,8,9,6,3
3,8,10,6,3
3,8,11,6,3
3,8,12,6,3
3,8,13,6,3
3,8,14,6,3
3,8,15,6,3
3,9,0,6,3
3,9,1,6,3
3,9,2,6,3
3,9,3,6,3
3,9,4,6,3
3,9,5,6,3
3,9,6,6,3
3,9,7,6,3
3,9,8,6,3
3,9,9,6,3
3,9,10,6,3
3,9,11,6,3
3,9,12,6,3
3,9,13,6,3
3,9,14,6,3
3,9,15,6,3
3,10,0,6,3
3,10,1,6,3
3,10,2,6,3
3,10,3,6,3
3,10,4,6,3
3,10,5,6,3
3,10,6,6,3
3,10,7,6,3
3,10,8,6,3
3,10,9,6,3
3,10,10,6,3
3,10,11,6,3
3,10,12,6,3
3,10,13,6,3
3,10,14,6,3
3,10,15,6,3
3,11,0,6,3
3,11,1,6,3
3,11,2,6,3
3,11,3,6,3
3,11,4,6,3
3,11,5,6,3
3,11,6,6,3
3,11,7,6,3
3,11,8,6,3
3,11,9,6,3
3,11,10,6,3
3,11,11,6,3
3,11,12,6,3
3,11,13,6,3
3,11,14,6,3
3,11,15,6,3
3,12,0,6,3
3,12,1,6,3
3,12,2,6,3
3,12,3,6,3
3,12,4,6,3
3,12,5,6,3
3,12,6,6,3
3,12,7,6,3
3,12,8,6,3
3,12,9,6,3
3,12,10,6,3
3,12,11,6,3
3,12,12,6,3
3,12,13,6,3
3,12,14,6,3
3,12,15,6,3
3,13,0,6,3
3,13,1,6,3
3,13,2,6,3
3,13,3,6,3
3,13,4,6,3
3,13,5,6,3
3,13,6,6,3
3,13,7,6,3
3,13,8,6,3
3,13,9,6,3
3,13,10,6,3
3,13,11,6,3
3,13,12,6,3
3,13,13,6,3
3,13,14,6,3
3,13,15,6,3
3,14,0,6,3
3,14,1,6,3
3,14,2,6,3
3,14,3,6,3
3,14,4,6,3
3,14,5,6,3
3,14,6,6,3
3,14,7,6,3
3,14,8,6,3
3,14,9,6,3
3,14,10,6,3
3,14,11,6,3
3,14,12,6,3
3,14,13,6,3
3,14,14,6,3
3,14,15,6,3
3,15,0,6,3
3,15,1,6,3
3,15,2,6,3
3,15,3,6,3
3,15,4,6,3
3,15,5,6,3
3,15,6,6,3
3,15,7,6,3
3,15,8,6,3
3,15,9,6,3
3,15,10,6,3
3,15,11,6,3
3,15,12,6,3
3,15,13,6,3
3,15,14,6,3
3,15,15,6,3
3,16,0,6,3
3,16,1,6,3
3,16,2,6,3
3,16,3,6,3
3,16,4,6,3
3,16,5,6,3
3,16,6,6,3
3,16,7,6,3
3,16,8,6,3
3,16,9,6,3
3,16,10,6,3
3,16,11,6,3
3,16,12,6,3
3,16,13,6,3
3,16,14,6,3
3,16,15,6,3
3,17,0,6,3
3,17,1,6,3
3,17,2,6,3
3,17,3,6,3
3,17,4,6,3
3,17,5,6,3
3,17,6,6,3
3,17,7,6,3
3,17,8,6,3
3,17,9,6,3
3,17,10,6,3
3,17,11,6,3
3,17,12,6,3
3,17,13,6,3
3,17,14,6,3
3,17,15,6,3
3,18,0,6,3
3,18,1,6,3
3,18,2,6,3
3,18,3,6,3
3,18,4,6,3
3,18,5,6,3
3,18,6,6,3
3,18,7,6,3
3,18,8,6,3
3,18,9,6,3
3,18,10,6,3
3,18,11,6,3
3,18,12,6,3
3,18,13,6,3
3,18,14,6,3
3,18,15,6,3
3,0,0,7,3
3,0,1,7,3
3,0,2,7,3
3,0,3,7,3
3,0,4,7,3
3,0,5,7,3
3,0,6,7,3
3,0,7,7,3
3,0,8,7,3
3,0,9,7,3
3,0,10,7,3
3,0,11,7,3
3,0,12,7,3
3,0,13,7,3
3,0,14,7,3
3,0,15,7,3
3,1,0,7,3
3,1,1,7,3
3,1,2,7,3
3,1,3,7,3
3,1,4,7,3
3,1,5,7,3
3,1,6,7,3
3,1,7,7,3
3,1,8,7,3
3,1,9,7,3
3,1,10,7,3
3,1,11,7,3
3,1,12,7,3
3,1,13,7,3
3,1,14,7,3
3,1,15,7,3
3,2,0,7,3
3,2,1,7,3
3,2,2,7,3
3,2,3,7,3
3,2,4,7,3
3,2,5,7,3
3,2,6,7,3
3,2,7,7,3
3,2,8,7,3
3,2,9,7,3
3,2,10,7,3
3,2,11,7,3
3,2,12,7,3
3,2,13,7,3
3,2,14,7,3
3,2,15,7,3
3,3,0,7,3
3,3,1,7,3
3,3,2,7,3
3,3,3,7,3
3,3,4,7,3
3,3,5,7,3
3,3,6,7,3
3,3,7,7,3
3,3,8,7,3
3,3,9,7,3
3,3,10,7,3
3,3,11,7,3
3,3,12,7,3
3,3,13,7,3
3,3,14,7,3
3,3,15,7,3
3,4,0,7,3
3,4,1,7,3
3,4,2,7,3
3,4,3,7,3
3,4,4,7,3
3,4,5,7,3
3,4,6,7,3
3,4,7,7,3
3,4,8,7,3
3,4,9,7,3
3,4,10,7,3
3,4,11,7,3
3,4,12,7,3
3,4,13,7,3
3,4,14,7,3
3,4,15,7,3
3,5,0,7,3
3,5,1,7,3
3,5,2,7,3
3,5,3,7,3
3,5,4,7,3
3,5,5,7,3
3,5,6,7,3
3,5,7,7,3
3,5,8,7,3
3,5,9,7,3
3,5,10,7,3
3,5,11,7,3
3,5,12,7,3
3,5,13,7,3
3,5,14,7,3
3,5,15,7,3
3,6,0,7,3
3,6,1,7,3
3,6,2,7,3
3,6,3,7,3
3,6,4,7,3
3,6,5,7,3
3,6,6,7,3
3,6,7,7,3
3,6,8,7,3
3,6,9,7,3
3,6,10,7,3
3,6,11,7,3
3,6,12,7,3
3,6,13,7,3
3,6,14,7,3
3,6,15,7,3
3,7,0,7,3
3,7,1,7,3
3,7,2,7,3
3,7,3,7,3
3,7,4,7,3
3,7,5,7,3
3,7,6,7,3
3,7,7,7,3
3,7,8,7,3
3,7,9,7,3
3,7,10,7,3
3,7,11,7,3
3,7,12,7,3
3,7,13,7,3
3,7,14,7,3
3,7,15,7,3
3,8,0,7,3
3,8,1,7,3
3,8,2,7,3
3,8,3,7,3
3,8,4,7,3
3,8,5,7,3
3,8,6,7,3
3,8,7,7,3
3,8,8,7,3
3,8,9,7,3
3,8,10,7,3
3,8,11,7,3
3,8,12,7,3
3,8,13,7,3
3,8,14,7,3
3,8,15,7,3
3,9,0,7,3
3,9,1,7,3
3,9,2,7,3
3,9,3,7,3
3,9,4,7,3
3,9,5,7,3
3,9,6,7,3
3,9,7,7,3
3,9,8,7,3
3,9,9,7,3
3,9,10,7,3
3,9,11,7,3
3,9,12,7,3
3,9,13,7,3
3,9,14,7,3
3,9,15,7,3
3,10,0,7,3
3,10,1,7,3
3,10,2,7,3
3,10,3,7,3
3,10,4,7,3
3,10,5,7,3
3,10,6,7,3
3,10,7,7,3
3,10,8,7,3
3,10,9,7,3
3,10,10,7,3
3,10,11,7,3
3,10,12,7,3
3,10,13,7,3
3,10,14,7,3
3,10,15,7,3
3,11,0,7,3
3,11,1,7,3
3,11,2,7,3
3,11,3,7,3
3,11,4,7,3
3,11,5,7,3
3,11,6,7,3
3,11,7,7,3
3,11,8,7,3
3,11,9,7,3
3,11,10,7,3
3,11,11,7,3
3,11,12,7,3
3,11,13,7,3
3,11,14,7,3
3,11,15,7,3
3,12,0,7,3
3,12,1,7,3
3,12,2,7,3
3,12,3,7,3
3,12,4,7,3
3,12,5,7,3
3,12,6,7,3
3,12,7,7,3
3,12,8,7,3
3,12,9,7,3
3,12,10,7,3
3,12,11,7,3
3,12,12,7,3
3,12,13,7,3
3,12,14,7,3
3,12,15,7,3
3,13,0,7,3
3,13,1,7,3
3,13,2,7,3
3,13,3,7,3
3,13,4,7,3
3,13,5,7,3
3,13,6,7,3
3,13,7,7,3
3,13,8,7,3
3,13,9,7,3
3,13,10,7,3
3,13,11,7,3
3,13,12,7,3
3,13,13,7,3
3,13,14,7,3
3,13,15,7,3
3,14,0,7,3
3,14,1,7,3
3,14,2,7,3
3,14,3,7,3
3,14,4,7,3
3,14,5,7,3
3,14,6,7,3
3,14,7,7,3
3,14,8,7,3
3,14,9,7,3
3,14,10,7,3
3,14,11,7,3
3,14,12,7,3
3,14,13,7,3
3,14,14,7,3
3,14,15,7,3
3,15,0,7,3
3,15,1,7,3
3,15,2,7,3
3,15,3,7,3
3,15,4,7,3
3,15,5,7,3
3,15,6,7,3
3,15,7,7,3
3,15,8,7,3
3,15,9,7,3
3,15,10,7,3
3,15,11,7,3
3,15,12,7,3
3,15,13,7,3
3,15,14,7,3
3,15,15,7,3
3,16,0,7,3
3,16,1,7,3
3,16,2,7,3
3,16,3,7,3
3,16,4,7,3
3,16,5,7,3
3,16,6,7,3
3,16,7,7,3
3,16,8,7,3
3,16,9,7,3
3,16,10,7,3
3,16,11,7,3
3,16,12,7,3
3,16,13,7,3
3,16,14,7,3
3,16,15,7,3
3,17,0,7,3
3,17,1,7,3
3,17,2,7,3
3,17,3,7,3
3,17,4,7,3
3,17,5,7,3
3,17,6,7,3
3,17,7,7,3
3,17,8,7,3
3,17,9,7,3
3,17,10,7,3
3,17,11,7,3
3,17,12,7,3
3,17,13,7,3
3,17,14,7,3
3,17,15,7,3
3,0,0,8,3
3,0,1,8,3
3,0,2,8,3
3,0,3,8,3
3,0,4,8,3
3,0,5,8,3
3,0,6,8,3
3,0,7,8,3
3,0,8,8,3
3,0,9,8,3
3,0,10,8,3
3,0,11,8,3
3,0,12,8,3
3,0,13,8,3
3,0,14,8,3
3,0,15,8,3
3,1,0,8,3
3,1,1,8,3
3,1,2,8,3
3,1,3,8,3
3,1,4,8,3
3,1,5,8,3
3,1,6,8,3
3,1,7,8,3
3,1,8,8,3
3,1,9,8,3
3,1,10,8,3
3,1,11,8,3
3,1,12,8,3
3,1,13,8,3
3,1,14,8,3
3,1,15,8,3
3,2,0,8,3
3,2,1,8,3
3,2,2,8,3
3,2,3,8,3
3,2,4,8,3
3,2,5,8,3
3,2,6,8,3
3,2,7,8,3
3,2,8,8,3
3,2,9,8,3
3,2,10,8,3
3,2,11,8,3
3,2,12,8,3
3,2,13,8,3
3,2,14,8,3
3,2,15,8,3
3,3,0,8,3
3,3,1,8,3
3,3,2,8,3
3,3,3,8,3
3,3,4,8,3
3,3,5,8,3
3,3,6,8,3
3,3,7,8,3
3,3,8,8,3
3,3,9,8,3
3,3,10,8,3
3,3,11,8,3
3,3,12,8,3
3,3,13,8,3
3,3,14,8,3
3,3,15,8,3
3,4,0,8,3
3,4,1,8,3
3,4,2,8,3
3,4,3,8,3
3,4,4,8,3
3,4,5,8,3
3,4,6,8,3
3,4,7,8,3
3,4,8,8,3
3,4,9,8,3
3,4,10,8,3
3,4,11,8,3
3,4,12,8,3
3,4,13,8,3
3,4,14,8,3
3,4,15,8,3
3,5,0,8,3
3,5,1,8,3
3,5,2,8,3
3,5,3,8,3
3,5,4,8,3
3,5,5,8,3
3,5,6,8,3
3,5,7,8,3
3,5,8,8,3
3,5,9,8,3
3,5,10,8,3
3,5,11,8,3
3,5,12,8,3
3,5,13,8,3
3,5,14,8,3
3,5,15,8,3
3,6,0,8,3
3,6,1,8,3
3,6,2,8,3
3,6,3,8,3
3,6,4,8,3
3,6,5,8,3
3,6,6,8,3
3,6,7,8,3
3,6,8,8,3
3,6,9,8,3
3,6,10,8,3
3,6,11,8,3
3,6,12,8,3
3,6,13,8,3
3,6,14,8,3
3,6,15,8,3
3,7,0,8,3
3,7,1,8,3
3,7,2,8,3
3,7,3,8,3
3,7,4,8,3
3,7,5,8,3
3,7,6,8,3
3,7,7,8,3
3,7,8,8,3
3,7,9,8,3
3,7,10,8,3
3,7,11,8,3
3,7,12,8,3
3,7,13,8,3
3,7,14,8,3
3,7,15,8,3
3,8,0,8,3
3,8,1,8,3
3,8,2,8,3
3,8,3,8,3
3,8,4,8,3
3,8,5,8,3
3,8,6,8,3
3,8,7,8,3
3,8,8,8,3
3,8,9,8,3
3,8,10,8,3
3,8,11,8,3
3,8,12,8,3
3,8,13,8,3
3,8,14,8,3
3,8,15,8,3
3,9,0,8,3
3,9,1,8,3
3,9,2,8,3
3,9,3,8,3
3,9,4,8,3
3,9,5,8,3
3,9,6,8,3
3,9,7,8,3
3,9,8,8,3
3,9,9,8,3
3,9,10,8,3
3,9,11,8,3
3,9,12,8,3
3,9,13,8,3
3,9,14,8,3
3,9,15,8,3
3,10,0,8,3
3,10,1,8,3
3,10,2,8,3
3,10,3,8,3
3,10,4,8,3
3,10,5,8,3
3,10,6,8,3
3,10,7,8,3
3,10,8,8,3
3,10,9,8,3
3,10,10,8,3
3,10,11,8,3
3,10,12,8,3
3,10,13,8,3
3,10,14,8,3
3,10,15,8,3
3,11,0,8,3
3,11,1,8,3
3,11,2,8,3
3,11,3,8,3
3,11,4,8,3
3,11,5,8,3
3,11,6,8,3
3,11,7,8,3
3,11,8,8,3
3,11,9,8,3
3,11,10,8,3
3,11,11,8,3
3,11,12,8,3
3,11,13,8,3
3,11,14,8,3
3,11,15,8,3
3,12,0,8,3
3,12,1,8,3
3,12,2,8,3
3,12,3,8,3
3,12,4,8,3
3,12,5,8,3
3,12,6,8,3
3,12,7,8,3
3,12,8,8,3
3,12,9,8,3
3,12,10,8,3
3,12,11,8,3
3,12,12,8,3
3,12,13,8,3
3,12,14,8,3
3,12,15,8,3
3,13,0,8,3
3,13,1,8,3
3,13,2,8,3
3,13,3,8,3
3,13,4,8,3
3,13,5,8,3
3,13,6,8,3
3,13,7,8,3
3,13,8,8,3
3,13,9,8,3
3,13,10,8,3
3,13,11,8,3
3,13,12,8,3
3,13,13,8,3
3,13,14,8,3
3,13,15,8,3
3,14,0,8,3
3,14,1,8,3
3,14,2,8,3
3,14,3,8,3
3,14,4,8,3
3,14,5,8,3
3,14,6,8,3
3,14,7,8,3
3,14,8,8,3
3,14,9,8,3
3,14,10,8,3
3,14,11,8,3
3,14,12,8,3
3,14,13,8,3
3,14,14,8,3
3,14,15,8,3
3,15,0,8,3
3,15,1,8,3
3,15,2,8,3
3,15,3,8,3
3,15,4,8,3
3,15,5,8,3
3,15,6,8,3
3,15,7,8,3
3,15,8,8,3
3,15,9,8,3
3,15,10,8,3
3,15,11,8,3
3,15,12,8,3
3,15,13,8,3
3,15,14,8,3
3,15,15,8,3
3,16,0,8,3
3,16,1,8,3
3,16,2,8,3
3,16,3,8,3
3,16,4,8,3
3,16,5,8,3
3,16,6,8,3
3,16,7,8,3
3,16,8,8,3
3,16,9,8,3
3,16,10,8,3
3,16,11,8,3
3,16,12,8,3
3,16,13,8,3
3,16,14,8,3
3,16,15,8,3
3,0,0,9,3
3,0,1,9,3
3,0,2,9,3
3,0,3,9,3
3,0,4,9,3
3,0,5,9,3
3,0,6,9,3
3,0,7,9,3
3,0,8,9,3
3,0,9,9,3
3,0,10,9,3
3,0,11,9,3
3,0,12,9,3
3,0,13,9,3
3,0,14,9,3
3,0,15,9,3
3,1,0,9,3
3,1,1,9,3
3,1,2,9,3
3,1,3,9,3
3,1,4,9,3
3,1,5,9,3
3,1,6,9,3
3,1,7,9,3
3,1,8,9,3
3,1,9,9,3
3,1,10,9,3
3,1,11,9,3
3,1,12,9,3
3,1,13,9,3
3,1,14,9,3
3,1,15,9,3
3,2,0,9,3
3,2,1,9,3
3,2,2,9,3
3,2,3,9,3
3,2,4,9,3
3,2,5,9,3
3,2,6,9,3
3,2,7,9,3
3,2,8,9,3
3,2,9,9,3
3,2,10,9,3
3,2,11,9,3
3,2,12,9,3
3,2,13,9,3
3,2,14,9,3
3,2,15,9,3
3,3,0,9,3
3,3,1,9,3
3,3,2,9,3
3,3,3,9,3
3,3,4,9,3
3,3,5,9,3
3,3,6,9,3
3,3,7,9,3
3,3,8,9,3
3,3,9,9,3
3,3,10,9,3
3,3,11,9,3
3,3,12,9,3
3,3,13,9,3
3,3,14,9,3
3,3,15,9,3
3,4,0,9,3
3,4,1,9,3
3,4,2,9,3
3,4,3,9,3
3,4,4,9,3
3,4,5,9,3
3,4,6,9,3
3,4,7,9,3
3,4,8,9,3
3,4,9,9,3
3,4,10,9,3
3,4,11,9,3
3,4,12,9,3
3,4,13,9,3
3,4,14,9,3
3,4,15,9,3
3,5,0,9,3
3,5,1,9,3
3,5,2,9,3
3,5,3,9,3
3,5,4,9,3
3,5,5,9,3
3,5,6,9,3
3,5,7,9,3
3,5,8,9,3
3,5,9,9,3
3,5,10,9,3
3,5,11,9,3
3,5,12,9,3
3,5,13,9,3
3,5,14,9,3
3,5,15,9,3
3,6,0,9,3
3,6,1,9,3
3,6,2,9,3
3,6,3,9,3
3,6,4,9,3
3,6,5,9,3
3,6,6,9,3
3,6,7,9,3
3,6,8,9,3
3,6,9,9,3
3,6,10,9,3
3,6,11,9,3
3,6,12,9,3
3,6,13,9,3
3,6,14,9,3
3,6,15,9,3
3,7,0,9,3
3,7,1,9,3
3,7,2,9,3
3,7,3,9,3
3,7,4,9,3
3,7,5,9,3
3,7,6,9,3
3,7,7,9,3
3,7,8,9,3
3,7,9,9,3
3,7,10,9,3
3,7,11,9,3
3,7,12,9,3
3,7,13,9,3
3,7,14,9,3
3,7,15,9,3
3,8,0,9,3
3,8,1,9,3
3,8,2,9,3
3,8,3,9,3
3,8,4,9,3
3,8,5,9,3
3,8,6,9,3
3,8,7,9,3
3,8,8,9,3
3,8,9,9,3
3,8,10,9,3
3,8,11,9,3
3,8,12,9,3
3,8,13,9,3
3,8,14,9,3
3,8,15,9,3
3,9,0,9,3
3,9,1,9,3
3,9,2,9,3
3,9,3,9,3
3,9,4,9,3
3,9,5,9,3
3,9,6,9,3
3,9,7,9,3
3,9,8,9,3
3,9,9,9,3
3,9,10,9,3
3,9,11,9,3
3,9,12,9,3
3,9,13,9,3
3,9,14,9,3
3,9,15,9,3
3,10,0,9,3
3,10,1,9,3
3,10,2,9,3
3,10,3,9,3
3,10,4,9,3
3,10,5,9,3
3,10,6,9,3
3,10,7,9,3
3,10,8,9,3
3,10,9,9,3
3,10,10,9,3
3,10,11,9,3
3,10,12,9,3
3,10,13,9,3
3,10,14,9,3
3,10,15,9,3
3,11,0,9,3
3,11,1,9,3
3,11,2,9,3
3,11,3,9,3
3,11,4,9,3
3,11,5,9,3
3,11,6,9,3
3,11,7,9,3
3,11,8,9,3
3,11,9,9,3
3,11,10,9,3
3,11,11,9,3
3,11,12,9,3
3,11,13,9,3
3,11,14,9,3
3,11,15,9,3
3,12,0,9,3
3,12,1,9,3
3,12,2,9,3
3,12,3,9,3
3,12,4,9,3
3,12,5,9,3
3,12,6,9,3
3,12,7,9,3
3,12,8,9,3
3,12,9,9,3
3,12,10,9,3
3,12,11,9,3
3,12,12,9,3
3,12,13,9,3
3,12,14,9,3
3,12,15,9,3
3,13,0,9,3
3,13,1,9,3
3,13,2,9,3
3,13,3,9,3
3,13,4,9,3
3,13,5,9,3
3,13,6,9,3
3,13,7,9,3
3,13,8,9,3
3,13,9,9,3
3,13,10,9,3
3,13,11,9,3
3,13,12,9,3
3,13,13,9,3
3,13,14,9,3
3,13,15,9,3
3,14,0,9,3
3,14,1,9,3
3,14,2,9,3
3,14,3,9,3
3,14,4,9,3
3,14,5,9,3
3,14,6,9,3
3,14,7,9,3
3,14,8,9,3
3,14,9,9,3
3,14,10,9,3
3,14,11,9,3
3,14,12,9,3
3,14,13,9,3
3,14,14,9,3
3,14,15,9,3
3,15,0,9,3
3,15,1,9,3
3,15,2,9,3
3,15,3,9,3
3,15,4,9,3
3,15,5,9,3
3,15,6,9,3
3,15,7,9,3
3,15,8,9,3
3,15,9,9,3
3,15,10,9,3
3,15,11,9,3
3,15,12,9,3
3,15,13,9,3
3,15,14,9,3
3,15,15,9,3
3,0,0,10,3
3,0,1,10,3
3,0,2,10,3
3,0,3,10,3
3,0,4,10,3
3,0,5,10,3
3,0,6,10,3
3,0,7,10,3
3,0,8,10,3
3,0,9,10,3
3,0,10,10,3
3,0,11,10,3
3,0,12,10,3
3,0,13,10,3
3,0,14,10,3
3,0,15,10,3
3,1,0,10,3
3,1,1,10,3
3,1,2,10,3
3,1,3,10,3
3,1,4,10,3
3,1,5,10,3
3,1,6,10,3
3,1,7,10,3
3,1,8,10,3
3,1,9,10,3
3,1,10,10,3
3,1,11,10,3
3,1,12,10,3
3,1,13,10,3
3,1,14,10,3
3,1,15,10,3
3,2,0,10,3
3,2,1,10,3
3,2,2,10,3
3,2,3,10,3
3,2,4,10,3
3,2,5,10,3
3,2,6,10,3
3,2,7,10,3
3,2,8,10,3
3,2,9,10,3
3,2,10,10,3
3,2,11,10,3
3,2,12,10,3
3,2,13,10,3
3,2,14,10,3
3,2,15,10,3
3,3,0,10,3
3,3,1,10,3
3,3,2,10,3
3,3,3,10,3
3,3,4,10,3
3,3,5,10,3
3,3,6,10,3
3,3,7,10,3
3,3,8,10,3
3,3,9,10,3
3,3,10,10,3
3,3,11,10,3
3,3,12,10,3
3,3,13,10,3
3,3,14,10,3
3,3,15,10,3
3,4,0,10,3
3,4,1,10,3
3,4,2,10,3
3,4,3,10,3
3,4,4,10,3
3,4,5,10,3
3,4,6,10,3
3,4,7,10,3
3,4,8,10,3
3,4,9,10,3
3,4,10,10,3
3,4,11,10,3
3,4,12,10,3
3,4,13,10,3
3,4,14,10,3
3,4,15,10,3
3,5,0,10,3
3,5,1,10,3
3,5,2,10,3
3,5,3,10,3
3,5,4,10,3
3,5,5,10,3
3,5,6,10,3
3,5,7,10,3
3,5,8,10,3
3,5,9,10,3
3,5,10,10,3
3,5,11,10,3
3,5,12,10,3
3,5,13,10,3
3,5,14,10,3
3,5,15,10,3
3,6,0,10,3
3,6,1,10,3
3,6,2,10,3
3,6,3,10,3
3,6,4,10,3
3,6,5,10,3
3,6,6,10,3
3,6,7,10,3
3,6,8,10,3
3,6,9,10,3
3,6,10,10,3
3,6,11,10,3
3,6,12,10,3
3,6,13,10,3
3,6,14,10,3
3,6,15,10,3
3,7,0,10,3
3,7,1,10,3
3,7,2,10,3
3,7,3,10,3
3,7,4,10,3
3,7,5,10,3
3,7,6,10,3
3,7,7,10,3
3,7,8,10,3
3,7,9,10,3
3,7,10,10,3
3,7,11,10,3
3,7,12,10,3
3,7,13,10,3
3,7,14,10,3
3,7,15,10,3
3,8,0,10,3
3,8,1,10,3
3,8,2,10,3
3,8,3,10,3
3,8,4,10,3
3,8,5,10,3
3,8,6,10,3
3,8,7,10,3
3,8,8,10,3
3,8,9,10,3
3,8,10,10,3
3,8,11,10,3
3,8,12,10,3
3,8,13,10,3
3,8,14,10,3
3,8,15,10,3
3,9,0,10,3
3,9,1,10,3
3,9,2,10,3
3,9,3,10,3
3,9,4,10,3
3,9,5,10,3
3,9,6,10,3
3,9,7,10,3
3,9,8,10,3
3,9,9,10,3
3,9,10,10,3
3,9,11,10,3
3,9,12,10,3
3,9,13,10,3
3,9,14,10,3
3,9,15,10,3
3,10,0,10,3
3,10,1,10,3
3,10,2,10,3
3,10,3,10,3
3,10,4,10,3
3,10,5,10,3
3,10,6,10,3
3,10,7,10,3
3,10,8,10,3
3,10,9,10,3
3,10,10,10,3
3,10,11,10,3
3,10,12,10,3
3,10,13,10,3
3,10,14,10,3
3,10,15,10,3
3,11,0,10,3
3,11,1,10,3
3,11,2,10,3
3,11,3,10,3
3,11,4,10,3
3,11,5,10,3
3,11,6,10,3
3,11,7,10,3
3,11,8,10,3
3,11,9,10,3
3,11,10,10,3
3,11,11,10,3
3,11,12,10,3
3,11,13,10,3
3,11,14,10,3
3,11,15,10,3
3,12,0,10,3
3,12,1,10,3
3,12,2,10,3
3,12,3,10,3
3,12,4,10,3
3,12,5,10,3
3,12,6,10,3
3,12,7,10,3
3,12,8,10,3
3,12,9,10,3
3,12,10,10,3
3,12,11,10,3
3,12,12,10,3
3,12,13,10,3
3,12,14,10,3
3,12,15,10,3
3,13,0,10,3
3,13,1,10,3
3,13,2,10,3
3,13,3,10,3
3,13,4,10,3
3,13,5,10,3
3,13,6,10,3
3,13,7,10,3
3,13,8,10,3
3,13,9,10,3
3,13,10,10,3
3,13,11,10,3
3,13,12,10,3
3,13,13,10,3
3,13,14,10,3
3,13,15,10,3
3,14,0,10,3
3,14,1,10,3
3,14,2,10,3
3,14,3,10,3
3,14,4,10,3
3,14,5,10,3
3,14,6,10,3
3,14,7,10,3
3,14,8,10,3
3,14,9,10,3
3,14,10,10,3
3,14,11,10,3
3,14,12,10,3
3,14,13,10,3
3,14,14,10,3
3,14,15,10,3
3,0,0,11,3
3,0,1,11,3
3,0,2,11,3
3,0,3,11,3
3,0,4,11,3
3,0,5,11,3
3,0,6,11,3
3,0,7,11,3
3,0,8,11,3
3,0,9,11,3
3,0,10,11,3
3,0,11,11,3
3,0,12,11,3
3,0,13,11,3
3,0,14,11,3
3,0,15,11,3
3,1,0,11,3
3,1,1,11,3
3,1,2,11,3
3,1,3,11,3
3,1,4,11,3
3,1,5,11,3
3,1,6,11,3
3,1,7,11,3
3,1,8,11,3
3,1,9,11,3
3,1,10,11,3
3,1,11,11,3
3,1,12,11,3
3,1,13,11,3
3,1,14,11,3
3,1,15,11,3
3,2,0,11,3
3,2,1,11,3
3,2,2,11,3
3,2,3,11,3
3,2,4,11,3
3,2,5,11,3
3,2,6,11,3
3,2,7,11,3
3,2,8,11,3
3,2,9,11,3
3,2,10,11,3
3,2,11,11,3
3,2,12,11,3
3,2,13,11,3
3,2,14,11,3
3,2,15,11,3
3,3,0,11,3
3,3,1,11,3
3,3,2,11,3
3,3,3,11,3
3,3,4,11,3
3,3,5,11,3
3,3,6,11,3
3,3,7,11,3
3,3,8,11,3
3,3,9,11,3
3,3,10,11,3
3,3,11,11,3
3,3,12,11,3
3,3,13,11,3
3,3,14,11,3
3,3,15,11,3
3,4,0,11,3
3,4,1,11,3
3,4,2,11,3
3,4,3,11,3
3,4,4,11,3
3,4,5,11,3
3,4,6,11,3
3,4,7,11,3
3,4,8,11,3
3,4,9,11,3
3,4,10,11,3
3,4,11,11,3
3,4,12,11,3
3,4,13,11,3
3,4,14,11,3
3,4,15,11,3
3,5,0,11,3
3,5,1,11,3
3,5,2,11,3
3,5,3,11,3
3,5,4,11,3
3,5,5,11,3
3,5,6,11,3
3,5,7,11,3
3,5,8,11,3
3,5,9,11,3
3,5,10,11,3
3,5,11,11,3
3,5,12,11,3
3,5,13,11,3
3,5,14,11,3
3,5,15,11,3
3,6,0,11,3
3,6,1,11,3
3,6,2,11,3
3,6,3,11,3
3,6,4,11,3
3,6,5,11,3
3,6,6,11,3
3,6,7,11,3
3,6,8,11,3
3,6,9,11,3
3,6,10,11,3
3,6,11,11,3
3,6,12,11,3
3,6,13,11,3
3,6,14,11,3
3,6,15,11,3
3,7,0,11,3
3,7,1,11,3
3,7,2,11,3
3,7,3,11,3
3,7,4,11,3
3,7,5,11,3
3,7,6,11,3
3,7,7,11,3
3,7,8,11,3
3,7,9,11,3
3,7,10,11,3
3,7,11,11,3
3,7,12,11,3
3,7,13,11,3
3,7,14,11,3
3,7,15,11,3
3,8,0,11,3
3,8,1,11,3
3,8,2,11,3
3,8,3,11,3
3,8,4,11,3
3,8,5,11,3
3,8,6,11,3
3,8,7,11,3
3,8,8,11,3
3,8,9,11,3
3,8,10,11,3
3,8,11,11,3
3,8,12,11,3
3,8,13,11,3
3,8,14,11,3
3,8,15,11,3
3,9,0,11,3
3,9,1,11,3
3,9,2,11,3
3,9,3,11,3
3,9,4,11,3
3,9,5,11,3
3,9,6,11,3
3,9,7,11,3
3,9,8,11,3
3,9,9,11,3
3,9,10,11,3
3,9,11,11,3
3,9,12,11,3
3,9,13,11,3
3,9,14,11,3
3,9,15,11,3
3,10,0,11,3
3,10,1,11,3
3,10,2,11,3
3,10,3,11,3
3,10,4,11,3
3,10,5,11,3
3,10,6,11,3
3,10,7,11,3
3,10,8,11,3
3,10,9,11,3
3,10,10,11,3
3,10,11,11,3
3,10,12,11,3
3,10,13,11,3
3,10,14,11,3
3,10,15,11,3
3,11,0,11,3
3,11,1,11,3
3,11,2,11,3
3,11,3,11,3
3,11,4,11,3
3,11,5,11,3
3,11,6,11,3
3,11,7,11,3
3,11,8,11,3
3,11,9,11,3
3,11,10,11,3
3,11,11,11,3
3,11,12,11,3
3,11,13,11,3
3,11,14,11,3
3,11,15,11,3
3,12,0,11,3
3,12,1,11,3
3,12,2,11,3
3,12,3,11,3
3,12,4,11,3
3,12,5,11,3
3,12,6,11,3
3,12,7,11,3
3,12,8,11,3
3,12,9,11,3
3,12,10,11,3
3,12,11,11,3
3,12,12,11,3
3,12,13,11,3
3,12,14,11,3
3,12,15,11,3
3,13,0,11,3
3,13,1,11,3
3,13,2,11,3
3,13,3,11,3
3,13,4,11,3
3,13,5,11,3
3,13,6,11,3
3,13,7,11,3
3,13,8,11,3
3,13,9,11,3
3,13,10,11,3
3,13,11,11,3
3,13,12,11,3
3,13,13,11,3
3,13,14,11,3
3,13,15,11,3
3,0,0,12,3
3,0,1,12,3
3,0,2,12,3
3,0,3,12,3
3,0,4,12,3
3,0,5,12,3
3,0,6,12,3
3,0,7,12,3
3,0,8,12,3
3,0,9,12,3
3,0,10,12,3
3,0,11,12,3
3,0,12,12,3
3,0,13,12,3
3,0,14,12,3
3,0,15,12,3
3,1,0,12,3
3,1,1,12,3
3,1,2,12,3
3,1,3,12,3
3,1,4,12,3
3,1,5,12,3
3,1,6,12,3
3,1,7,12,3
3,1,8,12,3
3,1,9,12,3
3,1,10,12,3
3,1,11,12,3
3,1,12,12,3
3,1,13,12,3
3,1,14,12,3
3,1,15,12,3
3,2,0,12,3
3,2,1,12,3
3,2,2,12,3
3,2,3,12,3
3,2,4,12,3
3,2,5,12,3
3,2,6,12,3
3,2,7,12,3
3,2,8,12,3
3,2,9,12,3
3,2,10,12,3
3,2,11,12,3
3,2,12,12,3
3,2,13,12,3
3,2,14,12,3
3,2,15,12,3
3,3,0,12,3
3,3,1,12,3
3,3,2,12,3
3,3,3,12,3
3,3,4,12,3
3,3,5,12,3
3,3,6,12,3
3,3,7,12,3
3,3,8,12,3
3,3,9,12,3
3,3,10,12,3
3,3,11,12,3
3,3,12,12,3
3,3,13,12,3
3,3,14,12,3
3,3,15,12,3
3,4,0,12,3
3,4,1,12,3
3,4,2,12,3
3,4,3,12,3
3,4,4,12,3
3,4,5,12,3
3,4,6,12,3
3,4,7,12,3
3,4,8,12,3
3,4,9,12,3
3,4,10,12,3
3,4,11,12,3
3,4,12,12,3
3,4,13,12,3
3,4,14,12,3
3,4,15,12,3
3,5,0,12,3
3,5,1,12,3
3,5,2,12,3
3,5,3,12,3
3,5,4,12,3
3,5,5,12,3
3,5,6,12,3
3,5,7,12,3
3,5,8,12,3
3,5,9,12,3
3,5,10,12,3
3,5,11,12,3
3,5,12,12,3
3,5,13,12,3
3,5,14,12,3
3,5,15,12,3
3,6,0,12,3
3,6,1,12,3
3,6,2,12,3
3,6,3,12,3
3,6,4,12,3
3,6,5,12,3
3,6,6,12,3
3,6,7,12,3
3,6,8,12,3
3,6,9,12,3
3,6,10,12,3
3,6,11,12,3
3,6,12,12,3
3,6,13,12,3
3,6,14,12,3
3,6,15,12,3
3,7,0,12,3
3,7,1,12,3
3,7,2,12,3
3,7,3,12,3
3,7,4,12,3
3,7,5,12,3
3,7,6,12,3
3,7,7,12,3
3,7,8,12,3
3,7,9,12,3
3,7,10,12,3
3,7,11,12,3
3,7,12,12,3
3,7,13,12,3
3,7,14,12,3
3,7,15,12,3
3,8,0,12,3
3,8,1,12,3
3,8,2,12,3
3,8,3,12,3
3,8,4,12,3
3,8,5,12,3
3,8,6,12,3
3,8,7,12,3
3,8,8,12,3
3,8,9,12,3
3,8,10,12,3
3,8,11,12,3
3,8,12,12,3
3,8,13,12,3
3,8,14,12,3
3,8,15,12,3
3,9,0,12,3
3,9,1,12,3
3,9,2,12,3
3,9,3,12,3
3,9,4,12,3
3,9,5,12,3
3,9,6,12,3
3,9,7,12,3
3,9,8,12,3
3,9,9,12,3
3,9,10,12,3
3,9,11,12,3
3,9,12,12,3
3,9,13,12,3
3,9,14,12,3
3,9,15,12,3
3,10,0,12,3
3,10,1,12,3
3,10,2,12,3
3,10,3,12,3
3,10,4,12,3
3,10,5,12,3
3,10,6,12,3
3,10,7,12,3
3,10,8,12,3
3,10,9,12,3
3,10,10,12,3
3,10,11,12,3
3,10,12,12,3
3,10,13,12,3
3,10,14,12,3
3,10,15,12,3
3,11,0,12,3
3,11,1,12,3
3,11,2,12,3
3,11,3,12,3
3,11,4,12,3
3,11,5,12,3
3,11,6,12,3
3,11,7,12,3
3,11,8,12,3
3,11,9,12,3
3,11,10,12,3
3,11,11,12,3
3,11,12,12,3
3,11,13,12,3
3,11,14,12,3
3,11,15,12,3
3,12,0,12,3
3,12,1,12,3
3,12,2,12,3
3,12,3,12,3
3,12,4,12,3
3,12,5,12,3
3,12,6,12,3
3,12,7,12,3
3,12,8,12,3
3,12,9,12,3
3,12,10,12,3
3,12,11,12,3
3,12,12,12,3
3,12,13,12,3
3,12,14,12,3
3,12,15,12,3
3,0,0,13,3
3,0,1,13,3
3,0,2,13,3
3,0,3,13,3
3,0,4,13,3
3,0,5,13,3
3,0,6,13,3
3,0,7,13,3
3,0,8,13,3
3,0,9,13,3
3,0,10,13,3
3,0,11,13,3
3,0,12,13,3
3,0,13,13,3
3,0,14,13,3
3,0,15,13,3
3,1,0,13,3
3,1,1,13,3
3,1,2,13,3
3,1,3,13,3
3,1,4,13,3
3,1,5,13,3
3,1,6,13,3
3,1,7,13,3
3,1,8,13,3
3,1,9,13,3
3,1,10,13,3
3,1,11,13,3
3,1,12,13,3
3,1,13,13,3
3,1,14,13,3
3,1,15,13,3
3,2,0,13,3
3,2,1,13,3
3,2,2,13,3
3,2,3,13,3
3,2,4,13,3
3,2,5,13,3
3,2,6,13,3
3,2,7,13,3
3,2,8,13,3
3,2,9,13,3
3,2,10,13,3
3,2,11,13,3
3,2,12,13,3
3,2,13,13,3
3,2,14,13,3
3,2,15,13,3
3,3,0,13,3
3,3,1,13,3
3,3,2,13,3
3,3,3,13,3
3,3,4,13,3
3,3,5,13,3
3,3,6,13,3
3,3,7,13,3
3,3,8,13,3
3,3,9,13,3
3,3,10,13,3
3,3,11,13,3
3,3,12,13,3
3,3,13,13,3
3,3,14,13,3
3,3,15,13,3
3,4,0,13,3
3,4,1,13,3
3,4,2,13,3
3,4,3,13,3
3,4,4,13,3
3,4,5,13,3
3,4,6,13,3
3,4,7,13,3
3,4,8,13,3
3,4,9,13,3
3,4,10,13,3
3,4,11,13,3
3,4,12,13,3
3,4,13,13,3
3,4,14,13,3
3,4,15,13,3
3,5,0,13,3
3,5,1,13,3
3,5,2,13,3
3,5,3,13,3
3,5,4,13,3
3,5,5,13,3
3,5,6,13,3
3,5,7,13,3
3,5,8,13,3
3,5,9,13,3
3,5,10,13,3
3,5,11,13,3
3,5,12,13,3
3,5,13,13,3
3,5,14,13,3
3,5,15,13,3
3,6,0,13,3
3,6,1,13,3
3,6,2,13,3
3,6,3,13,3
3,6,4,13,3
3,6,5,13,3
3,6,6,13,3
3,6,7,13,3
3,6,8,13,3
3,6,9,13,3
3,6,10,13,3
3,6,11,13,3
3,6,12,13,3
3,6,13,13,3
3,6,14,13,3
3,6,15,13,3
3,7,0,13,3
3,7,1,13,3
3,7,2,13,3
3,7,3,13,3
3,7,4,13,3
3,7,5,13,3
3,7,6,13,3
3,7,7,13,3
3,7,8,13,3
3,7,9,13,3
3,7,10,13,3
3,7,11,13,3
3,7,12,13,3
3,7,13,13,3
3,7,14,13,3
3,7,15,13,3
3,8,0,13,3
3,8,1,13,3
3,8,2,13,3
3,8,3,13,3
3,8,4,13,3
3,8,5,13,3
3,8,6,13,3
3,8,7,13,3
3,8,8,13,3
3,8,9,13,3
3,8,10,13,3
3,8,11,13,3
3,8,12,13,3
3,8,13,13,3
3,8,14,13,3
3,8,15,13,3
3,9,0,13,3
3,9,1,13,3
3,9,2,13,3
3,9,3,13,3
3,9,4,13,3
3,9,5,13,3
3,9,6,13,3
3,9,7,13,3
3,9,8,13,3
3,9,9,13,3
3,9,10,13,3
3,9,11,13,3
3,9,12,13,3
3,9,13,13,3
3,9,14,13,3
3,9,15,13,3
3,10,0,13,3
3,10,1,13,3
3,10,2,13,3
3,10,3,13,3
3,10,4,13,3
3,10,5,13,3
3,10,6,13,3
3,10,7,13,3
3,10,8,13,3
3,10,9,13,3
3,10,10,13,3
3,10,11,13,3
3,10,12,13,3
3,10,13,13,3
3,10,14,13,3
3,10,15,13,3
3,11,0,13,3
3,11,1,13,3
3,11,2,13,3
3,11,3,13,3
3,11,4,13,3
3,11,5,13,3
3,11,6,13,3
3,11,7,13,3
3,11,8,13,3
3,11,9,13,3
3,11,10,13,3
3,11,11,13,3
3,11,12,13,3
3,11,13,13,3
3,11,14,13,3
3,11,15,13,3
3,0,0,14,3
3,0,1,14,3
3,0,2,14,3
3,0,3,14,3
3,0,4,14,3
3,0,5,14,3
3,0,6,14,3
3,0,7,14,3
3,0,8,14,3
3,0,9,14,3
3,0,10,14,3
3,0,11,14,3
3,0,12,14,3
3,0,13,14,3
3,0,14,14,3
3,0,15,14,3
3,1,0,14,3
3,1,1,14,3
3,1,2,14,3
3,1,3,14,3
3,1,4,14,3
3,1,5,14,3
3,1,6,14,3
3,1,7,14,3
3,1,8,14,3
3,1,9,14,3
3,1,10,14,3
3,1,11,14,3
3,1,12,14,3
3,1,13,14,3
3,1,14,14,3
3,1,15,14,3
3,2,0,14,3
3,2,1,14,3
3,2,2,14,3
3,2,3,14,3
3,2,4,14,3
3,2,5,14,3
3,2,6,14,3
3,2,7,14,3
3,2,8,14,3
3,2,9,14,3
3,2,10,14,3
3,2,11,14,3
3,2,12,14,3
3,2,13,14,3
3,2,14,14,3
3,2,15,14,3
3,3,0,14,3
3,3,1,14,3
3,3,2,14,3
3,3,3,14,3
3,3,4,14,3
3,3,5,14,3
3,3,6,14,3
3,3,7,14,3
3,3,8,14,3
3,3,9,14,3
3,3,10,14,3
3,3,11,14,3
3,3,12,14,3
3,3,13,14,3
3,3,14,14,3
3,3,15,14,3
3,4,0,14,3
3,4,1,14,3
3,4,2,14,3
3,4,3,14,3
3,4,4,14,3
3,4,5,14,3
3,4,6,14,3
3,4,7,14,3
3,4,8,14,3
3,4,9,14,3
3,4,10,14,3
3,4,11,14,3
3,4,12,14,3
3,4,13,14,3
3,4,14,14,3
3,4,15,14,3
3,5,0,14,3
3,5,1,14,3
3,5,2,14,3
3,5,3,14,3
3,5,4,14,3
3,5,5,14,3
3,5,6,14,3
3,5,7,14,3
3,5,8,14,3
3,5,9,14,3
3,5,10,14,3
3,5,11,14,3
3,5,12,14,3
3,5,13,14,3
3,5,14,14,3
3,5,15,14,3
3,6,0,14,3
3,6,1,14,3
3,6,2,14,3
3,6,3,14,3
3,6,4,14,3
3,6,5,14,3
3,6,6,14,3
3,6,7,14,3
3,6,8,14,3
3,6,9,14,3
3,6,10,14,3
3,6,11,14,3
3,6,12,14,3
3,6,13,14,3
3,6,14,14,3
3,6,15,14,3
3,7,0,14,3
3,7,1,14,3
3,7,2,14,3
3,7,3,14,3
3,7,4,14,3
3,7,5,14,3
3,7,6,14,3
3,7,7,14,3
3,7,8,14,3
3,7,9,14,3
3,7,10,14,3
3,7,11,14,3
3,7,12,14,3
3,7,13,14,3
3,7,14,14,3
3,7,15,14,3
3,8,0,14,3
3,8,1,14,3
3,8,2,14,3
3,8,3,14,3
3,8,4,14,3
3,8,5,14,3
3,8,6,14,3
3,8,7,14,3
3,8,8,14,3
3,8,9,14,3
3,8,10,14,3
3,8,11,14,3
3,8,12,14,3
3,8,13,14,3
3,8,14,14,3
3,8,15,14,3
3,9,0,14,3
3,9,1,14,3
3,9,2,14,3
3,9,3,14,3
3,9,4,14,3
3,9,5,14,3
3,9,6,14,3
3,9,7,14,3
3,9,8,14,3
3,9,9,14,3
3,9,10,14,3
3,9,11,14,3
3,9,12,14,3
3,9,13,14,3
3,9,14,14,3
3,9,15,14,3
3,10,0,14,3
3,10,1,14,3
3,10,2,14,3
3,10,3,14,3
3,10,4,14,3
3,10,5,14,3
3,10,6,14,3
3,10,7,14,3
3,10,8,14,3
3,10,9,14,3
3,10,10,14,3
3,10,11,14,3
3,10,12,14,3
3,10,13,14,3
3,10,14,14,3
3,10,15,14,3
3,0,0,15,3
3,0,1,15,3
3,0,2,15,3
3,0,3,15,3
3,0,4,15,3
3,0,5,15,3
3,0,6,15,3
3,0,7,15,3
3,0,8,15,3
3,0,9,15,3
3,0,10,15,3
3,0,11,15,3
3,0,12,15,3
3,0,13,15,3
3,0,14,15,3
3,0,15,15,3
3,1,0,15,3
3,1,1,15,3
3,1,2,15,3
3,1,3,15,3
3,1,4,15,3
3,1,5,15,3
3,1,6,15,3
3,1,7,15,3
3,1,8,15,3
3,1,9,15,3
3,1,10,15,3
3,1,11,15,3
3,1,12,15,3
3,1,13,15,3
3,1,14,15,3
3,1,15,15,3
3,2,0,15,3
3,2,1,15,3
3,2,2,15,3
3,2,3,15,3
3,2,4,15,3
3,2,5,15,3
3,2,6,15,3
3,2,7,15,3
3,2,8,15,3
3,2,9,15,3
3,2,10,15,3
3,2,11,15,3
3,2,12,15,3
3,2,13,15,3
3,2,14,15,3
3,2,15,15,3
3,3,0,15,3
3,3,1,15,3
3,3,2,15,3
3,3,3,15,3
3,3,4,15,3
3,3,5,15,3
3,3,6,15,3
3,3,7,15,3
3,3,8,15,3
3,3,9,15,3
3,3,10,15,3
3,3,11,15,3
3,3,12,15,3
3,3,13,15,3
3,3,14,15,3
3,3,15,15,3
3,4,0,15,3
3,4,1,15,3
3,4,2,15,3
3,4,3,15,3
3,4,4,15,3
3,4,5,15,3
3,4,6,15,3
3,4,7,15,3
3,4,8,15,3
3,4,9,15,3
3,4,10,15,3
3,4,11,15,3
3,4,12,15,3
3,4,13,15,3
3,4,14,15,3
3,4,15,15,3
3,5,0,15,3
3,5,1,15,3
3,5,2,15,3
3,5,3,15,3
3,5,4,15,3
3,5,5,15,3
3,5,6,15,3
3,5,7,15,3
3,5,8,15,3
3,5,9,15,3
3,5,10,15,3
3,5,11,15,3
3,5,12,15,3
3,5,13,15,3
3,5,14,15,3
3,5,15,15,3
3,6,0,15,3
3,6,1,15,3
3,6,2,15,3
3,6,3,15,3
3,6,4,15,3
3,6,5,15,3
3,6,6,15,3
3,6,7,15,3
3,6,8,15,3
3,6,9,15,3
3,6,10,15,3
3,6,11,15,3
3,6,12,15,3
3,6,13,15,3
3,6,14,15,3
3,6,15,15,3
3,7,0,15,3
3,7,1,15,3
3,7,2,15,3
3,7,3,15,3
3,7,4,15,3
3,7,5,15,3
3,7,6,15,3
3,7,7,15,3
3,7,8,15,3
3,7,9,15,3
3,7,10,15,3
3,7,11,15,3
3,7,12,15,3
3,7,13,15,3
3,7,14,15,3
3,7,15,15,3
3,8,0,15,3
3,8,1,15,3
3,8,2,15,3
3,8,3,15,3
3,8,4,15,3
3,8,5,15,3
3,8,6,15,3
3,8,7,15,3
3,8,8,15,3
3,8,9,15,3
3,8,10,15,3
3,8,11,15,3
3,8,12,15,3
3,8,13,15,3
3,8,14,15,3
3,8,15,15,3
3,9,0,15,3
3,9,1,15,3
3,9,2,15,3
3,9,3,15,3
3,9,4,15,3
3,9,5,15,3
3,9,6,15,3
3,9,7,15,3
3,9,8,15,3
3,9,9,15,3
3,9,10,15,3
3,9,11,15,3
3,9,12,15,3
3,9,13,15,3
3,9,14,15,3
3,9,15,15,3
3,0,0,16,3
3,0,1,16,3
3,0,2,16,3
3,0,3,16,3
3,0,4,16,3
3,0,5,16,3
3,0,6,16,3
3,0,7,16,3
3,0,8,16,3
3,0,9,16,3
3,0,10,16,3
3,0,11,16,3
3,0,12,16,3
3,0,13,16,3
3,0,14,16,3
3,0,15,16,3
3,1,0,16,3
3,1,1,16,3
3,1,2,16,3
3,1,3,16,3
3,1,4,16,3
3,1,5,16,3
3,1,6,16,3
3,1,7,16,3
3,1,8,16,3
3,1,9,16,3
3,1,10,16,3
3,1,11,16,3
3,1,12,16,3
3,1,13,16,3
3,1,14,16,3
3,1,15,16,3
3,2,0,16,3
3,2,1,16,3
3,2,2,16,3
3,2,3,16,3
3,2,4,16,3
3,2,5,16,3
3,2,6,16,3
3,2,7,16,3
3,2,8,16,3
3,2,9,16,3
3,2,10,16,3
3,2,11,16,3
3,2,12,16,3
3,2,13,16,3
3,2,14,16,3
3,2,15,16,3
3,3,0,16,3
3,3,1,16,3
3,3,2,16,3
3,3,3,16,3
3,3,4,16,3
3,3,5,16,3
3,3,6,16,3
3,3,7,16,3
3,3,8,16,3
3,3,9,16,3
3,3,10,16,3
3,3,11,16,3
3,3,12,16,3
3,3,13,16,3
3,3,14,16,3
3,3,15,16,3
3,4,0,16,3
3,4,1,16,3
3,4,2,16,3
3,4,3,16,3
3,4,4,16,3
3,4,5,16,3
3,4,6,16,3
3,4,7,16,3
3,4,8,16,3
3,4,9,16,3
3,4,10,16,3
3,4,11,16,3
3,4,12,16,3
3,4,13,16,3
3,4,14,16,3
3,4,15,16,3
3,5,0,16,3
3,5,1,16,3
3,5,2,16,3
3,5,3,16,3
3,5,4,16,3
3,5,5,16,3
3,5,6,16,3
3,5,7,16,3
3,5,8,16,3
3,5,9,16,3
3,5,10,16,3
3,5,11,16,3
3,5,12,16,3
3,5,13,16,3
3,5,14,16,3
3,5,15,16,3
3,6,0,16,3
3,6,1,16,3
3,6,2,16,3
3,6,3,16,3
3,6,4,16,3
3,6,5,16,3
3,6,6,16,3
3,6,7,16,3
3,6,8,16,3
3,6,9,16,3
3,6,10,16,3
3,6,11,16,3
3,6,12,16,3
3,6,13,16,3
3,6,14,16,3
3,6,15,16,3
3,7,0,16,3
3,7,1,16,3
3,7,2,16,3
3,7,3,16,3
3,7,4,16,3
3,7,5,16,3
3,7,6,16,3
3,7,7,16,3
3,7,8,16,3
3,7,9,16,3
3,7,10,16,3
3,7,11,16,3
3,7,12,16,3
3,7,13,16,3
3,7,14,16,3
3,7,15,16,3
3,8,0,16,3
3,8,1,16,3
3,8,2,16,3
3,8,3,16,3
3,8,4,16,3
3,8,5,16,3
3,8,6,16,3
3,8,7,16,3
3,8,8,16,3
3,8,9,16,3
3,8,10,16,3
3,8,11,16,3
3,8,12,16,3
3,8,13,16,3
3,8,14,16,3
3,8,15,16,3
3,0,0,17,3
3,0,1,17,3
3,0,2,17,3
3,0,3,17,3
3,0,4,17,3
3,0,5,17,3
3,0,6,17,3
3,0,7,17,3
3,0,8,17,3
3,0,9,17,3
3,0,10,17,3
3,0,11,17,3
3,0,12,17,3
3,0,13,17,3
3,0,14,17,3
3,0,15,17,3
3,1,0,17,3
3,1,1,17,3
3,1,2,17,3
3,1,3,17,3
3,1,4,17,3
3,1,5,17,3
3,1,6,17,3
3,1,7,17,3
3,1,8,17,3
3,1,9,17,3
3,1,10,17,3
3,1,11,17,3
3,1,12,17,3
3,1,13,17,3
3,1,14,17,3
3,1,15,17,3
3,2,0,17,3
3,2,1,17,3
3,2,2,17,3
3,2,3,17,3
3,2,4,17,3
3,2,5,17,3
3,2,6,17,3
3,2,7,17,3
3,2,8,17,3
3,2,9,17,3
3,2,10,17,3
3,2,11,17,3
3,2,12,17,3
3,2,13,17,3
3,2,14,17,3
3,2,15,17,3
3,3,0,17,3
3,3,1,17,3
3,3,2,17,3
3,3,3,17,3
3,3,4,17,3
3,3,5,17,3
3,3,6,17,3
3,3,7,17,3
3,3,8,17,3
3,3,9,17,3
3,3,10,17,3
3,3,11,17,3
3,3,12,17,3
3,3,13,17,3
3,3,14,17,3
3,3,15,17,3
3,4,0,17,3
3,4,1,17,3
3,4,2,17,3
3,4,3,17,3
3,4,4,17,3
3,4,5,17,3
3,4,6,17,3
3,4,7,17,3
3,4,8,17,3
3,4,9,17,3
3,4,10,17,3
3,4,11,17,3
3,4,12,17,3
3,4,13,17,3
3,4,14,17,3
3,4,15,17,3
3,5,0,17,3
3,5,1,17,3
3,5,2,17,3
3,5,3,17,3
3,5,4,17,3
3,5,5,17,3
3,5,6,17,3
3,5,7,17,3
3,5,8,17,3
3,5,9,17,3
3,5,10,17,3
3,5,11,17,3
3,5,12,17,3
3,5,13,17,3
3,5,14,17,3
3,5,15,17,3
3,6,0,17,3
3,6,1,17,3
3,6,2,17,3
3,6,3,17,3
3,6,4,17,3
3,6,5,17,3
3,6,6,17,3
3,6,7,17,3
3,6,8,17,3
3,6,9,17,3
3,6,10,17,3
3,6,11,17,3
3,6,12,17,3
3,6,13,17,3
3,6,14,17,3
3,6,15,17,3
3,7,0,17,3
3,7,1,17,3
3,7,2,17,3
3,7,3,17,3
3,7,4,17,3
3,7,5,17,3
3,7,6,17,3
3,7,7,17,3
3,7,8,17,3
3,7,9,17,3
3,7,10,17,3
3,7,11,17,3
3,7,12,17,3
3,7,13,17,3
3,7,14,17,3
3,7,15,17,3
3,0,0,18,3
3,0,1,18,3
3,0,2,18,3
3,0,3,18,3
3,0,4,18,3
3,0,5,18,3
3,0,6,18,3
3,0,7,18,3
3,0,8,18,3
3,0,9,18,3
3,0,10,18,3
3,0,11,18,3
3,0,12,18,3
3,0,13,18,3
3,0,14,18,3
3,0,15,18,3
3,1,0,18,3
3,1,1,18,3
3,1,2,18,3
3,1,3,18,3
3,1,4,18,3
3,1,5,18,3
3,1,6,18,3
3,1,7,18,3
3,1,8,18,3
3,1,9,18,3
3,1,10,18,3
3,1,11,18,3
3,1,12,18,3
3,1,13,18,3
3,1,14,18,3
3,1,15,18,3
3,2,0,18,3
3,2,1,18,3
3,2,2,18,3
3,2,3,18,3
3,2,4,18,3
3,2,5,18,3
3,2,6,18,3
3,2,7,18,3
3,2,8,18,3
3,2,9,18,3
3,2,10,18,3
3,2,11,18,3
3,2,12,18,3
3,2,13,18,3
3,2,14,18,3
3,2,15,18,3
3,3,0,18,3
3,3,1,18,3
3,3,2,18,3
3,3,3,18,3
3,3,4,18,3
3,3,5,18,3
3,3,6,18,3
3,3,7,18,3
3,3,8,18,3
3,3,9,18,3
3,3,10,18,3
3,3,11,18,3
3,3,12,18,3
3,3,13,18,3
3,3,14,18,3
3,3,15,18,3
3,4,0,18,3
3,4,1,18,3
3,4,2,18,3
3,4,3,18,3
3,4,4,18,3
3,4,5,18,3
3,4,6,18,3
3,4,7,18,3
3,4,8,18,3
3,4,9,18,3
3,4,10,18,3
3,4,11,18,3
3,4,12,18,3
3,4,13,18,3
3,4,14,18,3
3,4,15,18,3
3,5,0,18,3
3,5,1,18,3
3,5,2,18,3
3,5,3,18,3
3,5,4,18,3
3,5,5,18,3
3,5,6,18,3
3,5,7,18,3
3,5,8,18,3
3,5,9,18,3
3,5,10,18,3
3,5,11,18,3
3,5,12,18,3
3,5,13,18,3
3,5,14,18,3
3,5,15,18,3
3,6,0,18,3
3,6,1,18,3
3,6,2,18,3
3,6,3,18,3
3,6,4,18,3
3,6,5,18,3
3,6,6,18,3
3,6,7,18,3
3,6,8,18,3
3,6,9,18,3
3,6,10,18,3
3,6,11,18,3
3,6,12,18,3
3,6,13,18,3
3,6,14,18,3
3,6,15,18,3
3,0,0,19,3
3,0,1,19,3
3,0,2,19,3
3,0,3,19,3
3,0,4,19,3
3,0,5,19,3
3,0,6,19,3
3,0,7,19,3
3,0,8,19,3
3,0,9,19,3
3,0,10,19,3
3,0,11,19,3
3,0,12,19,3
3,0,13,19,3
3,0,14,19,3
3,0,15,19,3
3,1,0,19,3
3,1,1,19,3
3,1,2,19,3
3,1,3,19,3
3,1,4,19,3
3,1,5,19,3
3,1,6,19,3
3,1,7,19,3
3,1,8,19,3
3,1,9,19,3
3,1,10,19,3
3,1,11,19,3
3,1,12,19,3
3,1,13,19,3
3,1,14,19,3
3,1,15,19,3
3,2,0,19,3
3,2,1,19,3
3,2,2,19,3
3,2,3,19,3
3,2,4,19,3
3,2,5,19,3
3,2,6,19,3
3,2,7,19,3
3,2,8,19,3
3,2,9,19,3
3,2,10,19,3
3,2,11,19,3
3,2,12,19,3
3,2,13,19,3
3,2,14,19,3
3,2,15,19,3
3,3,0,19,3
3,3,1,19,3
3,3,2,19,3
3,3,3,19,3
3,3,4,19,3
3,3,5,19,3
3,3,6,19,3
3,3,7,19,3
3,3,8,19,3
3,3,9,19,3
3,3,10,19,3
3,3,11,19,3
3,3,12,19,3
3,3,13,19,3
3,3,14,19,3
3,3,15,19,3
3,4,0,19,3
3,4,1,19,3
3,4,2,19,3
3,4,3,19,3
3,4,4,19,3
3,4,5,19,3
3,4,6,19,3
3,4,7,19,3
3,4,8,19,3
3,4,9,19,3
3,4,10,19,3
3,4,11,19,3
3,4,12,19,3
3,4,13,19,3
3,4,14,19,3
3,4,15,19,3
3,5,0,19,3
3,5,1,19,3
3,5,2,19,3
3,5,3,19,3
3,5,4,19,3
3,5,5,19,3
3,5,6,19,3
3,5,7,19,3
3,5,8,19,3
3,5,9,19,3
3,5,10,19,3
3,5,11,19,3
3,5,12,19,3
3,5,13,19,3
3,5,14,19,3
3,5,15,19,3
3,0,0,20,3
3,0,1,20,3
3,0,2,20,3
3,0,3,20,3
3,0,4,20,3
3,0,5,20,3
3,0,6,20,3
3,0,7,20,3
3,0,8,20,3
3,0,9,20,3
3,0,10,20,3
3,0,11,20,3
3,0,12,20,3
3,0,13,20,3
3,0,14,20,3
3,0,15,20,3
3,1,0,20,3
3,1,1,20,3
3,1,2,20,3
3,1,3,20,3
3,1,4,20,3
3,1,5,20,3
3,1,6,20,3
3,1,7,20,3
3,1,8,20,3
3,1,9,20,3
3,1,10,20,3
3,1,11,20,3
3,1,12,20,3
3,1,13,20,3
3,1,14,20,3
3,1,15,20,3
3,2,0,20,3
3,2,1,20,3
3,2,2,20,3
3,2,3,20,3
3,2,4,20,3
3,2,5,20,3
3,2,6,20,3
3,2,7,20,3
3,2,8,20,3
3,2,9,20,3
3,2,10,20,3
3,2,11,20,3
3,2,12,20,3
3,2,13,20,3
3,2,14,20,3
3,2,15,20,3
3,3,0,20,3
3,3,1,20,3
3,3,2,20,3
3,3,3,20,3
3,3,4,20,3
3,3,5,20,3
3,3,6,20,3
3,3,7,20,3
3,3,8,20,3
3,3,9,20,3
3,3,10,20,3
3,3,11,20,3
3,3,12,20,3
3,3,13,20,3
3,3,14,20,3
3,3,15,20,3
3,4,0,20,3
3,4,1,20,3
3,4,2,20,3
3,4,3,20,3
3,4,4,20,3
3,4,5,20,3
3,4,6,20,3
3,4,7,20,3
3,4,8,20,3
3,4,9,20,3
3,4,10,20,3
3,4,11,20,3
3,4,12,20,3
3,4,13,20,3
3,4,14,20,3
3,4,15,20,3
3,0,0,21,3
3,0,1,21,3
3,0,2,21,3
3,0,3,21,3
3,0,4,21,3
3,0,5,21,3
3,0,6,21,3
3,0,7,21,3
3,0,8,21,3
3,0,9,21,3
3,0,10,21,3
3,0,11,21,3
3,0,12,21,3
3,0,13,21,3
3,0,14,21,3
3,0,15,21,3
3,1,0,21,3
3,1,1,21,3
3,1,2,21,3
3,1,3,21,3
3,1,4,21,3
3,1,5,21,3
3,1,6,21,3
3,1,7,21,3
3,1,8,21,3
3,1,9,21,3
3,1,10,21,3
3,1,11,21,3
3,1,12,21,3
3,1,13,21,3
3,1,14,21,3
3,1,15,21,3
3,2,0,21,3
3,2,1,21,3
3,2,2,21,3
3,2,3,21,3
3,2,4,21,3
3,2,5,21,3
3,2,6,21,3
3,2,7,21,3
3,2,8,21,3
3,2,9,21,3
3,2,10,21,3
3,2,11,21,3
3,2,12,21,3
3,2,13,21,3
3,2,14,21,3
3,2,15,21,3
3,3,0,21,3
3,3,1,21,3
3,3,2,21,3
3,3,3,21,3
3,3,4,21,3
3,3,5,21,3
3,3,6,21,3
3,3,7,21,3
3,3,8,21,3
3,3,9,21,3
3,3,10,21,3
3,3,11,21,3
3,3,12,21,3
3,3,13,21,3
3,3,14,21,3
3,3,15,21,3
3,0,0,22,3
3,0,1,22,3
3,0,2,22,3
3,0,3,22,3
3,0,4,22,3
3,0,5,22,3
3,0,6,22,3
3,0,7,22,3
3,0,8,22,3
3,0,9,22,3
3,0,10,22,3
3,0,11,22,3
3,0,12,22,3
3,0,13,22,3
3,0,14,22,3
3,0,15,22,3
3,1,0,22,3
3,1,1,22,3
3,1,2,22,3
3,1,3,22,3
3,1,4,22,3
3,1,5,22,3
3,1,6,22,3
3,1,7,22,3
3,1,8,22,3
3,1,9,22,3
3,1,10,22,3
3,1,11,22,3
3,1,12,22,3
3,1,13,22,3
3,1,14,22,3
3,1,15,22,3
3,2,0,22,3
3,2,1,22,3
3,2,2,22,3
3,2,3,22,3
3,2,4,22,3
3,2,5,22,3
3,2,6,22,3
3,2,7,22,3
3,2,8,22,3
3,2,9,22,3
3,2,10,22,3
3,2,11,22,3
3,2,12,22,3
3,2,13,22,3
3,2,14,22,3
3,2,15,22,3
3,0,0,23,3
3,0,1,23,3
3,0,2,23,3
3,0,3,23,3
3,0,4,23,3
3,0,5,23,3
3,0,6,23,3
3,0,7,23,3
3,0,8,23,3
3,0,9,23,3
3,0,10,23,3
3,0,11,23,3
3,0,12,23,3
3,0,13,23,3
3,0,14,23,3
3,0,15,23,3
3,1,0,23,3
3,1,1,23,3
3,1,2,23,3
3,1,3,23,3
3,1,4,23,3
3,1,5,23,3
3,1,6,23,3
3,1,7,23,3
3,1,8,23,3
3,1,9,23,3
3,1,10,23,3
3,1,11,23,3
3,1,12,23,3
3,1,13,23,3
3,1,14,23,3
3,1,15,23,3
3,0,0,24,3
3,0,1,24,3
3,0,2,24,3
3,0,3,24,3
3,0,4,24,3
3,0,5,24,3
3,0,6,24,3
3,0,7,24,3
3,0,8,24,3
3,0,9,24,3
3,0,10,24,3
3,0,11,24,3
3,0,12,24,3
3,0,13,24,3
3,0,14,24,3
3,0,15,24,3
3,0,0,1,4
3,0,1,1,4
3,0,2,1,4
3,0,3,1,4
3,0,4,1,4
3,0,5,1,4
3,0,6,1,4
3,0,7,1,4
3,0,8,1,4
3,0,9,1,4
3,0,10,1,4
3,0,11,1,4
3,0,12,1,4
3,1,0,1,4
3,1,1,1,4
3,1,2,1,4
3,1,3,1,4
3,1,4,1,4
3,1,5,1,4
3,1,6,1,4
3,1,7,1,4
3,1,8,1,4
3,1,9,1,4
3,1,10,1,4
3,1,11,1,4
3,1,12,1,4
3,2,0,1,4
3,2,1,1,4
3,2,2,1,4
3,2,3,1,4
3,2,4,1,4
3,2,5,1,4
3,2,6,1,4
3,2,7,1,4
3,2,8,1,4
3,2,9,1,4
3,2,10,1,4
3,2,11,1,4
3,2,12,1,4
3,3,0,1,4
3,3,1,1,4
3,3,2,1,4
3,3,3,1,4
3,3,4,1,4
3,3,5,1,4
3,3,6,1,4
3,3,7,1,4
3,3,8,1,4
3,3,9,1,4
3,3,10,1,4
3,3,11,1,4
3,3,12,1,4
3,4,0,1,4
3,4,1,1,4
3,4,2,1,4
3,4,3,1,4
3,4,4,1,4
3,4,5,1,4
3,4,6,1,4
3,4,7,1,4
3,4,8,1,4
3,4,9,1,4
3,4,10,1,4
3,4,11,1,4
3,4,12,1,4
3,5,0,1,4
3,5,1,1,4
3,5,2,1,4
3,5,3,1,4
3,5,4,1,4
3,5,5,1,4
3,5,6,1,4
3,5,7,1,4
3,5,8,1,4
3,5,9,1,4
3,5,10,1,4
3,5,11,1,4
3,5,12,1,4
3,6,0,1,4
3,6,1,1,4
3,6,2,1,4
3,6,3,1,4
3,6,4,1,4
3,6,5,1,4
3,6,6,1,4
3,6,7,1,4
3,6,8,1,4
3,6,9,1,4
3,6,10,1,4
3,6,11,1,4
3,6,12,1,4
3,7,0,1,4
3,7,1,1,4
3,7,2,1,4
3,7,3,1,4
3,7,4,1,4
3,7,5,1,4
3,7,6,1,4
3,7,7,1,4
3,7,8,1,4
3,7,9,1,4
3,7,10,1,4
3,7,11,1,4
3,7,12,1,4
3,8,0,1,4
3,8,1,1,4
3,8,2,1,4
3,8,3,1,4
3,8,4,1,4
3,8,5,1,4
3,8,6,1,4
3,8,7,1,4
3,8,8,1,4
3,8,9,1,4
3,8,10,1,4
3,8,11,1,4
3,8,12,1,4
3,9,0,1,4
3,9,1,1,4
3,9,2,1,4
3,9,3,1,4
3,9,4,1,4
3,9,5,1,4
3,9,6,1,4
3,9,7,1,4
3,9,8,1,4
3,9,9,1,4
3,9,10,1,4
3,9,11,1,4
3,9,12,1,4
3,10,0,1,4
3,10,1,1,4
3,10,2,1,4
3,10,3,1,4
3,10,4,1,4
3,10,5,1,4
3,10,6,1,4
3,10,7,1,4
3,10,8,1,4
3,10,9,1,4
3,10,10,1,4
3,10,11,1,4
3,10,12,1,4
3,11,0,1,4
3,11,1,1,4
3,11,2,1,4
3,11,3,1,4
3,11,4,1,4
3,11,5,1,4
3,11,6,1,4
3,11,7,1,4
3,11,8,1,4
3,11,9,1,4
3,11,10,1,4
3,11,11,1,4
3,11,12,1,4
3,12,0,1,4
3,12,1,1,4
3,12,2,1,4
3,12,3,1,4
3,12,4,1,4
3,12,5,1,4
3,12,6,1,4
3,12,7,1,4
3,12,8,1,4
3,12,9,1,4
3,12,10,1,4
3,12,11,1,4
3,12,12,1,4
3,13,0,1,4
3,13,1,1,4
3,13,2,1,4
3,13,3,1,4
3,13,4,1,4
3,13,5,1,4
3,13,6,1,4
3,13,7,1,4
3,13,8,1,4
3,13,9,1,4
3,13,10,1,4
3,13,11,1,4
3,13,12,1,4
3,14,0,1,4
3,14,1,1,4
3,14,2,1,4
3,14,3,1,4
3,14,4,1,4
3,14,5,1,4
3,14,6,1,4
3,14,7,1,4
3,14,8,1,4
3,14,9,1,4
3,14,10,1,4
3,14,11,1,4
3,14,12,1,4
3,15,0,1,4
3,15,1,1,4
3,15,2,1,4
3,15,3,1,4
3,15,4,1,4
3,15,5,1,4
3,15,6,1,4
3,15,7,1,4
3,15,8,1,4
3,15,9,1,4
3,15,10,1,4
3,15,11,1,4
3,15,12,1,4
3,16,0,1,4
3,16,1,1,4
3,16,2,1,4
3,16,3,1,4
3,16,4,1,4
3,16,5,1,4
3,16,6,1,4
3,16,7,1,4
3,16,8,1,4
3,16,9,1,4
3,16,10,1,4
3,16,11,1,4
3,16,12,1,4
3,17,0,1,4
3,17,1,1,4
3,17,2,1,4
3,17,3,1,4
3,17,4,1,4
3,17,5,1,4
3,17,6,1,4
3,17,7,1,4
3,17,8,1,4
3,17,9,1,4
3,17,10,1,4
3,17,11,1,4
3,17,12,1,4
3,18,0,1,4
3,18,1,1,4
3,18,2,1,4
3,18,3,1,4
3,18,4,1,4
3,18,5,1,4
3,18,6,1,4
3,18,7,1,4
3,18,8,1,4
3,18,9,1,4
3,18,10,1,4
3,18,11,1,4
3,18,12,1,4
3,19,0,1,4
3,19,1,1,4
3,19,2,1,4
3,19,3,1,4
3,19,4,1,4
3,19,5,1,4
3,19,6,1,4
3,19,7,1,4
3,19,8,1,4
3,19,9,1,4
3,19,10,1,4
3,19,11,1,4
3,19,12,1,4
3,20,0,1,4
3,20,1,1,4
3,20,2,1,4
3,20,3,1,4
3,20,4,1,4
3,20,5,1,4
3,20,6,1,4
3,20,7,1,4
3,20,8,1,4
3,20,9,1,4
3,20,10,1,4
3,20,11,1,4
3,20,12,1,4
3,21,0,1,4
3,21,1,1,4
3,21,2,1,4
3,21,3,1,4
3,21,4,1,4
3,21,5,1,4
3,21,6,1,4
3,21,7,1,4
3,21,8,1,4
3,21,9,1,4
3,21,10,1,4
3,21,11,1,4
3,21,12,1,4
3,22,0,1,4
3,22,1,1,4
3,22,2,1,4
3,22,3,1,4
3,22,4,1,4
3,22,5,1,4
3,22,6,1,4
3,22,7,1,4
3,22,8,1,4
3,22,9,1,4
3,22,10,1,4
3,22,11,1,4
3,22,12,1,4
3,23,0,1,4
3,23,1,1,4
3,23,2,1,4
3,23,3,1,4
3,23,4,1,4
3,23,5,1,4
3,23,6,1,4
3,23,7,1,4
3,23,8,1,4
3,23,9,1,4
3,23,10,1,4
3,23,11,1,4
3,23,12,1,4
3,0,0,2,4
3,0,1,2,4
3,0,2,2,4
3,0,3,2,4
3,0,4,2,4
3,0,5,2,4
3,0,6,2,4
3,0,7,2,4
3,0,8,2,4
3,0,9,2,4
3,0,10,2,4
3,0,11,2,4
3,0,12,2,4
3,1,0,2,4
3,1,1,2,4
3,1,2,2,4
3,1,3,2,4
3,1,4,2,4
3,1,5,2,4
3,1,6,2,4
3,1,7,2,4
3,1,8,2,4
3,1,9,2,4
3,1,10,2,4
3,1,11,2,4
3,1,12,2,4
3,2,0,2,4
3,2,1,2,4
3,2,2,2,4
3,2,3,2,4
3,2,4,2,4
3,2,5,2,4
3,2,6,2,4
3,2,7,2,4
3,2,8,2,4
3,2,9,2,4
3,2,10,2,4
3,2,11,2,4
3,2,12,2,4
3,3,0,2,4
3,3,1,2,4
3,3,2,2,4
3,3,3,2,4
3,3,4,2,4
3,3,5,2,4
3,3,6,2,4
3,3,7,2,4
3,3,8,2,4
3,3,9,2,4
3,3,10,2,4
3,3,11,2,4
3,3,12,2,4
3,4,0,2,4
3,4,1,2,4
3,4,2,2,4
3,4,3,2,4
3,4,4,2,4
3,4,5,2,4
3,4,6,2,4
3,4,7,2,4
3,4,8,2,4
3,4,9,2,4
3,4,10,2,4
3,4,11,2,4
3,4,12,2,4
3,5,0,2,4
3,5,1,2,4
3,5,2,2,4
3,5,3,2,4
3,5,4,2,4
3,5,5,2,4
3,5,6,2,4
3,5,7,2,4
3,5,8,2,4
3,5,9,2,4
3,5,10,2,4
3,5,11,2,4
3,5,12,2,4
3,6,0,2,4
3,6,1,2,4
3,6,2,2,4
3,6,3,2,4
3,6,4,2,4
3,6,5,2,4
3,6,6,2,4
3,6,7,2,4
3,6,8,2,4
3,6,9,2,4
3,6,10,2,4
3,6,11,2,4
3,6,12,2,4
3,7,0,2,4
3,7,1,2,4
3,7,2,2,4
3,7,3,2,4
3,7,4,2,4
3,7,5,2,4
3,7,6,2,4
3,7,7,2,4
3,7,8,2,4
3,7,9,2,4
3,7,10,2,4
3,7,11,2,4
3,7,12,2,4
3,8,0,2,4
3,8,1,2,4
3,8,2,2,4
3,8,3,2,4
3,8,4,2,4
3,8,5,2,4
3,8,6,2,4
3,8,7,2,4
3,8,8,2,4
3,8,9,2,4
3,8,10,2,4
3,8,11,2,4
3,8,12,2,4
3,9,0,2,4
3,9,1,2,4
3,9,2,2,4
3,9,3,2,4
3,9,4,2,4
3,9,5,2,4
3,9,6,2,4
3,9,7,2,4
3,9,8,2,4
3,9,9,2,4
3,9,10,2,4
3,9,11,2,4
3,9,12,2,4
3,10,0,2,4
3,10,1,2,4
3,10,2,2,4
3,10,3,2,4
3,10,4,2,4
3,10,5,2,4
3,10,6,2,4
3,10,7,2,4
3,10,8,2,4
3,10,9,2,4
3,10,10,2,4
3,10,11,2,4
3,10,12,2,4
3,11,0,2,4
3,11,1,2,4
3,11,2,2,4
3,11,3,2,4
3,11,4,2,4
3,11,5,2,4
3,11,6,2,4
3,11,7,2,4
3,11,8,2,4
3,11,9,2,4
3,11,10,2,4
3,11,11,2,4
3,11,12,2,4
3,12,0,2,4
3,12,1,2,4
3,12,2,2,4
3,12,3,2,4
3,12,4,2,4
3,12,5,2,4
3,12,6,2,4
3,12,7,2,4
3,12,8,2,4
3,12,9,2,4
3,12,10,2,4
3,12,11,2,4
3,12,12,2,4
3,13,0,2,4
3,13,1,2,4
3,13,2,2,4
3,13,3,2,4
3,13,4,2,4
3,13,5,2,4
3,13,6,2,4
3,13,7,2,4
3,13,8,2,4
3,13,9,2,4
3,13,10,2,4
3,13,11,2,4
3,13,12,2,4
3,14,0,2,4
3,14,1,2,4
3,14,2,2,4
3,14,3,2,4
3,14,4,2,4
3,14,5,2,4
3,14,6,2,4
3,14,7,2,4
3,14,8,2,4
3,14,9,2,4
3,14,10,2,4
3,14,11,2,4
3,14,12,2,4
3,15,0,2,4
3,15,1,2,4
3,15,2,2,4
3,15,3,2,4
3,15,4,2,4
3,15,5,2,4
3,15,6,2,4
3,15,7,2,4
3,15,8,2,4
3,15,9,2,4
3,15,10,2,4
3,15,11,2,4
3,15,12,2,4
3,16,0,2,4
3,16,1,2,4
3,16,2,2,4
3,16,3,2,4
3,16,4,2,4
3,16,5,2,4
3,16,6,2,4
3,16,7,2,4
3,16,8,2,4
3,16,9,2,4
3,16,10,2,4
3,16,11,2,4
3,16,12,2,4
3,17,0,2,4
3,17,1,2,4
3,17,2,2,4
3,17,3,2,4
3,17,4,2,4
3,17,5,2,4
3,17,6,2,4
3,17,7,2,4
3,17,8,2,4
3,17,9,2,4
3,17,10,2,4
3,17,11,2,4
3,17,12,2,4
3,18,0,2,4
3,18,1,2,4
3,18,2,2,4
3,18,3,2,4
3,18,4,2,4
3,18,5,2,4
3,18,6,2,4
3,18,7,2,4
3,18,8,2,4
3,18,9,2,4
3,18,10,2,4
3,18,11,2,4
3,18,12,2,4
3,19,0,2,4
3,19,1,2,4
3,19,2,2,4
3,19,3,2,4
3,19,4,2,4
3,19,5,2,4
3,19,6,2,4
3,19,7,2,4
3,19,8,2,4
3,19,9,2,4
3,19,10,2,4
3,19,11,2,4
3,19,12,2,4
3,20,0,2,4
3,20,1,2,4
3,20,2,2,4
3,20,3,2,4
3,20,4,2,4
3,20,5,2,4
3,20,6,2,4
3,20,7,2,4
3,20,8,2,4
3,20,9,2,4
3,20,10,2,4
3,20,11,2,4
3,20,12,2,4
3,21,0,2,4
3,21,1,2,4
3,21,2,2,4
3,21,3,2,4
3,21,4,2,4
3,21,5,2,4
3,21,6,2,4
3,21,7,2,4
3,21,8,2,4
3,21,9,2,4
3,21,10,2,4
3,21,11,2,4
3,21,12,2,4
3,22,0,2,4
3,22,1,2,4
3,22,2,2,4
3,22,3,2,4
3,22,4,2,4
3,22,5,2,4
3,22,6,2,4
3,22,7,2,4
3,22,8,2,4
3,22,9,2,4
3,22,10,2,4
3,22,11,2,4
3,22,12,2,4
3,0,0,3,4
3,0,1,3,4
3,0,2,3,4
3,0,3,3,4
3,0,4,3,4
3,0,5,3,4
3,0,6,3,4
3,0,7,3,4
3,0,8,3,4
3,0,9,3,4
3,0,10,3,4
3,0,11,3,4
3,0,12,3,4
3,1,0,3,4
3,1,1,3,4
3,1,2,3,4
3,1,3,3,4
3,1,4,3,4
3,1,5,3,4
3,1,6,3,4
3,1,7,3,4
3,1,8,3,4
3,1,9,3,4
3,1,10,3,4
3,1,11,3,4
3,1,12,3,4
3,2,0,3,4
3,2,1,3,4
3,2,2,3,4
3,2,3,3,4
3,2,4,3,4
3,2,5,3,4
3,2,6,3,4
3,2,7,3,4
3,2,8,3,4
3,2,9,3,4
3,2,10,3,4
3,2,11,3,4
3,2,12,3,4
3,3,0,3,4
3,3,1,3,4
3,3,2,3,4
3,3,3,3,4
3,3,4,3,4
3,3,5,3,4
3,3,6,3,4
3,3,7,3,4
3,3,8,3,4
3,3,9,3,4
3,3,10,3,4
3,3,11,3,4
3,3,12,3,4
3,4,0,3,4
3,4,1,3,4
3,4,2,3,4
3,4,3,3,4
3,4,4,3,4
3,4,5,3,4
3,4,6,3,4
3,4,7,3,4
3,4,8,3,4
3,4,9,3,4
3,4,10,3,4
3,4,11,3,4
3,4,12,3,4
3,5,0,3,4
3,5,1,3,4
3,5,2,3,4
3,5,3,3,4
3,5,4,3,4
3,5,5,3,4
3,5,6,3,4
3,5,7,3,4
3,5,8,3,4
3,5,9,3,4
3,5,10,3,4
3,5,11,3,4
3,5,12,3,4
3,6,0,3,4
3,6,1,3,4
3,6,2,3,4
3,6,3,3,4
3,6,4,3,4
3,6,5,3,4
3,6,6,3,4
3,6,7,3,4
3,6,8,3,4
3,6,9,3,4
3,6,10,3,4
3,6,11,3,4
3,6,12,3,4
3,7,0,3,4
3,7,1,3,4
3,7,2,3,4
3,7,3,3,4
3,7,4,3,4
3,7,5,3,4
3,7,6,3,4
3,7,7,3,4
3,7,8,3,4
3,7,9,3,4
3,7,10,3,4
3,7,11,3,4
3,7,12,3,4
3,8,0,3,4
3,8,1,3,4
3,8,2,3,4
3,8,3,3,4
3,8,4,3,4
3,8,5,3,4
3,8,6,3,4
3,8,7,3,4
3,8,8,3,4
3,8,9,3,4
3,8,10,3,4
3,8,11,3,4
3,8,12,3,4
3,9,0,3,4
3,9,1,3,4
3,9,2,3,4
3,9,3,3,4
3,9,4,3,4
3,9,5,3,4
3,9,6,3,4
3,9,7,3,4
3,9,8,3,4
3,9,9,3,4
3,9,10,3,4
3,9,11,3,4
3,9,12,3,4
3,10,0,3,4
3,10,1,3,4
3,10,2,3,4
3,10,3,3,4
3,10,4,3,4
3,10,5,3,4
3,10,6,3,4
3,10,7,3,4
3,10,8,3,4
3,10,9,3,4
3,10,10,3,4
3,10,11,3,4
3,10,12,3,4
3,11,0,3,4
3,11,1,3,4
3,11,2,3,4
3,11,3,3,4
3,11,4,3,4
3,11,5,3,4
3,11,6,3,4
3,11,7,3,4
3,11,8,3,4
3,11,9,3,4
3,11,10,3,4
3,11,11,3,4
3,11,12,3,4
3,12,0,3,4
3,12,1,3,4
3,12,2,3,4
3,12,3,3,4
3,12,4,3,4
3,12,5,3,4
3,12,6,3,4
3,12,7,3,4
3,12,8,3,4
3,12,9,3,4
3,12,10,3,4
3,12,11,3,4
3,12,12,3,4
3,13,0,3,4
3,13,1,3,4
3,13,2,3,4
3,13,3,3,4
3,13,4,3,4
3,13,5,3,4
3,13,6,3,4
3,13,7,3,4
3,13,8,3,4
3,13,9,3,4
3,13,10,3,4
3,13,11,3,4
3,13,12,3,4
3,14,0,3,4
3,14,1,3,4
3,14,2,3,4
3,14,3,3,4
3,14,4,3,4
3,14,5,3,4
3,14,6,3,4
3,14,7,3,4
3,14,8,3,4
3,14,9,3,4
3,14,10,3,4
3,14,11,3,4
3,14,12,3,4
3,15,0,3,4
3,15,1,3,4
3,15,2,3,4
3,15,3,3,4
3,15,4,3,4
3,15,5,3,4
3,15,6,3,4
3,15,7,3,4
3,15,8,3,4
3,15,9,3,4
3,15,10,3,4
3,15,11,3,4
3,15,12,3,4
3,16,0,3,4
3,16,1,3,4
3,16,2,3,4
3,16,3,3,4
3,16,4,3,4
3,16,5,3,4
3,16,6,3,4
3,16,7,3,4
3,16,8,3,4
3,16,9,3,4
3,16,10,3,4
3,16,11,3,4
3,16,12,3,4
3,17,0,3,4
3,17,1,3,4
3,17,2,3,4
3,17,3,3,4
3,17,4,3,4
3,17,5,3,4
3,17,6,3,4
3,17,7,3,4
3,17,8,3,4
3,17,9,3,4
3,17,10,3,4
3,17,11,3,4
3,17,12,3,4
3,18,0,3,4
3,18,1,3,4
3,18,2,3,4
3,18,3,3,4
3,18,4,3,4
3,18,5,3,4
3,18,6,3,4
3,18,7,3,4
3,18,8,3,4
3,18,9,3,4
3,18,10,3,4
3,18,11,3,4
3,18,12,3,4
3,19,0,3,4
3,19,1,3,4
3,19,2,3,4
3,19,3,3,4
3,19,4,3,4
3,19,5,3,4
3,19,6,3,4
3,19,7,3,4
3,19,8,3,4
3,19,9,3,4
3,19,10,3,4
3,19,11,3,4
3,19,12,3,4
3,20,0,3,4
3,20,1,3,4
3,20,2,3,4
3,20,3,3,4
3,20,4,3,4
3,20,5,3,4
3,20,6,3,4
3,20,7,3,4
3,20,8,3,4
3,20,9,3,4
3,20,10,3,4
3,20,11,3,4
3,20,12,3,4
3,21,0,3,4
3,21,1,3,4
3,21,2,3,4
3,21,3,3,4
3,21,4,3,4
3,21,5,3,4
3,21,6,3,4
3,21,7,3,4
3,21,8,3,4
3,21,9,3,4
3,21,10,3,4
3,21,11,3,4
3,21,12,3,4
3,0,0,4,4
3,0,1,4,4
3,0,2,4,4
3,0,3,4,4
3,0,4,4,4
3,0,5,4,4
3,0,6,4,4
3,0,7,4,4
3,0,8,4,4
3,0,9,4,4
3,0,10,4,4
3,0,11,4,4
3,0,12,4,4
3,1,0,4,4
3,1,1,4,4
3,1,2,4,4
3,1,3,4,4
3,1,4,4,4
3,1,5,4,4
3,1,6,4,4
3,1,7,4,4
3,1,8,4,4
3,1,9,4,4
3,1,10,4,4
3,1,11,4,4
3,1,12,4,4
3,2,0,4,4
3,2,1,4,4
3,2,2,4,4
3,2,3,4,4
3,2,4,4,4
3,2,5,4,4
3,2,6,4,4
3,2,7,4,4
3,2,8,4,4
3,2,9,4,4
3,2,10,4,4
3,2,11,4,4
3,2,12,4,4
3,3,0,4,4
3,3,1,4,4
3,3,2,4,4
3,3,3,4,4
3,3,4,4,4
3,3,5,4,4
3,3,6,4,4
3,3,7,4,4
3,3,8,4,4
3,3,9,4,4
3,3,10,4,4
3,3,11,4,4
3,3,12,4,4
3,4,0,4,4
3,4,1,4,4
3,4,2,4,4
3,4,3,4,4
3,4,4,4,4
3,4,5,4,4
3,4,6,4,4
3,4,7,4,4
3,4,8,4,4
3,4,9,4,4
3,4,10,4,4
3,4,11,4,4
3,4,12,4,4
3,5,0,4,4
3,5,1,4,4
3,5,2,4,4
3,5,3,4,4
3,5,4,4,4
3,5,5,4,4
3,5,6,4,4
3,5,7,4,4
3,5,8,4,4
3,5,9,4,4
3,5,10,4,4
3,5,11,4,4
3,5,12,4,4
3,6,0,4,4
3,6,1,4,4
3,6,2,4,4
3,6,3,4,4
3,6,4,4,4
3,6,5,4,4
3,6,6,4,4
3,6,7,4,4
3,6,8,4,4
3,6,9,4,4
3,6,10,4,4
3,6,11,4,4
3,6,12,4,4
3,7,0,4,4
3,7,1,4,4
3,7,2,4,4
3,7,3,4,4
3,7,4,4,4
3,7,5,4,4
3,7,6,4,4
3,7,7,4,4
3,7,8,4,4
3,7,9,4,4
3,7,10,4,4
3,7,11,4,4
3,7,12,4,4
3,8,0,4,4
3,8,1,4,4
3,8,2,4,4
3,8,3,4,4
3,8,4,4,4
3,8,5,4,4
3,8,6,4,4
3,8,7,4,4
3,8,8,4,4
3,8,9,4,4
3,8,10,4,4
3,8,11,4,4
3,8,12,4,4
3,9,0,4,4
3,9,1,4,4
3,9,2,4,4
3,9,3,4,4
3,9,4,4,4
3,9,5,4,4
3,9,6,4,4
3,9,7,4,4
3,9,8,4,4
3,9,9,4,4
3,9,10,4,4
3,9,11,4,4
3,9,12,4,4
3,10,0,4,4
3,10,1,4,4
3,10,2,4,4
3,10,3,4,4
3,10,4,4,4
3,10,5,4,4
3,10,6,4,4
3,10,7,4,4
3,10,8,4,4
3,10,9,4,4
3,10,10,4,4
3,10,11,4,4
3,10,12,4,4
3,11,0,4,4
3,11,1,4,4
3,11,2,4,4
3,11,3,4,4
3,11,4,4,4
3,11,5,4,4
3,11,6,4,4
3,11,7,4,4
3,11,8,4,4
3,11,9,4,4
3,11,10,4,4
3,11,11,4,4
3,11,12,4,4
3,12,0,4,4
3,12,1,4,4
3,12,2,4,4
3,12,3,4,4
3,12,4,4,4
3,12,5,4,4
3,12,6,4,4
3,12,7,4,4
3,12,8,4,4
3,12,9,4,4
3,12,10,4,4
3,12,11,4,4
3,12,12,4,4
3,13,0,4,4
3,13,1,4,4
3,13,2,4,4
3,13,3,4,4
3,13,4,4,4
3,13,5,4,4
3,13,6,4,4
3,13,7,4,4
3,13,8,4,4
3,13,9,4,4
3,13,10,4,4
3,13,11,4,4
3,13,12,4,4
3,14,0,4,4
3,14,1,4,4
3,14,2,4,4
3,14,3,4,4
3,14,4,4,4
3,14,5,4,4
3,14,6,4,4
3,14,7,4,4
3,14,8,4,4
3,14,9,4,4
3,14,10,4,4
3,14,11,4,4
3,14,12,4,4
3,15,0,4,4
3,15,1,4,4
3,15,2,4,4
3,15,3,4,4
3,15,4,4,4
3,15,5,4,4
3,15,6,4,4
3,15,7,4,4
3,15,8,4,4
3,15,9,4,4
3,15,10,4,4
3,15,11,4,4
3,15,12,4,4
3,16,0,4,4
3,16,1,4,4
3,16,2,4,4
3,16,3,4,4
3,16,4,4,4
3,16,5,4,4
3,16,6,4,4
3,16,7,4,4
3,16,8,4,4
3,16,9,4,4
3,16,10,4,4
3,16,11,4,4
3,16,12,4,4
3,17,0,4,4
3,17,1,4,4
3,17,2,4,4
3,17,3,4,4
3,17,4,4,4
3,17,5,4,4
3,17,6,4,4
3,17,7,4,4
3,17,8,4,4
3,17,9,4,4
3,17,10,4,4
3,17,11,4,4
3,17,12,4,4
3,18,0,4,4
3,18,1,4,4
3,18,2,4,4
3,18,3,4,4
3,18,4,4,4
3,18,5,4,4
3,18,6,4,4
3,18,7,4,4
3,18,8,4,4
3,18,9,4,4
3,18,10,4,4
3,18,11,4,4
3,18,12,4,4
3,19,0,4,4
3,19,1,4,4
3,19,2,4,4
3,19,3,4,4
3,19,4,4,4
3,19,5,4,4
3,19,6,4,4
3,19,7,4,4
3,19,8,4,4
3,19,9,4,4
3,19,10,4,4
3,19,11,4,4
3,19,12,4,4
3,20,0,4,4
3,20,1,4,4
3,20,2,4,4
3,20,3,4,4
3,20,4,4,4
3,20,5,4,4
3,20,6,4,4
3,20,7,4,4
3,20,8,4,4
3,20,9,4,4
3,20,10,4,4
3,20,11,4,4
3,20,12,4,4
3,0,0,5,4
3,0,1,5,4
3,0,2,5,4
3,0,3,5,4
3,0,4,5,4
3,0,5,5,4
3,0,6,5,4
3,0,7,5,4
3,0,8,5,4
3,0,9,5,4
3,0,10,5,4
3,0,11,5,4
3,0,12,5,4
3,1,0,5,4
3,1,1,5,4
3,1,2,5,4
3,1,3,5,4
3,1,4,5,4
3,1,5,5,4
3,1,6,5,4
3,1,7,5,4
3,1,8,5,4
3,1,9,5,4
3,1,10,5,4
3,1,11,5,4
3,1,12,5,4
3,2,0,5,4
3,2,1,5,4
3,2,2,5,4
3,2,3,5,4
3,2,4,5,4
3,2,5,5,4
3,2,6,5,4
3,2,7,5,4
3,2,8,5,4
3,2,9,5,4
3,2,10,5,4
3,2,11,5,4
3,2,12,5,4
3,3,0,5,4
3,3,1,5,4
3,3,2,5,4
3,3,3,5,4
3,3,4,5,4
3,3,5,5,4
3,3,6,5,4
3,3,7,5,4
3,3,8,5,4
3,3,9,5,4
3,3,10,5,4
3,3,11,5,4
3,3,12,5,4
3,4,0,5,4
3,4,1,5,4
3,4,2,5,4
3,4,3,5,4
3,4,4,5,4
3,4,5,5,4
3,4,6,5,4
3,4,7,5,4
3,4,8,5,4
3,4,9,5,4
3,4,10,5,4
3,4,11,5,4
3,4,12,5,4
3,5,0,5,4
3,5,1,5,4
3,5,2,5,4
3,5,3,5,4
3,5,4,5,4
3,5,5,5,4
3,5,6,5,4
3,5,7,5,4
3,5,8,5,4
3,5,9,5,4
3,5,10,5,4
3,5,11,5,4
3,5,12,5,4
3,6,0,5,4
3,6,1,5,4
3,6,2,5,4
3,6,3,5,4
3,6,4,5,4
3,6,5,5,4
3,6,6,5,4
3,6,7,5,4
3,6,8,5,4
3,6,9,5,4
3,6,10,5,4
3,6,11,5,4
3,6,12,5,4
3,7,0,5,4
3,7,1,5,4
3,7,2,5,4
3,7,3,5,4
3,7,4,5,4
3,7,5,5,4
3,7,6,5,4
3,7,7,5,4
3,7,8,5,4
3,7,9,5,4
3,7,10,5,4
3,7,11,5,4
3,7,12,5,4
3,8,0,5,4
3,8,1,5,4
3,8,2,5,4
3,8,3,5,4
3,8,4,5,4
3,8,5,5,4
3,8,6,5,4
3,8,7,5,4
3,8,8,5,4
3,8,9,5,4
3,8,10,5,4
3,8,11,5,4
3,8,12,5,4
3,9,0,5,4
3,9,1,5,4
3,9,2,5,4
3,9,3,5,4
3,9,4,5,4
3,9,5,5,4
3,9,6,5,4
3,9,7,5,4
3,9,8,5,4
3,9,9,5,4
3,9,10,5,4
3,9,11,5,4
3,9,12,5,4
3,10,0,5,4
3,10,1,5,4
3,10,2,5,4
3,10,3,5,4
3,10,4,5,4
3,10,5,5,4
3,10,6,5,4
3,10,7,5,4
3,10,8,5,4
3,10,9,5,4
3,10,10,5,4
3,10,11,5,4
3,10,12,5,4
3,11,0,5,4
3,11,1,5,4
3,11,2,5,4
3,11,3,5,4
3,11,4,5,4
3,11,5,5,4
3,11,6,5,4
3,11,7,5,4
3,11,8,5,4
3,11,9,5,4
3,11,10,5,4
3,11,11,5,4
3,11,12,5,4
3,12,0,5,4
3,12,1,5,4
3,12,2,5,4
3,12,3,5,4
3,12,4,5,4
3,12,5,5,4
3,12,6,5,4
3,12,7,5,4
3,12,8,5,4
3,12,9,5,4
3,12,10,5,4
3,12,11,5,4
3,12,12,5,4
3,13,0,5,4
3,13,1,5,4
3,13,2,5,4
3,13,3,5,4
3,13,4,5,4
3,13,5,5,4
3,13,6,5,4
3,13,7,5,4
3,13,8,5,4
3,13,9,5,4
3,13,10,5,4
3,13,11,5,4
3,13,12,5,4
3,14,0,5,4
3,14,1,5,4
3,14,2,5,4
3,14,3,5,4
3,14,4,5,4
3,14,5,5,4
3,14,6,5,4
3,14,7,5,4
3,14,8,5,4
3,14,9,5,4
3,14,10,5,4
3,14,11,5,4
3,14,12,5,4
3,15,0,5,4
3,15,1,5,4
3,15,2,5,4
3,15,3,5,4
3,15,4,5,4
3,15,5,5,4
3,15,6,5,4
3,15,7,5,4
3,15,8,5,4
3,15,9,5,4
3,15,10,5,4
3,15,11,5,4
3,15,12,5,4
3,16,0,5,4
3,16,1,5,4
3,16,2,5,4
3,16,3,5,4
3,16,4,5,4
3,16,5,5,4
3,16,6,5,4
3,16,7,5,4
3,16,8,5,4
3,16,9,5,4
3,16,10,5,4
3,16,11,5,4
3,16,12,5,4
3,17,0,5,4
3,17,1,5,4
3,17,2,5,4
3,17,3,5,4
3,17,4,5,4
3,17,5,5,4
3,17,6,5,4
3,17,7,5,4
3,17,8,5,4
3,17,9,5,4
3,17,10,5,4
3,17,11,5,4
3,17,12,5,4
3,18,0,5,4
3,18,1,5,4
3,18,2,5,4
3,18,3,5,4
3,18,4,5,4
3,18,5,5,4
3,18,6,5,4
3,18,7,5,4
3,18,8,5,4
3,18,9,5,4
3,18,10,5,4
3,18,11,5,4
3,18,12,5,4
3,19,0,5,4
3,19,1,5,4
3,19,2,5,4
3,19,3,5,4
3,19,4,5,4
3,19,5,5,4
3,19,6,5,4
3,19,7,5,4
3,19,8,5,4
3,19,9,5,4
3,19,10,5,4
3,19,11,5,4
3,19,12,5,4
3,0,0,6,4
3,0,1,6,4
3,0,2,6,4
3,0,3,6,4
3,0,4,6,4
3,0,5,6,4
3,0,6,6,4
3,0,7,6,4
3,0,8,6,4
3,0,9,6,4
3,0,10,6,4
3,0,11,6,4
3,0,12,6,4
3,1,0,6,4
3,1,1,6,4
3,1,2,6,4
3,1,3,6,4
3,1,4,6,4
3,1,5,6,4
3,1,6,6,4
3,1,7,6,4
3,1,8,6,4
3,1,9,6,4
3,1,10,6,4
3,1,11,6,4
3,1,12,6,4
3,2,0,6,4
3,2,1,6,4
3,2,2,6,4
3,2,3,6,4
3,2,4,6,4
3,2,5,6,4
3,2,6,6,4
3,2,7,6,4
3,2,8,6,4
3,2,9,6,4
3,2,10,6,4
3,2,11,6,4
3,2,12,6,4
3,3,0,6,4
3,3,1,6,4
3,3,2,6,4
3,3,3,6,4
3,3,4,6,4
3,3,5,6,4
3,3,6,6,4
3,3,7,6,4
3,3,8,6,4
3,3,9,6,4
3,3,10,6,4
3,3,11,6,4
3,3,12,6,4
3,4,0,6,4
3,4,1,6,4
3,4,2,6,4
3,4,3,6,4
3,4,4,6,4
3,4,5,6,4
3,4,6,6,4
3,4,7,6,4
3,4,8,6,4
3,4,9,6,4
3,4,10,6,4
3,4,11,6,4
3,4,12,6,4
3,5,0,6,4
3,5,1,6,4
3,5,2,6,4
3,5,3,6,4
3,5,4,6,4
3,5,5,6,4
3,5,6,6,4
3,5,7,6,4
3,5,8,6,4
3,5,9,6,4
3,5,10,6,4
3,5,11,6,4
3,5,12,6,4
3,6,0,6,4
3,6,1,6,4
3,6,2,6,4
3,6,3,6,4
3,6,4,6,4
3,6,5,6,4
3,6,6,6,4
3,6,7,6,4
3,6,8,6,4
3,6,9,6,4
3,6,10,6,4
3,6,11,6,4
3,6,12,6,4
3,7,0,6,4
3,7,1,6,4
3,7,2,6,4
3,7,3,6,4
3,7,4,6,4
3,7,5,6,4
3,7,6,6,4
3,7,7,6,4
3,7,8,6,4
3,7,9,6,4
3,7,10,6,4
3,7,11,6,4
3,7,12,6,4
3,8,0,6,4
3,8,1,6,4
3,8,2,6,4
3,8,3,6,4
3,8,4,6,4
3,8,5,6,4
3,8,6,6,4
3,8,7,6,4
3,8,8,6,4
3,8,9,6,4
3,8,10,6,4
3,8,11,6,4
3,8,12,6,4
3,9,0,6,4
3,9,1,6,4
3,9,2,6,4
3,9,3,6,4
3,9,4,6,4
3,9,5,6,4
3,9,6,6,4
3,9,7,6,4
3,9,8,6,4
3,9,9,6,4
3,9,10,6,4
3,9,11,6,4
3,9,12,6,4
3,10,0,6,4
3,10,1,6,4
3,10,2,6,4
3,10,3,6,4
3,10,4,6,4
3,10,5,6,4
3,10,6,6,4
3,10,7,6,4
3,10,8,6,4
3,10,9,6,4
3,10,10,6,4
3,10,11,6,4
3,10,12,6,4
3,11,0,6,4
3,11,1,6,4
3,11,2,6,4
3,11,3,6,4
3,11,4,6,4
3,11,5,6,4
3,11,6,6,4
3,11,7,6,4
3,11,8,6,4
3,11,9,6,4
3,11,10,6,4
3,11,11,6,4
3,11,12,6,4
3,12,0,6,4
3,12,1,6,4
3,12,2,6,4
3,12,3,6,4
3,12,4,6,4
3,12,5,6,4
3,12,6,6,4
3,12,7,6,4
3,12,8,6,4
3,12,9,6,4
3,12,10,6,4
3,12,11,6,4
3,12,12,6,4
3,13,0,6,4
3,13,1,6,4
3,13,2,6,4
3,13,3,6,4
3,13,4,6,4
3,13,5,6,4
3,13,6,6,4
3,13,7,6,4
3,13,8,6,4
3,13,9,6,4
3,13,10,6,4
3,13,11,6,4
3,13,12,6,4
3,14,0,6,4
3,14,1,6,4
3,14,2,6,4
3,14,3,6,4
3,14,4,6,4
3,14,5,6,4
3,14,6,6,4
3,14,7,6,4
3,14,8,6,4
3,14,9,6,4
3,14,10,6,4
3,14,11,6,4
3,14,12,6,4
3,15,0,6,4
3,15,1,6,4
3,15,2,6,4
3,15,3,6,4
3,15,4,6,4
3,15,5,6,4
3,15,6,6,4
3,15,7,6,4
3,15,8,6,4
3,15,9,6,4
3,15,10,6,4
3,15,11,6,4
3,15,12,6,4
3,16,0,6,4
3,16,1,6,4
3,16,2,6,4
3,16,3,6,4
3,16,4,6,4
3,16,5,6,4
3,16,6,6,4
3,16,7,6,4
3,16,8,6,4
3,16,9,6,4
3,16,10,6,4
3,16,11,6,4
3,16,12,6,4
3,17,0,6,4
3,17,1,6,4
3,17,2,6,4
3,17,3,6,4
3,17,4,6,4
3,17,5,6,4
3,17,6,6,4
3,17,7,6,4
3,17,8,6,4
3,17,9,6,4
3,17,10,6,4
3,17,11,6,4
3,17,12,6,4
3,18,0,6,4
3,18,1,6,4
3,18,2,6,4
3,18,3,6,4
3,18,4,6,4
3,18,5,6,4
3,18,6,6,4
3,18,7,6,4
3,18,8,6,4
3,18,9,6,4
3,18,10,6,4
3,18,11,6,4
3,18,12,6,4
3,0,0,7,4
3,0,1,7,4
3,0,2,7,4
3,0,3,7,4
3,0,4,7,4
3,0,5,7,4
3,0,6,7,4
3,0,7,7,4
3,0,8,7,4
3,0,9,7,4
3,0,10,7,4
3,0,11,7,4
3,0,12,7,4
3,1,0,7,4
3,1,1,7,4
3,1,2,7,4
3,1,3,7,4
3,1,4,7,4
3,1,5,7,4
3,1,6,7,4
3,1,7,7,4
3,1,8,7,4
3,1,9,7,4
3,1,10,7,4
3,1,11,7,4
3,1,12,7,4
3,2,0,7,4
3,2,1,7,4
3,2,2,7,4
3,2,3,7,4
3,2,4,7,4
3,2,5,7,4
3,2,6,7,4
3,2,7,7,4
3,2,8,7,4
3,2,9,7,4
3,2,10,7,4
3,2,11,7,4
3,2,12,7,4
3,3,0,7,4
3,3,1,7,4
3,3,2,7,4
3,3,3,7,4
3,3,4,7,4
3,3,5,7,4
3,3,6,7,4
3,3,7,7,4
3,3,8,7,4
3,3,9,7,4
3,3,10,7,4
3,3,11,7,4
3,3,12,7,4
3,4,0,7,4
3,4,1,7,4
3,4,2,7,4
3,4,3,7,4
3,4,4,7,4
3,4,5,7,4
3,4,6,7,4
3,4,7,7,4
3,4,8,7,4
3,4,9,7,4
3,4,10,7,4
3,4,11,7,4
3,4,12,7,4
3,5,0,7,4
3,5,1,7,4
3,5,2,7,4
3,5,3,7,4
3,5,4,7,4
3,5,5,7,4
3,5,6,7,4
3,5,7,7,4
3,5,8,7,4
3,5,9,7,4
3,5,10,7,4
3,5,11,7,4
3,5,12,7,4
3,6,0,7,4
3,6,1,7,4
3,6,2,7,4
3,6,3,7,4
3,6,4,7,4
3,6,5,7,4
3,6,6,7,4
3,6,7,7,4
3,6,8,7,4
3,6,9,7,4
3,6,10,7,4
3,6,11,7,4
3,6,12,7,4
3,7,0,7,4
3,7,1,7,4
3,7,2,7,4
3,7,3,7,4
3,7,4,7,4
3,7,5,7,4
3,7,6,7,4
3,7,7,7,4
3,7,8,7,4
3,7,9,7,4
3,7,10,7,4
3,7,11,7,4
3,7,12,7,4
3,8,0,7,4
3,8,1,7,4
3,8,2,7,4
3,8,3,7,4
3,8,4,7,4
3,8,5,7,4
3,8,6,7,4
3,8,7,7,4
3,8,8,7,4
3,8,9,7,4
3,8,10,7,4
3,8,11,7,4
3,8,12,7,4
3,9,0,7,4
3,9,1,7,4
3,9,2,7,4
3,9,3,7,4
3,9,4,7,4
3,9,5,7,4
3,9,6,7,4
3,9,7,7,4
3,9,8,7,4
3,9,9,7,4
3,9,10,7,4
3,9,11,7,4
3,9,12,7,4
3,10,0,7,4
3,10,1,7,4
3,10,2,7,4
3,10,3,7,4
3,10,4,7,4
3,10,5,7,4
3,10,6,7,4
3,10,7,7,4
3,10,8,7,4
3,10,9,7,4
3,10,10,7,4
3,10,11,7,4
3,10,12,7,4
3,11,0,7,4
3,11,1,7,4
3,11,2,7,4
3,11,3,7,4
3,11,4,7,4
3,11,5,7,4
3,11,6,7,4
3,11,7,7,4
3,11,8,7,4
3,11,9,7,4
3,11,10,7,4
3,11,11,7,4
3,11,12,7,4
3,12,0,7,4
3,12,1,7,4
3,12,2,7,4
3,12,3,7,4
3,12,4,7,4
3,12,5,7,4
3,12,6,7,4
3,12,7,7,4
3,12,8,7,4
3,12,9,7,4
3,12,10,7,4
3,12,11,7,4
3,12,12,7,4
3,13,0,7,4
3,13,1,7,4
3,13,2,7,4
3,13,3,7,4
3,13,4,7,4
3,13,5,7,4
3,13,6,7,4
3,13,7,7,4
3,13,8,7,4
3,13,9,7,4
3,13,10,7,4
3,13,11,7,4
3,13,12,7,4
3,14,0,7,4
3,14,1,7,4
3,14,2,7,4
3,14,3,7,4
3,14,4,7,4
3,14,5,7,4
3,14,6,7,4
3,14,7,7,4
3,14,8,7,4
3,14,9,7,4
3,14,10,7,4
3,14,11,7,4
3,14,12,7,4
3,15,0,7,4
3,15,1,7,4
3,15,2,7,4
3,15,3,7,4
3,15,4,7,4
3,15,5,7,4
3,15,6,7,4
3,15,7,7,4
3,15,8,7,4
3,15,9,7,4
3,15,10,7,4
3,15,11,7,4
3,15,12,7,4
3,16,0,7,4
3,16,1,7,4
3,16,2,7,4
3,16,3,7,4
3,16,4,7,4
3,16,5,7,4
3,16,6,7,4
3,16,7,7,4
3,16,8,7,4
3,16,9,7,4
3,16,10,7,4
3,16,11,7,4
3,16,12,7,4
3,17,0,7,4
3,17,1,7,4
3,17,2,7,4
3,17,3,7,4
3,17,4,7,4
3,17,5,7,4
3,17,6,7,4
3,17,7,7,4
3,17,8,7,4
3,17,9,7,4
3,17,10,7,4
3,17,11,7,4
3,17,12,7,4
3,0,0,8,4
3,0,1,8,4
3,0,2,8,4
3,0,3,8,4
3,0,4,8,4
3,0,5,8,4
3,0,6,8,4
3,0,7,8,4
3,0,8,8,4
3,0,9,8,4
3,0,10,8,4
3,0,11,8,4
3,0,12,8,4
3,1,0,8,4
3,1,1,8,4
3,1,2,8,4
3,1,3,8,4
3,1,4,8,4
3,1,5,8,4
3,1,6,8,4
3,1,7,8,4
3,1,8,8,4
3,1,9,8,4
3,1,10,8,4
3,1,11,8,4
3,1,12,8,4
3,2,0,8,4
3,2,1,8,4
3,2,2,8,4
3,2,3,8,4
3,2,4,8,4
3,2,5,8,4
3,2,6,8,4
3,2,7,8,4
3,2,8,8,4
3,2,9,8,4
3,2,10,8,4
3,2,11,8,4
3,2,12,8,4
3,3,0,8,4
3,3,1,8,4
3,3,2,8,4
3,3,3,8,4
3,3,4,8,4
3,3,5,8,4
3,3,6,8,4
3,3,7,8,4
3,3,8,8,4
3,3,9,8,4
3,3,10,8,4
3,3,11,8,4
3,3,12,8,4
3,4,0,8,4
3,4,1,8,4
3,4,2,8,4
3,4,3,8,4
3,4,4,8,4
3,4,5,8,4
3,4,6,8,4
3,4,7,8,4
3,4,8,8,4
3,4,9,8,4
3,4,10,8,4
3,4,11,8,4
3,4,12,8,4
3,5,0,8,4
3,5,1,8,4
3,5,2,8,4
3,5,3,8,4
3,5,4,8,4
3,5,5,8,4
3,5,6,8,4
3,5,7,8,4
3,5,8,8,4
3,5,9,8,4
3,5,10,8,4
3,5,11,8,4
3,5,12,8,4
3,6,0,8,4
3,6,1,8,4
3,6,2,8,4
3,6,3,8,4
3,6,4,8,4
3,6,5,8,4
3,6,6,8,4
3,6,7,8,4
3,6,8,8,4
3,6,9,8,4
3,6,10,8,4
3,6,11,8,4
3,6,12,8,4
3,7,0,8,4
3,7,1,8,4
3,7,2,8,4
3,7,3,8,4
3,7,4,8,4
3,7,5,8,4
3,7,6,8,4
3,7,7,8,4
3,7,8,8,4
3,7,9,8,4
3,7,10,8,4
3,7,11,8,4
3,7,12,8,4
3,8,0,8,4
3,8,1,8,4
3,8,2,8,4
3,8,3,8,4
3,8,4,8,4
3,8,5,8,4
3,8,6,8,4
3,8,7,8,4
3,8,8,8,4
3,8,9,8,4
3,8,10,8,4
3,8,11,8,4
3,8,12,8,4
3,9,0,8,4
3,9,1,8,4
3,9,2,8,4
3,9,3,8,4
3,9,4,8,4
3,9,5,8,4
3,9,6,8,4
3,9,7,8,4
3,9,8,8,4
3,9,9,8,4
3,9,10,8,4
3,9,11,8,4
3,9,12,8,4
3,10,0,8,4
3,10,1,8,4
3,10,2,8,4
3,10,3,8,4
3,10,4,8,4
3,10,5,8,4
3,10,6,8,4
3,10,7,8,4
3,10,8,8,4
3,10,9,8,4
3,10,10,8,4
3,10,11,8,4
3,10,12,8,4
3,11,0,8,4
3,11,1,8,4
3,11,2,8,4
3,11,3,8,4
3,11,4,8,4
3,11,5,8,4
3,11,6,8,4
3,11,7,8,4
3,11,8,8,4
3,11,9,8,4
3,11,10,8,4
3,11,11,8,4
3,11,12,8,4
3,12,0,8,4
3,12,1,8,4
3,12,2,8,4
3,12,3,8,4
3,12,4,8,4
3,12,5,8,4
3,12,6,8,4
3,12,7,8,4
3,12,8,8,4
3,12,9,8,4
3,12,10,8,4
3,12,11,8,4
3,12,12,8,4
3,13,0,8,4
3,13,1,8,4
3,13,2,8,4
3,13,3,8,4
3,13,4,8,4
3,13,5,8,4
3,13,6,8,4
3,13,7,8,4
3,13,8,8,4
3,13,9,8,4
3,13,10,8,4
3,13,11,8,4
3,13,12,8,4
3,14,0,8,4
3,14,1,8,4
3,14,2,8,4
3,14,3,8,4
3,14,4,8,4
3,14,5,8,4
3,14,6,8,4
3,14,7,8,4
3,14,8,8,4
3,14,9,8,4
3,14,10,8,4
3,14,11,8,4
3,14,12,8,4
3,15,0,8,4
3,15,1,8,4
3,15,2,8,4
3,15,3,8,4
3,15,4,8,4
3,15,5,8,4
3,15,6,8,4
3,15,7,8,4
3,15,8,8,4
3,15,9,8,4
3,15,10,8,4
3,15,11,8,4
3,15,12,8,4
3,16,0,8,4
3,16,1,8,4
3,16,2,8,4
3,16,3,8,4
3,16,4,8,4
3,16,5,8,4
3,16,6,8,4
3,16,7,8,4
3,16,8,8,4
3,16,9,8,4
3,16,10,8,4
3,16,11,8,4
3,16,12,8,4
3,0,0,9,4
3,0,1,9,4
3,0,2,9,4
3,0,3,9,4
3,0,4,9,4
3,0,5,9,4
3,0,6,9,4
3,0,7,9,4
3,0,8,9,4
3,0,9,9,4
3,0,10,9,4
3,0,11,9,4
3,0,12,9,4
3,1,0,9,4
3,1,1,9,4
3,1,2,9,4
3,1,3,9,4
3,1,4,9,4
3,1,5,9,4
3,1,6,9,4
3,1,7,9,4
3,1,8,9,4
3,1,9,9,4
3,1,10,9,4
3,1,11,9,4
3,1,12,9,4
3,2,0,9,4
3,2,1,9,4
3,2,2,9,4
3,2,3,9,4
3,2,4,9,4
3,2,5,9,4
3,2,6,9,4
3,2,7,9,4
3,2,8,9,4
3,2,9,9,4
3,2,10,9,4
3,2,11,9,4
3,2,12,9,4
3,3,0,9,4
3,3,1,9,4
3,3,2,9,4
3,3,3,9,4
3,3,4,9,4
3,3,5,9,4
3,3,6,9,4
3,3,7,9,4
3,3,8,9,4
3,3,9,9,4
3,3,10,9,4
3,3,11,9,4
3,3,12,9,4
3,4,0,9,4
3,4,1,9,4
3,4,2,9,4
3,4,3,9,4
3,4,4,9,4
3,4,5,9,4
3,4,6,9,4
3,4,7,9,4
3,4,8,9,4
3,4,9,9,4
3,4,10,9,4
3,4,11,9,4
3,4,12,9,4
3,5,0,9,4
3,5,1,9,4
3,5,2,9,4
3,5,3,9,4
3,5,4,9,4
3,5,5,9,4
3,5,6,9,4
3,5,7,9,4
3,5,8,9,4
3,5,9,9,4
3,5,10,9,4
3,5,11,9,4
3,5,12,9,4
3,6,0,9,4
3,6,1,9,4
3,6,2,9,4
3,6,3,9,4
3,6,4,9,4
3,6,5,9,4
3,6,6,9,4
3,6,7,9,4
3,6,8,9,4
3,6,9,9,4
3,6,10,9,4
3,6,11,9,4
3,6,12,9,4
3,7,0,9,4
3,7,1,9,4
3,7,2,9,4
3,7,3,9,4
3,7,4,9,4
3,7,5,9,4
3,7,6,9,4
3,7,7,9,4
3,7,8,9,4
3,7,9,9,4
3,7,10,9,4
3,7,11,9,4
3,7,12,9,4
3,8,0,9,4
3,8,1,9,4
3,8,2,9,4
3,8,3,9,4
3,8,4,9,4
3,8,5,9,4
3,8,6,9,4
3,8,7,9,4
3,8,8,9,4
3,8,9,9,4
3,8,10,9,4
3,8,11,9,4
3,8,12,9,4
3,9,0,9,4
3,9,1,9,4
3,9,2,9,4
3,9,3,9,4
3,9,4,9,4
3,9,5,9,4
3,9,6,9,4
3,9,7,9,4
3,9,8,9,4
3,9,9,9,4
3,9,10,9,4
3,9,11,9,4
3,9,12,9,4
3,10,0,9,4
3,10,1,9,4
3,10,2,9,4
3,10,3,9,4
3,10,4,9,4
3,10,5,9,4
3,10,6,9,4
3,10,7,9,4
3,10,8,9,4
3,10,9,9,4
3,10,10,9,4
3,10,11,9,4
3,10,12,9,4
3,11,0,9,4
3,11,1,9,4
3,11,2,9,4
3,11,3,9,4
3,11,4,9,4
3,11,5,9,4
3,11,6,9,4
3,11,7,9,4
3,11,8,9,4
3,11,9,9,4
3,11,10,9,4
3,11,11,9,4
3,11,12,9,4
3,12,0,9,4
3,12,1,9,4
3,12,2,9,4
3,12,3,9,4
3,12,4,9,4
3,12,5,9,4
3,12,6,9,4
3,12,7,9,4
3,12,8,9,4
3,12,9,9,4
3,12,10,9,4
3,12,11,9,4
3,12,12,9,4
3,13,0,9,4
3,13,1,9,4
3,13,2,9,4
3,13,3,9,4
3,13,4,9,4
3,13,5,9,4
3,13,6,9,4
3,13,7,9,4
3,13,8,9,4
3,13,9,9,4
3,13,10,9,4
3,13,11,9,4
3,13,12,9,4
3,14,0,9,4
3,14,1,9,4
3,14,2,9,4
3,14,3,9,4
3,14,4,9,4
3,14,5,9,4
3,14,6,9,4
3,14,7,9,4
3,14,8,9,4
3,14,9,9,4
3,14,10,9,4
3,14,11,9,4
3,14,12,9,4
3,15,0,9,4
3,15,1,9,4
3,15,2,9,4
3,15,3,9,4
3,15,4,9,4
3,15,5,9,4
3,15,6,9,4
3,15,7,9,4
3,15,8,9,4
3,15,9,9,4
3,15,10,9,4
3,15,11,9,4
3,15,12,9,4
3,0,0,10,4
3,0,1,10,4
3,0,2,10,4
3,0,3,10,4
3,0,4,10,4
3,0,5,10,4
3,0,6,10,4
3,0,7,10,4
3,0,8,10,4
3,0,9,10,4
3,0,10,10,4
3,0,11,10,4
3,0,12,10,4
3,1,0,10,4
3,1,1,10,4
3,1,2,10,4
3,1,3,10,4
3,1,4,10,4
3,1,5,10,4
3,1,6,10,4
3,1,7,10,4
3,1,8,10,4
3,1,9,10,4
3,1,10,10,4
3,1,11,10,4
3,1,12,10,4
3,2,0,10,4
3,2,1,10,4
3,2,2,10,4
3,2,3,10,4
3,2,4,10,4
3,2,5,10,4
3,2,6,10,4
3,2,7,10,4
3,2,8,10,4
3,2,9,10,4
3,2,10,10,4
3,2,11,10,4
3,2,12,10,4
3,3,0,10,4
3,3,1,10,4
3,3,2,10,4
3,3,3,10,4
3,3,4,10,4
3,3,5,10,4
3,3,6,10,4
3,3,7,10,4
3,3,8,10,4
3,3,9,10,4
3,3,10,10,4
3,3,11,10,4
3,3,12,10,4
3,4,0,10,4
3,4,1,10,4
3,4,2,10,4
3,4,3,10,4
3,4,4,10,4
3,4,5,10,4
3,4,6,10,4
3,4,7,10,4
3,4,8,10,4
3,4,9,10,4
3,4,10,10,4
3,4,11,10,4
3,4,12,10,4
3,5,0,10,4
3,5,1,10,4
3,5,2,10,4
3,5,3,10,4
3,5,4,10,4
3,5,5,10,4
3,5,6,10,4
3,5,7,10,4
3,5,8,10,4
3,5,9,10,4
3,5,10,10,4
3,5,11,10,4
3,5,12,10,4
3,6,0,10,4
3,6,1,10,4
3,6,2,10,4
3,6,3,10,4
3,6,4,10,4
3,6,5,10,4
3,6,6,10,4
3,6,7,10,4
3,6,8,10,4
3,6,9,10,4
3,6,10,10,4
3,6,11,10,4
3,6,12,10,4
3,7,0,10,4
3,7,1,10,4
3,7,2,10,4
3,7,3,10,4
3,7,4,10,4
3,7,5,10,4
3,7,6,10,4
3,7,7,10,4
3,7,8,10,4
3,7,9,10,4
3,7,10,10,4
3,7,11,10,4
3,7,12,10,4
3,8,0,10,4
3,8,1,10,4
3,8,2,10,4
3,8,3,10,4
3,8,4,10,4
3,8,5,10,4
3,8,6,10,4
3,8,7,10,4
3,8,8,10,4
3,8,9,10,4
3,8,10,10,4
3,8,11,10,4
3,8,12,10,4
3,9,0,10,4
3,9,1,10,4
3,9,2,10,4
3,9,3,10,4
3,9,4,10,4
3,9,5,10,4
3,9,6,10,4
3,9,7,10,4
3,9,8,10,4
3,9,9,10,4
3,9,10,10,4
3,9,11,10,4
3,9,12,10,4
3,10,0,10,4
3,10,1,10,4
3,10,2,10,4
3,10,3,10,4
3,10,4,10,4
3,10,5,10,4
3,10,6,10,4
3,10,7,10,4
3,10,8,10,4
3,10,9,10,4
3,10,10,10,4
3,10,11,10,4
3,10,12,10,4
3,11,0,10,4
3,11,1,10,4
3,11,2,10,4
3,11,3,10,4
3,11,4,10,4
3,11,5,10,4
3,11,6,10,4
3,11,7,10,4
3,11,8,10,4
3,11,9,10,4
3,11,10,10,4
3,11,11,10,4
3,11,12,10,4
3,12,0,10,4
3,12,1,10,4
3,12,2,10,4
3,12,3,10,4
3,12,4,10,4
3,12,5,10,4
3,12,6,10,4
3,12,7,10,4
3,12,8,10,4
3,12,9,10,4
3,12,10,10,4
3,12,11,10,4
3,12,12,10,4
3,13,0,10,4
3,13,1,10,4
3,13,2,10,4
3,13,3,10,4
3,13,4,10,4
3,13,5,10,4
3,13,6,10,4
3,13,7,10,4
3,13,8,10,4
3,13,9,10,4
3,13,10,10,4
3,13,11,10,4
3,13,12,10,4
3,14,0,10,4
3,14,1,10,4
3,14,2,10,4
3,14,3,10,4
3,14,4,10,4
3,14,5,10,4
3,14,6,10,4
3,14,7,10,4
3,14,8,10,4
3,14,9,10,4
3,14,10,10,4
3,14,11,10,4
3,14,12,10,4
3,0,0,11,4
3,0,1,11,4
3,0,2,11,4
3,0,3,11,4
3,0,4,11,4
3,0,5,11,4
3,0,6,11,4
3,0,7,11,4
3,0,8,11,4
3,0,9,11,4
3,0,10,11,4
3,0,11,11,4
3,0,12,11,4
3,1,0,11,4
3,1,1,11,4
3,1,2,11,4
3,1,3,11,4
3,1,4,11,4
3,1,5,11,4
3,1,6,11,4
3,1,7,11,4
3,1,8,11,4
3,1,9,11,4
3,1,10,11,4
3,1,11,11,4
3,1,12,11,4
3,2,0,11,4
3,2,1,11,4
3,2,2,11,4
3,2,3,11,4
3,2,4,11,4
3,2,5,11,4
3,2,6,11,4
3,2,7,11,4
3,2,8,11,4
3,2,9,11,4
3,2,10,11,4
3,2,11,11,4
3,2,12,11,4
3,3,0,11,4
3,3,1,11,4
3,3,2,11,4
3,3,3,11,4
3,3,4,11,4
3,3,5,11,4
3,3,6,11,4
3,3,7,11,4
3,3,8,11,4
3,3,9,11,4
3,3,10,11,4
3,3,11,11,4
3,3,12,11,4
3,4,0,11,4
3,4,1,11,4
3,4,2,11,4
3,4,3,11,4
3,4,4,11,4
3,4,5,11,4
3,4,6,11,4
3,4,7,11,4
3,4,8,11,4
3,4,9,11,4
3,4,10,11,4
3,4,11,11,4
3,4,12,11,4
3,5,0,11,4
3,5,1,11,4
3,5,2,11,4
3,5,3,11,4
3,5,4,11,4
3,5,5,11,4
3,5,6,11,4
3,5,7,11,4
3,5,8,11,4
3,5,9,11,4
3,5,10,11,4
3,5,11,11,4
3,5,12,11,4
3,6,0,11,4
3,6,1,11,4
3,6,2,11,4
3,6,3,11,4
3,6,4,11,4
3,6,5,11,4
3,6,6,11,4
3,6,7,11,4
3,6,8,11,4
3,6,9,11,4
3,6,10,11,4
3,6,11,11,4
3,6,12,11,4
3,7,0,11,4
3,7,1,11,4
3,7,2,11,4
3,7,3,11,4
3,7,4,11,4
3,7,5,11,4
3,7,6,11,4
3,7,7,11,4
3,7,8,11,4
3,7,9,11,4
3,7,10,11,4
3,7,11,11,4
3,7,12,11,4
3,8,0,11,4
3,8,1,11,4
3,8,2,11,4
3,8,3,11,4
3,8,4,11,4
3,8,5,11,4
3,8,6,11,4
3,8,7,11,4
3,8,8,11,4
3,8,9,11,4
3,8,10,11,4
3,8,11,11,4
3,8,12,11,4
3,9,0,11,4
3,9,1,11,4
3,9,2,11,4
3,9,3,11,4
3,9,4,11,4
3,9,5,11,4
3,9,6,11,4
3,9,7,11,4
3,9,8,11,4
3,9,9,11,4
3,9,10,11,4
3,9,11,11,4
3,9,12,11,4
3,10,0,11,4
3,10,1,11,4
3,10,2,11,4
3,10,3,11,4
3,10,4,11,4
3,10,5,11,4
3,10,6,11,4
3,10,7,11,4
3,10,8,11,4
3,10,9,11,4
3,10,10,11,4
3,10,11,11,4
3,10,12,11,4
3,11,0,11,4
3,11,1,11,4
3,11,2,11,4
3,11,3,11,4
3,11,4,11,4
3,11,5,11,4
3,11,6,11,4
3,11,7,11,4
3,11,8,11,4
3,11,9,11,4
3,11,10,11,4
3,11,11,11,4
3,11,12,11,4
3,12,0,11,4
3,12,1,11,4
3,12,2,11,4
3,12,3,11,4
3,12,4,11,4
3,12,5,11,4
3,12,6,11,4
3,12,7,11,4
3,12,8,11,4
3,12,9,11,4
3,12,10,11,4
3,12,11,11,4
3,12,12,11,4
3,13,0,11,4
3,13,1,11,4
3,13,2,11,4
3,13,3,11,4
3,13,4,11,4
3,13,5,11,4
3,13,6,11,4
3,13,7,11,4
3,13,8,11,4
3,13,9,11,4
3,13,10,11,4
3,13,11,11,4
3,13,12,11,4
3,0,0,12,4
3,0,1,12,4
3,0,2,12,4
3,0,3,12,4
3,0,4,12,4
3,0,5,12,4
3,0,6,12,4
3,0,7,12,4
3,0,8,12,4
3,0,9,12,4
3,0,10,12,4
3,0,11,12,4
3,0,12,12,4
3,1,0,12,4
3,1,1,12,4
3,1,2,12,4
3,1,3,12,4
3,1,4,12,4
3,1,5,12,4
3,1,6,12,4
3,1,7,12,4
3,1,8,12,4
3,1,9,12,4
3,1,10,12,4
3,1,11,12,4
3,1,12,12,4
3,2,0,12,4
3,2,1,12,4
3,2,2,12,4
3,2,3,12,4
3,2,4,12,4
3,2,5,12,4
3,2,6,12,4
3,2,7,12,4
3,2,8,12,4
3,2,9,12,4
3,2,10,12,4
3,2,11,12,4
3,2,12,12,4
3,3,0,12,4
3,3,1,12,4
3,3,2,12,4
3,3,3,12,4
3,3,4,12,4
3,3,5,12,4
3,3,6,12,4
3,3,7,12,4
3,3,8,12,4
3,3,9,12,4
3,3,10,12,4
3,3,11,12,4
3,3,12,12,4
3,4,0,12,4
3,4,1,12,4
3,4,2,12,4
3,4,3,12,4
3,4,4,12,4
3,4,5,12,4
3,4,6,12,4
3,4,7,12,4
3,4,8,12,4
3,4,9,12,4
3,4,10,12,4
3,4,11,12,4
3,4,12,12,4
3,5,0,12,4
3,5,1,12,4
3,5,2,12,4
3,5,3,12,4
3,5,4,12,4
3,5,5,12,4
3,5,6,12,4
3,5,7,12,4
3,5,8,12,4
3,5,9,12,4
3,5,10,12,4
3,5,11,12,4
3,5,12,12,4
3,6,0,12,4
3,6,1,12,4
3,6,2,12,4
3,6,3,12,4
3,6,4,12,4
3,6,5,12,4
3,6,6,12,4
3,6,7,12,4
3,6,8,12,4
3,6,9,12,4
3,6,10,12,4
3,6,11,12,4
3,6,12,12,4
3,7,0,12,4
3,7,1,12,4
3,7,2,12,4
3,7,3,12,4
3,7,4,12,4
3,7,5,12,4
3,7,6,12,4
3,7,7,12,4
3,7,8,12,4
3,7,9,12,4
3,7,10,12,4
3,7,11,12,4
3,7,12,12,4
3,8,0,12,4
3,8,1,12,4
3,8,2,12,4
3,8,3,12,4
3,8,4,12,4
3,8,5,12,4
3,8,6,12,4
3,8,7,12,4
3,8,8,12,4
3,8,9,12,4
3,8,10,12,4
3,8,11,12,4
3,8,12,12,4
3,9,0,12,4
3,9,1,12,4
3,9,2,12,4
3,9,3,12,4
3,9,4,12,4
3,9,5,12,4
3,9,6,12,4
3,9,7,12,4
3,9,8,12,4
3,9,9,12,4
3,9,10,12,4
3,9,11,12,4
3,9,12,12,4
3,10,0,12,4
3,10,1,12,4
3,10,2,12,4
3,10,3,12,4
3,10,4,12,4
3,10,5,12,4
3,10,6,12,4
3,10,7,12,4
3,10,8,12,4
3,10,9,12,4
3,10,10,12,4
3,10,11,12,4
3,10,12,12,4
3,11,0,12,4
3,11,1,12,4
3,11,2,12,4
3,11,3,12,4
3,11,4,12,4
3,11,5,12,4
3,11,6,12,4
3,11,7,12,4
3,11,8,12,4
3,11,9,12,4
3,11,10,12,4
3,11,11,12,4
3,11,12,12,4
3,12,0,12,4
3,12,1,12,4
3,12,2,12,4
3,12,3,12,4
3,12,4,12,4
3,12,5,12,4
3,12,6,12,4
3,12,7,12,4
3,12,8,12,4
3,12,9,12,4
3,12,10,12,4
3,12,11,12,4
3,12,12,12,4
3,0,0,13,4
3,0,1,13,4
3,0,2,13,4
3,0,3,13,4
3,0,4,13,4
3,0,5,13,4
3,0,6,13,4
3,0,7,13,4
3,0,8,13,4
3,0,9,13,4
3,0,10,13,4
3,0,11,13,4
3,0,12,13,4
3,1,0,13,4
3,1,1,13,4
3,1,2,13,4
3,1,3,13,4
3,1,4,13,4
3,1,5,13,4
3,1,6,13,4
3,1,7,13,4
3,1,8,13,4
3,1,9,13,4
3,1,10,13,4
3,1,11,13,4
3,1,12,13,4
3,2,0,13,4
3,2,1,13,4
3,2,2,13,4
3,2,3,13,4
3,2,4,13,4
3,2,5,13,4
3,2,6,13,4
3,2,7,13,4
3,2,8,13,4
3,2,9,13,4
3,2,10,13,4
3,2,11,13,4
3,2,12,13,4
3,3,0,13,4
3,3,1,13,4
3,3,2,13,4
3,3,3,13,4
3,3,4,13,4
3,3,5,13,4
3,3,6,13,4
3,3,7,13,4
3,3,8,13,4
3,3,9,13,4
3,3,10,13,4
3,3,11,13,4
3,3,12,13,4
3,4,0,13,4
3,4,1,13,4
3,4,2,13,4
3,4,3,13,4
3,4,4,13,4
3,4,5,13,4
3,4,6,13,4
3,4,7,13,4
3,4,8,13,4
3,4,9,13,4
3,4,10,13,4
3,4,11,13,4
3,4,12,13,4
3,5,0,13,4
3,5,1,13,4
3,5,2,13,4
3,5,3,13,4
3,5,4,13,4
3,5,5,13,4
3,5,6,13,4
3,5,7,13,4
3,5,8,13,4
3,5,9,13,4
3,5,10,13,4
3,5,11,13,4
3,5,12,13,4
3,6,0,13,4
3,6,1,13,4
3,6,2,13,4
3,6,3,13,4
3,6,4,13,4
3,6,5,13,4
3,6,6,13,4
3,6,7,13,4
3,6,8,13,4
3,6,9,13,4
3,6,10,13,4
3,6,11,13,4
3,6,12,13,4
3,7,0,13,4
3,7,1,13,4
3,7,2,13,4
3,7,3,13,4
3,7,4,13,4
3,7,5,13,4
3,7,6,13,4
3,7,7,13,4
3,7,8,13,4
3,7,9,13,4
3,7,10,13,4
3,7,11,13,4
3,7,12,13,4
3,8,0,13,4
3,8,1,13,4
3,8,2,13,4
3,8,3,13,4
3,8,4,13,4
3,8,5,13,4
3,8,6,13,4
3,8,7,13,4
3,8,8,13,4
3,8,9,13,4
3,8,10,13,4
3,8,11,13,4
3,8,12,13,4
3,9,0,13,4
3,9,1,13,4
3,9,2,13,4
3,9,3,13,4
3,9,4,13,4
3,9,5,13,4
3,9,6,13,4
3,9,7,13,4
3,9,8,13,4
3,9,9,13,4
3,9,10,13,4
3,9,11,13,4
3,9,12,13,4
3,10,0,13,4
3,10,1,13,4
3,10,2,13,4
3,10,3,13,4
3,10,4,13,4
3,10,5,13,4
3,10,6,13,4
3,10,7,13,4
3,10,8,13,4
3,10,9,13,4
3,10,10,13,4
3,10,11,13,4
3,10,12,13,4
3,11,0,13,4
3,11,1,13,4
3,11,2,13,4
3,11,3,13,4
3,11,4,13,4
3,11,5,13,4
3,11,6,13,4
3,11,7,13,4
3,11,8,13,4
3,11,9,13,4
3,11,10,13,4
3,11,11,13,4
3,11,12,13,4
3,0,0,14,4
3,0,1,14,4
3,0,2,14,4
3,0,3,14,4
3,0,4,14,4
3,0,5,14,4
3,0,6,14,4
3,0,7,14,4
3,0,8,14,4
3,0,9,14,4
3,0,10,14,4
3,0,11,14,4
3,0,12,14,4
3,1,0,14,4
3,1,1,14,4
3,1,2,14,4
3,1,3,14,4
3,1,4,14,4
3,1,5,14,4
3,1,6,14,4
3,1,7,14,4
3,1,8,14,4
3,1,9,14,4
3,1,10,14,4
3,1,11,14,4
3,1,12,14,4
3,2,0,14,4
3,2,1,14,4
3,2,2,14,4
3,2,3,14,4
3,2,4,14,4
3,2,5,14,4
3,2,6,14,4
3,2,7,14,4
3,2,8,14,4
3,2,9,14,4
3,2,10,14,4
3,2,11,14,4
3,2,12,14,4
3,3,0,14,4
3,3,1,14,4
3,3,2,14,4
3,3,3,14,4
3,3,4,14,4
3,3,5,14,4
3,3,6,14,4
3,3,7,14,4
3,3,8,14,4
3,3,9,14,4
3,3,10,14,4
3,3,11,14,4
3,3,12,14,4
3,4,0,14,4
3,4,1,14,4
3,4,2,14,4
3,4,3,14,4
3,4,4,14,4
3,4,5,14,4
3,4,6,14,4
3,4,7,14,4
3,4,8,14,4
3,4,9,14,4
3,4,10,14,4
3,4,11,14,4
3,4,12,14,4
3,5,0,14,4
3,5,1,14,4
3,5,2,14,4
3,5,3,14,4
3,5,4,14,4
3,5,5,14,4
3,5,6,14,4
3,5,7,14,4
3,5,8,14,4
3,5,9,14,4
3,5,10,14,4
3,5,11,14,4
3,5,12,14,4
3,6,0,14,4
3,6,1,14,4
3,6,2,14,4
3,6,3,14,4
3,6,4,14,4
3,6,5,14,4
3,6,6,14,4
3,6,7,14,4
3,6,8,14,4
3,6,9,14,4
3,6,10,14,4
3,6,11,14,4
3,6,12,14,4
3,7,0,14,4
3,7,1,14,4
3,7,2,14,4
3,7,3,14,4
3,7,4,14,4
3,7,5,14,4
3,7,6,14,4
3,7,7,14,4
3,7,8,14,4
3,7,9,14,4
3,7,10,14,4
3,7,11,14,4
3,7,12,14,4
3,8,0,14,4
3,8,1,14,4
3,8,2,14,4
3,8,3,14,4
3,8,4,14,4
3,8,5,14,4
3,8,6,14,4
3,8,7,14,4
3,8,8,14,4
3,8,9,14,4
3,8,10,14,4
3,8,11,14,4
3,8,12,14,4
3,9,0,14,4
3,9,1,14,4
3,9,2,14,4
3,9,3,14,4
3,9,4,14,4
3,9,5,14,4
3,9,6,14,4
3,9,7,14,4
3,9,8,14,4
3,9,9,14,4
3,9,10,14,4
3,9,11,14,4
3,9,12,14,4
3,10,0,14,4
3,10,1,14,4
3,10,2,14,4
3,10,3,14,4
3,10,4,14,4
3,10,5,14,4
3,10,6,14,4
3,10,7,14,4
3,10,8,14,4
3,10,9,14,4
3,10,10,14,4
3,10,11,14,4
3,10,12,14,4
3,0,0,15,4
3,0,1,15,4
3,0,2,15,4
3,0,3,15,4
3,0,4,15,4
3,0,5,15,4
3,0,6,15,4
3,0,7,15,4
3,0,8,15,4
3,0,9,15,4
3,0,10,15,4
3,0,11,15,4
3,0,12,15,4
3,1,0,15,4
3,1,1,15,4
3,1,2,15,4
3,1,3,15,4
3,1,4,15,4
3,1,5,15,4
3,1,6,15,4
3,1,7,15,4
3,1,8,15,4
3,1,9,15,4
3,1,10,15,4
3,1,11,15,4
3,1,12,15,4
3,2,0,15,4
3,2,1,15,4
3,2,2,15,4
3,2,3,15,4
3,2,4,15,4
3,2,5,15,4
3,2,6,15,4
3,2,7,15,4
3,2,8,15,4
3,2,9,15,4
3,2,10,15,4
3,2,11,15,4
3,2,12,15,4
3,3,0,15,4
3,3,1,15,4
3,3,2,15,4
3,3,3,15,4
3,3,4,15,4
3,3,5,15,4
3,3,6,15,4
3,3,7,15,4
3,3,8,15,4
3,3,9,15,4
3,3,10,15,4
3,3,11,15,4
3,3,12,15,4
3,4,0,15,4
3,4,1,15,4
3,4,2,15,4
3,4,3,15,4
3,4,4,15,4
3,4,5,15,4
3,4,6,15,4
3,4,7,15,4
3,4,8,15,4
3,4,9,15,4
3,4,10,15,4
3,4,11,15,4
3,4,12,15,4
3,5,0,15,4
3,5,1,15,4
3,5,2,15,4
3,5,3,15,4
3,5,4,15,4
3,5,5,15,4
3,5,6,15,4
3,5,7,15,4
3,5,8,15,4
3,5,9,15,4
3,5,10,15,4
3,5,11,15,4
3,5,12,15,4
3,6,0,15,4
3,6,1,15,4
3,6,2,15,4
3,6,3,15,4
3,6,4,15,4
3,6,5,15,4
3,6,6,15,4
3,6,7,15,4
3,6,8,15,4
3,6,9,15,4
3,6,10,15,4
3,6,11,15,4
3,6,12,15,4
3,7,0,15,4
3,7,1,15,4
3,7,2,15,4
3,7,3,15,4
3,7,4,15,4
3,7,5,15,4
3,7,6,15,4
3,7,7,15,4
3,7,8,15,4
3,7,9,15,4
3,7,10,15,4
3,7,11,15,4
3,7,12,15,4
3,8,0,15,4
3,8,1,15,4
3,8,2,15,4
3,8,3,15,4
3,8,4,15,4
3,8,5,15,4
3,8,6,15,4
3,8,7,15,4
3,8,8,15,4
3,8,9,15,4
3,8,10,15,4
3,8,11,15,4
3,8,12,15,4
3,9,0,15,4
3,9,1,15,4
3,9,2,15,4
3,9,3,15,4
3,9,4,15,4
3,9,5,15,4
3,9,6,15,4
3,9,7,15,4
3,9,8,15,4
3,9,9,15,4
3,9,10,15,4
3,9,11,15,4
3,9,12,15,4
3,0,0,16,4
3,0,1,16,4
3,0,2,16,4
3,0,3,16,4
3,0,4,16,4
3,0,5,16,4
3,0,6,16,4
3,0,7,16,4
3,0,8,16,4
3,0,9,16,4
3,0,10,16,4
3,0,11,16,4
3,0,12,16,4
3,1,0,16,4
3,1,1,16,4
3,1,2,16,4
3,1,3,16,4
3,1,4,16,4
3,1,5,16,4
3,1,6,16,4
3,1,7,16,4
3,1,8,16,4
3,1,9,16,4
3,1,10,16,4
3,1,11,16,4
3,1,12,16,4
3,2,0,16,4
3,2,1,16,4
3,2,2,16,4
3,2,3,16,4
3,2,4,16,4
3,2,5,16,4
3,2,6,16,4
3,2,7,16,4
3,2,8,16,4
3,2,9,16,4
3,2,10,16,4
3,2,11,16,4
3,2,12,16,4
3,3,0,16,4
3,3,1,16,4
3,3,2,16,4
3,3,3,16,4
3,3,4,16,4
3,3,5,16,4
3,3,6,16,4
3,3,7,16,4
3,3,8,16,4
3,3,9,16,4
3,3,10,16,4
3,3,11,16,4
3,3,12,16,4
3,4,0,16,4
3,4,1,16,4
3,4,2,16,4
3,4,3,16,4
3,4,4,16,4
3,4,5,16,4
3,4,6,16,4
3,4,7,16,4
3,4,8,16,4
3,4,9,16,4
3,4,10,16,4
3,4,11,16,4
3,4,12,16,4
3,5,0,16,4
3,5,1,16,4
3,5,2,16,4
3,5,3,16,4
3,5,4,16,4
3,5,5,16,4
3,5,6,16,4
3,5,7,16,4
3,5,8,16,4
3,5,9,16,4
3,5,10,16,4
3,5,11,16,4
3,5,12,16,4
3,6,0,16,4
3,6,1,16,4
3,6,2,16,4
3,6,3,16,4
3,6,4,16,4
3,6,5,16,4
3,6,6,16,4
3,6,7,16,4
3,6,8,16,4
3,6,9,16,4
3,6,10,16,4
3,6,11,16,4
3,6,12,16,4
3,7,0,16,4
3,7,1,16,4
3,7,2,16,4
3,7,3,16,4
3,7,4,16,4
3,7,5,16,4
3,7,6,16,4
3,7,7,16,4
3,7,8,16,4
3,7,9,16,4
3,7,10,16,4
3,7,11,16,4
3,7,12,16,4
3,8,0,16,4
3,8,1,16,4
3,8,2,16,4
3,8,3,16,4
3,8,4,16,4
3,8,5,16,4
3,8,6,16,4
3,8,7,16,4
3,8,8,16,4
3,8,9,16,4
3,8,10,16,4
3,8,11,16,4
3,8,12,16,4
3,0,0,17,4
3,0,1,17,4
3,0,2,17,4
3,0,3,17,4
3,0,4,17,4
3,0,5,17,4
3,0,6,17,4
3,0,7,17,4
3,0,8,17,4
3,0,9,17,4
3,0,10,17,4
3,0,11,17,4
3,0,12,17,4
3,1,0,17,4
3,1,1,17,4
3,1,2,17,4
3,1,3,17,4
3,1,4,17,4
3,1,5,17,4
3,1,6,17,4
3,1,7,17,4
3,1,8,17,4
3,1,9,17,4
3,1,10,17,4
3,1,11,17,4
3,1,12,17,4
3,2,0,17,4
3,2,1,17,4
3,2,2,17,4
3,2,3,17,4
3,2,4,17,4
3,2,5,17,4
3,2,6,17,4
3,2,7,17,4
3,2,8,17,4
3,2,9,17,4
3,2,10,17,4
3,2,11,17,4
3,2,12,17,4
3,3,0,17,4
3,3,1,17,4
3,3,2,17,4
3,3,3,17,4
3,3,4,17,4
3,3,5,17,4
3,3,6,17,4
3,3,7,17,4
3,3,8,17,4
3,3,9,17,4
3,3,10,17,4
3,3,11,17,4
3,3,12,17,4
3,4,0,17,4
3,4,1,17,4
3,4,2,17,4
3,4,3,17,4
3,4,4,17,4
3,4,5,17,4
3,4,6,17,4
3,4,7,17,4
3,4,8,17,4
3,4,9,17,4
3,4,10,17,4
3,4,11,17,4
3,4,12,17,4
3,5,0,17,4
3,5,1,17,4
3,5,2,17,4
3,5,3,17,4
3,5,4,17,4
3,5,5,17,4
3,5,6,17,4
3,5,7,17,4
3,5,8,17,4
3,5,9,17,4
3,5,10,17,4
3,5,11,17,4
3,5,12,17,4
3,6,0,17,4
3,6,1,17,4
3,6,2,17,4
3,6,3,17,4
3,6,4,17,4
3,6,5,17,4
3,6,6,17,4
3,6,7,17,4
3,6,8,17,4
3,6,9,17,4
3,6,10,17,4
3,6,11,17,4
3,6,12,17,4
3,7,0,17,4
3,7,1,17,4
3,7,2,17,4
3,7,3,17,4
3,7,4,17,4
3,7,5,17,4
3,7,6,17,4
3,7,7,17,4
3,7,8,17,4
3,7,9,17,4
3,7,10,17,4
3,7,11,17,4
3,7,12,17,4
3,0,0,18,4
3,0,1,18,4
3,0,2,18,4
3,0,3,18,4
3,0,4,18,4
3,0,5,18,4
3,0,6,18,4
3,0,7,18,4
3,0,8,18,4
3,0,9,18,4
3,0,10,18,4
3,0,11,18,4
3,0,12,18,4
3,1,0,18,4
3,1,1,18,4
3,1,2,18,4
3,1,3,18,4
3,1,4,18,4
3,1,5,18,4
3,1,6,18,4
3,1,7,18,4
3,1,8,18,4
3,1,9,18,4
3,1,10,18,4
3,1,11,18,4
3,1,12,18,4
3,2,0,18,4
3,2,1,18,4
3,2,2,18,4
3,2,3,18,4
3,2,4,18,4
3,2,5,18,4
3,2,6,18,4
3,2,7,18,4
3,2,8,18,4
3,2,9,18,4
3,2,10,18,4
3,2,11,18,4
3,2,12,18,4
3,3,0,18,4
3,3,1,18,4
3,3,2,18,4
3,3,3,18,4
3,3,4,18,4
3,3,5,18,4
3,3,6,18,4
3,3,7,18,4
3,3,8,18,4
3,3,9,18,4
3,3,10,18,4
3,3,11,18,4
3,3,12,18,4
3,4,0,18,4
3,4,1,18,4
3,4,2,18,4
3,4,3,18,4
3,4,4,18,4
3,4,5,18,4
3,4,6,18,4
3,4,7,18,4
3,4,8,18,4
3,4,9,18,4
3,4,10,18,4
3,4,11,18,4
3,4,12,18,4
3,5,0,18,4
3,5,1,18,4
3,5,2,18,4
3,5,3,18,4
3,5,4,18,4
3,5,5,18,4
3,5,6,18,4
3,5,7,18,4
3,5,8,18,4
3,5,9,18,4
3,5,10,18,4
3,5,11,18,4
3,5,12,18,4
3,6,0,18,4
3,6,1,18,4
3,6,2,18,4
3,6,3,18,4
3,6,4,18,4
3,6,5,18,4
3,6,6,18,4
3,6,7,18,4
3,6,8,18,4
3,6,9,18,4
3,6,10,18,4
3,6,11,18,4
3,6,12,18,4
3,0,0,19,4
3,0,1,19,4
3,0,2,19,4
3,0,3,19,4
3,0,4,19,4
3,0,5,19,4
3,0,6,19,4
3,0,7,19,4
3,0,8,19,4
3,0,9,19,4
3,0,10,19,4
3,0,11,19,4
3,0,12,19,4
3,1,0,19,4
3,1,1,19,4
3,1,2,19,4
3,1,3,19,4
3,1,4,19,4
3,1,5,19,4
3,1,6,19,4
3,1,7,19,4
3,1,8,19,4
3,1,9,19,4
3,1,10,19,4
3,1,11,19,4
3,1,12,19,4
3,2,0,19,4
3,2,1,19,4
3,2,2,19,4
3,2,3,19,4
3,2,4,19,4
3,2,5,19,4
3,2,6,19,4
3,2,7,19,4
3,2,8,19,4
3,2,9,19,4
3,2,10,19,4
3,2,11,19,4
3,2,12,19,4
3,3,0,19,4
3,3,1,19,4
3,3,2,19,4
3,3,3,19,4
3,3,4,19,4
3,3,5,19,4
3,3,6,19,4
3,3,7,19,4
3,3,8,19,4
3,3,9,19,4
3,3,10,19,4
3,3,11,19,4
3,3,12,19,4
3,4,0,19,4
3,4,1,19,4
3,4,2,19,4
3,4,3,19,4
3,4,4,19,4
3,4,5,19,4
3,4,6,19,4
3,4,7,19,4
3,4,8,19,4
3,4,9,19,4
3,4,10,19,4
3,4,11,19,4
3,4,12,19,4
3,5,0,19,4
3,5,1,19,4
3,5,2,19,4
3,5,3,19,4
3,5,4,19,4
3,5,5,19,4
3,5,6,19,4
3,5,7,19,4
3,5,8,19,4
3,5,9,19,4
3,5,10,19,4
3,5,11,19,4
3,5,12,19,4
3,0,0,20,4
3,0,1,20,4
3,0,2,20,4
3,0,3,20,4
3,0,4,20,4
3,0,5,20,4
3,0,6,20,4
3,0,7,20,4
3,0,8,20,4
3,0,9,20,4
3,0,10,20,4
3,0,11,20,4
3,0,12,20,4
3,1,0,20,4
3,1,1,20,4
3,1,2,20,4
3,1,3,20,4
3,1,4,20,4
3,1,5,20,4
3,1,6,20,4
3,1,7,20,4
3,1,8,20,4
3,1,9,20,4
3,1,10,20,4
3,1,11,20,4
3,1,12,20,4
3,2,0,20,4
3,2,1,20,4
3,2,2,20,4
3,2,3,20,4
3,2,4,20,4
3,2,5,20,4
3,2,6,20,4
3,2,7,20,4
3,2,8,20,4
3,2,9,20,4
3,2,10,20,4
3,2,11,20,4
3,2,12,20,4
3,3,0,20,4
3,3,1,20,4
3,3,2,20,4
3,3,3,20,4
3,3,4,20,4
3,3,5,20,4
3,3,6,20,4
3,3,7,20,4
3,3,8,20,4
3,3,9,20,4
3,3,10,20,4
3,3,11,20,4
3,3,12,20,4
3,4,0,20,4
3,4,1,20,4
3,4,2,20,4
3,4,3,20,4
3,4,4,20,4
3,4,5,20,4
3,4,6,20,4
3,4,7,20,4
3,4,8,20,4
3,4,9,20,4
3,4,10,20,4
3,4,11,20,4
3,4,12,20,4
3,0,0,21,4
3,0,1,21,4
3,0,2,21,4
3,0,3,21,4
3,0,4,21,4
3,0,5,21,4
3,0,6,21,4
3,0,7,21,4
3,0,8,21,4
3,0,9,21,4
3,0,10,21,4
3,0,11,21,4
3,0,12,21,4
3,1,0,21,4
3,1,1,21,4
3,1,2,21,4
3,1,3,21,4
3,1,4,21,4
3,1,5,21,4
3,1,6,21,4
3,1,7,21,4
3,1,8,21,4
3,1,9,21,4
3,1,10,21,4
3,1,11,21,4
3,1,12,21,4
3,2,0,21,4
3,2,1,21,4
3,2,2,21,4
3,2,3,21,4
3,2,4,21,4
3,2,5,21,4
3,2,6,21,4
3,2,7,21,4
3,2,8,21,4
3,2,9,21,4
3,2,10,21,4
3,2,11,21,4
3,2,12,21,4
3,3,0,21,4
3,3,1,21,4
3,3,2,21,4
3,3,3,21,4
3,3,4,21,4
3,3,5,21,4
3,3,6,21,4
3,3,7,21,4
3,3,8,21,4
3,3,9,21,4
3,3,10,21,4
3,3,11,21,4
3,3,12,21,4
3,0,0,22,4
3,0,1,22,4
3,0,2,22,4
3,0,3,22,4
3,0,4,22,4
3,0,5,22,4
3,0,6,22,4
3,0,7,22,4
3,0,8,22,4
3,0,9,22,4
3,0,10,22,4
3,0,11,22,4
3,0,12,22,4
3,1,0,22,4
3,1,1,22,4
3,1,2,22,4
3,1,3,22,4
3,1,4,22,4
3,1,5,22,4
3,1,6,22,4
3,1,7,22,4
3,1,8,22,4
3,1,9,22,4
3,1,10,22,4
3,1,11,22,4
3,1,12,22,4
3,2,0,22,4
3,2,1,22,4
3,2,2,22,4
3,2,3,22,4
3,2,4,22,4
3,2,5,22,4
3,2,6,22,4
3,2,7,22,4
3,2,8,22,4
3,2,9,22,4
3,2,10,22,4
3,2,11,22,4
3,2,12,22,4
3,0,0,23,4
3,0,1,23,4
3,0,2,23,4
3,0,3,23,4
3,0,4,23,4
3,0,5,23,4
3,0,6,23,4
3,0,7,23,4
3,0,8,23,4
3,0,9,23,4
3,0,10,23,4
3,0,11,23,4
3,0,12,23,4
3,1,0,23,4
3,1,1,23,4
3,1,2,23,4
3,1,3,23,4
3,1,4,23,4
3,1,5,23,4
3,1,6,23,4
3,1,7,23,4
3,1,8,23,4
3,1,9,23,4
3,1,10,23,4
3,1,11,23,4
3,1,12,23,4
3,0,0,24,4
3,0,1,24,4
3,0,2,24,4
3,0,3,24,4
3,0,4,24,4
3,0,5,24,4
3,0,6,24,4
3,0,7,24,4
3,0,8,24,4
3,0,9,24,4
3,0,10,24,4
3,0,11,24,4
3,0,12,24,4
3,0,0,1,5
3,0,1,1,5
3,0,2,1,5
3,0,3,1,5
3,0,4,1,5
3,0,5,1,5
3,0,6,1,5
3,0,7,1,5
3,0,8,1,5
3,0,9,1,5
3,1,0,1,5
3,1,1,1,5
3,1,2,1,5
3,1,3,1,5
3,1,4,1,5
3,1,5,1,5
3,1,6,1,5
3,1,7,1,5
3,1,8,1,5
3,1,9,1,5
3,2,0,1,5
3,2,1,1,5
3,2,2,1,5
3,2,3,1,5
3,2,4,1,5
3,2,5,1,5
3,2,6,1,5
3,2,7,1,5
3,2,8,1,5
3,2,9,1,5
3,3,0,1,5
3,3,1,1,5
3,3,2,1,5
3,3,3,1,5
3,3,4,1,5
3,3,5,1,5
3,3,6,1,5
3,3,7,1,5
3,3,8,1,5
3,3,9,1,5
3,4,0,1,5
3,4,1,1,5
3,4,2,1,5
3,4,3,1,5
3,4,4,1,5
3,4,5,1,5
3,4,6,1,5
3,4,7,1,5
3,4,8,1,5
3,4,9,1,5
3,5,0,1,5
3,5,1,1,5
3,5,2,1,5
3,5,3,1,5
3,5,4,1,5
3,5,5,1,5
3,5,6,1,5
3,5,7,1,5
3,5,8,1,5
3,5,9,1,5
3,6,0,1,5
3,6,1,1,5
3,6,2,1,5
3,6,3,1,5
3,6,4,1,5
3,6,5,1,5
3,6,6,1,5
3,6,7,1,5
3,6,8,1,5
3,6,9,1,5
3,7,0,1,5
3,7,1,1,5
3,7,2,1,5
3,7,3,1,5
3,7,4,1,5
3,7,5,1,5
3,7,6,1,5
3,7,7,1,5
3,7,8,1,5
3,7,9,1,5
3,8,0,1,5
3,8,1,1,5
3,8,2,1,5
3,8,3,1,5
3,8,4,1,5
3,8,5,1,5
3,8,6,1,5
3,8,7,1,5
3,8,8,1,5
3,8,9,1,5
3,9,0,1,5
3,9,1,1,5
3,9,2,1,5
3,9,3,1,5
3,9,4,1,5
3,9,5,1,5
3,9,6,1,5
3,9,7,1,5
3,9,8,1,5
3,9,9,1,5
3,10,0,1,5
3,10,1,1,5
3,10,2,1,5
3,10,3,1,5
3,10,4,1,5
3,10,5,1,5
3,10,6,1,5
3,10,7,1,5
3,10,8,1,5
3,10,9,1,5
3,11,0,1,5
3,11,1,1,5
3,11,2,1,5
3,11,3,1,5
3,11,4,1,5
3,11,5,1,5
3,11,6,1,5
3,11,7,1,5
3,11,8,1,5
3,11,9,1,5
3,12,0,1,5
3,12,1,1,5
3,12,2,1,5
3,12,3,1,5
3,12,4,1,5
3,12,5,1,5
3,12,6,1,5
3,12,7,1,5
3,12,8,1,5
3,12,9,1,5
3,13,0,1,5
3,13,1,1,5
3,13,2,1,5
3,13,3,1,5
3,13,4,1,5
3,13,5,1,5
3,13,6,1,5
3,13,7,1,5
3,13,8,1,5
3,13,9,1,5
3,14,0,1,5
3,14,1,1,5
3,14,2,1,5
3,14,3,1,5
3,14,4,1,5
3,14,5,1,5
3,14,6,1,5
3,14,7,1,5
3,14,8,1,5
3,14,9,1,5
3,15,0,1,5
3,15,1,1,5
3,15,2,1,5
3,15,3,1,5
3,15,4,1,5
3,15,5,1,5
3,15,6,1,5
3,15,7,1,5
3,15,8,1,5
3,15,9,1,5
3,16,0,1,5
3,16,1,1,5
3,16,2,1,5
3,16,3,1,5
3,16,4,1,5
3,16,5,1,5
3,16,6,1,5
3,16,7,1,5
3,16,8,1,5
3,16,9,1,5
3,17,0,1,5
3,17,1,1,5
3,17,2,1,5
3,17,3,1,5
3,17,4,1,5
3,17,5,1,5
3,17,6,1,5
3,17,7,1,5
3,17,8,1,5
3,17,9,1,5
3,18,0,1,5
3,18,1,1,5
3,18,2,1,5
3,18,3,1,5
3,18,4,1,5
3,18,5,1,5
3,18,6,1,5
3,18,7,1,5
3,18,8,1,5
3,18,9,1,5
3,19,0,1,5
3,19,1,1,5
3,19,2,1,5
3,19,3,1,5
3,19,4,1,5
3,19,5,1,5
3,19,6,1,5
3,19,7,1,5
3,19,8,1,5
3,19,9,1,5
3,20,0,1,5
3,20,1,1,5
3,20,2,1,5
3,20,3,1,5
3,20,4,1,5
3,20,5,1,5
3,20,6,1,5
3,20,7,1,5
3,20,8,1,5
3,20,9,1,5
3,21,0,1,5
3,21,1,1,5
3,21,2,1,5
3,21,3,1,5
3,21,4,1,5
3,21,5,1,5
3,21,6,1,5
3,21,7,1,5
3,21,8,1,5
3,21,9,1,5
3,22,0,1,5
3,22,1,1,5
3,22,2,1,5
3,22,3,1,5
3,22,4,1,5
3,22,5,1,5
3,22,6,1,5
3,22,7,1,5
3,22,8,1,5
3,22,9,1,5
3,23,0,1,5
3,23,1,1,5
3,23,2,1,5
3,23,3,1,5
3,23,4,1,5
3,23,5,1,5
3,23,6,1,5
3,23,7,1,5
3,23,8,1,5
3,23,9,1,5
3,0,0,2,5
3,0,1,2,5
3,0,2,2,5
3,0,3,2,5
3,0,4,2,5
3,0,5,2,5
3,0,6,2,5
3,0,7,2,5
3,0,8,2,5
3,0,9,2,5
3,1,0,2,5
3,1,1,2,5
3,1,2,2,5
3,1,3,2,5
3,1,4,2,5
3,1,5,2,5
3,1,6,2,5
3,1,7,2,5
3,1,8,2,5
3,1,9,2,5
3,2,0,2,5
3,2,1,2,5
3,2,2,2,5
3,2,3,2,5
3,2,4,2,5
3,2,5,2,5
3,2,6,2,5
3,2,7,2,5
3,2,8,2,5
3,2,9,2,5
3,3,0,2,5
3,3,1,2,5
3,3,2,2,5
3,3,3,2,5
3,3,4,2,5
3,3,5,2,5
3,3,6,2,5
3,3,7,2,5
3,3,8,2,5
3,3,9,2,5
3,4,0,2,5
3,4,1,2,5
3,4,2,2,5
3,4,3,2,5
3,4,4,2,5
3,4,5,2,5
3,4,6,2,5
3,4,7,2,5
3,4,8,2,5
3,4,9,2,5
3,5,0,2,5
3,5,1,2,5
3,5,2,2,5
3,5,3,2,5
3,5,4,2,5
3,5,5,2,5
3,5,6,2,5
3,5,7,2,5
3,5,8,2,5
3,5,9,2,5
3,6,0,2,5
3,6,1,2,5
3,6,2,2,5
3,6,3,2,5
3,6,4,2,5
3,6,5,2,5
3,6,6,2,5
3,6,7,2,5
3,6,8,2,5
3,6,9,2,5
3,7,0,2,5
3,7,1,2,5
3,7,2,2,5
3,7,3,2,5
3,7,4,2,5
3,7,5,2,5
3,7,6,2,5
3,7,7,2,5
3,7,8,2,5
3,7,9,2,5
3,8,0,2,5
3,8,1,2,5
3,8,2,2,5
3,8,3,2,5
3,8,4,2,5
3,8,5,2,5
3,8,6,2,5
3,8,7,2,5
3,8,8,2,5
3,8,9,2,5
3,9,0,2,5
3,9,1,2,5
3,9,2,2,5
3,9,3,2,5
3,9,4,2,5
3,9,5,2,5
3,9,6,2,5
3,9,7,2,5
3,9,8,2,5
3,9,9,2,5
3,10,0,2,5
3,10,1,2,5
3,10,2,2,5
3,10,3,2,5
3,10,4,2,5
3,10,5,2,5
3,10,6,2,5
3,10,7,2,5
3,10,8,2,5
3,10,9,2,5
3,11,0,2,5
3,11,1,2,5
3,11,2,2,5
3,11,3,2,5
3,11,4,2,5
3,11,5,2,5
3,11,6,2,5
3,11,7,2,5
3,11,8,2,5
3,11,9,2,5
3,12,0,2,5
3,12,1,2,5
3,12,2,2,5
3,12,3,2,5
3,12,4,2,5
3,12,5,2,5
3,12,6,2,5
3,12,7,2,5
3,12,8,2,5
3,12,9,2,5
3,13,0,2,5
3,13,1,2,5
3,13,2,2,5
3,13,3,2,5
3,13,4,2,5
3,13,5,2,5
3,13,6,2,5
3,13,7,2,5
3,13,8,2,5
3,13,9,2,5
3,14,0,2,5
3,14,1,2,5
3,14,2,2,5
3,14,3,2,5
3,14,4,2,5
3,14,5,2,5
3,14,6,2,5
3,14,7,2,5
3,14,8,2,5
3,14,9,2,5
3,15,0,2,5
3,15,1,2,5
3,15,2,2,5
3,15,3,2,5
3,15,4,2,5
3,15,5,2,5
3,15,6,2,5
3,15,7,2,5
3,15,8,2,5
3,15,9,2,5
3,16,0,2,5
3,16,1,2,5
3,16,2,2,5
3,16,3,2,5
3,16,4,2,5
3,16,5,2,5
3,16,6,2,5
3,16,7,2,5
3,16,8,2,5
3,16,9,2,5
3,17,0,2,5
3,17,1,2,5
3,17,2,2,5
3,17,3,2,5
3,17,4,2,5
3,17,5,2,5
3,17,6,2,5
3,17,7,2,5
3,17,8,2,5
3,17,9,2,5
3,18,0,2,5
3,18,1,2,5
3,18,2,2,5
3,18,3,2,5
3,18,4,2,5
3,18,5,2,5
3,18,6,2,5
3,18,7,2,5
3,18,8,2,5
3,18,9,2,5
3,19,0,2,5
3,19,1,2,5
3,19,2,2,5
3,19,3,2,5
3,19,4,2,5
3,19,5,2,5
3,19,6,2,5
3,19,7,2,5
3,19,8,2,5
3,19,9,2,5
3,20,0,2,5
3,20,1,2,5
3,20,2,2,5
3,20,3,2,5
3,20,4,2,5
3,20,5,2,5
3,20,6,2,5
3,20,7,2,5
3,20,8,2,5
3,20,9,2,5
3,21,0,2,5
3,21,1,2,5
3,21,2,2,5
3,21,3,2,5
3,21,4,2,5
3,21,5,2,5
3,21,6,2,5
3,21,7,2,5
3,21,8,2,5
3,21,9,2,5
3,22,0,2,5
3,22,1,2,5
3,22,2,2,5
3,22,3,2,5
3,22,4,2,5
3,22,5,2,5
3,22,6,2,5
3,22,7,2,5
3,22,8,2,5
3,22,9,2,5
3,0,0,3,5
3,0,1,3,5
3,0,2,3,5
3,0,3,3,5
3,0,4,3,5
3,0,5,3,5
3,0,6,3,5
3,0,7,3,5
3,0,8,3,5
3,0,9,3,5
3,1,0,3,5
3,1,1,3,5
3,1,2,3,5
3,1,3,3,5
3,1,4,3,5
3,1,5,3,5
3,1,6,3,5
3,1,7,3,5
3,1,8,3,5
3,1,9,3,5
3,2,0,3,5
3,2,1,3,5
3,2,2,3,5
3,2,3,3,5
3,2,4,3,5
3,2,5,3,5
3,2,6,3,5
3,2,7,3,5
3,2,8,3,5
3,2,9,3,5
3,3,0,3,5
3,3,1,3,5
3,3,2,3,5
3,3,3,3,5
3,3,4,3,5
3,3,5,3,5
3,3,6,3,5
3,3,7,3,5
3,3,8,3,5
3,3,9,3,5
3,4,0,3,5
3,4,1,3,5
3,4,2,3,5
3,4,3,3,5
3,4,4,3,5
3,4,5,3,5
3,4,6,3,5
3,4,7,3,5
3,4,8,3,5
3,4,9,3,5
3,5,0,3,5
3,5,1,3,5
3,5,2,3,5
3,5,3,3,5
3,5,4,3,5
3,5,5,3,5
3,5,6,3,5
3,5,7,3,5
3,5,8,3,5
3,5,9,3,5
3,6,0,3,5
3,6,1,3,5
3,6,2,3,5
3,6,3,3,5
3,6,4,3,5
3,6,5,3,5
3,6,6,3,5
3,6,7,3,5
3,6,8,3,5
3,6,9,3,5
3,7,0,3,5
3,7,1,3,5
3,7,2,3,5
3,7,3,3,5
3,7,4,3,5
3,7,5,3,5
3,7,6,3,5
3,7,7,3,5
3,7,8,3,5
3,7,9,3,5
3,8,0,3,5
3,8,1,3,5
3,8,2,3,5
3,8,3,3,5
3,8,4,3,5
3,8,5,3,5
3,8,6,3,5
3,8,7,3,5
3,8,8,3,5
3,8,9,3,5
3,9,0,3,5
3,9,1,3,5
3,9,2,3,5
3,9,3,3,5
3,9,4,3,5
3,9,5,3,5
3,9,6,3,5
3,9,7,3,5
3,9,8,3,5
3,9,9,3,5
3,10,0,3,5
3,10,1,3,5
3,10,2,3,5
3,10,3,3,5
3,10,4,3,5
3,10,5,3,5
3,10,6,3,5
3,10,7,3,5
3,10,8,3,5
3,10,9,3,5
3,11,0,3,5
3,11,1,3,5
3,11,2,3,5
3,11,3,3,5
3,11,4,3,5
3,11,5,3,5
3,11,6,3,5
3,11,7,3,5
3,11,8,3,5
3,11,9,3,5
3,12,0,3,5
3,12,1,3,5
3,12,2,3,5
3,12,3,3,5
3,12,4,3,5
3,12,5,3,5
3,12,6,3,5
3,12,7,3,5
3,12,8,3,5
3,12,9,3,5
3,13,0,3,5
3,13,1,3,5
3,13,2,3,5
3,13,3,3,5
3,13,4,3,5
3,13,5,3,5
3,13,6,3,5
3,13,7,3,5
3,13,8,3,5
3,13,9,3,5
3,14,0,3,5
3,14,1,3,5
3,14,2,3,5
3,14,3,3,5
3,14,4,3,5
3,14,5,3,5
3,14,6,3,5
3,14,7,3,5
3,14,8,3,5
3,14,9,3,5
3,15,0,3,5
3,15,1,3,5
3,15,2,3,5
3,15,3,3,5
3,15,4,3,5
3,15,5,3,5
3,15,6,3,5
3,15,7,3,5
3,15,8,3,5
3,15,9,3,5
3,16,0,3,5
3,16,1,3,5
3,16,2,3,5
3,16,3,3,5
3,16,4,3,5
3,16,5,3,5
3,16,6,3,5
3,16,7,3,5
3,16,8,3,5
3,16,9,3,5
3,17,0,3,5
3,17,1,3,5
3,17,2,3,5
3,17,3,3,5
3,17,4,3,5
3,17,5,3,5
3,17,6,3,5
3,17,7,3,5
3,17,8,3,5
3,17,9,3,5
3,18,0,3,5
3,18,1,3,5
3,18,2,3,5
3,18,3,3,5
3,18,4,3,5
3,18,5,3,5
3,18,6,3,5
3,18,7,3,5
3,18,8,3,5
3,18,9,3,5
3,19,0,3,5
3,19,1,3,5
3,19,2,3,5
3,19,3,3,5
3,19,4,3,5
3,19,5,3,5
3,19,6,3,5
3,19,7,3,5
3,19,8,3,5
3,19,9,3,5
3,20,0,3,5
3,20,1,3,5
3,20,2,3,5
3,20,3,3,5
3,20,4,3,5
3,20,5,3,5
3,20,6,3,5
3,20,7,3,5
3,20,8,3,5
3,20,9,3,5
3,21,0,3,5
3,21,1,3,5
3,21,2,3,5
3,21,3,3,5
3,21,4,3,5
3,21,5,3,5
3,21,6,3,5
3,21,7,3,5
3,21,8,3,5
3,21,9,3,5
3,0,0,4,5
3,0,1,4,5
3,0,2,4,5
3,0,3,4,5
3,0,4,4,5
3,0,5,4,5
3,0,6,4,5
3,0,7,4,5
3,0,8,4,5
3,0,9,4,5
3,1,0,4,5
3,1,1,4,5
3,1,2,4,5
3,1,3,4,5
3,1,4,4,5
3,1,5,4,5
3,1,6,4,5
3,1,7,4,5
3,1,8,4,5
3,1,9,4,5
3,2,0,4,5
3,2,1,4,5
3,2,2,4,5
3,2,3,4,5
3,2,4,4,5
3,2,5,4,5
3,2,6,4,5
3,2,7,4,5
3,2,8,4,5
3,2,9,4,5
3,3,0,4,5
3,3,1,4,5
3,3,2,4,5
3,3,3,4,5
3,3,4,4,5
3,3,5,4,5
3,3,6,4,5
3,3,7,4,5
3,3,8,4,5
3,3,9,4,5
3,4,0,4,5
3,4,1,4,5
3,4,2,4,5
3,4,3,4,5
3,4,4,4,5
3,4,5,4,5
3,4,6,4,5
3,4,7,4,5
3,4,8,4,5
3,4,9,4,5
3,5,0,4,5
3,5,1,4,5
3,5,2,4,5
3,5,3,4,5
3,5,4,4,5
3,5,5,4,5
3,5,6,4,5
3,5,7,4,5
3,5,8,4,5
3,5,9,4,5
3,6,0,4,5
3,6,1,4,5
3,6,2,4,5
3,6,3,4,5
3,6,4,4,5
3,6,5,4,5
3,6,6,4,5
3,6,7,4,5
3,6,8,4,5
3,6,9,4,5
3,7,0,4,5
3,7,1,4,5
3,7,2,4,5
3,7,3,4,5
3,7,4,4,5
3,7,5,4,5
3,7,6,4,5
3,7,7,4,5
3,7,8,4,5
3,7,9,4,5
3,8,0,4,5
3,8,1,4,5
3,8,2,4,5
3,8,3,4,5
3,8,4,4,5
3,8,5,4,5
3,8,6,4,5
3,8,7,4,5
3,8,8,4,5
3,8,9,4,5
3,9,0,4,5
3,9,1,4,5
3,9,2,4,5
3,9,3,4,5
3,9,4,4,5
3,9,5,4,5
3,9,6,4,5
3,9,7,4,5
3,9,8,4,5
3,9,9,4,5
3,10,0,4,5
3,10,1,4,5
3,10,2,4,5
3,10,3,4,5
3,10,4,4,5
3,10,5,4,5
3,10,6,4,5
3,10,7,4,5
3,10,8,4,5
3,10,9,4,5
3,11,0,4,5
3,11,1,4,5
3,11,2,4,5
3,11,3,4,5
3,11,4,4,5
3,11,5,4,5
3,11,6,4,5
3,11,7,4,5
3,11,8,4,5
3,11,9,4,5
3,12,0,4,5
3,12,1,4,5
3,12,2,4,5
3,12,3,4,5
3,12,4,4,5
3,12,5,4,5
3,12,6,4,5
3,12,7,4,5
3,12,8,4,5
3,12,9,4,5
3,13,0,4,5
3,13,1,4,5
3,13,2,4,5
3,13,3,4,5
3,13,4,4,5
3,13,5,4,5
3,13,6,4,5
3,13,7,4,5
3,13,8,4,5
3,13,9,4,5
3,14,0,4,5
3,14,1,4,5
3,14,2,4,5
3,14,3,4,5
3,14,4,4,5
3,14,5,4,5
3,14,6,4,5
3,14,7,4,5
3,14,8,4,5
3,14,9,4,5
3,15,0,4,5
3,15,1,4,5
3,15,2,4,5
3,15,3,4,5
3,15,4,4,5
3,15,5,4,5
3,15,6,4,5
3,15,7,4,5
3,15,8,4,5
3,15,9,4,5
3,16,0,4,5
3,16,1,4,5
3,16,2,4,5
3,16,3,4,5
3,16,4,4,5
3,16,5,4,5
3,16,6,4,5
3,16,7,4,5
3,16,8,4,5
3,16,9,4,5
3,17,0,4,5
3,17,1,4,5
3,17,2,4,5
3,17,3,4,5
3,17,4,4,5
3,17,5,4,5
3,17,6,4,5
3,17,7,4,5
3,17,8,4,5
3,17,9,4,5
3,18,0,4,5
3,18,1,4,5
3,18,2,4,5
3,18,3,4,5
3,18,4,4,5
3,18,5,4,5
3,18,6,4,5
3,18,7,4,5
3,18,8,4,5
3,18,9,4,5
3,19,0,4,5
3,19,1,4,5
3,19,2,4,5
3,19,3,4,5
3,19,4,4,5
3,19,5,4,5
3,19,6,4,5
3,19,7,4,5
3,19,8,4,5
3,19,9,4,5
3,20,0,4,5
3,20,1,4,5
3,20,2,4,5
3,20,3,4,5
3,20,4,4,5
3,20,5,4,5
3,20,6,4,5
3,20,7,4,5
3,20,8,4,5
3,20,9,4,5
3,0,0,5,5
3,0,1,5,5
3,0,2,5,5
3,0,3,5,5
3,0,4,5,5
3,0,5,5,5
3,0,6,5,5
3,0,7,5,5
3,0,8,5,5
3,0,9,5,5
3,1,0,5,5
3,1,1,5,5
3,1,2,5,5
3,1,3,5,5
3,1,4,5,5
3,1,5,5,5
3,1,6,5,5
3,1,7,5,5
3,1,8,5,5
3,1,9,5,5
3,2,0,5,5
3,2,1,5,5
3,2,2,5,5
3,2,3,5,5
3,2,4,5,5
3,2,5,5,5
3,2,6,5,5
3,2,7,5,5
3,2,8,5,5
3,2,9,5,5
3,3,0,5,5
3,3,1,5,5
3,3,2,5,5
3,3,3,5,5
3,3,4,5,5
3,3,5,5,5
3,3,6,5,5
3,3,7,5,5
3,3,8,5,5
3,3,9,5,5
3,4,0,5,5
3,4,1,5,5
3,4,2,5,5
3,4,3,5,5
3,4,4,5,5
3,4,5,5,5
3,4,6,5,5
3,4,7,5,5
3,4,8,5,5
3,4,9,5,5
3,5,0,5,5
3,5,1,5,5
3,5,2,5,5
3,5,3,5,5
3,5,4,5,5
3,5,5,5,5
3,5,6,5,5
3,5,7,5,5
3,5,8,5,5
3,5,9,5,5
3,6,0,5,5
3,6,1,5,5
3,6,2,5,5
3,6,3,5,5
3,6,4,5,5
3,6,5,5,5
3,6,6,5,5
3,6,7,5,5
3,6,8,5,5
3,6,9,5,5
3,7,0,5,5
3,7,1,5,5
3,7,2,5,5
3,7,3,5,5
3,7,4,5,5
3,7,5,5,5
3,7,6,5,5
3,7,7,5,5
3,7,8,5,5
3,7,9,5,5
3,8,0,5,5
3,8,1,5,5
3,8,2,5,5
3,8,3,5,5
3,8,4,5,5
3,8,5,5,5
3,8,6,5,5
3,8,7,5,5
3,8,8,5,5
3,8,9,5,5
3,9,0,5,5
3,9,1,5,5
3,9,2,5,5
3,9,3,5,5
3,9,4,5,5
3,9,5,5,5
3,9,6,5,5
3,9,7,5,5
3,9,8,5,5
3,9,9,5,5
3,10,0,5,5
3,10,1,5,5
3,10,2,5,5
3,10,3,5,5
3,10,4,5,5
3,10,5,5,5
3,10,6,5,5
3,10,7,5,5
3,10,8,5,5
3,10,9,5,5
3,11,0,5,5
3,11,1,5,5
3,11,2,5,5
3,11,3,5,5
3,11,4,5,5
3,11,5,5,5
3,11,6,5,5
3,11,7,5,5
3,11,8,5,5
3,11,9,5,5
3,12,0,5,5
3,12,1,5,5
3,12,2,5,5
3,12,3,5,5
3,12,4,5,5
3,12,5,5,5
3,12,6,5,5
3,12,7,5,5
3,12,8,5,5
3,12,9,5,5
3,13,0,5,5
3,13,1,5,5
3,13,2,5,5
3,13,3,5,5
3,13,4,5,5
3,13,5,5,5
3,13,6,5,5
3,13,7,5,5
3,13,8,5,5
3,13,9,5,5
3,14,0,5,5
3,14,1,5,5
3,14,2,5,5
3,14,3,5,5
3,14,4,5,5
3,14,5,5,5
3,14,6,5,5
3,14,7,5,5
3,14,8,5,5
3,14,9,5,5
3,15,0,5,5
3,15,1,5,5
3,15,2,5,5
3,15,3,5,5
3,15,4,5,5
3,15,5,5,5
3,15,6,5,5
3,15,7,5,5
3,15,8,5,5
3,15,9,5,5
3,16,0,5,5
3,16,1,5,5
3,16,2,5,5
3,16,3,5,5
3,16,4,5,5
3,16,5,5,5
3,16,6,5,5
3,16,7,5,5
3,16,8,5,5
3,16,9,5,5
3,17,0,5,5
3,17,1,5,5
3,17,2,5,5
3,17,3,5,5
3,17,4,5,5
3,17,5,5,5
3,17,6,5,5
3,17,7,5,5
3,17,8,5,5
3,17,9,5,5
3,18,0,5,5
3,18,1,5,5
3,18,2,5,5
3,18,3,5,5
3,18,4,5,5
3,18,5,5,5
3,18,6,5,5
3,18,7,5,5
3,18,8,5,5
3,18,9,5,5
3,19,0,5,5
3,19,1,5,5
3,19,2,5,5
3,19,3,5,5
3,19,4,5,5
3,19,5,5,5
3,19,6,5,5
3,19,7,5,5
3,19,8,5,5
3,19,9,5,5
3,0,0,6,5
3,0,1,6,5
3,0,2,6,5
3,0,3,6,5
3,0,4,6,5
3,0,5,6,5
3,0,6,6,5
3,0,7,6,5
3,0,8,6,5
3,0,9,6,5
3,1,0,6,5
3,1,1,6,5
3,1,2,6,5
3,1,3,6,5
3,1,4,6,5
3,1,5,6,5
3,1,6,6,5
3,1,7,6,5
3,1,8,6,5
3,1,9,6,5
3,2,0,6,5
3,2,1,6,5
3,2,2,6,5
3,2,3,6,5
3,2,4,6,5
3,2,5,6,5
3,2,6,6,5
3,2,7,6,5
3,2,8,6,5
3,2,9,6,5
3,3,0,6,5
3,3,1,6,5
3,3,2,6,5
3,3,3,6,5
3,3,4,6,5
3,3,5,6,5
3,3,6,6,5
3,3,7,6,5
3,3,8,6,5
3,3,9,6,5
3,4,0,6,5
3,4,1,6,5
3,4,2,6,5
3,4,3,6,5
3,4,4,6,5
3,4,5,6,5
3,4,6,6,5
3,4,7,6,5
3,4,8,6,5
3,4,9,6,5
3,5,0,6,5
3,5,1,6,5
3,5,2,6,5
3,5,3,6,5
3,5,4,6,5
3,5,5,6,5
3,5,6,6,5
3,5,7,6,5
3,5,8,6,5
3,5,9,6,5
3,6,0,6,5
3,6,1,6,5
3,6,2,6,5
3,6,3,6,5
3,6,4,6,5
3,6,5,6,5
3,6,6,6,5
3,6,7,6,5
3,6,8,6,5
3,6,9,6,5
3,7,0,6,5
3,7,1,6,5
3,7,2,6,5
3,7,3,6,5
3,7,4,6,5
3,7,5,6,5
3,7,6,6,5
3,7,7,6,5
3,7,8,6,5
3,7,9,6,5
3,8,0,6,5
3,8,1,6,5
3,8,2,6,5
3,8,3,6,5
3,8,4,6,5
3,8,5,6,5
3,8,6,6,5
3,8,7,6,5
3,8,8,6,5
3,8,9,6,5
3,9,0,6,5
3,9,1,6,5
3,9,2,6,5
3,9,3,6,5
3,9,4,6,5
3,9,5,6,5
3,9,6,6,5
3,9,7,6,5
3,9,8,6,5
3,9,9,6,5
3,10,0,6,5
3,10,1,6,5
3,10,2,6,5
3,10,3,6,5
3,10,4,6,5
3,10,5,6,5
3,10,6,6,5
3,10,7,6,5
3,10,8,6,5
3,10,9,6,5
3,11,0,6,5
3,11,1,6,5
3,11,2,6,5
3,11,3,6,5
3,11,4,6,5
3,11,5,6,5
3,11,6,6,5
3,11,7,6,5
3,11,8,6,5
3,11,9,6,5
3,12,0,6,5
3,12,1,6,5
3,12,2,6,5
3,12,3,6,5
3,12,4,6,5
3,12,5,6,5
3,12,6,6,5
3,12,7,6,5
3,12,8,6,5
3,12,9,6,5
3,13,0,6,5
3,13,1,6,5
3,13,2,6,5
3,13,3,6,5
3,13,4,6,5
3,13,5,6,5
3,13,6,6,5
3,13,7,6,5
3,13,8,6,5
3,13,9,6,5
3,14,0,6,5
3,14,1,6,5
3,14,2,6,5
3,14,3,6,5
3,14,4,6,5
3,14,5,6,5
3,14,6,6,5
3,14,7,6,5
3,14,8,6,5
3,14,9,6,5
3,15,0,6,5
3,15,1,6,5
3,15,2,6,5
3,15,3,6,5
3,15,4,6,5
3,15,5,6,5
3,15,6,6,5
3,15,7,6,5
3,15,8,6,5
3,15,9,6,5
3,16,0,6,5
3,16,1,6,5
3,16,2,6,5
3,16,3,6,5
3,16,4,6,5
3,16,5,6,5
3,16,6,6,5
3,16,7,6,5
3,16,8,6,5
3,16,9,6,5
3,17,0,6,5
3,17,1,6,5
3,17,2,6,5
3,17,3,6,5
3,17,4,6,5
3,17,5,6,5
3,17,6,6,5
3,17,7,6,5
3,17,8,6,5
3,17,9,6,5
3,18,0,6,5
3,18,1,6,5
3,18,2,6,5
3,18,3,6,5
3,18,4,6,5
3,18,5,6,5
3,18,6,6,5
3,18,7,6,5
3,18,8,6,5
3,18,9,6,5
3,0,0,7,5
3,0,1,7,5
3,0,2,7,5
3,0,3,7,5
3,0,4,7,5
3,0,5,7,5
3,0,6,7,5
3,0,7,7,5
3,0,8,7,5
3,0,9,7,5
3,1,0,7,5
3,1,1,7,5
3,1,2,7,5
3,1,3,7,5
3,1,4,7,5
3,1,5,7,5
3,1,6,7,5
3,1,7,7,5
3,1,8,7,5
3,1,9,7,5
3,2,0,7,5
3,2,1,7,5
3,2,2,7,5
3,2,3,7,5
3,2,4,7,5
3,2,5,7,5
3,2,6,7,5
3,2,7,7,5
3,2,8,7,5
3,2,9,7,5
3,3,0,7,5
3,3,1,7,5
3,3,2,7,5
3,3,3,7,5
3,3,4,7,5
3,3,5,7,5
3,3,6,7,5
3,3,7,7,5
3,3,8,7,5
3,3,9,7,5
3,4,0,7,5
3,4,1,7,5
3,4,2,7,5
3,4,3,7,5
3,4,4,7,5
3,4,5,7,5
3,4,6,7,5
3,4,7,7,5
3,4,8,7,5
3,4,9,7,5
3,5,0,7,5
3,5,1,7,5
3,5,2,7,5
3,5,3,7,5
3,5,4,7,5
3,5,5,7,5
3,5,6,7,5
3,5,7,7,5
3,5,8,7,5
3,5,9,7,5
3,6,0,7,5
3,6,1,7,5
3,6,2,7,5
3,6,3,7,5
3,6,4,7,5
3,6,5,7,5
3,6,6,7,5
3,6,7,7,5
3,6,8,7,5
3,6,9,7,5
3,7,0,7,5
3,7,1,7,5
3,7,2,7,5
3,7,3,7,5
3,7,4,7,5
3,7,5,7,5
3,7,6,7,5
3,7,7,7,5
3,7,8,7,5
3,7,9,7,5
3,8,0,7,5
3,8,1,7,5
3,8,2,7,5
3,8,3,7,5
3,8,4,7,5
3,8,5,7,5
3,8,6,7,5
3,8,7,7,5
3,8,8,7,5
3,8,9,7,5
3,9,0,7,5
3,9,1,7,5
3,9,2,7,5
3,9,3,7,5
3,9,4,7,5
3,9,5,7,5
3,9,6,7,5
3,9,7,7,5
3,9,8,7,5
3,9,9,7,5
3,10,0,7,5
3,10,1,7,5
3,10,2,7,5
3,10,3,7,5
3,10,4,7,5
3,10,5,7,5
3,10,6,7,5
3,10,7,7,5
3,10,8,7,5
3,10,9,7,5
3,11,0,7,5
3,11,1,7,5
3,11,2,7,5
3,11,3,7,5
3,11,4,7,5
3,11,5,7,5
3,11,6,7,5
3,11,7,7,5
3,11,8,7,5
3,11,9,7,5
3,12,0,7,5
3,12,1,7,5
3,12,2,7,5
3,12,3,7,5
3,12,4,7,5
3,12,5,7,5
3,12,6,7,5
3,12,7,7,5
3,12,8,7,5
3,12,9,7,5
3,13,0,7,5
3,13,1,7,5
3,13,2,7,5
3,13,3,7,5
3,13,4,7,5
3,13,5,7,5
3,13,6,7,5
3,13,7,7,5
3,13,8,7,5
3,13,9,7,5
3,14,0,7,5
3,14,1,7,5
3,14,2,7,5
3,14,3,7,5
3,14,4,7,5
3,14,5,7,5
3,14,6,7,5
3,14,7,7,5
3,14,8,7,5
3,14,9,7,5
3,15,0,7,5
3,15,1,7,5
3,15,2,7,5
3,15,3,7,5
3,15,4,7,5
3,15,5,7,5
3,15,6,7,5
3,15,7,7,5
3,15,8,7,5
3,15,9,7,5
3,16,0,7,5
3,16,1,7,5
3,16,2,7,5
3,16,3,7,5
3,16,4,7,5
3,16,5,7,5
3,16,6,7,5
3,16,7,7,5
3,16,8,7,5
3,16,9,7,5
3,17,0,7,5
3,17,1,7,5
3,17,2,7,5
3,17,3,7,5
3,17,4,7,5
3,17,5,7,5
3,17,6,7,5
3,17,7,7,5
3,17,8,7,5
3,17,9,7,5
3,0,0,8,5
3,0,1,8,5
3,0,2,8,5
3,0,3,8,5
3,0,4,8,5
3,0,5,8,5
3,0,6,8,5
3,0,7,8,5
3,0,8,8,5
3,0,9,8,5
3,1,0,8,5
3,1,1,8,5
3,1,2,8,5
3,1,3,8,5
3,1,4,8,5
3,1,5,8,5
3,1,6,8,5
3,1,7,8,5
3,1,8,8,5
3,1,9,8,5
3,2,0,8,5
3,2,1,8,5
3,2,2,8,5
3,2,3,8,5
3,2,4,8,5
3,2,5,8,5
3,2,6,8,5
3,2,7,8,5
3,2,8,8,5
3,2,9,8,5
3,3,0,8,5
3,3,1,8,5
3,3,2,8,5
3,3,3,8,5
3,3,4,8,5
3,3,5,8,5
3,3,6,8,5
3,3,7,8,5
3,3,8,8,5
3,3,9,8,5
3,4,0,8,5
3,4,1,8,5
3,4,2,8,5
3,4,3,8,5
3,4,4,8,5
3,4,5,8,5
3,4,6,8,5
3,4,7,8,5
3,4,8,8,5
3,4,9,8,5
3,5,0,8,5
3,5,1,8,5
3,5,2,8,5
3,5,3,8,5
3,5,4,8,5
3,5,5,8,5
3,5,6,8,5
3,5,7,8,5
3,5,8,8,5
3,5,9,8,5
3,6,0,8,5
3,6,1,8,5
3,6,2,8,5
3,6,3,8,5
3,6,4,8,5
3,6,5,8,5
3,6,6,8,5
3,6,7,8,5
3,6,8,8,5
3,6,9,8,5
3,7,0,8,5
3,7,1,8,5
3,7,2,8,5
3,7,3,8,5
3,7,4,8,5
3,7,5,8,5
3,7,6,8,5
3,7,7,8,5
3,7,8,8,5
3,7,9,8,5
3,8,0,8,5
3,8,1,8,5
3,8,2,8,5
3,8,3,8,5
3,8,4,8,5
3,8,5,8,5
3,8,6,8,5
3,8,7,8,5
3,8,8,8,5
3,8,9,8,5
3,9,0,8,5
3,9,1,8,5
3,9,2,8,5
3,9,3,8,5
3,9,4,8,5
3,9,5,8,5
3,9,6,8,5
3,9,7,8,5
3,9,8,8,5
3,9,9,8,5
3,10,0,8,5
3,10,1,8,5
3,10,2,8,5
3,10,3,8,5
3,10,4,8,5
3,10,5,8,5
3,10,6,8,5
3,10,7,8,5
3,10,8,8,5
3,10,9,8,5
3,11,0,8,5
3,11,1,8,5
3,11,2,8,5
3,11,3,8,5
3,11,4,8,5
3,11,5,8,5
3,11,6,8,5
3,11,7,8,5
3,11,8,8,5
3,11,9,8,5
3,12,0,8,5
3,12,1,8,5
3,12,2,8,5
3,12,3,8,5
3,12,4,8,5
3,12,5,8,5
3,12,6,8,5
3,12,7,8,5
3,12,8,8,5
3,12,9,8,5
3,13,0,8,5
3,13,1,8,5
3,13,2,8,5
3,13,3,8,5
3,13,4,8,5
3,13,5,8,5
3,13,6,8,5
3,13,7,8,5
3,13,8,8,5
3,13,9,8,5
3,14,0,8,5
3,14,1,8,5
3,14,2,8,5
3,14,3,8,5
3,14,4,8,5
3,14,5,8,5
3,14,6,8,5
3,14,7,8,5
3,14,8,8,5
3,14,9,8,5
3,15,0,8,5
3,15,1,8,5
3,15,2,8,5
3,15,3,8,5
3,15,4,8,5
3,15,5,8,5
3,15,6,8,5
3,15,7,8,5
3,15,8,8,5
3,15,9,8,5
3,16,0,8,5
3,16,1,8,5
3,16,2,8,5
3,16,3,8,5
3,16,4,8,5
3,16,5,8,5
3,16,6,8,5
3,16,7,8,5
3,16,8,8,5
3,16,9,8,5
3,0,0,9,5
3,0,1,9,5
3,0,2,9,5
3,0,3,9,5
3,0,4,9,5
3,0,5,9,5
3,0,6,9,5
3,0,7,9,5
3,0,8,9,5
3,0,9,9,5
3,1,0,9,5
3,1,1,9,5
3,1,2,9,5
3,1,3,9,5
3,1,4,9,5
3,1,5,9,5
3,1,6,9,5
3,1,7,9,5
3,1,8,9,5
3,1,9,9,5
3,2,0,9,5
3,2,1,9,5
3,2,2,9,5
3,2,3,9,5
3,2,4,9,5
3,2,5,9,5
3,2,6,9,5
3,2,7,9,5
3,2,8,9,5
3,2,9,9,5
3,3,0,9,5
3,3,1,9,5
3,3,2,9,5
3,3,3,9,5
3,3,4,9,5
3,3,5,9,5
3,3,6,9,5
3,3,7,9,5
3,3,8,9,5
3,3,9,9,5
3,4,0,9,5
3,4,1,9,5
3,4,2,9,5
3,4,3,9,5
3,4,4,9,5
3,4,5,9,5
3,4,6,9,5
3,4,7,9,5
3,4,8,9,5
3,4,9,9,5
3,5,0,9,5
3,5,1,9,5
3,5,2,9,5
3,5,3,9,5
3,5,4,9,5
3,5,5,9,5
3,5,6,9,5
3,5,7,9,5
3,5,8,9,5
3,5,9,9,5
3,6,0,9,5
3,6,1,9,5
3,6,2,9,5
3,6,3,9,5
3,6,4,9,5
3,6,5,9,5
3,6,6,9,5
3,6,7,9,5
3,6,8,9,5
3,6,9,9,5
3,7,0,9,5
3,7,1,9,5
3,7,2,9,5
3,7,3,9,5
3,7,4,9,5
3,7,5,9,5
3,7,6,9,5
3,7,7,9,5
3,7,8,9,5
3,7,9,9,5
3,8,0,9,5
3,8,1,9,5
3,8,2,9,5
3,8,3,9,5
3,8,4,9,5
3,8,5,9,5
3,8,6,9,5
3,8,7,9,5
3,8,8,9,5
3,8,9,9,5
3,9,0,9,5
3,9,1,9,5
3,9,2,9,5
3,9,3,9,5
3,9,4,9,5
3,9,5,9,5
3,9,6,9,5
3,9,7,9,5
3,9,8,9,5
3,9,9,9,5
3,10,0,9,5
3,10,1,9,5
3,10,2,9,5
3,10,3,9,5
3,10,4,9,5
3,10,5,9,5
3,10,6,9,5
3,10,7,9,5
3,10,8,9,5
3,10,9,9,5
3,11,0,9,5
3,11,1,9,5
3,11,2,9,5
3,11,3,9,5
3,11,4,9,5
3,11,5,9,5
3,11,6,9,5
3,11,7,9,5
3,11,8,9,5
3,11,9,9,5
3,12,0,9,5
3,12,1,9,5
3,12,2,9,5
3,12,3,9,5
3,12,4,9,5
3,12,5,9,5
3,12,6,9,5
3,12,7,9,5
3,12,8,9,5
3,12,9,9,5
3,13,0,9,5
3,13,1,9,5
3,13,2,9,5
3,13,3,9,5
3,13,4,9,5
3,13,5,9,5
3,13,6,9,5
3,13,7,9,5
3,13,8,9,5
3,13,9,9,5
3,14,0,9,5
3,14,1,9,5
3,14,2,9,5
3,14,3,9,5
3,14,4,9,5
3,14,5,9,5
3,14,6,9,5
3,14,7,9,5
3,14,8,9,5
3,14,9,9,5
3,15,0,9,5
3,15,1,9,5
3,15,2,9,5
3,15,3,9,5
3,15,4,9,5
3,15,5,9,5
3,15,6,9,5
3,15,7,9,5
3,15,8,9,5
3,15,9,9,5
3,0,0,10,5
3,0,1,10,5
3,0,2,10,5
3,0,3,10,5
3,0,4,10,5
3,0,5,10,5
3,0,6,10,5
3,0,7,10,5
3,0,8,10,5
3,0,9,10,5
3,1,0,10,5
3,1,1,10,5
3,1,2,10,5
3,1,3,10,5
3,1,4,10,5
3,1,5,10,5
3,1,6,10,5
3,1,7,10,5
3,1,8,10,5
3,1,9,10,5
3,2,0,10,5
3,2,1,10,5
3,2,2,10,5
3,2,3,10,5
3,2,4,10,5
3,2,5,10,5
3,2,6,10,5
3,2,7,10,5
3,2,8,10,5
3,2,9,10,5
3,3,0,10,5
3,3,1,10,5
3,3,2,10,5
3,3,3,10,5
3,3,4,10,5
3,3,5,10,5
3,3,6,10,5
3,3,7,10,5
3,3,8,10,5
3,3,9,10,5
3,4,0,10,5
3,4,1,10,5
3,4,2,10,5
3,4,3,10,5
3,4,4,10,5
3,4,5,10,5
3,4,6,10,5
3,4,7,10,5
3,4,8,10,5
3,4,9,10,5
3,5,0,10,5
3,5,1,10,5
3,5,2,10,5
3,5,3,10,5
3,5,4,10,5
3,5,5,10,5
3,5,6,10,5
3,5,7,10,5
3,5,8,10,5
3,5,9,10,5
3,6,0,10,5
3,6,1,10,5
3,6,2,10,5
3,6,3,10,5
3,6,4,10,5
3,6,5,10,5
3,6,6,10,5
3,6,7,10,5
3,6,8,10,5
3,6,9,10,5
3,7,0,10,5
3,7,1,10,5
3,7,2,10,5
3,7,3,10,5
3,7,4,10,5
3,7,5,10,5
3,7,6,10,5
3,7,7,10,5
3,7,8,10,5
3,7,9,10,5
3,8,0,10,5
3,8,1,10,5
3,8,2,10,5
3,8,3,10,5
3,8,4,10,5
3,8,5,10,5
3,8,6,10,5
3,8,7,10,5
3,8,8,10,5
3,8,9,10,5
3,9,0,10,5
3,9,1,10,5
3,9,2,10,5
3,9,3,10,5
3,9,4,10,5
3,9,5,10,5
3,9,6,10,5
3,9,7,10,5
3,9,8,10,5
3,9,9,10,5
3,10,0,10,5
3,10,1,10,5
3,10,2,10,5
3,10,3,10,5
3,10,4,10,5
3,10,5,10,5
3,10,6,10,5
3,10,7,10,5
3,10,8,10,5
3,10,9,10,5
3,11,0,10,5
3,11,1,10,5
3,11,2,10,5
3,11,3,10,5
3,11,4,10,5
3,11,5,10,5
3,11,6,10,5
3,11,7,10,5
3,11,8,10,5
3,11,9,10,5
3,12,0,10,5
3,12,1,10,5
3,12,2,10,5
3,12,3,10,5
3,12,4,10,5
3,12,5,10,5
3,12,6,10,5
3,12,7,10,5
3,12,8,10,5
3,12,9,10,5
3,13,0,10,5
3,13,1,10,5
3,13,2,10,5
3,13,3,10,5
3,13,4,10,5
3,13,5,10,5
3,13,6,10,5
3,13,7,10,5
3,13,8,10,5
3,13,9,10,5
3,14,0,10,5
3,14,1,10,5
3,14,2,10,5
3,14,3,10,5
3,14,4,10,5
3,14,5,10,5
3,14,6,10,5
3,14,7,10,5
3,14,8,10,5
3,14,9,10,5
3,0,0,11,5
3,0,1,11,5
3,0,2,11,5
3,0,3,11,5
3,0,4,11,5
3,0,5,11,5
3,0,6,11,5
3,0,7,11,5
3,0,8,11,5
3,0,9,11,5
3,1,0,11,5
3,1,1,11,5
3,1,2,11,5
3,1,3,11,5
3,1,4,11,5
3,1,5,11,5
3,1,6,11,5
3,1,7,11,5
3,1,8,11,5
3,1,9,11,5
3,2,0,11,5
3,2,1,11,5
3,2,2,11,5
3,2,3,11,5
3,2,4,11,5
3,2,5,11,5
3,2,6,11,5
3,2,7,11,5
3,2,8,11,5
3,2,9,11,5
3,3,0,11,5
3,3,1,11,5
3,3,2,11,5
3,3,3,11,5
3,3,4,11,5
3,3,5,11,5
3,3,6,11,5
3,3,7,11,5
3,3,8,11,5
3,3,9,11,5
3,4,0,11,5
3,4,1,11,5
3,4,2,11,5
3,4,3,11,5
3,4,4,11,5
3,4,5,11,5
3,4,6,11,5
3,4,7,11,5
3,4,8,11,5
3,4,9,11,5
3,5,0,11,5
3,5,1,11,5
3,5,2,11,5
3,5,3,11,5
3,5,4,11,5
3,5,5,11,5
3,5,6,11,5
3,5,7,11,5
3,5,8,11,5
3,5,9,11,5
3,6,0,11,5
3,6,1,11,5
3,6,2,11,5
3,6,3,11,5
3,6,4,11,5
3,6,5,11,5
3,6,6,11,5
3,6,7,11,5
3,6,8,11,5
3,6,9,11,5
3,7,0,11,5
3,7,1,11,5
3,7,2,11,5
3,7,3,11,5
3,7,4,11,5
3,7,5,11,5
3,7,6,11,5
3,7,7,11,5
3,7,8,11,5
3,7,9,11,5
3,8,0,11,5
3,8,1,11,5
3,8,2,11,5
3,8,3,11,5
3,8,4,11,5
3,8,5,11,5
3,8,6,11,5
3,8,7,11,5
3,8,8,11,5
3,8,9,11,5
3,9,0,11,5
3,9,1,11,5
3,9,2,11,5
3,9,3,11,5
3,9,4,11,5
3,9,5,11,5
3,9,6,11,5
3,9,7,11,5
3,9,8,11,5
3,9,9,11,5
3,10,0,11,5
3,10,1,11,5
3,10,2,11,5
3,10,3,11,5
3,10,4,11,5
3,10,5,11,5
3,10,6,11,5
3,10,7,11,5
3,10,8,11,5
3,10,9,11,5
3,11,0,11,5
3,11,1,11,5
3,11,2,11,5
3,11,3,11,5
3,11,4,11,5
3,11,5,11,5
3,11,6,11,5
3,11,7,11,5
3,11,8,11,5
3,11,9,11,5
3,12,0,11,5
3,12,1,11,5
3,12,2,11,5
3,12,3,11,5
3,12,4,11,5
3,12,5,11,5
3,12,6,11,5
3,12,7,11,5
3,12,8,11,5
3,12,9,11,5
3,13,0,11,5
3,13,1,11,5
3,13,2,11,5
3,13,3,11,5
3,13,4,11,5
3,13,5,11,5
3,13,6,11,5
3,13,7,11,5
3,13,8,11,5
3,13,9,11,5
3,0,0,12,5
3,0,1,12,5
3,0,2,12,5
3,0,3,12,5
3,0,4,12,5
3,0,5,12,5
3,0,6,12,5
3,0,7,12,5
3,0,8,12,5
3,0,9,12,5
3,1,0,12,5
3,1,1,12,5
3,1,2,12,5
3,1,3,12,5
3,1,4,12,5
3,1,5,12,5
3,1,6,12,5
3,1,7,12,5
3,1,8,12,5
3,1,9,12,5
3,2,0,12,5
3,2,1,12,5
3,2,2,12,5
3,2,3,12,5
3,2,4,12,5
3,2,5,12,5
3,2,6,12,5
3,2,7,12,5
3,2,8,12,5
3,2,9,12,5
3,3,0,12,5
3,3,1,12,5
3,3,2,12,5
3,3,3,12,5
3,3,4,12,5
3,3,5,12,5
3,3,6,12,5
3,3,7,12,5
3,3,8,12,5
3,3,9,12,5
3,4,0,12,5
3,4,1,12,5
3,4,2,12,5
3,4,3,12,5
3,4,4,12,5
3,4,5,12,5
3,4,6,12,5
3,4,7,12,5
3,4,8,12,5
3,4,9,12,5
3,5,0,12,5
3,5,1,12,5
3,5,2,12,5
3,5,3,12,5
3,5,4,12,5
3,5,5,12,5
3,5,6,12,5
3,5,7,12,5
3,5,8,12,5
3,5,9,12,5
3,6,0,12,5
3,6,1,12,5
3,6,2,12,5
3,6,3,12,5
3,6,4,12,5
3,6,5,12,5
3,6,6,12,5
3,6,7,12,5
3,6,8,12,5
3,6,9,12,5
3,7,0,12,5
3,7,1,12,5
3,7,2,12,5
3,7,3,12,5
3,7,4,12,5
3,7,5,12,5
3,7,6,12,5
3,7,7,12,5
3,7,8,12,5
3,7,9,12,5
3,8,0,12,5
3,8,1,12,5
3,8,2,12,5
3,8,3,12,5
3,8,4,12,5
3,8,5,12,5
3,8,6,12,5
3,8,7,12,5
3,8,8,12,5
3,8,9,12,5
3,9,0,12,5
3,9,1,12,5
3,9,2,12,5
3,9,3,12,5
3,9,4,12,5
3,9,5,12,5
3,9,6,12,5
3,9,7,12,5
3,9,8,12,5
3,9,9,12,5
3,10,0,12,5
3,10,1,12,5
3,10,2,12,5
3,10,3,12,5
3,10,4,12,5
3,10,5,12,5
3,10,6,12,5
3,10,7,12,5
3,10,8,12,5
3,10,9,12,5
3,11,0,12,5
3,11,1,12,5
3,11,2,12,5
3,11,3,12,5
3,11,4,12,5
3,11,5,12,5
3,11,6,12,5
3,11,7,12,5
3,11,8,12,5
3,11,9,12,5
3,12,0,12,5
3,12,1,12,5
3,12,2,12,5
3,12,3,12,5
3,12,4,12,5
3,12,5,12,5
3,12,6,12,5
3,12,7,12,5
3,12,8,12,5
3,12,9,12,5
3,0,0,13,5
3,0,1,13,5
3,0,2,13,5
3,0,3,13,5
3,0,4,13,5
3,0,5,13,5
3,0,6,13,5
3,0,7,13,5
3,0,8,13,5
3,0,9,13,5
3,1,0,13,5
3,1,1,13,5
3,1,2,13,5
3,1,3,13,5
3,1,4,13,5
3,1,5,13,5
3,1,6,13,5
3,1,7,13,5
3,1,8,13,5
3,1,9,13,5
3,2,0,13,5
3,2,1,13,5
3,2,2,13,5
3,2,3,13,5
3,2,4,13,5
3,2,5,13,5
3,2,6,13,5
3,2,7,13,5
3,2,8,13,5
3,2,9,13,5
3,3,0,13,5
3,3,1,13,5
3,3,2,13,5
3,3,3,13,5
3,3,4,13,5
3,3,5,13,5
3,3,6,13,5
3,3,7,13,5
3,3,8,13,5
3,3,9,13,5
3,4,0,13,5
3,4,1,13,5
3,4,2,13,5
3,4,3,13,5
3,4,4,13,5
3,4,5,13,5
3,4,6,13,5
3,4,7,13,5
3,4,8,13,5
3,4,9,13,5
3,5,0,13,5
3,5,1,13,5
3,5,2,13,5
3,5,3,13,5
3,5,4,13,5
3,5,5,13,5
3,5,6,13,5
3,5,7,13,5
3,5,8,13,5
3,5,9,13,5
3,6,0,13,5
3,6,1,13,5
3,6,2,13,5
3,6,3,13,5
3,6,4,13,5
3,6,5,13,5
3,6,6,13,5
3,6,7,13,5
3,6,8,13,5
3,6,9,13,5
3,7,0,13,5
3,7,1,13,5
3,7,2,13,5
3,7,3,13,5
3,7,4,13,5
3,7,5,13,5
3,7,6,13,5
3,7,7,13,5
3,7,8,13,5
3,7,9,13,5
3,8,0,13,5
3,8,1,13,5
3,8,2,13,5
3,8,3,13,5
3,8,4,13,5
3,8,5,13,5
3,8,6,13,5
3,8,7,13,5
3,8,8,13,5
3,8,9,13,5
3,9,0,13,5
3,9,1,13,5
3,9,2,13,5
3,9,3,13,5
3,9,4,13,5
3,9,5,13,5
3,9,6,13,5
3,9,7,13,5
3,9,8,13,5
3,9,9,13,5
3,10,0,13,5
3,10,1,13,5
3,10,2,13,5
3,10,3,13,5
3,10,4,13,5
3,10,5,13,5
3,10,6,13,5
3,10,7,13,5
3,10,8,13,5
3,10,9,13,5
3,11,0,13,5
3,11,1,13,5
3,11,2,13,5
3,11,3,13,5
3,11,4,13,5
3,11,5,13,5
3,11,6,13,5
3,11,7,13,5
3,11,8,13,5
3,11,9,13,5
3,0,0,14,5
3,0,1,14,5
3,0,2,14,5
3,0,3,14,5
3,0,4,14,5
3,0,5,14,5
3,0,6,14,5
3,0,7,14,5
3,0,8,14,5
3,0,9,14,5
3,1,0,14,5
3,1,1,14,5
3,1,2,14,5
3,1,3,14,5
3,1,4,14,5
3,1,5,14,5
3,1,6,14,5
3,1,7,14,5
3,1,8,14,5
3,1,9,14,5
3,2,0,14,5
3,2,1,14,5
3,2,2,14,5
3,2,3,14,5
3,2,4,14,5
3,2,5,14,5
3,2,6,14,5
3,2,7,14,5
3,2,8,14,5
3,2,9,14,5
3,3,0,14,5
3,3,1,14,5
3,3,2,14,5
3,3,3,14,5
3,3,4,14,5
3,3,5,14,5
3,3,6,14,5
3,3,7,14,5
3,3,8,14,5
3,3,9,14,5
3,4,0,14,5
3,4,1,14,5
3,4,2,14,5
3,4,3,14,5
3,4,4,14,5
3,4,5,14,5
3,4,6,14,5
3,4,7,14,5
3,4,8,14,5
3,4,9,14,5
3,5,0,14,5
3,5,1,14,5
3,5,2,14,5
3,5,3,14,5
3,5,4,14,5
3,5,5,14,5
3,5,6,14,5
3,5,7,14,5
3,5,8,14,5
3,5,9,14,5
3,6,0,14,5
3,6,1,14,5
3,6,2,14,5
3,6,3,14,5
3,6,4,14,5
3,6,5,14,5
3,6,6,14,5
3,6,7,14,5
3,6,8,14,5
3,6,9,14,5
3,7,0,14,5
3,7,1,14,5
3,7,2,14,5
3,7,3,14,5
3,7,4,14,5
3,7,5,14,5
3,7,6,14,5
3,7,7,14,5
3,7,8,14,5
3,7,9,14,5
3,8,0,14,5
3,8,1,14,5
3,8,2,14,5
3,8,3,14,5
3,8,4,14,5
3,8,5,14,5
3,8,6,14,5
3,8,7,14,5
3,8,8,14,5
3,8,9,14,5
3,9,0,14,5
3,9,1,14,5
3,9,2,14,5
3,9,3,14,5
3,9,4,14,5
3,9,5,14,5
3,9,6,14,5
3,9,7,14,5
3,9,8,14,5
3,9,9,14,5
3,10,0,14,5
3,10,1,14,5
3,10,2,14,5
3,10,3,14,5
3,10,4,14,5
3,10,5,14,5
3,10,6,14,5
3,10,7,14,5
3,10,8,14,5
3,10,9,14,5
3,0,0,15,5
3,0,1,15,5
3,0,2,15,5
3,0,3,15,5
3,0,4,15,5
3,0,5,15,5
3,0,6,15,5
3,0,7,15,5
3,0,8,15,5
3,0,9,15,5
3,1,0,15,5
3,1,1,15,5
3,1,2,15,5
3,1,3,15,5
3,1,4,15,5
3,1,5,15,5
3,1,6,15,5
3,1,7,15,5
3,1,8,15,5
3,1,9,15,5
3,2,0,15,5
3,2,1,15,5
3,2,2,15,5
3,2,3,15,5
3,2,4,15,5
3,2,5,15,5
3,2,6,15,5
3,2,7,15,5
3,2,8,15,5
3,2,9,15,5
3,3,0,15,5
3,3,1,15,5
3,3,2,15,5
3,3,3,15,5
3,3,4,15,5
3,3,5,15,5
3,3,6,15,5
3,3,7,15,5
3,3,8,15,5
3,3,9,15,5
3,4,0,15,5
3,4,1,15,5
3,4,2,15,5
3,4,3,15,5
3,4,4,15,5
3,4,5,15,5
3,4,6,15,5
3,4,7,15,5
3,4,8,15,5
3,4,9,15,5
3,5,0,15,5
3,5,1,15,5
3,5,2,15,5
3,5,3,15,5
3,5,4,15,5
3,5,5,15,5
3,5,6,15,5
3,5,7,15,5
3,5,8,15,5
3,5,9,15,5
3,6,0,15,5
3,6,1,15,5
3,6,2,15,5
3,6,3,15,5
3,6,4,15,5
3,6,5,15,5
3,6,6,15,5
3,6,7,15,5
3,6,8,15,5
3,6,9,15,5
3,7,0,15,5
3,7,1,15,5
3,7,2,15,5
3,7,3,15,5
3,7,4,15,5
3,7,5,15,5
3,7,6,15,5
3,7,7,15,5
3,7,8,15,5
3,7,9,15,5
3,8,0,15,5
3,8,1,15,5
3,8,2,15,5
3,8,3,15,5
3,8,4,15,5
3,8,5,15,5
3,8,6,15,5
3,8,7,15,5
3,8,8,15,5
3,8,9,15,5
3,9,0,15,5
3,9,1,15,5
3,9,2,15,5
3,9,3,15,5
3,9,4,15,5
3,9,5,15,5
3,9,6,15,5
3,9,7,15,5
3,9,8,15,5
3,9,9,15,5
3,0,0,16,5
3,0,1,16,5
3,0,2,16,5
3,0,3,16,5
3,0,4,16,5
3,0,5,16,5
3,0,6,16,5
3,0,7,16,5
3,0,8,16,5
3,0,9,16,5
3,1,0,16,5
3,1,1,16,5
3,1,2,16,5
3,1,3,16,5
3,1,4,16,5
3,1,5,16,5
3,1,6,16,5
3,1,7,16,5
3,1,8,16,5
3,1,9,16,5
3,2,0,16,5
3,2,1,16,5
3,2,2,16,5
3,2,3,16,5
3,2,4,16,5
3,2,5,16,5
3,2,6,16,5
3,2,7,16,5
3,2,8,16,5
3,2,9,16,5
3,3,0,16,5
3,3,1,16,5
3,3,2,16,5
3,3,3,16,5
3,3,4,16,5
3,3,5,16,5
3,3,6,16,5
3,3,7,16,5
3,3,8,16,5
3,3,9,16,5
3,4,0,16,5
3,4,1,16,5
3,4,2,16,5
3,4,3,16,5
3,4,4,16,5
3,4,5,16,5
3,4,6,16,5
3,4,7,16,5
3,4,8,16,5
3,4,9,16,5
3,5,0,16,5
3,5,1,16,5
3,5,2,16,5
3,5,3,16,5
3,5,4,16,5
3,5,5,16,5
3,5,6,16,5
3,5,7,16,5
3,5,8,16,5
3,5,9,16,5
3,6,0,16,5
3,6,1,16,5
3,6,2,16,5
3,6,3,16,5
3,6,4,16,5
3,6,5,16,5
3,6,6,16,5
3,6,7,16,5
3,6,8,16,5
3,6,9,16,5
3,7,0,16,5
3,7,1,16,5
3,7,2,16,5
3,7,3,16,5
3,7,4,16,5
3,7,5,16,5
3,7,6,16,5
3,7,7,16,5
3,7,8,16,5
3,7,9,16,5
3,8,0,16,5
3,8,1,16,5
3,8,2,16,5
3,8,3,16,5
3,8,4,16,5
3,8,5,16,5
3,8,6,16,5
3,8,7,16,5
3,8,8,16,5
3,8,9,16,5
3,0,0,17,5
3,0,1,17,5
3,0,2,17,5
3,0,3,17,5
3,0,4,17,5
3,0,5,17,5
3,0,6,17,5
3,0,7,17,5
3,0,8,17,5
3,0,9,17,5
3,1,0,17,5
3,1,1,17,5
3,1,2,17,5
3,1,3,17,5
3,1,4,17,5
3,1,5,17,5
3,1,6,17,5
3,1,7,17,5
3,1,8,17,5
3,1,9,17,5
3,2,0,17,5
3,2,1,17,5
3,2,2,17,5
3,2,3,17,5
3,2,4,17,5
3,2,5,17,5
3,2,6,17,5
3,2,7,17,5
3,2,8,17,5
3,2,9,17,5
3,3,0,17,5
3,3,1,17,5
3,3,2,17,5
3,3,3,17,5
3,3,4,17,5
3,3,5,17,5
3,3,6,17,5
3,3,7,17,5
3,3,8,17,5
3,3,9,17,5
3,4,0,17,5
3,4,1,17,5
3,4,2,17,5
3,4,3,17,5
3,4,4,17,5
3,4,5,17,5
3,4,6,17,5
3,4,7,17,5
3,4,8,17,5
3,4,9,17,5
3,5,0,17,5
3,5,1,17,5
3,5,2,17,5
3,5,3,17,5
3,5,4,17,5
3,5,5,17,5
3,5,6,17,5
3,5,7,17,5
3,5,8,17,5
3,5,9,17,5
3,6,0,17,5
3,6,1,17,5
3,6,2,17,5
3,6,3,17,5
3,6,4,17,5
3,6,5,17,5
3,6,6,17,5
3,6,7,17,5
3,6,8,17,5
3,6,9,17,5
3,7,0,17,5
3,7,1,17,5
3,7,2,17,5
3,7,3,17,5
3,7,4,17,5
3,7,5,17,5
3,7,6,17,5
3,7,7,17,5
3,7,8,17,5
3,7,9,17,5
3,0,0,18,5
3,0,1,18,5
3,0,2,18,5
3,0,3,18,5
3,0,4,18,5
3,0,5,18,5
3,0,6,18,5
3,0,7,18,5
3,0,8,18,5
3,0,9,18,5
3,1,0,18,5
3,1,1,18,5
3,1,2,18,5
3,1,3,18,5
3,1,4,18,5
3,1,5,18,5
3,1,6,18,5
3,1,7,18,5
3,1,8,18,5
3,1,9,18,5
3,2,0,18,5
3,2,1,18,5
3,2,2,18,5
3,2,3,18,5
3,2,4,18,5
3,2,5,18,5
3,2,6,18,5
3,2,7,18,5
3,2,8,18,5
3,2,9,18,5
3,3,0,18,5
3,3,1,18,5
3,3,2,18,5
3,3,3,18,5
3,3,4,18,5
3,3,5,18,5
3,3,6,18,5
3,3,7,18,5
3,3,8,18,5
3,3,9,18,5
3,4,0,18,5
3,4,1,18,5
3,4,2,18,5
3,4,3,18,5
3,4,4,18,5
3,4,5,18,5
3,4,6,18,5
3,4,7,18,5
3,4,8,18,5
3,4,9,18,5
3,5,0,18,5
3,5,1,18,5
3,5,2,18,5
3,5,3,18,5
3,5,4,18,5
3,5,5,18,5
3,5,6,18,5
3,5,7,18,5
3,5,8,18,5
3,5,9,18,5
3,6,0,18,5
3,6,1,18,5
3,6,2,18,5
3,6,3,18,5
3,6,4,18,5
3,6,5,18,5
3,6,6,18,5
3,6,7,18,5
3,6,8,18,5
3,6,9,18,5
3,0,0,19,5
3,0,1,19,5
3,0,2,19,5
3,0,3,19,5
3,0,4,19,5
3,0,5,19,5
3,0,6,19,5
3,0,7,19,5
3,0,8,19,5
3,0,9,19,5
3,1,0,19,5
3,1,1,19,5
3,1,2,19,5
3,1,3,19,5
3,1,4,19,5
3,1,5,19,5
3,1,6,19,5
3,1,7,19,5
3,1,8,19,5
3,1,9,19,5
3,2,0,19,5
3,2,1,19,5
3,2,2,19,5
3,2,3,19,5
3,2,4,19,5
3,2,5,19,5
3,2,6,19,5
3,2,7,19,5
3,2,8,19,5
3,2,9,19,5
3,3,0,19,5
3,3,1,19,5
3,3,2,19,5
3,3,3,19,5
3,3,4,19,5
3,3,5,19,5
3,3,6,19,5
3,3,7,19,5
3,3,8,19,5
3,3,9,19,5
3,4,0,19,5
3,4,1,19,5
3,4,2,19,5
3,4,3,19,5
3,4,4,19,5
3,4,5,19,5
3,4,6,19,5
3,4,7,19,5
3,4,8,19,5
3,4,9,19,5
3,5,0,19,5
3,5,1,19,5
3,5,2,19,5
3,5,3,19,5
3,5,4,19,5
3,5,5,19,5
3,5,6,19,5
3,5,7,19,5
3,5,8,19,5
3,5,9,19,5
3,0,0,20,5
3,0,1,20,5
3,0,2,20,5
3,0,3,20,5
3,0,4,20,5
3,0,5,20,5
3,0,6,20,5
3,0,7,20,5
3,0,8,20,5
3,0,9,20,5
3,1,0,20,5
3,1,1,20,5
3,1,2,20,5
3,1,3,20,5
3,1,4,20,5
3,1,5,20,5
3,1,6,20,5
3,1,7,20,5
3,1,8,20,5
3,1,9,20,5
3,2,0,20,5
3,2,1,20,5
3,2,2,20,5
3,2,3,20,5
3,2,4,20,5
3,2,5,20,5
3,2,6,20,5
3,2,7,20,5
3,2,8,20,5
3,2,9,20,5
3,3,0,20,5
3,3,1,20,5
3,3,2,20,5
3,3,3,20,5
3,3,4,20,5
3,3,5,20,5
3,3,6,20,5
3,3,7,20,5
3,3,8,20,5
3,3,9,20,5
3,4,0,20,5
3,4,1,20,5
3,4,2,20,5
3,4,3,20,5
3,4,4,20,5
3,4,5,20,5
3,4,6,20,5
3,4,7,20,5
3,4,8,20,5
3,4,9,20,5
3,0,0,21,5
3,0,1,21,5
3,0,2,21,5
3,0,3,21,5
3,0,4,21,5
3,0,5,21,5
3,0,6,21,5
3,0,7,21,5
3,0,8,21,5
3,0,9,21,5
3,1,0,21,5
3,1,1,21,5
3,1,2,21,5
3,1,3,21,5
3,1,4,21,5
3,1,5,21,5
3,1,6,21,5
3,1,7,21,5
3,1,8,21,5
3,1,9,21,5
3,2,0,21,5
3,2,1,21,5
3,2,2,21,5
3,2,3,21,5
3,2,4,21,5
3,2,5,21,5
3,2,6,21,5
3,2,7,21,5
3,2,8,21,5
3,2,9,21,5
3,3,0,21,5
3,3,1,21,5
3,3,2,21,5
3,3,3,21,5
3,3,4,21,5
3,3,5,21,5
3,3,6,21,5
3,3,7,21,5
3,3,8,21,5
3,3,9,21,5
3,0,0,22,5
3,0,1,22,5
3,0,2,22,5
3,0,3,22,5
3,0,4,22,5
3,0,5,22,5
3,0,6,22,5
3,0,7,22,5
3,0,8,22,5
3,0,9,22,5
3,1,0,22,5
3,1,1,22,5
3,1,2,22,5
3,1,3,22,5
3,1,4,22,5
3,1,5,22,5
3,1,6,22,5
3,1,7,22,5
3,1,8,22,5
3,1,9,22,5
3,2,0,22,5
3,2,1,22,5
3,2,2,22,5
3,2,3,22,5
3,2,4,22,5
3,2,5,22,5
3,2,6,22,5
3,2,7,22,5
3,2,8,22,5
3,2,9,22,5
3,0,0,23,5
3,0,1,23,5
3,0,2,23,5
3,0,3,23,5
3,0,4,23,5
3,0,5,23,5
3,0,6,23,5
3,0,7,23,5
3,0,8,23,5
3,0,9,23,5
3,1,0,23,5
3,1,1,23,5
3,1,2,23,5
3,1,3,23,5
3,1,4,23,5
3,1,5,23,5
3,1,6,23,5
3,1,7,23,5
3,1,8,23,5
3,1,9,23,5
3,0,0,24,5
3,0,1,24,5
3,0,2,24,5
3,0,3,24,5
3,0,4,24,5
3,0,5,24,5
3,0,6,24,5
3,0,7,24,5
3,0,8,24,5
3,0,9,24,5
3,0,0,1,6
3,0,1,1,6
3,0,2,1,6
3,0,3,1,6
3,0,4,1,6
3,0,5,1,6
3,0,6,1,6
3,1,0,1,6
3,1,1,1,6
3,1,2,1,6
3,1,3,1,6
3,1,4,1,6
3,1,5,1,6
3,1,6,1,6
3,2,0,1,6
3,2,1,1,6
3,2,2,1,6
3,2,3,1,6
3,2,4,1,6
3,2,5,1,6
3,2,6,1,6
3,3,0,1,6
3,3,1,1,6
3,3,2,1,6
3,3,3,1,6
3,3,4,1,6
3,3,5,1,6
3,3,6,1,6
3,4,0,1,6
3,4,1,1,6
3,4,2,1,6
3,4,3,1,6
3,4,4,1,6
3,4,5,1,6
3,4,6,1,6
3,5,0,1,6
3,5,1,1,6
3,5,2,1,6
3,5,3,1,6
3,5,4,1,6
3,5,5,1,6
3,5,6,1,6
3,6,0,1,6
3,6,1,1,6
3,6,2,1,6
3,6,3,1,6
3,6,4,1,6
3,6,5,1,6
3,6,6,1,6
3,7,0,1,6
3,7,1,1,6
3,7,2,1,6
3,7,3,1,6
3,7,4,1,6
3,7,5,1,6
3,7,6,1,6
3,8,0,1,6
3,8,1,1,6
3,8,2,1,6
3,8,3,1,6
3,8,4,1,6
3,8,5,1,6
3,8,6,1,6
3,9,0,1,6
3,9,1,1,6
3,9,2,1,6
3,9,3,1,6
3,9,4,1,6
3,9,5,1,6
3,9,6,1,6
3,10,0,1,6
3,10,1,1,6
3,10,2,1,6
3,10,3,1,6
3,10,4,1,6
3,10,5,1,6
3,10,6,1,6
3,11,0,1,6
3,11,1,1,6
3,11,2,1,6
3,11,3,1,6
3,11,4,1,6
3,11,5,1,6
3,11,6,1,6
3,12,0,1,6
3,12,1,1,6
3,12,2,1,6
3,12,3,1,6
3,12,4,1,6
3,12,5,1,6
3,12,6,1,6
3,13,0,1,6
3,13,1,1,6
3,13,2,1,6
3,13,3,1,6
3,13,4,1,6
3,13,5,1,6
3,13,6,1,6
3,14,0,1,6
3,14,1,1,6
3,14,2,1,6
3,14,3,1,6
3,14,4,1,6
3,14,5,1,6
3,14,6,1,6
3,15,0,1,6
3,15,1,1,6
3,15,2,1,6
3,15,3,1,6
3,15,4,1,6
3,15,5,1,6
3,15,6,1,6
3,16,0,1,6
3,16,1,1,6
3,16,2,1,6
3,16,3,1,6
3,16,4,1,6
3,16,5,1,6
3,16,6,1,6
3,17,0,1,6
3,17,1,1,6
3,17,2,1,6
3,17,3,1,6
3,17,4,1,6
3,17,5,1,6
3,17,6,1,6
3,18,0,1,6
3,18,1,1,6
3,18,2,1,6
3,18,3,1,6
3,18,4,1,6
3,18,5,1,6
3,18,6,1,6
3,19,0,1,6
3,19,1,1,6
3,19,2,1,6
3,19,3,1,6
3,19,4,1,6
3,19,5,1,6
3,19,6,1,6
3,20,0,1,6
3,20,1,1,6
3,20,2,1,6
3,20,3,1,6
3,20,4,1,6
3,20,5,1,6
3,20,6,1,6
3,21,0,1,6
3,21,1,1,6
3,21,2,1,6
3,21,3,1,6
3,21,4,1,6
3,21,5,1,6
3,21,6,1,6
3,22,0,1,6
3,22,1,1,6
3,22,2,1,6
3,22,3,1,6
3,22,4,1,6
3,22,5,1,6
3,22,6,1,6
3,23,0,1,6
3,23,1,1,6
3,23,2,1,6
3,23,3,1,6
3,23,4,1,6
3,23,5,1,6
3,23,6,1,6
3,0,0,2,6
3,0,1,2,6
3,0,2,2,6
3,0,3,2,6
3,0,4,2,6
3,0,5,2,6
3,0,6,2,6
3,1,0,2,6
3,1,1,2,6
3,1,2,2,6
3,1,3,2,6
3,1,4,2,6
3,1,5,2,6
3,1,6,2,6
3,2,0,2,6
3,2,1,2,6
3,2,2,2,6
3,2,3,2,6
3,2,4,2,6
3,2,5,2,6
3,2,6,2,6
3,3,0,2,6
3,3,1,2,6
3,3,2,2,6
3,3,3,2,6
3,3,4,2,6
3,3,5,2,6
3,3,6,2,6
3,4,0,2,6
3,4,1,2,6
3,4,2,2,6
3,4,3,2,6
3,4,4,2,6
3,4,5,2,6
3,4,6,2,6
3,5,0,2,6
3,5,1,2,6
3,5,2,2,6
3,5,3,2,6
3,5,4,2,6
3,5,5,2,6
3,5,6,2,6
3,6,0,2,6
3,6,1,2,6
3,6,2,2,6
3,6,3,2,6
3,6,4,2,6
3,6,5,2,6
3,6,6,2,6
3,7,0,2,6
3,7,1,2,6
3,7,2,2,6
3,7,3,2,6
3,7,4,2,6
3,7,5,2,6
3,7,6,2,6
3,8,0,2,6
3,8,1,2,6
3,8,2,2,6
3,8,3,2,6
3,8,4,2,6
3,8,5,2,6
3,8,6,2,6
3,9,0,2,6
3,9,1,2,6
3,9,2,2,6
3,9,3,2,6
3,9,4,2,6
3,9,5,2,6
3,9,6,2,6
3,10,0,2,6
3,10,1,2,6
3,10,2,2,6
3,10,3,2,6
3,10,4,2,6
3,10,5,2,6
3,10,6,2,6
3,11,0,2,6
3,11,1,2,6
3,11,2,2,6
3,11,3,2,6
3,11,4,2,6
3,11,5,2,6
3,11,6,2,6
3,12,0,2,6
3,12,1,2,6
3,12,2,2,6
3,12,3,2,6
3,12,4,2,6
3,12,5,2,6
3,12,6,2,6
3,13,0,2,6
3,13,1,2,6
3,13,2,2,6
3,13,3,2,6
3,13,4,2,6
3,13,5,2,6
3,13,6,2,6
3,14,0,2,6
3,14,1,2,6
3,14,2,2,6
3,14,3,2,6
3,14,4,2,6
3,14,5,2,6
3,14,6,2,6
3,15,0,2,6
3,15,1,2,6
3,15,2,2,6
3,15,3,2,6
3,15,4,2,6
3,15,5,2,6
3,15,6,2,6
3,16,0,2,6
3,16,1,2,6
3,16,2,2,6
3,16,3,2,6
3,16,4,2,6
3,16,5,2,6
3,16,6,2,6
3,17,0,2,6
3,17,1,2,6
3,17,2,2,6
3,17,3,2,6
3,17,4,2,6
3,17,5,2,6
3,17,6,2,6
3,18,0,2,6
3,18,1,2,6
3,18,2,2,6
3,18,3,2,6
3,18,4,2,6
3,18,5,2,6
3,18,6,2,6
3,19,0,2,6
3,19,1,2,6
3,19,2,2,6
3,19,3,2,6
3,19,4,2,6
3,19,5,2,6
3,19,6,2,6
3,20,0,2,6
3,20,1,2,6
3,20,2,2,6
3,20,3,2,6
3,20,4,2,6
3,20,5,2,6
3,20,6,2,6
3,21,0,2,6
3,21,1,2,6
3,21,2,2,6
3,21,3,2,6
3,21,4,2,6
3,21,5,2,6
3,21,6,2,6
3,22,0,2,6
3,22,1,2,6
3,22,2,2,6
3,22,3,2,6
3,22,4,2,6
3,22,5,2,6
3,22,6,2,6
3,0,0,3,6
3,0,1,3,6
3,0,2,3,6
3,0,3,3,6
3,0,4,3,6
3,0,5,3,6
3,0,6,3,6
3,1,0,3,6
3,1,1,3,6
3,1,2,3,6
3,1,3,3,6
3,1,4,3,6
3,1,5,3,6
3,1,6,3,6
3,2,0,3,6
3,2,1,3,6
3,2,2,3,6
3,2,3,3,6
3,2,4,3,6
3,2,5,3,6
3,2,6,3,6
3,3,0,3,6
3,3,1,3,6
3,3,2,3,6
3,3,3,3,6
3,3,4,3,6
3,3,5,3,6
3,3,6,3,6
3,4,0,3,6
3,4,1,3,6
3,4,2,3,6
3,4,3,3,6
3,4,4,3,6
3,4,5,3,6
3,4,6,3,6
3,5,0,3,6
3,5,1,3,6
3,5,2,3,6
3,5,3,3,6
3,5,4,3,6
3,5,5,3,6
3,5,6,3,6
3,6,0,3,6
3,6,1,3,6
3,6,2,3,6
3,6,3,3,6
3,6,4,3,6
3,6,5,3,6
3,6,6,3,6
3,7,0,3,6
3,7,1,3,6
3,7,2,3,6
3,7,3,3,6
3,7,4,3,6
3,7,5,3,6
3,7,6,3,6
3,8,0,3,6
3,8,1,3,6
3,8,2,3,6
3,8,3,3,6
3,8,4,3,6
3,8,5,3,6
3,8,6,3,6
3,9,0,3,6
3,9,1,3,6
3,9,2,3,6
3,9,3,3,6
3,9,4,3,6
3,9,5,3,6
3,9,6,3,6
3,10,0,3,6
3,10,1,3,6
3,10,2,3,6
3,10,3,3,6
3,10,4,3,6
3,10,5,3,6
3,10,6,3,6
3,11,0,3,6
3,11,1,3,6
3,11,2,3,6
3,11,3,3,6
3,11,4,3,6
3,11,5,3,6
3,11,6,3,6
3,12,0,3,6
3,12,1,3,6
3,12,2,3,6
3,12,3,3,6
3,12,4,3,6
3,12,5,3,6
3,12,6,3,6
3,13,0,3,6
3,13,1,3,6
3,13,2,3,6
3,13,3,3,6
3,13,4,3,6
3,13,5,3,6
3,13,6,3,6
3,14,0,3,6
3,14,1,3,6
3,14,2,3,6
3,14,3,3,6
3,14,4,3,6
3,14,5,3,6
3,14,6,3,6
3,15,0,3,6
3,15,1,3,6
3,15,2,3,6
3,15,3,3,6
3,15,4,3,6
3,15,5,3,6
3,15,6,3,6
3,16,0,3,6
3,16,1,3,6
3,16,2,3,6
3,16,3,3,6
3,16,4,3,6
3,16,5,3,6
3,16,6,3,6
3,17,0,3,6
3,17,1,3,6
3,17,2,3,6
3,17,3,3,6
3,17,4,3,6
3,17,5,3,6
3,17,6,3,6
3,18,0,3,6
3,18,1,3,6
3,18,2,3,6
3,18,3,3,6
3,18,4,3,6
3,18,5,3,6
3,18,6,3,6
3,19,0,3,6
3,19,1,3,6
3,19,2,3,6
3,19,3,3,6
3,19,4,3,6
3,19,5,3,6
3,19,6,3,6
3,20,0,3,6
3,20,1,3,6
3,20,2,3,6
3,20,3,3,6
3,20,4,3,6
3,20,5,3,6
3,20,6,3,6
3,21,0,3,6
3,21,1,3,6
3,21,2,3,6
3,21,3,3,6
3,21,4,3,6
3,21,5,3,6
3,21,6,3,6
3,0,0,4,6
3,0,1,4,6
3,0,2,4,6
3,0,3,4,6
3,0,4,4,6
3,0,5,4,6
3,0,6,4,6
3,1,0,4,6
3,1,1,4,6
3,1,2,4,6
3,1,3,4,6
3,1,4,4,6
3,1,5,4,6
3,1,6,4,6
3,2,0,4,6
3,2,1,4,6
3,2,2,4,6
3,2,3,4,6
3,2,4,4,6
3,2,5,4,6
3,2,6,4,6
3,3,0,4,6
3,3,1,4,6
3,3,2,4,6
3,3,3,4,6
3,3,4,4,6
3,3,5,4,6
3,3,6,4,6
3,4,0,4,6
3,4,1,4,6
3,4,2,4,6
3,4,3,4,6
3,4,4,4,6
3,4,5,4,6
3,4,6,4,6
3,5,0,4,6
3,5,1,4,6
3,5,2,4,6
3,5,3,4,6
3,5,4,4,6
3,5,5,4,6
3,5,6,4,6
3,6,0,4,6
3,6,1,4,6
3,6,2,4,6
3,6,3,4,6
3,6,4,4,6
3,6,5,4,6
3,6,6,4,6
3,7,0,4,6
3,7,1,4,6
3,7,2,4,6
3,7,3,4,6
3,7,4,4,6
3,7,5,4,6
3,7,6,4,6
3,8,0,4,6
3,8,1,4,6
3,8,2,4,6
3,8,3,4,6
3,8,4,4,6
3,8,5,4,6
3,8,6,4,6
3,9,0,4,6
3,9,1,4,6
3,9,2,4,6
3,9,3,4,6
3,9,4,4,6
3,9,5,4,6
3,9,6,4,6
3,10,0,4,6
3,10,1,4,6
3,10,2,4,6
3,10,3,4,6
3,10,4,4,6
3,10,5,4,6
3,10,6,4,6
3,11,0,4,6
3,11,1,4,6
3,11,2,4,6
3,11,3,4,6
3,11,4,4,6
3,11,5,4,6
3,11,6,4,6
3,12,0,4,6
3,12,1,4,6
3,12,2,4,6
3,12,3,4,6
3,12,4,4,6
3,12,5,4,6
3,12,6,4,6
3,13,0,4,6
3,13,1,4,6
3,13,2,4,6
3,13,3,4,6
3,13,4,4,6
3,13,5,4,6
3,13,6,4,6
3,14,0,4,6
3,14,1,4,6
3,14,2,4,6
3,14,3,4,6
3,14,4,4,6
3,14,5,4,6
3,14,6,4,6
3,15,0,4,6
3,15,1,4,6
3,15,2,4,6
3,15,3,4,6
3,15,4,4,6
3,15,5,4,6
3,15,6,4,6
3,16,0,4,6
3,16,1,4,6
3,16,2,4,6
3,16,3,4,6
3,16,4,4,6
3,16,5,4,6
3,16,6,4,6
3,17,0,4,6
3,17,1,4,6
3,17,2,4,6
3,17,3,4,6
3,17,4,4,6
3,17,5,4,6
3,17,6,4,6
3,18,0,4,6
3,18,1,4,6
3,18,2,4,6
3,18,3,4,6
3,18,4,4,6
3,18,5,4,6
3,18,6,4,6
3,19,0,4,6
3,19,1,4,6
3,19,2,4,6
3,19,3,4,6
3,19,4,4,6
3,19,5,4,6
3,19,6,4,6
3,20,0,4,6
3,20,1,4,6
3,20,2,4,6
3,20,3,4,6
3,20,4,4,6
3,20,5,4,6
3,20,6,4,6
3,0,0,5,6
3,0,1,5,6
3,0,2,5,6
3,0,3,5,6
3,0,4,5,6
3,0,5,5,6
3,0,6,5,6
3,1,0,5,6
3,1,1,5,6
3,1,2,5,6
3,1,3,5,6
3,1,4,5,6
3,1,5,5,6
3,1,6,5,6
3,2,0,5,6
3,2,1,5,6
3,2,2,5,6
3,2,3,5,6
3,2,4,5,6
3,2,5,5,6
3,2,6,5,6
3,3,0,5,6
3,3,1,5,6
3,3,2,5,6
3,3,3,5,6
3,3,4,5,6
3,3,5,5,6
3,3,6,5,6
3,4,0,5,6
3,4,1,5,6
3,4,2,5,6
3,4,3,5,6
3,4,4,5,6
3,4,5,5,6
3,4,6,5,6
3,5,0,5,6
3,5,1,5,6
3,5,2,5,6
3,5,3,5,6
3,5,4,5,6
3,5,5,5,6
3,5,6,5,6
3,6,0,5,6
3,6,1,5,6
3,6,2,5,6
3,6,3,5,6
3,6,4,5,6
3,6,5,5,6
3,6,6,5,6
3,7,0,5,6
3,7,1,5,6
3,7,2,5,6
3,7,3,5,6
3,7,4,5,6
3,7,5,5,6
3,7,6,5,6
3,8,0,5,6
3,8,1,5,6
3,8,2,5,6
3,8,3,5,6
3,8,4,5,6
3,8,5,5,6
3,8,6,5,6
3,9,0,5,6
3,9,1,5,6
3,9,2,5,6
3,9,3,5,6
3,9,4,5,6
3,9,5,5,6
3,9,6,5,6
3,10,0,5,6
3,10,1,5,6
3,10,2,5,6
3,10,3,5,6
3,10,4,5,6
3,10,5,5,6
3,10,6,5,6
3,11,0,5,6
3,11,1,5,6
3,11,2,5,6
3,11,3,5,6
3,11,4,5,6
3,11,5,5,6
3,11,6,5,6
3,12,0,5,6
3,12,1,5,6
3,12,2,5,6
3,12,3,5,6
3,12,4,5,6
3,12,5,5,6
3,12,6,5,6
3,13,0,5,6
3,13,1,5,6
3,13,2,5,6
3,13,3,5,6
3,13,4,5,6
3,13,5,5,6
3,13,6,5,6
3,14,0,5,6
3,14,1,5,6
3,14,2,5,6
3,14,3,5,6
3,14,4,5,6
3,14,5,5,6
3,14,6,5,6
3,15,0,5,6
3,15,1,5,6
3,15,2,5,6
3,15,3,5,6
3,15,4,5,6
3,15,5,5,6
3,15,6,5,6
3,16,0,5,6
3,16,1,5,6
3,16,2,5,6
3,16,3,5,6
3,16,4,5,6
3,16,5,5,6
3,16,6,5,6
3,17,0,5,6
3,17,1,5,6
3,17,2,5,6
3,17,3,5,6
3,17,4,5,6
3,17,5,5,6
3,17,6,5,6
3,18,0,5,6
3,18,1,5,6
3,18,2,5,6
3,18,3,5,6
3,18,4,5,6
3,18,5,5,6
3,18,6,5,6
3,19,0,5,6
3,19,1,5,6
3,19,2,5,6
3,19,3,5,6
3,19,4,5,6
3,19,5,5,6
3,19,6,5,6
3,0,0,6,6
3,0,1,6,6
3,0,2,6,6
3,0,3,6,6
3,0,4,6,6
3,0,5,6,6
3,0,6,6,6
3,1,0,6,6
3,1,1,6,6
3,1,2,6,6
3,1,3,6,6
3,1,4,6,6
3,1,5,6,6
3,1,6,6,6
3,2,0,6,6
3,2,1,6,6
3,2,2,6,6
3,2,3,6,6
3,2,4,6,6
3,2,5,6,6
3,2,6,6,6
3,3,0,6,6
3,3,1,6,6
3,3,2,6,6
3,3,3,6,6
3,3,4,6,6
3,3,5,6,6
3,3,6,6,6
3,4,0,6,6
3,4,1,6,6
3,4,2,6,6
3,4,3,6,6
3,4,4,6,6
3,4,5,6,6
3,4,6,6,6
3,5,0,6,6
3,5,1,6,6
3,5,2,6,6
3,5,3,6,6
3,5,4,6,6
3,5,5,6,6
3,5,6,6,6
3,6,0,6,6
3,6,1,6,6
3,6,2,6,6
3,6,3,6,6
3,6,4,6,6
3,6,5,6,6
3,6,6,6,6
3,7,0,6,6
3,7,1,6,6
3,7,2,6,6
3,7,3,6,6
3,7,4,6,6
3,7,5,6,6
3,7,6,6,6
3,8,0,6,6
3,8,1,6,6
3,8,2,6,6
3,8,3,6,6
3,8,4,6,6
3,8,5,6,6
3,8,6,6,6
3,9,0,6,6
3,9,1,6,6
3,9,2,6,6
3,9,3,6,6
3,9,4,6,6
3,9,5,6,6
3,9,6,6,6
3,10,0,6,6
3,10,1,6,6
3,10,2,6,6
3,10,3,6,6
3,10,4,6,6
3,10,5,6,6
3,10,6,6,6
3,11,0,6,6
3,11,1,6,6
3,11,2,6,6
3,11,3,6,6
3,11,4,6,6
3,11,5,6,6
3,11,6,6,6
3,12,0,6,6
3,12,1,6,6
3,12,2,6,6
3,12,3,6,6
3,12,4,6,6
3,12,5,6,6
3,12,6,6,6
3,13,0,6,6
3,13,1,6,6
3,13,2,6,6
3,13,3,6,6
3,13,4,6,6
3,13,5,6,6
3,13,6,6,6
3,14,0,6,6
3,14,1,6,6
3,14,2,6,6
3,14,3,6,6
3,14,4,6,6
3,14,5,6,6
3,14,6,6,6
3,15,0,6,6
3,15,1,6,6
3,15,2,6,6
3,15,3,6,6
3,15,4,6,6
3,15,5,6,6
3,15,6,6,6
3,16,0,6,6
3,16,1,6,6
3,16,2,6,6
3,16,3,6,6
3,16,4,6,6
3,16,5,6,6
3,16,6,6,6
3,17,0,6,6
3,17,1,6,6
3,17,2,6,6
3,17,3,6,6
3,17,4,6,6
3,17,5,6,6
3,17,6,6,6
3,18,0,6,6
3,18,1,6,6
3,18,2,6,6
3,18,3,6,6
3,18,4,6,6
3,18,5,6,6
3,18,6,6,6
3,0,0,7,6
3,0,1,7,6
3,0,2,7,6
3,0,3,7,6
3,0,4,7,6
3,0,5,7,6
3,0,6,7,6
3,1,0,7,6
3,1,1,7,6
3,1,2,7,6
3,1,3,7,6
3,1,4,7,6
3,1,5,7,6
3,1,6,7,6
3,2,0,7,6
3,2,1,7,6
3,2,2,7,6
3,2,3,7,6
3,2,4,7,6
3,2,5,7,6
3,2,6,7,6
3,3,0,7,6
3,3,1,7,6
3,3,2,7,6
3,3,3,7,6
3,3,4,7,6
3,3,5,7,6
3,3,6,7,6
3,4,0,7,6
3,4,1,7,6
3,4,2,7,6
3,4,3,7,6
3,4,4,7,6
3,4,5,7,6
3,4,6,7,6
3,5,0,7,6
3,5,1,7,6
3,5,2,7,6
3,5,3,7,6
3,5,4,7,6
3,5,5,7,6
3,5,6,7,6
3,6,0,7,6
3,6,1,7,6
3,6,2,7,6
3,6,3,7,6
3,6,4,7,6
3,6,5,7,6
3,6,6,7,6
3,7,0,7,6
3,7,1,7,6
3,7,2,7,6
3,7,3,7,6
3,7,4,7,6
3,7,5,7,6
3,7,6,7,6
3,8,0,7,6
3,8,1,7,6
3,8,2,7,6
3,8,3,7,6
3,8,4,7,6
3,8,5,7,6
3,8,6,7,6
3,9,0,7,6
3,9,1,7,6
3,9,2,7,6
3,9,3,7,6
3,9,4,7,6
3,9,5,7,6
3,9,6,7,6
3,10,0,7,6
3,10,1,7,6
3,10,2,7,6
3,10,3,7,6
3,10,4,7,6
3,10,5,7,6
3,10,6,7,6
3,11,0,7,6
3,11,1,7,6
3,11,2,7,6
3,11,3,7,6
3,11,4,7,6
3,11,5,7,6
3,11,6,7,6
3,12,0,7,6
3,12,1,7,6
3,12,2,7,6
3,12,3,7,6
3,12,4,7,6
3,12,5,7,6
3,12,6,7,6
3,13,0,7,6
3,13,1,7,6
3,13,2,7,6
3,13,3,7,6
3,13,4,7,6
3,13,5,7,6
3,13,6,7,6
3,14,0,7,6
3,14,1,7,6
3,14,2,7,6
3,14,3,7,6
3,14,4,7,6
3,14,5,7,6
3,14,6,7,6
3,15,0,7,6
3,15,1,7,6
3,15,2,7,6
3,15,3,7,6
3,15,4,7,6
3,15,5,7,6
3,15,6,7,6
3,16,0,7,6
3,16,1,7,6
3,16,2,7,6
3,16,3,7,6
3,16,4,7,6
3,16,5,7,6
3,16,6,7,6
3,17,0,7,6
3,17,1,7,6
3,17,2,7,6
3,17,3,7,6
3,17,4,7,6
3,17,5,7,6
3,17,6,7,6
3,0,0,8,6
3,0,1,8,6
3,0,2,8,6
3,0,3,8,6
3,0,4,8,6
3,0,5,8,6
3,0,6,8,6
3,1,0,8,6
3,1,1,8,6
3,1,2,8,6
3,1,3,8,6
3,1,4,8,6
3,1,5,8,6
3,1,6,8,6
3,2,0,8,6
3,2,1,8,6
3,2,2,8,6
3,2,3,8,6
3,2,4,8,6
3,2,5,8,6
3,2,6,8,6
3,3,0,8,6
3,3,1,8,6
3,3,2,8,6
3,3,3,8,6
3,3,4,8,6
3,3,5,8,6
3,3,6,8,6
3,4,0,8,6
3,4,1,8,6
3,4,2,8,6
3,4,3,8,6
3,4,4,8,6
3,4,5,8,6
3,4,6,8,6
3,5,0,8,6
3,5,1,8,6
3,5,2,8,6
3,5,3,8,6
3,5,4,8,6
3,5,5,8,6
3,5,6,8,6
3,6,0,8,6
3,6,1,8,6
3,6,2,8,6
3,6,3,8,6
3,6,4,8,6
3,6,5,8,6
3,6,6,8,6
3,7,0,8,6
3,7,1,8,6
3,7,2,8,6
3,7,3,8,6
3,7,4,8,6
3,7,5,8,6
3,7,6,8,6
3,8,0,8,6
3,8,1,8,6
3,8,2,8,6
3,8,3,8,6
3,8,4,8,6
3,8,5,8,6
3,8,6,8,6
3,9,0,8,6
3,9,1,8,6
3,9,2,8,6
3,9,3,8,6
3,9,4,8,6
3,9,5,8,6
3,9,6,8,6
3,10,0,8,6
3,10,1,8,6
3,10,2,8,6
3,10,3,8,6
3,10,4,8,6
3,10,5,8,6
3,10,6,8,6
3,11,0,8,6
3,11,1,8,6
3,11,2,8,6
3,11,3,8,6
3,11,4,8,6
3,11,5,8,6
3,11,6,8,6
3,12,0,8,6
3,12,1,8,6
3,12,2,8,6
3,12,3,8,6
3,12,4,8,6
3,12,5,8,6
3,12,6,8,6
3,13,0,8,6
3,13,1,8,6
3,13,2,8,6
3,13,3,8,6
3,13,4,8,6
3,13,5,8,6
3,13,6,8,6
3,14,0,8,6
3,14,1,8,6
3,14,2,8,6
3,14,3,8,6
3,14,4,8,6
3,14,5,8,6
3,14,6,8,6
3,15,0,8,6
3,15,1,8,6
3,15,2,8,6
3,15,3,8,6
3,15,4,8,6
3,15,5,8,6
3,15,6,8,6
3,16,0,8,6
3,16,1,8,6
3,16,2,8,6
3,16,3,8,6
3,16,4,8,6
3,16,5,8,6
3,16,6,8,6
3,0,0,9,6
3,0,1,9,6
3,0,2,9,6
3,0,3,9,6
3,0,4,9,6
3,0,5,9,6
3,0,6,9,6
3,1,0,9,6
3,1,1,9,6
3,1,2,9,6
3,1,3,9,6
3,1,4,9,6
3,1,5,9,6
3,1,6,9,6
3,2,0,9,6
3,2,1,9,6
3,2,2,9,6
3,2,3,9,6
3,2,4,9,6
3,2,5,9,6
3,2,6,9,6
3,3,0,9,6
3,3,1,9,6
3,3,2,9,6
3,3,3,9,6
3,3,4,9,6
3,3,5,9,6
3,3,6,9,6
3,4,0,9,6
3,4,1,9,6
3,4,2,9,6
3,4,3,9,6
3,4,4,9,6
3,4,5,9,6
3,4,6,9,6
3,5,0,9,6
3,5,1,9,6
3,5,2,9,6
3,5,3,9,6
3,5,4,9,6
3,5,5,9,6
3,5,6,9,6
3,6,0,9,6
3,6,1,9,6
3,6,2,9,6
3,6,3,9,6
3,6,4,9,6
3,6,5,9,6
3,6,6,9,6
3,7,0,9,6
3,7,1,9,6
3,7,2,9,6
3,7,3,9,6
3,7,4,9,6
3,7,5,9,6
3,7,6,9,6
3,8,0,9,6
3,8,1,9,6
3,8,2,9,6
3,8,3,9,6
3,8,4,9,6
3,8,5,9,6
3,8,6,9,6
3,9,0,9,6
3,9,1,9,6
3,9,2,9,6
3,9,3,9,6
3,9,4,9,6
3,9,5,9,6
3,9,6,9,6
3,10,0,9,6
3,10,1,9,6
3,10,2,9,6
3,10,3,9,6
3,10,4,9,6
3,10,5,9,6
3,10,6,9,6
3,11,0,9,6
3,11,1,9,6
3,11,2,9,6
3,11,3,9,6
3,11,4,9,6
3,11,5,9,6
3,11,6,9,6
3,12,0,9,6
3,12,1,9,6
3,12,2,9,6
3,12,3,9,6
3,12,4,9,6
3,12,5,9,6
3,12,6,9,6
3,13,0,9,6
3,13,1,9,6
3,13,2,9,6
3,13,3,9,6
3,13,4,9,6
3,13,5,9,6
3,13,6,9,6
3,14,0,9,6
3,14,1,9,6
3,14,2,9,6
3,14,3,9,6
3,14,4,9,6
3,14,5,9,6
3,14,6,9,6
3,15,0,9,6
3,15,1,9,6
3,15,2,9,6
3,15,3,9,6
3,15,4,9,6
3,15,5,9,6
3,15,6,9,6
3,0,0,10,6
3,0,1,10,6
3,0,2,10,6
3,0,3,10,6
3,0,4,10,6
3,0,5,10,6
3,0,6,10,6
3,1,0,10,6
3,1,1,10,6
3,1,2,10,6
3,1,3,10,6
3,1,4,10,6
3,1,5,10,6
3,1,6,10,6
3,2,0,10,6
3,2,1,10,6
3,2,2,10,6
3,2,3,10,6
3,2,4,10,6
3,2,5,10,6
3,2,6,10,6
3,3,0,10,6
3,3,1,10,6
3,3,2,10,6
3,3,3,10,6
3,3,4,10,6
3,3,5,10,6
3,3,6,10,6
3,4,0,10,6
3,4,1,10,6
3,4,2,10,6
3,4,3,10,6
3,4,4,10,6
3,4,5,10,6
3,4,6,10,6
3,5,0,10,6
3,5,1,10,6
3,5,2,10,6
3,5,3,10,6
3,5,4,10,6
3,5,5,10,6
3,5,6,10,6
3,6,0,10,6
3,6,1,10,6
3,6,2,10,6
3,6,3,10,6
3,6,4,10,6
3,6,5,10,6
3,6,6,10,6
3,7,0,10,6
3,7,1,10,6
3,7,2,10,6
3,7,3,10,6
3,7,4,10,6
3,7,5,10,6
3,7,6,10,6
3,8,0,10,6
3,8,1,10,6
3,8,2,10,6
3,8,3,10,6
3,8,4,10,6
3,8,5,10,6
3,8,6,10,6
3,9,0,10,6
3,9,1,10,6
3,9,2,10,6
3,9,3,10,6
3,9,4,10,6
3,9,5,10,6
3,9,6,10,6
3,10,0,10,6
3,10,1,10,6
3,10,2,10,6
3,10,3,10,6
3,10,4,10,6
3,10,5,10,6
3,10,6,10,6
3,11,0,10,6
3,11,1,10,6
3,11,2,10,6
3,11,3,10,6
3,11,4,10,6
3,11,5,10,6
3,11,6,10,6
3,12,0,10,6
3,12,1,10,6
3,12,2,10,6
3,12,3,10,6
3,12,4,10,6
3,12,5,10,6
3,12,6,10,6
3,13,0,10,6
3,13,1,10,6
3,13,2,10,6
3,13,3,10,6
3,13,4,10,6
3,13,5,10,6
3,13,6,10,6
3,14,0,10,6
3,14,1,10,6
3,14,2,10,6
3,14,3,10,6
3,14,4,10,6
3,14,5,10,6
3,14,6,10,6
3,0,0,11,6
3,0,1,11,6
3,0,2,11,6
3,0,3,11,6
3,0,4,11,6
3,0,5,11,6
3,0,6,11,6
3,1,0,11,6
3,1,1,11,6
3,1,2,11,6
3,1,3,11,6
3,1,4,11,6
3,1,5,11,6
3,1,6,11,6
3,2,0,11,6
3,2,1,11,6
3,2,2,11,6
3,2,3,11,6
3,2,4,11,6
3,2,5,11,6
3,2,6,11,6
3,3,0,11,6
3,3,1,11,6
3,3,2,11,6
3,3,3,11,6
3,3,4,11,6
3,3,5,11,6
3,3,6,11,6
3,4,0,11,6
3,4,1,11,6
3,4,2,11,6
3,4,3,11,6
3,4,4,11,6
3,4,5,11,6
3,4,6,11,6
3,5,0,11,6
3,5,1,11,6
3,5,2,11,6
3,5,3,11,6
3,5,4,11,6
3,5,5,11,6
3,5,6,11,6
3,6,0,11,6
3,6,1,11,6
3,6,2,11,6
3,6,3,11,6
3,6,4,11,6
3,6,5,11,6
3,6,6,11,6
3,7,0,11,6
3,7,1,11,6
3,7,2,11,6
3,7,3,11,6
3,7,4,11,6
3,7,5,11,6
3,7,6,11,6
3,8,0,11,6
3,8,1,11,6
3,8,2,11,6
3,8,3,11,6
3,8,4,11,6
3,8,5,11,6
3,8,6,11,6
3,9,0,11,6
3,9,1,11,6
3,9,2,11,6
3,9,3,11,6
3,9,4,11,6
3,9,5,11,6
3,9,6,11,6
3,10,0,11,6
3,10,1,11,6
3,10,2,11,6
3,10,3,11,6
3,10,4,11,6
3,10,5,11,6
3,10,6,11,6
3,11,0,11,6
3,11,1,11,6
3,11,2,11,6
3,11,3,11,6
3,11,4,11,6
3,11,5,11,6
3,11,6,11,6
3,12,0,11,6
3,12,1,11,6
3,12,2,11,6
3,12,3,11,6
3,12,4,11,6
3,12,5,11,6
3,12,6,11,6
3,13,0,11,6
3,13,1,11,6
3,13,2,11,6
3,13,3,11,6
3,13,4,11,6
3,13,5,11,6
3,13,6,11,6
3,0,0,12,6
3,0,1,12,6
3,0,2,12,6
3,0,3,12,6
3,0,4,12,6
3,0,5,12,6
3,0,6,12,6
3,1,0,12,6
3,1,1,12,6
3,1,2,12,6
3,1,3,12,6
3,1,4,12,6
3,1,5,12,6
3,1,6,12,6
3,2,0,12,6
3,2,1,12,6
3,2,2,12,6
3,2,3,12,6
3,2,4,12,6
3,2,5,12,6
3,2,6,12,6
3,3,0,12,6
3,3,1,12,6
3,3,2,12,6
3,3,3,12,6
3,3,4,12,6
3,3,5,12,6
3,3,6,12,6
3,4,0,12,6
3,4,1,12,6
3,4,2,12,6
3,4,3,12,6
3,4,4,12,6
3,4,5,12,6
3,4,6,12,6
3,5,0,12,6
3,5,1,12,6
3,5,2,12,6
3,5,3,12,6
3,5,4,12,6
3,5,5,12,6
3,5,6,12,6
3,6,0,12,6
3,6,1,12,6
3,6,2,12,6
3,6,3,12,6
3,6,4,12,6
3,6,5,12,6
3,6,6,12,6
3,7,0,12,6
3,7,1,12,6
3,7,2,12,6
3,7,3,12,6
3,7,4,12,6
3,7,5,12,6
3,7,6,12,6
3,8,0,12,6
3,8,1,12,6
3,8,2,12,6
3,8,3,12,6
3,8,4,12,6
3,8,5,12,6
3,8,6,12,6
3,9,0,12,6
3,9,1,12,6
3,9,2,12,6
3,9,3,12,6
3,9,4,12,6
3,9,5,12,6
3,9,6,12,6
3,10,0,12,6
3,10,1,12,6
3,10,2,12,6
3,10,3,12,6
3,10,4,12,6
3,10,5,12,6
3,10,6,12,6
3,11,0,12,6
3,11,1,12,6
3,11,2,12,6
3,11,3,12,6
3,11,4,12,6
3,11,5,12,6
3,11,6,12,6
3,12,0,12,6
3,12,1,12,6
3,12,2,12,6
3,12,3,12,6
3,12,4,12,6
3,12,5,12,6
3,12,6,12,6
3,0,0,13,6
3,0,1,13,6
3,0,2,13,6
3,0,3,13,6
3,0,4,13,6
3,0,5,13,6
3,0,6,13,6
3,1,0,13,6
3,1,1,13,6
3,1,2,13,6
3,1,3,13,6
3,1,4,13,6
3,1,5,13,6
3,1,6,13,6
3,2,0,13,6
3,2,1,13,6
3,2,2,13,6
3,2,3,13,6
3,2,4,13,6
3,2,5,13,6
3,2,6,13,6
3,3,0,13,6
3,3,1,13,6
3,3,2,13,6
3,3,3,13,6
3,3,4,13,6
3,3,5,13,6
3,3,6,13,6
3,4,0,13,6
3,4,1,13,6
3,4,2,13,6
3,4,3,13,6
3,4,4,13,6
3,4,5,13,6
3,4,6,13,6
3,5,0,13,6
3,5,1,13,6
3,5,2,13,6
3,5,3,13,6
3,5,4,13,6
3,5,5,13,6
3,5,6,13,6
3,6,0,13,6
3,6,1,13,6
3,6,2,13,6
3,6,3,13,6
3,6,4,13,6
3,6,5,13,6
3,6,6,13,6
3,7,0,13,6
3,7,1,13,6
3,7,2,13,6
3,7,3,13,6
3,7,4,13,6
3,7,5,13,6
3,7,6,13,6
3,8,0,13,6
3,8,1,13,6
3,8,2,13,6
3,8,3,13,6
3,8,4,13,6
3,8,5,13,6
3,8,6,13,6
3,9,0,13,6
3,9,1,13,6
3,9,2,13,6
3,9,3,13,6
3,9,4,13,6
3,9,5,13,6
3,9,6,13,6
3,10,0,13,6
3,10,1,13,6
3,10,2,13,6
3,10,3,13,6
3,10,4,13,6
3,10,5,13,6
3,10,6,13,6
3,11,0,13,6
3,11,1,13,6
3,11,2,13,6
3,11,3,13,6
3,11,4,13,6
3,11,5,13,6
3,11,6,13,6
3,0,0,14,6
3,0,1,14,6
3,0,2,14,6
3,0,3,14,6
3,0,4,14,6
3,0,5,14,6
3,0,6,14,6
3,1,0,14,6
3,1,1,14,6
3,1,2,14,6
3,1,3,14,6
3,1,4,14,6
3,1,5,14,6
3,1,6,14,6
3,2,0,14,6
3,2,1,14,6
3,2,2,14,6
3,2,3,14,6
3,2,4,14,6
3,2,5,14,6
3,2,6,14,6
3,3,0,14,6
3,3,1,14,6
3,3,2,14,6
3,3,3,14,6
3,3,4,14,6
3,3,5,14,6
3,3,6,14,6
3,4,0,14,6
3,4,1,14,6
3,4,2,14,6
3,4,3,14,6
3,4,4,14,6
3,4,5,14,6
3,4,6,14,6
3,5,0,14,6
3,5,1,14,6
3,5,2,14,6
3,5,3,14,6
3,5,4,14,6
3,5,5,14,6
3,5,6,14,6
3,6,0,14,6
3,6,1,14,6
3,6,2,14,6
3,6,3,14,6
3,6,4,14,6
3,6,5,14,6
3,6,6,14,6
3,7,0,14,6
3,7,1,14,6
3,7,2,14,6
3,7,3,14,6
3,7,4,14,6
3,7,5,14,6
3,7,6,14,6
3,8,0,14,6
3,8,1,14,6
3,8,2,14,6
3,8,3,14,6
3,8,4,14,6
3,8,5,14,6
3,8,6,14,6
3,9,0,14,6
3,9,1,14,6
3,9,2,14,6
3,9,3,14,6
3,9,4,14,6
3,9,5,14,6
3,9,6,14,6
3,10,0,14,6
3,10,1,14,6
3,10,2,14,6
3,10,3,14,6
3,10,4,14,6
3,10,5,14,6
3,10,6,14,6
3,0,0,15,6
3,0,1,15,6
3,0,2,15,6
3,0,3,15,6
3,0,4,15,6
3,0,5,15,6
3,0,6,15,6
3,1,0,15,6
3,1,1,15,6
3,1,2,15,6
3,1,3,15,6
3,1,4,15,6
3,1,5,15,6
3,1,6,15,6
3,2,0,15,6
3,2,1,15,6
3,2,2,15,6
3,2,3,15,6
3,2,4,15,6
3,2,5,15,6
3,2,6,15,6
3,3,0,15,6
3,3,1,15,6
3,3,2,15,6
3,3,3,15,6
3,3,4,15,6
3,3,5,15,6
3,3,6,15,6
3,4,0,15,6
3,4,1,15,6
3,4,2,15,6
3,4,3,15,6
3,4,4,15,6
3,4,5,15,6
3,4,6,15,6
3,5,0,15,6
3,5,1,15,6
3,5,2,15,6
3,5,3,15,6
3,5,4,15,6
3,5,5,15,6
3,5,6,15,6
3,6,0,15,6
3,6,1,15,6
3,6,2,15,6
3,6,3,15,6
3,6,4,15,6
3,6,5,15,6
3,6,6,15,6
3,7,0,15,6
3,7,1,15,6
3,7,2,15,6
3,7,3,15,6
3,7,4,15,6
3,7,5,15,6
3,7,6,15,6
3,8,0,15,6
3,8,1,15,6
3,8,2,15,6
3,8,3,15,6
3,8,4,15,6
3,8,5,15,6
3,8,6,15,6
3,9,0,15,6
3,9,1,15,6
3,9,2,15,6
3,9,3,15,6
3,9,4,15,6
3,9,5,15,6
3,9,6,15,6
3,0,0,16,6
3,0,1,16,6
3,0,2,16,6
3,0,3,16,6
3,0,4,16,6
3,0,5,16,6
3,0,6,16,6
3,1,0,16,6
3,1,1,16,6
3,1,2,16,6
3,1,3,16,6
3,1,4,16,6
3,1,5,16,6
3,1,6,16,6
3,2,0,16,6
3,2,1,16,6
3,2,2,16,6
3,2,3,16,6
3,2,4,16,6
3,2,5,16,6
3,2,6,16,6
3,3,0,16,6
3,3,1,16,6
3,3,2,16,6
3,3,3,16,6
3,3,4,16,6
3,3,5,16,6
3,3,6,16,6
3,4,0,16,6
3,4,1,16,6
3,4,2,16,6
3,4,3,16,6
3,4,4,16,6
3,4,5,16,6
3,4,6,16,6
3,5,0,16,6
3,5,1,16,6
3,5,2,16,6
3,5,3,16,6
3,5,4,16,6
3,5,5,16,6
3,5,6,16,6
3,6,0,16,6
3,6,1,16,6
3,6,2,16,6
3,6,3,16,6
3,6,4,16,6
3,6,5,16,6
3,6,6,16,6
3,7,0,16,6
3,7,1,16,6
3,7,2,16,6
3,7,3,16,6
3,7,4,16,6
3,7,5,16,6
3,7,6,16,6
3,8,0,16,6
3,8,1,16,6
3,8,2,16,6
3,8,3,16,6
3,8,4,16,6
3,8,5,16,6
3,8,6,16,6
3,0,0,17,6
3,0,1,17,6
3,0,2,17,6
3,0,3,17,6
3,0,4,17,6
3,0,5,17,6
3,0,6,17,6
3,1,0,17,6
3,1,1,17,6
3,1,2,17,6
3,1,3,17,6
3,1,4,17,6
3,1,5,17,6
3,1,6,17,6
3,2,0,17,6
3,2,1,17,6
3,2,2,17,6
3,2,3,17,6
3,2,4,17,6
3,2,5,17,6
3,2,6,17,6
3,3,0,17,6
3,3,1,17,6
3,3,2,17,6
3,3,3,17,6
3,3,4,17,6
3,3,5,17,6
3,3,6,17,6
3,4,0,17,6
3,4,1,17,6
3,4,2,17,6
3,4,3,17,6
3,4,4,17,6
3,4,5,17,6
3,4,6,17,6
3,5,0,17,6
3,5,1,17,6
3,5,2,17,6
3,5,3,17,6
3,5,4,17,6
3,5,5,17,6
3,5,6,17,6
3,6,0,17,6
3,6,1,17,6
3,6,2,17,6
3,6,3,17,6
3,6,4,17,6
3,6,5,17,6
3,6,6,17,6
3,7,0,17,6
3,7,1,17,6
3,7,2,17,6
3,7,3,17,6
3,7,4,17,6
3,7,5,17,6
3,7,6,17,6
3,0,0,18,6
3,0,1,18,6
3,0,2,18,6
3,0,3,18,6
3,0,4,18,6
3,0,5,18,6
3,0,6,18,6
3,1,0,18,6
3,1,1,18,6
3,1,2,18,6
3,1,3,18,6
3,1,4,18,6
3,1,5,18,6
3,1,6,18,6
3,2,0,18,6
3,2,1,18,6
3,2,2,18,6
3,2,3,18,6
3,2,4,18,6
3,2,5,18,6
3,2,6,18,6
3,3,0,18,6
3,3,1,18,6
3,3,2,18,6
3,3,3,18,6
3,3,4,18,6
3,3,5,18,6
3,3,6,18,6
3,4,0,18,6
3,4,1,18,6
3,4,2,18,6
3,4,3,18,6
3,4,4,18,6
3,4,5,18,6
3,4,6,18,6
3,5,0,18,6
3,5,1,18,6
3,5,2,18,6
3,5,3,18,6
3,5,4,18,6
3,5,5,18,6
3,5,6,18,6
3,6,0,18,6
3,6,1,18,6
3,6,2,18,6
3,6,3,18,6
3,6,4,18,6
3,6,5,18,6
3,6,6,18,6
3,0,0,19,6
3,0,1,19,6
3,0,2,19,6
3,0,3,19,6
3,0,4,19,6
3,0,5,19,6
3,0,6,19,6
3,1,0,19,6
3,1,1,19,6
3,1,2,19,6
3,1,3,19,6
3,1,4,19,6
3,1,5,19,6
3,1,6,19,6
3,2,0,19,6
3,2,1,19,6
3,2,2,19,6
3,2,3,19,6
3,2,4,19,6
3,2,5,19,6
3,2,6,19,6
3,3,0,19,6
3,3,1,19,6
3,3,2,19,6
3,3,3,19,6
3,3,4,19,6
3,3,5,19,6
3,3,6,19,6
3,4,0,19,6
3,4,1,19,6
3,4,2,19,6
3,4,3,19,6
3,4,4,19,6
3,4,5,19,6
3,4,6,19,6
3,5,0,19,6
3,5,1,19,6
3,5,2,19,6
3,5,3,19,6
3,5,4,19,6
3,5,5,19,6
3,5,6,19,6
3,0,0,20,6
3,0,1,20,6
3,0,2,20,6
3,0,3,20,6
3,0,4,20,6
3,0,5,20,6
3,0,6,20,6
3,1,0,20,6
3,1,1,20,6
3,1,2,20,6
3,1,3,20,6
3,1,4,20,6
3,1,5,20,6
3,1,6,20,6
3,2,0,20,6
3,2,1,20,6
3,2,2,20,6
3,2,3,20,6
3,2,4,20,6
3,2,5,20,6
3,2,6,20,6
3,3,0,20,6
3,3,1,20,6
3,3,2,20,6
3,3,3,20,6
3,3,4,20,6
3,3,5,20,6
3,3,6,20,6
3,4,0,20,6
3,4,1,20,6
3,4,2,20,6
3,4,3,20,6
3,4,4,20,6
3,4,5,20,6
3,4,6,20,6
3,0,0,21,6
3,0,1,21,6
3,0,2,21,6
3,0,3,21,6
3,0,4,21,6
3,0,5,21,6
3,0,6,21,6
3,1,0,21,6
3,1,1,21,6
3,1,2,21,6
3,1,3,21,6
3,1,4,21,6
3,1,5,21,6
3,1,6,21,6
3,2,0,21,6
3,2,1,21,6
3,2,2,21,6
3,2,3,21,6
3,2,4,21,6
3,2,5,21,6
3,2,6,21,6
3,3,0,21,6
3,3,1,21,6
3,3,2,21,6
3,3,3,21,6
3,3,4,21,6
3,3,5,21,6
3,3,6,21,6
3,0,0,22,6
3,0,1,22,6
3,0,2,22,6
3,0,3,22,6
3,0,4,22,6
3,0,5,22,6
3,0,6,22,6
3,1,0,22,6
3,1,1,22,6
3,1,2,22,6
3,1,3,22,6
3,1,4,22,6
3,1,5,22,6
3,1,6,22,6
3,2,0,22,6
3,2,1,22,6
3,2,2,22,6
3,2,3,22,6
3,2,4,22,6
3,2,5,22,6
3,2,6,22,6
3,0,0,23,6
3,0,1,23,6
3,0,2,23,6
3,0,3,23,6
3,0,4,23,6
3,0,5,23,6
3,0,6,23,6
3,1,0,23,6
3,1,1,23,6
3,1,2,23,6
3,1,3,23,6
3,1,4,23,6
3,1,5,23,6
3,1,6,23,6
3,0,0,24,6
3,0,1,24,6
3,0,2,24,6
3,0,3,24,6
3,0,4,24,6
3,0,5,24,6
3,0,6,24,6
3,0,0,1,7
3,0,1,1,7
3,0,2,1,7
3,0,3,1,7
3,1,0,1,7
3,1,1,1,7
3,1,2,1,7
3,1,3,1,7
3,2,0,1,7
3,2,1,1,7
3,2,2,1,7
3,2,3,1,7
3,3,0,1,7
3,3,1,1,7
3,3,2,1,7
3,3,3,1,7
3,4,0,1,7
3,4,1,1,7
3,4,2,1,7
3,4,3,1,7
3,5,0,1,7
3,5,1,1,7
3,5,2,1,7
3,5,3,1,7
3,6,0,1,7
3,6,1,1,7
3,6,2,1,7
3,6,3,1,7
3,7,0,1,7
3,7,1,1,7
3,7,2,1,7
3,7,3,1,7
3,8,0,1,7
3,8,1,1,7
3,8,2,1,7
3,8,3,1,7
3,9,0,1,7
3,9,1,1,7
3,9,2,1,7
3,9,3,1,7
3,10,0,1,7
3,10,1,1,7
3,10,2,1,7
3,10,3,1,7
3,11,0,1,7
3,11,1,1,7
3,11,2,1,7
3,11,3,1,7
3,12,0,1,7
3,12,1,1,7
3,12,2,1,7
3,12,3,1,7
3,13,0,1,7
3,13,1,1,7
3,13,2,1,7
3,13,3,1,7
3,14,0,1,7
3,14,1,1,7
3,14,2,1,7
3,14,3,1,7
3,15,0,1,7
3,15,1,1,7
3,15,2,1,7
3,15,3,1,7
3,16,0,1,7
3,16,1,1,7
3,16,2,1,7
3,16,3,1,7
3,17,0,1,7
3,17,1,1,7
3,17,2,1,7
3,17,3,1,7
3,18,0,1,7
3,18,1,1,7
3,18,2,1,7
3,18,3,1,7
3,19,0,1,7
3,19,1,1,7
3,19,2,1,7
3,19,3,1,7
3,20,0,1,7
3,20,1,1,7
3,20,2,1,7
3,20,3,1,7
3,21,0,1,7
3,21,1,1,7
3,21,2,1,7
3,21,3,1,7
3,22,0,1,7
3,22,1,1,7
3,22,2,1,7
3,22,3,1,7
3,23,0,1,7
3,23,1,1,7
3,23,2,1,7
3,23,3,1,7
3,0,0,2,7
3,0,1,2,7
3,0,2,2,7
3,0,3,2,7
3,1,0,2,7
3,1,1,2,7
3,1,2,2,7
3,1,3,2,7
3,2,0,2,7
3,2,1,2,7
3,2,2,2,7
3,2,3,2,7
3,3,0,2,7
3,3,1,2,7
3,3,2,2,7
3,3,3,2,7
3,4,0,2,7
3,4,1,2,7
3,4,2,2,7
3,4,3,2,7
3,5,0,2,7
3,5,1,2,7
3,5,2,2,7
3,5,3,2,7
3,6,0,2,7
3,6,1,2,7
3,6,2,2,7
3,6,3,2,7
3,7,0,2,7
3,7,1,2,7
3,7,2,2,7
3,7,3,2,7
3,8,0,2,7
3,8,1,2,7
3,8,2,2,7
3,8,3,2,7
3,9,0,2,7
3,9,1,2,7
3,9,2,2,7
3,9,3,2,7
3,10,0,2,7
3,10,1,2,7
3,10,2,2,7
3,10,3,2,7
3,11,0,2,7
3,11,1,2,7
3,11,2,2,7
3,11,3,2,7
3,12,0,2,7
3,12,1,2,7
3,12,2,2,7
3,12,3,2,7
3,13,0,2,7
3,13,1,2,7
3,13,2,2,7
3,13,3,2,7
3,14,0,2,7
3,14,1,2,7
3,14,2,2,7
3,14,3,2,7
3,15,0,2,7
3,15,1,2,7
3,15,2,2,7
3,15,3,2,7
3,16,0,2,7
3,16,1,2,7
3,16,2,2,7
3,16,3,2,7
3,17,0,2,7
3,17,1,2,7
3,17,2,2,7
3,17,3,2,7
3,18,0,2,7
3,18,1,2,7
3,18,2,2,7
3,18,3,2,7
3,19,0,2,7
3,19,1,2,7
3,19,2,2,7
3,19,3,2,7
3,20,0,2,7
3,20,1,2,7
3,20,2,2,7
3,20,3,2,7
3,21,0,2,7
3,21,1,2,7
3,21,2,2,7
3,21,3,2,7
3,22,0,2,7
3,22,1,2,7
3,22,2,2,7
3,22,3,2,7
3,0,0,3,7
3,0,1,3,7
3,0,2,3,7
3,0,3,3,7
3,1,0,3,7
3,1,1,3,7
3,1,2,3,7
3,1,3,3,7
3,2,0,3,7
3,2,1,3,7
3,2,2,3,7
3,2,3,3,7
3,3,0,3,7
3,3,1,3,7
3,3,2,3,7
3,3,3,3,7
3,4,0,3,7
3,4,1,3,7
3,4,2,3,7
3,4,3,3,7
3,5,0,3,7
3,5,1,3,7
3,5,2,3,7
3,5,3,3,7
3,6,0,3,7
3,6,1,3,7
3,6,2,3,7
3,6,3,3,7
3,7,0,3,7
3,7,1,3,7
3,7,2,3,7
3,7,3,3,7
3,8,0,3,7
3,8,1,3,7
3,8,2,3,7
3,8,3,3,7
3,9,0,3,7
3,9,1,3,7
3,9,2,3,7
3,9,3,3,7
3,10,0,3,7
3,10,1,3,7
3,10,2,3,7
3,10,3,3,7
3,11,0,3,7
3,11,1,3,7
3,11,2,3,7
3,11,3,3,7
3,12,0,3,7
3,12,1,3,7
3,12,2,3,7
3,12,3,3,7
3,13,0,3,7
3,13,1,3,7
3,13,2,3,7
3,13,3,3,7
3,14,0,3,7
3,14,1,3,7
3,14,2,3,7
3,14,3,3,7
3,15,0,3,7
3,15,1,3,7
3,15,2,3,7
3,15,3,3,7
3,16,0,3,7
3,16,1,3,7
3,16,2,3,7
3,16,3,3,7
3,17,0,3,7
3,17,1,3,7
3,17,2,3,7
3,17,3,3,7
3,18,0,3,7
3,18,1,3,7
3,18,2,3,7
3,18,3,3,7
3,19,0,3,7
3,19,1,3,7
3,19,2,3,7
3,19,3,3,7
3,20,0,3,7
3,20,1,3,7
3,20,2,3,7
3,20,3,3,7
3,21,0,3,7
3,21,1,3,7
3,21,2,3,7
3,21,3,3,7
3,0,0,4,7
3,0,1,4,7
3,0,2,4,7
3,0,3,4,7
3,1,0,4,7
3,1,1,4,7
3,1,2,4,7
3,1,3,4,7
3,2,0,4,7
3,2,1,4,7
3,2,2,4,7
3,2,3,4,7
3,3,0,4,7
3,3,1,4,7
3,3,2,4,7
3,3,3,4,7
3,4,0,4,7
3,4,1,4,7
3,4,2,4,7
3,4,3,4,7
3,5,0,4,7
3,5,1,4,7
3,5,2,4,7
3,5,3,4,7
3,6,0,4,7
3,6,1,4,7
3,6,2,4,7
3,6,3,4,7
3,7,0,4,7
3,7,1,4,7
3,7,2,4,7
3,7,3,4,7
3,8,0,4,7
3,8,1,4,7
3,8,2,4,7
3,8,3,4,7
3,9,0,4,7
3,9,1,4,7
3,9,2,4,7
3,9,3,4,7
3,10,0,4,7
3,10,1,4,7
3,10,2,4,7
3,10,3,4,7
3,11,0,4,7
3,11,1,4,7
3,11,2,4,7
3,11,3,4,7
3,12,0,4,7
3,12,1,4,7
3,12,2,4,7
3,12,3,4,7
3,13,0,4,7
3,13,1,4,7
3,13,2,4,7
3,13,3,4,7
3,14,0,4,7
3,14,1,4,7
3,14,2,4,7
3,14,3,4,7
3,15,0,4,7
3,15,1,4,7
3,15,2,4,7
3,15,3,4,7
3,16,0,4,7
3,16,1,4,7
3,16,2,4,7
3,16,3,4,7
3,17,0,4,7
3,17,1,4,7
3,17,2,4,7
3,17,3,4,7
3,18,0,4,7
3,18,1,4,7
3,18,2,4,7
3,18,3,4,7
3,19,0,4,7
3,19,1,4,7
3,19,2,4,7
3,19,3,4,7
3,20,0,4,7
3,20,1,4,7
3,20,2,4,7
3,20,3,4,7
3,0,0,5,7
3,0,1,5,7
3,0,2,5,7
3,0,3,5,7
3,1,0,5,7
3,1,1,5,7
3,1,2,5,7
3,1,3,5,7
3,2,0,5,7
3,2,1,5,7
3,2,2,5,7
3,2,3,5,7
3,3,0,5,7
3,3,1,5,7
3,3,2,5,7
3,3,3,5,7
3,4,0,5,7
3,4,1,5,7
3,4,2,5,7
3,4,3,5,7
3,5,0,5,7
3,5,1,5,7
3,5,2,5,7
3,5,3,5,7
3,6,0,5,7
3,6,1,5,7
3,6,2,5,7
3,6,3,5,7
3,7,0,5,7
3,7,1,5,7
3,7,2,5,7
3,7,3,5,7
3,8,0,5,7
3,8,1,5,7
3,8,2,5,7
3,8,3,5,7
3,9,0,5,7
3,9,1,5,7
3,9,2,5,7
3,9,3,5,7
3,10,0,5,7
3,10,1,5,7
3,10,2,5,7
3,10,3,5,7
3,11,0,5,7
3,11,1,5,7
3,11,2,5,7
3,11,3,5,7
3,12,0,5,7
3,12,1,5,7
3,12,2,5,7
3,12,3,5,7
3,13,0,5,7
3,13,1,5,7
3,13,2,5,7
3,13,3,5,7
3,14,0,5,7
3,14,1,5,7
3,14,2,5,7
3,14,3,5,7
3,15,0,5,7
3,15,1,5,7
3,15,2,5,7
3,15,3,5,7
3,16,0,5,7
3,16,1,5,7
3,16,2,5,7
3,16,3,5,7
3,17,0,5,7
3,17,1,5,7
3,17,2,5,7
3,17,3,5,7
3,18,0,5,7
3,18,1,5,7
3,18,2,5,7
3,18,3,5,7
3,19,0,5,7
3,19,1,5,7
3,19,2,5,7
3,19,3,5,7
3,0,0,6,7
3,0,1,6,7
3,0,2,6,7
3,0,3,6,7
3,1,0,6,7
3,1,1,6,7
3,1,2,6,7
3,1,3,6,7
3,2,0,6,7
3,2,1,6,7
3,2,2,6,7
3,2,3,6,7
3,3,0,6,7
3,3,1,6,7
3,3,2,6,7
3,3,3,6,7
3,4,0,6,7
3,4,1,6,7
3,4,2,6,7
3,4,3,6,7
3,5,0,6,7
3,5,1,6,7
3,5,2,6,7
3,5,3,6,7
3,6,0,6,7
3,6,1,6,7
3,6,2,6,7
3,6,3,6,7
3,7,0,6,7
3,7,1,6,7
3,7,2,6,7
3,7,3,6,7
3,8,0,6,7
3,8,1,6,7
3,8,2,6,7
3,8,3,6,7
3,9,0,6,7
3,9,1,6,7
3,9,2,6,7
3,9,3,6,7
3,10,0,6,7
3,10,1,6,7
3,10,2,6,7
3,10,3,6,7
3,11,0,6,7
3,11,1,6,7
3,11,2,6,7
3,11,3,6,7
3,12,0,6,7
3,12,1,6,7
3,12,2,6,7
3,12,3,6,7
3,13,0,6,7
3,13,1,6,7
3,13,2,6,7
3,13,3,6,7
3,14,0,6,7
3,14,1,6,7
3,14,2,6,7
3,14,3,6,7
3,15,0,6,7
3,15,1,6,7
3,15,2,6,7
3,15,3,6,7
3,16,0,6,7
3,16,1,6,7
3,16,2,6,7
3,16,3,6,7
3,17,0,6,7
3,17,1,6,7
3,17,2,6,7
3,17,3,6,7
3,18,0,6,7
3,18,1,6,7
3,18,2,6,7
3,18,3,6,7
3,0,0,7,7
3,0,1,7,7
3,0,2,7,7
3,0,3,7,7
3,1,0,7,7
3,1,1,7,7
3,1,2,7,7
3,1,3,7,7
3,2,0,7,7
3,2,1,7,7
3,2,2,7,7
3,2,3,7,7
3,3,0,7,7
3,3,1,7,7
3,3,2,7,7
3,3,3,7,7
3,4,0,7,7
3,4,1,7,7
3,4,2,7,7
3,4,3,7,7
3,5,0,7,7
3,5,1,7,7
3,5,2,7,7
3,5,3,7,7
3,6,0,7,7
3,6,1,7,7
3,6,2,7,7
3,6,3,7,7
3,7,0,7,7
3,7,1,7,7
3,7,2,7,7
3,7,3,7,7
3,8,0,7,7
3,8,1,7,7
3,8,2,7,7
3,8,3,7,7
3,9,0,7,7
3,9,1,7,7
3,9,2,7,7
3,9,3,7,7
3,10,0,7,7
3,10,1,7,7
3,10,2,7,7
3,10,3,7,7
3,11,0,7,7
3,11,1,7,7
3,11,2,7,7
3,11,3,7,7
3,12,0,7,7
3,12,1,7,7
3,12,2,7,7
3,12,3,7,7
3,13,0,7,7
3,13,1,7,7
3,13,2,7,7
3,13,3,7,7
3,14,0,7,7
3,14,1,7,7
3,14,2,7,7
3,14,3,7,7
3,15,0,7,7
3,15,1,7,7
3,15,2,7,7
3,15,3,7,7
3,16,0,7,7
3,16,1,7,7
3,16,2,7,7
3,16,3,7,7
3,17,0,7,7
3,17,1,7,7
3,17,2,7,7
3,17,3,7,7
3,0,0,8,7
3,0,1,8,7
3,0,2,8,7
3,0,3,8,7
3,1,0,8,7
3,1,1,8,7
3,1,2,8,7
3,1,3,8,7
3,2,0,8,7
3,2,1,8,7
3,2,2,8,7
3,2,3,8,7
3,3,0,8,7
3,3,1,8,7
3,3,2,8,7
3,3,3,8,7
3,4,0,8,7
3,4,1,8,7
3,4,2,8,7
3,4,3,8,7
3,5,0,8,7
3,5,1,8,7
3,5,2,8,7
3,5,3,8,7
3,6,0,8,7
3,6,1,8,7
3,6,2,8,7
3,6,3,8,7
3,7,0,8,7
3,7,1,8,7
3,7,2,8,7
3,7,3,8,7
3,8,0,8,7
3,8,1,8,7
3,8,2,8,7
3,8,3,8,7
3,9,0,8,7
3,9,1,8,7
3,9,2,8,7
3,9,3,8,7
3,10,0,8,7
3,10,1,8,7
3,10,2,8,7
3,10,3,8,7
3,11,0,8,7
3,11,1,8,7
3,11,2,8,7
3,11,3,8,7
3,12,0,8,7
3,12,1,8,7
3,12,2,8,7
3,12,3,8,7
3,13,0,8,7
3,13,1,8,7
3,13,2,8,7
3,13,3,8,7
3,14,0,8,7
3,14,1,8,7
3,14,2,8,7
3,14,3,8,7
3,15,0,8,7
3,15,1,8,7
3,15,2,8,7
3,15,3,8,7
3,16,0,8,7
3,16,1,8,7
3,16,2,8,7
3,16,3,8,7
3,0,0,9,7
3,0,1,9,7
3,0,2,9,7
3,0,3,9,7
3,1,0,9,7
3,1,1,9,7
3,1,2,9,7
3,1,3,9,7
3,2,0,9,7
3,2,1,9,7
3,2,2,9,7
3,2,3,9,7
3,3,0,9,7
3,3,1,9,7
3,3,2,9,7
3,3,3,9,7
3,4,0,9,7
3,4,1,9,7
3,4,2,9,7
3,4,3,9,7
3,5,0,9,7
3,5,1,9,7
3,5,2,9,7
3,5,3,9,7
3,6,0,9,7
3,6,1,9,7
3,6,2,9,7
3,6,3,9,7
3,7,0,9,7
3,7,1,9,7
3,7,2,9,7
3,7,3,9,7
3,8,0,9,7
3,8,1,9,7
3,8,2,9,7
3,8,3,9,7
3,9,0,9,7
3,9,1,9,7
3,9,2,9,7
3,9,3,9,7
3,10,0,9,7
3,10,1,9,7
3,10,2,9,7
3,10,3,9,7
3,11,0,9,7
3,11,1,9,7
3,11,2,9,7
3,11,3,9,7
3,12,0,9,7
3,12,1,9,7
3,12,2,9,7
3,12,3,9,7
3,13,0,9,7
3,13,1,9,7
3,13,2,9,7
3,13,3,9,7
3,14,0,9,7
3,14,1,9,7
3,14,2,9,7
3,14,3,9,7
3,15,0,9,7
3,15,1,9,7
3,15,2,9,7
3,15,3,9,7
3,0,0,10,7
3,0,1,10,7
3,0,2,10,7
3,0,3,10,7
3,1,0,10,7
3,1,1,10,7
3,1,2,10,7
3,1,3,10,7
3,2,0,10,7
3,2,1,10,7
3,2,2,10,7
3,2,3,10,7
3,3,0,10,7
3,3,1,10,7
3,3,2,10,7
3,3,3,10,7
3,4,0,10,7
3,4,1,10,7
3,4,2,10,7
3,4,3,10,7
3,5,0,10,7
3,5,1,10,7
3,5,2,10,7
3,5,3,10,7
3,6,0,10,7
3,6,1,10,7
3,6,2,10,7
3,6,3,10,7
3,7,0,10,7
3,7,1,10,7
3,7,2,10,7
3,7,3,10,7
3,8,0,10,7
3,8,1,10,7
3,8,2,10,7
3,8,3,10,7
3,9,0,10,7
3,9,1,10,7
3,9,2,10,7
3,9,3,10,7
3,10,0,10,7
3,10,1,10,7
3,10,2,10,7
3,10,3,10,7
3,11,0,10,7
3,11,1,10,7
3,11,2,10,7
3,11,3,10,7
3,12,0,10,7
3,12,1,10,7
3,12,2,10,7
3,12,3,10,7
3,13,0,10,7
3,13,1,10,7
3,13,2,10,7
3,13,3,10,7
3,14,0,10,7
3,14,1,10,7
3,14,2,10,7
3,14,3,10,7
3,0,0,11,7
3,0,1,11,7
3,0,2,11,7
3,0,3,11,7
3,1,0,11,7
3,1,1,11,7
3,1,2,11,7
3,1,3,11,7
3,2,0,11,7
3,2,1,11,7
3,2,2,11,7
3,2,3,11,7
3,3,0,11,7
3,3,1,11,7
3,3,2,11,7
3,3,3,11,7
3,4,0,11,7
3,4,1,11,7
3,4,2,11,7
3,4,3,11,7
3,5,0,11,7
3,5,1,11,7
3,5,2,11,7
3,5,3,11,7
3,6,0,11,7
3,6,1,11,7
3,6,2,11,7
3,6,3,11,7
3,7,0,11,7
3,7,1,11,7
3,7,2,11,7
3,7,3,11,7
3,8,0,11,7
3,8,1,11,7
3,8,2,11,7
3,8,3,11,7
3,9,0,11,7
3,9,1,11,7
3,9,2,11,7
3,9,3,11,7
3,10,0,11,7
3,10,1,11,7
3,10,2,11,7
3,10,3,11,7
3,11,0,11,7
3,11,1,11,7
3,11,2,11,7
3,11,3,11,7
3,12,0,11,7
3,12,1,11,7
3,12,2,11,7
3,12,3,11,7
3,13,0,11,7
3,13,1,11,7
3,13,2,11,7
3,13,3,11,7
3,0,0,12,7
3,0,1,12,7
3,0,2,12,7
3,0,3,12,7
3,1,0,12,7
3,1,1,12,7
3,1,2,12,7
3,1,3,12,7
3,2,0,12,7
3,2,1,12,7
3,2,2,12,7
3,2,3,12,7
3,3,0,12,7
3,3,1,12,7
3,3,2,12,7
3,3,3,12,7
3,4,0,12,7
3,4,1,12,7
3,4,2,12,7
3,4,3,12,7
3,5,0,12,7
3,5,1,12,7
3,5,2,12,7
3,5,3,12,7
3,6,0,12,7
3,6,1,12,7
3,6,2,12,7
3,6,3,12,7
3,7,0,12,7
3,7,1,12,7
3,7,2,12,7
3,7,3,12,7
3,8,0,12,7
3,8,1,12,7
3,8,2,12,7
3,8,3,12,7
3,9,0,12,7
3,9,1,12,7
3,9,2,12,7
3,9,3,12,7
3,10,0,12,7
3,10,1,12,7
3,10,2,12,7
3,10,3,12,7
3,11,0,12,7
3,11,1,12,7
3,11,2,12,7
3,11,3,12,7
3,12,0,12,7
3,12,1,12,7
3,12,2,12,7
3,12,3,12,7
3,0,0,13,7
3,0,1,13,7
3,0,2,13,7
3,0,3,13,7
3,1,0,13,7
3,1,1,13,7
3,1,2,13,7
3,1,3,13,7
3,2,0,13,7
3,2,1,13,7
3,2,2,13,7
3,2,3,13,7
3,3,0,13,7
3,3,1,13,7
3,3,2,13,7
3,3,3,13,7
3,4,0,13,7
3,4,1,13,7
3,4,2,13,7
3,4,3,13,7
3,5,0,13,7
3,5,1,13,7
3,5,2,13,7
3,5,3,13,7
3,6,0,13,7
3,6,1,13,7
3,6,2,13,7
3,6,3,13,7
3,7,0,13,7
3,7,1,13,7
3,7,2,13,7
3,7,3,13,7
3,8,0,13,7
3,8,1,13,7
3,8,2,13,7
3,8,3,13,7
3,9,0,13,7
3,9,1,13,7
3,9,2,13,7
3,9,3,13,7
3,10,0,13,7
3,10,1,13,7
3,10,2,13,7
3,10,3,13,7
3,11,0,13,7
3,11,1,13,7
3,11,2,13,7
3,11,3,13,7
3,0,0,14,7
3,0,1,14,7
3,0,2,14,7
3,0,3,14,7
3,1,0,14,7
3,1,1,14,7
3,1,2,14,7
3,1,3,14,7
3,2,0,14,7
3,2,1,14,7
3,2,2,14,7
3,2,3,14,7
3,3,0,14,7
3,3,1,14,7
3,3,2,14,7
3,3,3,14,7
3,4,0,14,7
3,4,1,14,7
3,4,2,14,7
3,4,3,14,7
3,5,0,14,7
3,5,1,14,7
3,5,2,14,7
3,5,3,14,7
3,6,0,14,7
3,6,1,14,7
3,6,2,14,7
3,6,3,14,7
3,7,0,14,7
3,7,1,14,7
3,7,2,14,7
3,7,3,14,7
3,8,0,14,7
3,8,1,14,7
3,8,2,14,7
3,8,3,14,7
3,9,0,14,7
3,9,1,14,7
3,9,2,14,7
3,9,3,14,7
3,10,0,14,7
3,10,1,14,7
3,10,2,14,7
3,10,3,14,7
3,0,0,15,7
3,0,1,15,7
3,0,2,15,7
3,0,3,15,7
3,1,0,15,7
3,1,1,15,7
3,1,2,15,7
3,1,3,15,7
3,2,0,15,7
3,2,1,15,7
3,2,2,15,7
3,2,3,15,7
3,3,0,15,7
3,3,1,15,7
3,3,2,15,7
3,3,3,15,7
3,4,0,15,7
3,4,1,15,7
3,4,2,15,7
3,4,3,15,7
3,5,0,15,7
3,5,1,15,7
3,5,2,15,7
3,5,3,15,7
3,6,0,15,7
3,6,1,15,7
3,6,2,15,7
3,6,3,15,7
3,7,0,15,7
3,7,1,15,7
3,7,2,15,7
3,7,3,15,7
3,8,0,15,7
3,8,1,15,7
3,8,2,15,7
3,8,3,15,7
3,9,0,15,7
3,9,1,15,7
3,9,2,15,7
3,9,3,15,7
3,0,0,16,7
3,0,1,16,7
3,0,2,16,7
3,0,3,16,7
3,1,0,16,7
3,1,1,16,7
3,1,2,16,7
3,1,3,16,7
3,2,0,16,7
3,2,1,16,7
3,2,2,16,7
3,2,3,16,7
3,3,0,16,7
3,3,1,16,7
3,3,2,16,7
3,3,3,16,7
3,4,0,16,7
3,4,1,16,7
3,4,2,16,7
3,4,3,16,7
3,5,0,16,7
3,5,1,16,7
3,5,2,16,7
3,5,3,16,7
3,6,0,16,7
3,6,1,16,7
3,6,2,16,7
3,6,3,16,7
3,7,0,16,7
3,7,1,16,7
3,7,2,16,7
3,7,3,16,7
3,8,0,16,7
3,8,1,16,7
3,8,2,16,7
3,8,3,16,7
3,0,0,17,7
3,0,1,17,7
3,0,2,17,7
3,0,3,17,7
3,1,0,17,7
3,1,1,17,7
3,1,2,17,7
3,1,3,17,7
3,2,0,17,7
3,2,1,17,7
3,2,2,17,7
3,2,3,17,7
3,3,0,17,7
3,3,1,17,7
3,3,2,17,7
3,3,3,17,7
3,4,0,17,7
3,4,1,17,7
3,4,2,17,7
3,4,3,17,7
3,5,0,17,7
3,5,1,17,7
3,5,2,17,7
3,5,3,17,7
3,6,0,17,7
3,6,1,17,7
3,6,2,17,7
3,6,3,17,7
3,7,0,17,7
3,7,1,17,7
3,7,2,17,7
3,7,3,17,7
3,0,0,18,7
3,0,1,18,7
3,0,2,18,7
3,0,3,18,7
3,1,0,18,7
3,1,1,18,7
3,1,2,18,7
3,1,3,18,7
3,2,0,18,7
3,2,1,18,7
3,2,2,18,7
3,2,3,18,7
3,3,0,18,7
3,3,1,18,7
3,3,2,18,7
3,3,3,18,7
3,4,0,18,7
3,4,1,18,7
3,4,2,18,7
3,4,3,18,7
3,5,0,18,7
3,5,1,18,7
3,5,2,18,7
3,5,3,18,7
3,6,0,18,7
3,6,1,18,7
3,6,2,18,7
3,6,3,18,7
3,0,0,19,7
3,0,1,19,7
3,0,2,19,7
3,0,3,19,7
3,1,0,19,7
3,1,1,19,7
3,1,2,19,7
3,1,3,19,7
3,2,0,19,7
3,2,1,19,7
3,2,2,19,7
3,2,3,19,7
3,3,0,19,7
3,3,1,19,7
3,3,2,19,7
3,3,3,19,7
3,4,0,19,7
3,4,1,19,7
3,4,2,19,7
3,4,3,19,7
3,5,0,19,7
3,5,1,19,7
3,5,2,19,7
3,5,3,19,7
3,0,0,20,7
3,0,1,20,7
3,0,2,20,7
3,0,3,20,7
3,1,0,20,7
3,1,1,20,7
3,1,2,20,7
3,1,3,20,7
3,2,0,20,7
3,2,1,20,7
3,2,2,20,7
3,2,3,20,7
3,3,0,20,7
3,3,1,20,7
3,3,2,20,7
3,3,3,20,7
3,4,0,20,7
3,4,1,20,7
3,4,2,20,7
3,4,3,20,7
3,0,0,21,7
3,0,1,21,7
3,0,2,21,7
3,0,3,21,7
3,1,0,21,7
3,1,1,21,7
3,1,2,21,7
3,1,3,21,7
3,2,0,21,7
3,2,1,21,7
3,2,2,21,7
3,2,3,21,7
3,3,0,21,7
3,3,1,21,7
3,3,2,21,7
3,3,3,21,7
3,0,0,22,7
3,0,1,22,7
3,0,2,22,7
3,0,3,22,7
3,1,0,22,7
3,1,1,22,7
3,1,2,22,7
3,1,3,22,7
3,2,0,22,7
3,2,1,22,7
3,2,2,22,7
3,2,3,22,7
3,0,0,23,7
3,0,1,23,7
3,0,2,23,7
3,0,3,23,7
3,1,0,23,7
3,1,1,23,7
3,1,2,23,7
3,1,3,23,7
3,0,0,24,7
3,0,1,24,7
3,0,2,24,7
3,0,3,24,7
3,0,0,1,8
3,1,0,1,8
3,2,0,1,8
3,3,0,1,8
3,4,0,1,8
3,5,0,1,8
3,6,0,1,8
3,7,0,1,8
3,8,0,1,8
3,9,0,1,8
3,10,0,1,8
3,11,0,1,8
3,12,0,1,8
3,13,0,1,8
3,14,0,1,8
3,15,0,1,8
3,16,0,1,8
3,17,0,1,8
3,18,0,1,8
3,19,0,1,8
3,20,0,1,8
3,21,0,1,8
3,22,0,1,8
3,23,0,1,8
3,0,0,2,8
3,1,0,2,8
3,2,0,2,8
3,3,0,2,8
3,4,0,2,8
3,5,0,2,8
3,6,0,2,8
3,7,0,2,8
3,8,0,2,8
3,9,0,2,8
3,10,0,2,8
3,11,0,2,8
3,12,0,2,8
3,13,0,2,8
3,14,0,2,8
3,15,0,2,8
3,16,0,2,8
3,17,0,2,8
3,18,0,2,8
3,19,0,2,8
3,20,0,2,8
3,21,0,2,8
3,22,0,2,8
3,0,0,3,8
3,1,0,3,8
3,2,0,3,8
3,3,0,3,8
3,4,0,3,8
3,5,0,3,8
3,6,0,3,8
3,7,0,3,8
3,8,0,3,8
3,9,0,3,8
3,10,0,3,8
3,11,0,3,8
3,12,0,3,8
3,13,0,3,8
3,14,0,3,8
3,15,0,3,8
3,16,0,3,8
3,17,0,3,8
3,18,0,3,8
3,19,0,3,8
3,20,0,3,8
3,21,0,3,8
3,0,0,4,8
3,1,0,4,8
3,2,0,4,8
3,3,0,4,8
3,4,0,4,8
3,5,0,4,8
3,6,0,4,8
3,7,0,4,8
3,8,0,4,8
3,9,0,4,8
3,10,0,4,8
3,11,0,4,8
3,12,0,4,8
3,13,0,4,8
3,14,0,4,8
3,15,0,4,8
3,16,0,4,8
3,17,0,4,8
3,18,0,4,8
3,19,0,4,8
3,20,0,4,8
3,0,0,5,8
3,1,0,5,8
3,2,0,5,8
3,3,0,5,8
3,4,0,5,8
3,5,0,5,8
3,6,0,5,8
3,7,0,5,8
3,8,0,5,8
3,9,0,5,8
3,10,0,5,8
3,11,0,5,8
3,12,0,5,8
3,13,0,5,8
3,14,0,5,8
3,15,0,5,8
3,16,0,5,8
3,17,0,5,8
3,18,0,5,8
3,19,0,5,8
3,0,0,6,8
3,1,0,6,8
3,2,0,6,8
3,3,0,6,8
3,4,0,6,8
3,5,0,6,8
3,6,0,6,8
3,7,0,6,8
3,8,0,6,8
3,9,0,6,8
3,10,0,6,8
3,11,0,6,8
3,12,0,6,8
3,13,0,6,8
3,14,0,6,8
3,15,0,6,8
3,16,0,6,8
3,17,0,6,8
3,18,0,6,8
3,0,0,7,8
3,1,0,7,8
3,2,0,7,8
3,3,0,7,8
3,4,0,7,8
3,5,0,7,8
3,6,0,7,8
3,7,0,7,8
3,8,0,7,8
3,9,0,7,8
3,10,0,7,8
3,11,0,7,8
3,12,0,7,8
3,13,0,7,8
3,14,0,7,8
3,15,0,7,8
3,16,0,7,8
3,17,0,7,8
3,0,0,8,8
3,1,0,8,8
3,2,0,8,8
3,3,0,8,8
3,4,0,8,8
3,5,0,8,8
3,6,0,8,8
3,7,0,8,8
3,8,0,8,8
3,9,0,8,8
3,10,0,8,8
3,11,0,8,8
3,12,0,8,8
3,13,0,8,8
3,14,0,8,8
3,15,0,8,8
3,16,0,8,8
3,0,0,9,8
3,1,0,9,8
3,2,0,9,8
3,3,0,9,8
3,4,0,9,8
3,5,0,9,8
3,6,0,9,8
3,7,0,9,8
3,8,0,9,8
3,9,0,9,8
3,10,0,9,8
3,11,0,9,8
3,12,0,9,8
3,13,0,9,8
3,14,0,9,8
3,15,0,9,8
3,0,0,10,8
3,1,0,10,8
3,2,0,10,8
3,3,0,10,8
3,4,0,10,8
3,5,0,10,8
3,6,0,10,8
3,7,0,10,8
3,8,0,10,8
3,9,0,10,8
3,10,0,10,8
3,11,0,10,8
3,12,0,10,8
3,13,0,10,8
3,14,0,10,8
3,0,0,11,8
3,1,0,11,8
3,2,0,11,8
3,3,0,11,8
3,4,0,11,8
3,5,0,11,8
3,6,0,11,8
3,7,0,11,8
3,8,0,11,8
3,9,0,11,8
3,10,0,11,8
3,11,0,11,8
3,12,0,11,8
3,13,0,11,8
3,0,0,12,8
3,1,0,12,8
3,2,0,12,8
3,3,0,12,8
3,4,0,12,8
3,5,0,12,8
3,6,0,12,8
3,7,0,12,8
3,8,0,12,8
3,9,0,12,8
3,10,0,12,8
3,11,0,12,8
3,12,0,12,8
3,0,0,13,8
3,1,0,13,8
3,2,0,13,8
3,3,0,13,8
3,4,0,13,8
3,5,0,13,8
3,6,0,13,8
3,7,0,13,8
3,8,0,13,8
3,9,0,13,8
3,10,0,13,8
3,11,0,13,8
3,0,0,14,8
3,1,0,14,8
3,2,0,14,8
3,3,0,14,8
3,4,0,14,8
3,5,0,14,8
3,6,0,14,8
3,7,0,14,8
3,8,0,14,8
3,9,0,14,8
3,10,0,14,8
3,0,0,15,8
3,1,0,15,8
3,2,0,15,8
3,3,0,15,8
3,4,0,15,8
3,5,0,15,8
3,6,0,15,8
3,7,0,15,8
3,8,0,15,8
3,9,0,15,8
3,0,0,16,8
3,1,0,16,8
3,2,0,16,8
3,3,0,16,8
3,4,0,16,8
3,5,0,16,8
3,6,0,16,8
3,7,0,16,8
3,8,0,16,8
3,0,0,17,8
3,1,0,17,8
3,2,0,17,8
3,3,0,17,8
3,4,0,17,8
3,5,0,17,8
3,6,0,17,8
3,7,0,17,8
3,0,0,18,8
3,1,0,18,8
3,2,0,18,8
3,3,0,18,8
3,4,0,18,8
3,5,0,18,8
3,6,0,18,8
3,0,0,19,8
3,1,0,19,8
3,2,0,19,8
3,3,0,19,8
3,4,0,19,8
3,5,0,19,8
3,0,0,20,8
3,1,0,20,8
3,2,0,20,8
3,3,0,20,8
3,4,0,20,8
3,0,0,21,8
3,1,0,21,8
3,2,0,21,8
3,3,0,21,8
3,0,0,22,8
3,1,0,22,8
3,2,0,22,8
3,0,0,23,8
3,1,0,23,8
3,0,0,24,8
4,0,0,1,1
4,0,1,1,1
4,0,2,1,1
4,0,3,1,1
4,0,4,1,1
4,0,5,1,1
4,0,6,1,1
4,0,7,1,1
4,0,8,1,1
4,0,9,1,1
4,0,10,1,1
4,0,11,1,1
4,0,12,1,1
4,0,13,1,1
4,0,14,1,1
4,0,15,1,1
4,0,16,1,1
4,0,17,1,1
4,0,18,1,1
4,0,19,1,1
4,0,20,1,1
4,0,21,1,1
4,0,22,1,1
4,0,23,1,1
4,1,0,1,1
4,1,1,1,1
4,1,2,1,1
4,1,3,1,1
4,1,4,1,1
4,1,5,1,1
4,1,6,1,1
4,1,7,1,1
4,1,8,1,1
4,1,9,1,1
4,1,10,1,1
4,1,11,1,1
4,1,12,1,1
4,1,13,1,1
4,1,14,1,1
4,1,15,1,1
4,1,16,1,1
4,1,17,1,1
4,1,18,1,1
4,1,19,1,1
4,1,20,1,1
4,1,21,1,1
4,1,22,1,1
4,1,23,1,1
4,2,0,1,1
4,2,1,1,1
4,2,2,1,1
4,2,3,1,1
4,2,4,1,1
4,2,5,1,1
4,2,6,1,1
4,2,7,1,1
4,2,8,1,1
4,2,9,1,1
4,2,10,1,1
4,2,11,1,1
4,2,12,1,1
4,2,13,1,1
4,2,14,1,1
4,2,15,1,1
4,2,16,1,1
4,2,17,1,1
4,2,18,1,1
4,2,19,1,1
4,2,20,1,1
4,2,21,1,1
4,2,22,1,1
4,2,23,1,1
4,3,0,1,1
4,3,1,1,1
4,3,2,1,1
4,3,3,1,1
4,3,4,1,1
4,3,5,1,1
4,3,6,1,1
4,3,7,1,1
4,3,8,1,1
4,3,9,1,1
4,3,10,1,1
4,3,11,1,1
4,3,12,1,1
4,3,13,1,1
4,3,14,1,1
4,3,15,1,1
4,3,16,1,1
4,3,17,1,1
4,3,18,1,1
4,3,19,1,1
4,3,20,1,1
4,3,21,1,1
4,3,22,1,1
4,3,23,1,1
4,4,0,1,1
4,4,1,1,1
4,4,2,1,1
4,4,3,1,1
4,4,4,1,1
4,4,5,1,1
4,4,6,1,1
4,4,7,1,1
4,4,8,1,1
4,4,9,1,1
4,4,10,1,1
4,4,11,1,1
4,4,12,1,1
4,4,13,1,1
4,4,14,1,1
4,4,15,1,1
4,4,16,1,1
4,4,17,1,1
4,4,18,1,1
4,4,19,1,1
4,4,20,1,1
4,4,21,1,1
4,4,22,1,1
4,4,23,1,1
4,5,0,1,1
4,5,1,1,1
4,5,2,1,1
4,5,3,1,1
4,5,4,1,1
4,5,5,1,1
4,5,6,1,1
4,5,7,1,1
4,5,8,1,1
4,5,9,1,1
4,5,10,1,1
4,5,11,1,1
4,5,12,1,1
4,5,13,1,1
4,5,14,1,1
4,5,15,1,1
4,5,16,1,1
4,5,17,1,1
4,5,18,1,1
4,5,19,1,1
4,5,20,1,1
4,5,21,1,1
4,5,22,1,1
4,5,23,1,1
4,6,0,1,1
4,6,1,1,1
4,6,2,1,1
4,6,3,1,1
4,6,4,1,1
4,6,5,1,1
4,6,6,1,1
4,6,7,1,1
4,6,8,1,1
4,6,9,1,1
4,6,10,1,1
4,6,11,1,1
4,6,12,1,1
4,6,13,1,1
4,6,14,1,1
4,6,15,1,1
4,6,16,1,1
4,6,17,1,1
4,6,18,1,1
4,6,19,1,1
4,6,20,1,1
4,6,21,1,1
4,6,22,1,1
4,6,23,1,1
4,7,0,1,1
4,7,1,1,1
4,7,2,1,1
4,7,3,1,1
4,7,4,1,1
4,7,5,1,1
4,7,6,1,1
4,7,7,1,1
4,7,8,1,1
4,7,9,1,1
4,7,10,1,1
4,7,11,1,1
4,7,12,1,1
4,7,13,1,1
4,7,14,1,1
4,7,15,1,1
4,7,16,1,1
4,7,17,1,1
4,7,18,1,1
4,7,19,1,1
4,7,20,1,1
4,7,21,1,1
4,7,22,1,1
4,7,23,1,1
4,8,0,1,1
4,8,1,1,1
4,8,2,1,1
4,8,3,1,1
4,8,4,1,1
4,8,5,1,1
4,8,6,1,1
4,8,7,1,1
4,8,8,1,1
4,8,9,1,1
4,8,10,1,1
4,8,11,1,1
4,8,12,1,1
4,8,13,1,1
4,8,14,1,1
4,8,15,1,1
4,8,16,1,1
4,8,17,1,1
4,8,18,1,1
4,8,19,1,1
4,8,20,1,1
4,8,21,1,1
4,8,22,1,1
4,8,23,1,1
4,9,0,1,1
4,9,1,1,1
4,9,2,1,1
4,9,3,1,1
4,9,4,1,1
4,9,5,1,1
4,9,6,1,1
4,9,7,1,1
4,9,8,1,1
4,9,9,1,1
4,9,10,1,1
4,9,11,1,1
4,9,12,1,1
4,9,13,1,1
4,9,14,1,1
4,9,15,1,1
4,9,16,1,1
4,9,17,1,1
4,9,18,1,1
4,9,19,1,1
4,9,20,1,1
4,9,21,1,1
4,9,22,1,1
4,9,23,1,1
4,10,0,1,1
4,10,1,1,1
4,10,2,1,1
4,10,3,1,1
4,10,4,1,1
4,10,5,1,1
4,10,6,1,1
4,10,7,1,1
4,10,8,1,1
4,10,9,1,1
4,10,10,1,1
4,10,11,1,1
4,10,12,1,1
4,10,13,1,1
4,10,14,1,1
4,10,15,1,1
4,10,16,1,1
4,10,17,1,1
4,10,18,1,1
4,10,19,1,1
4,10,20,1,1
4,10,21,1,1
4,10,22,1,1
4,10,23,1,1
4,11,0,1,1
4,11,1,1,1
4,11,2,1,1
4,11,3,1,1
4,11,4,1,1
4,11,5,1,1
4,11,6,1,1
4,11,7,1,1
4,11,8,1,1
4,11,9,1,1
4,11,10,1,1
4,11,11,1,1
4,11,12,1,1
4,11,13,1,1
4,11,14,1,1
4,11,15,1,1
4,11,16,1,1
4,11,17,1,1
4,11,18,1,1
4,11,19,1,1
4,11,20,1,1
4,11,21,1,1
4,11,22,1,1
4,11,23,1,1
4,12,0,1,1
4,12,1,1,1
4,12,2,1,1
4,12,3,1,1
4,12,4,1,1
4,12,5,1,1
4,12,6,1,1
4,12,7,1,1
4,12,8,1,1
4,12,9,1,1
4,12,10,1,1
4,12,11,1,1
4,12,12,1,1
4,12,13,1,1
4,12,14,1,1
4,12,15,1,1
4,12,16,1,1
4,12,17,1,1
4,12,18,1,1
4,12,19,1,1
4,12,20,1,1
4,12,21,1,1
4,12,22,1,1
4,12,23,1,1
4,13,0,1,1
4,13,1,1,1
4,13,2,1,1
4,13,3,1,1
4,13,4,1,1
4,13,5,1,1
4,13,6,1,1
4,13,7,1,1
4,13,8,1,1
4,13,9,1,1
4,13,10,1,1
4,13,11,1,1
4,13,12,1,1
4,13,13,1,1
4,13,14,1,1
4,13,15,1,1
4,13,16,1,1
4,13,17,1,1
4,13,18,1,1
4,13,19,1,1
4,13,20,1,1
4,13,21,1,1
4,13,22,1,1
4,13,23,1,1
4,14,0,1,1
4,14,1,1,1
4,14,2,1,1
4,14,3,1,1
4,14,4,1,1
4,14,5,1,1
4,14,6,1,1
4,14,7,1,1
4,14,8,1,1
4,14,9,1,1
4,14,10,1,1
4,14,11,1,1
4,14,12,1,1
4,14,13,1,1
4,14,14,1,1
4,14,15,1,1
4,14,16,1,1
4,14,17,1,1
4,14,18,1,1
4,14,19,1,1
4,14,20,1,1
4,14,21,1,1
4,14,22,1,1
4,14,23,1,1
4,15,0,1,1
4,15,1,1,1
4,15,2,1,1
4,15,3,1,1
4,15,4,1,1
4,15,5,1,1
4,15,6,1,1
4,15,7,1,1
4,15,8,1,1
4,15,9,1,1
4,15,10,1,1
4,15,11,1,1
4,15,12,1,1
4,15,13,1,1
4,15,14,1,1
4,15,15,1,1
4,15,16,1,1
4,15,17,1,1
4,15,18,1,1
4,15,19,1,1
4,15,20,1,1
4,15,21,1,1
4,15,22,1,1
4,15,23,1,1
4,16,0,1,1
4,16,1,1,1
4,16,2,1,1
4,16,3,1,1
4,16,4,1,1
4,16,5,1,1
4,16,6,1,1
4,16,7,1,1
4,16,8,1,1
4,16,9,1,1
4,16,10,1,1
4,16,11,1,1
4,16,12,1,1
4,16,13,1,1
4,16,14,1,1
4,16,15,1,1
4,16,16,1,1
4,16,17,1,1
4,16,18,1,1
4,16,19,1,1
4,16,20,1,1
4,16,21,1,1
4,16,22,1,1
4,16,23,1,1
4,17,0,1,1
4,17,1,1,1
4,17,2,1,1
4,17,3,1,1
4,17,4,1,1
4,17,5,1,1
4,17,6,1,1
4,17,7,1,1
4,17,8,1,1
4,17,9,1,1
4,17,10,1,1
4,17,11,1,1
4,17,12,1,1
4,17,13,1,1
4,17,14,1,1
4,17,15,1,1
4,17,16,1,1
4,17,17,1,1
4,17,18,1,1
4,17,19,1,1
4,17,20,1,1
4,17,21,1,1
4,17,22,1,1
4,17,23,1,1
4,18,0,1,1
4,18,1,1,1
4,18,2,1,1
4,18,3,1,1
4,18,4,1,1
4,18,5,1,1
4,18,6,1,1
4,18,7,1,1
4,18,8,1,1
4,18,9,1,1
4,18,10,1,1
4,18,11,1,1
4,18,12,1,1
4,18,13,1,1
4,18,14,1,1
4,18,15,1,1
4,18,16,1,1
4,18,17,1,1
4,18,18,1,1
4,18,19,1,1
4,18,20,1,1
4,18,21,1,1
4,18,22,1,1
4,18,23,1,1
4,19,0,1,1
4,19,1,1,1
4,19,2,1,1
4,19,3,1,1
4,19,4,1,1
4,19,5,1,1
4,19,6,1,1
4,19,7,1,1
4,19,8,1,1
4,19,9,1,1
4,19,10,1,1
4,19,11,1,1
4,19,12,1,1
4,19,13,1,1
4,19,14,1,1
4,19,15,1,1
4,19,16,1,1
4,19,17,1,1
4,19,18,1,1
4,19,19,1,1
4,19,20,1,1
4,19,21,1,1
4,19,22,1,1
4,19,23,1,1
4,20,0,1,1
4,20,1,1,1
4,20,2,1,1
4,20,3,1,1
4,20,4,1,1
4,20,5,1,1
4,20,6,1,1
4,20,7,1,1
4,20,8,1,1
4,20,9,1,1
4,20,10,1,1
4,20,11,1,1
4,20,12,1,1
4,20,13,1,1
4,20,14,1,1
4,20,15,1,1
4,20,16,1,1
4,20,17,1,1
4,20,18,1,1
4,20,19,1,1
4,20,20,1,1
4,20,21,1,1
4,20,22,1,1
4,20,23,1,1
4,21,0,1,1
4,21,1,1,1
4,21,2,1,1
4,21,3,1,1
4,21,4,1,1
4,21,5,1,1
4,21,6,1,1
4,21,7,1,1
4,21,8,1,1
4,21,9,1,1
4,21,10,1,1
4,21,11,1,1
4,21,12,1,1
4,21,13,1,1
4,21,14,1,1
4,21,15,1,1
4,21,16,1,1
4,21,17,1,1
4,21,18,1,1
4,21,19,1,1
4,21,20,1,1
4,21,21,1,1
4,21,22,1,1
4,21,23,1,1
4,0,0,2,1
4,0,1,2,1
4,0,2,2,1
4,0,3,2,1
4,0,4,2,1
4,0,5,2,1
4,0,6,2,1
4,0,7,2,1
4,0,8,2,1
4,0,9,2,1
4,0,10,2,1
4,0,11,2,1
4,0,12,2,1
4,0,13,2,1
4,0,14,2,1
4,0,15,2,1
4,0,16,2,1
4,0,17,2,1
4,0,18,2,1
4,0,19,2,1
4,0,20,2,1
4,0,21,2,1
4,0,22,2,1
4,0,23,2,1
4,1,0,2,1
4,1,1,2,1
4,1,2,2,1
4,1,3,2,1
4,1,4,2,1
4,1,5,2,1
4,1,6,2,1
4,1,7,2,1
4,1,8,2,1
4,1,9,2,1
4,1,10,2,1
4,1,11,2,1
4,1,12,2,1
4,1,13,2,1
4,1,14,2,1
4,1,15,2,1
4,1,16,2,1
4,1,17,2,1
4,1,18,2,1
4,1,19,2,1
4,1,20,2,1
4,1,21,2,1
4,1,22,2,1
4,1,23,2,1
4,2,0,2,1
4,2,1,2,1
4,2,2,2,1
4,2,3,2,1
4,2,4,2,1
4,2,5,2,1
4,2,6,2,1
4,2,7,2,1
4,2,8,2,1
4,2,9,2,1
4,2,10,2,1
4,2,11,2,1
4,2,12,2,1
4,2,13,2,1
4,2,14,2,1
4,2,15,2,1
4,2,16,2,1
4,2,17,2,1
4,2,18,2,1
4,2,19,2,1
4,2,20,2,1
4,2,21,2,1
4,2,22,2,1
4,2,23,2,1
4,3,0,2,1
4,3,1,2,1
4,3,2,2,1
4,3,3,2,1
4,3,4,2,1
4,3,5,2,1
4,3,6,2,1
4,3,7,2,1
4,3,8,2,1
4,3,9,2,1
4,3,10,2,1
4,3,11,2,1
4,3,12,2,1
4,3,13,2,1
4,3,14,2,1
4,3,15,2,1
4,3,16,2,1
4,3,17,2,1
4,3,18,2,1
4,3,19,2,1
4,3,20,2,1
4,3,21,2,1
4,3,22,2,1
4,3,23,2,1
4,4,0,2,1
4,4,1,2,1
4,4,2,2,1
4,4,3,2,1
4,4,4,2,1
4,4,5,2,1
4,4,6,2,1
4,4,7,2,1
4,4,8,2,1
4,4,9,2,1
4,4,10,2,1
4,4,11,2,1
4,4,12,2,1
4,4,13,2,1
4,4,14,2,1
4,4,15,2,1
4,4,16,2,1
4,4,17,2,1
4,4,18,2,1
4,4,19,2,1
4,4,20,2,1
4,4,21,2,1
4,4,22,2,1
4,4,23,2,1
4,5,0,2,1
4,5,1,2,1
4,5,2,2,1
4,5,3,2,1
4,5,4,2,1
4,5,5,2,1
4,5,6,2,1
4,5,7,2,1
4,5,8,2,1
4,5,9,2,1
4,5,10,2,1
4,5,11,2,1
4,5,12,2,1
4,5,13,2,1
4,5,14,2,1
4,5,15,2,1
4,5,16,2,1
4,5,17,2,1
4,5,18,2,1
4,5,19,2,1
4,5,20,2,1
4,5,21,2,1
4,5,22,2,1
4,5,23,2,1
4,6,0,2,1
4,6,1,2,1
4,6,2,2,1
4,6,3,2,1
4,6,4,2,1
4,6,5,2,1
4,6,6,2,1
4,6,7,2,1
4,6,8,2,1
4,6,9,2,1
4,6,10,2,1
4,6,11,2,1
4,6,12,2,1
4,6,13,2,1
4,6,14,2,1
4,6,15,2,1
4,6,16,2,1
4,6,17,2,1
4,6,18,2,1
4,6,19,2,1
4,6,20,2,1
4,6,21,2,1
4,6,22,2,1
4,6,23,2,1
4,7,0,2,1
4,7,1,2,1
4,7,2,2,1
4,7,3,2,1
4,7,4,2,1
4,7,5,2,1
4,7,6,2,1
4,7,7,2,1
4,7,8,2,1
4,7,9,2,1
4,7,10,2,1
4,7,11,2,1
4,7,12,2,1
4,7,13,2,1
4,7,14,2,1
4,7,15,2,1
4,7,16,2,1
4,7,17,2,1
4,7,18,2,1
4,7,19,2,1
4,7,20,2,1
4,7,21,2,1
4,7,22,2,1
4,7,23,2,1
4,8,0,2,1
4,8,1,2,1
4,8,2,2,1
4,8,3,2,1
4,8,4,2,1
4,8,5,2,1
4,8,6,2,1
4,8,7,2,1
4,8,8,2,1
4,8,9,2,1
4,8,10,2,1
4,8,11,2,1
4,8,12,2,1
4,8,13,2,1
4,8,14,2,1
4,8,15,2,1
4,8,16,2,1
4,8,17,2,1
4,8,18,2,1
4,8,19,2,1
4,8,20,2,1
4,8,21,2,1
4,8,22,2,1
4,8,23,2,1
4,9,0,2,1
4,9,1,2,1
4,9,2,2,1
4,9,3,2,1
4,9,4,2,1
4,9,5,2,1
4,9,6,2,1
4,9,7,2,1
4,9,8,2,1
4,9,9,2,1
4,9,10,2,1
4,9,11,2,1
4,9,12,2,1
4,9,13,2,1
4,9,14,2,1
4,9,15,2,1
4,9,16,2,1
4,9,17,2,1
4,9,18,2,1
4,9,19,2,1
4,9,20,2,1
4,9,21,2,1
4,9,22,2,1
4,9,23,2,1
4,10,0,2,1
4,10,1,2,1
4,10,2,2,1
4,10,3,2,1
4,10,4,2,1
4,10,5,2,1
4,10,6,2,1
4,10,7,2,1
4,10,8,2,1
4,10,9,2,1
4,10,10,2,1
4,10,11,2,1
4,10,12,2,1
4,10,13,2,1
4,10,14,2,1
4,10,15,2,1
4,10,16,2,1
4,10,17,2,1
4,10,18,2,1
4,10,19,2,1
4,10,20,2,1
4,10,21,2,1
4,10,22,2,1
4,10,23,2,1
4,11,0,2,1
4,11,1,2,1
4,11,2,2,1
4,11,3,2,1
4,11,4,2,1
4,11,5,2,1
4,11,6,2,1
4,11,7,2,1
4,11,8,2,1
4,11,9,2,1
4,11,10,2,1
4,11,11,2,1
4,11,12,2,1
4,11,13,2,1
4,11,14,2,1
4,11,15,2,1
4,11,16,2,1
4,11,17,2,1
4,11,18,2,1
4,11,19,2,1
4,11,20,2,1
4,11,21,2,1
4,11,22,2,1
4,11,23,2,1
4,12,0,2,1
4,12,1,2,1
4,12,2,2,1
4,12,3,2,1
4,12,4,2,1
4,12,5,2,1
4,12,6,2,1
4,12,7,2,1
4,12,8,2,1
4,12,9,2,1
4,12,10,2,1
4,12,11,2,1
4,12,12,2,1
4,12,13,2,1
4,12,14,2,1
4,12,15,2,1
4,12,16,2,1
4,12,17,2,1
4,12,18,2,1
4,12,19,2,1
4,12,20,2,1
4,12,21,2,1
4,12,22,2,1
4,12,23,2,1
4,13,0,2,1
4,13,1,2,1
4,13,2,2,1
4,13,3,2,1
4,13,4,2,1
4,13,5,2,1
4,13,6,2,1
4,13,7,2,1
4,13,8,2,1
4,13,9,2,1
4,13,10,2,1
4,13,11,2,1
4,13,12,2,1
4,13,13,2,1
4,13,14,2,1
4,13,15,2,1
4,13,16,2,1
4,13,17,2,1
4,13,18,2,1
4,13,19,2,1
4,13,20,2,1
4,13,21,2,1
4,13,22,2,1
4,13,23,2,1
4,14,0,2,1
4,14,1,2,1
4,14,2,2,1
4,14,3,2,1
4,14,4,2,1
4,14,5,2,1
4,14,6,2,1
4,14,7,2,1
4,14,8,2,1
4,14,9,2,1
4,14,10,2,1
4,14,11,2,1
4,14,12,2,1
4,14,13,2,1
4,14,14,2,1
4,14,15,2,1
4,14,16,2,1
4,14,17,2,1
4,14,18,2,1
4,14,19,2,1
4,14,20,2,1
4,14,21,2,1
4,14,22,2,1
4,14,23,2,1
4,15,0,2,1
4,15,1,2,1
4,15,2,2,1
4,15,3,2,1
4,15,4,2,1
4,15,5,2,1
4,15,6,2,1
4,15,7,2,1
4,15,8,2,1
4,15,9,2,1
4,15,10,2,1
4,15,11,2,1
4,15,12,2,1
4,15,13,2,1
4,15,14,2,1
4,15,15,2,1
4,15,16,2,1
4,15,17,2,1
4,15,18,2,1
4,15,19,2,1
4,15,20,2,1
4,15,21,2,1
4,15,22,2,1
4,15,23,2,1
4,16,0,2,1
4,16,1,2,1
4,16,2,2,1
4,16,3,2,1
4,16,4,2,1
4,16,5,2,1
4,16,6,2,1
4,16,7,2,1
4,16,8,2,1
4,16,9,2,1
4,16,10,2,1
4,16,11,2,1
4,16,12,2,1
4,16,13,2,1
4,16,14,2,1
4,16,15,2,1
4,16,16,2,1
4,16,17,2,1
4,16,18,2,1
4,16,19,2,1
4,16,20,2,1
4,16,21,2,1
4,16,22,2,1
4,16,23,2,1
4,17,0,2,1
4,17,1,2,1
4,17,2,2,1
4,17,3,2,1
4,17,4,2,1
4,17,5,2,1
4,17,6,2,1
4,17,7,2,1
4,17,8,2,1
4,17,9,2,1
4,17,10,2,1
4,17,11,2,1
4,17,12,2,1
4,17,13,2,1
4,17,14,2,1
4,17,15,2,1
4,17,16,2,1
4,17,17,2,1
4,17,18,2,1
4,17,19,2,1
4,17,20,2,1
4,17,21,2,1
4,17,22,2,1
4,17,23,2,1
4,18,0,2,1
4,18,1,2,1
4,18,2,2,1
4,18,3,2,1
4,18,4,2,1
4,18,5,2,1
4,18,6,2,1
4,18,7,2,1
4,18,8,2,1
4,18,9,2,1
4,18,10,2,1
4,18,11,2,1
4,18,12,2,1
4,18,13,2,1
4,18,14,2,1
4,18,15,2,1
4,18,16,2,1
4,18,17,2,1
4,18,18,2,1
4,18,19,2,1
4,18,20,2,1
4,18,21,2,1
4,18,22,2,1
4,18,23,2,1
4,0,0,3,1
4,0,1,3,1
4,0,2,3,1
4,0,3,3,1
4,0,4,3,1
4,0,5,3,1
4,0,6,3,1
4,0,7,3,1
4,0,8,3,1
4,0,9,3,1
4,0,10,3,1
4,0,11,3,1
4,0,12,3,1
4,0,13,3,1
4,0,14,3,1
4,0,15,3,1
4,0,16,3,1
4,0,17,3,1
4,0,18,3,1
4,0,19,3,1
4,0,20,3,1
4,0,21,3,1
4,0,22,3,1
4,0,23,3,1
4,1,0,3,1
4,1,1,3,1
4,1,2,3,1
4,1,3,3,1
4,1,4,3,1
4,1,5,3,1
4,1,6,3,1
4,1,7,3,1
4,1,8,3,1
4,1,9,3,1
4,1,10,3,1
4,1,11,3,1
4,1,12,3,1
4,1,13,3,1
4,1,14,3,1
4,1,15,3,1
4,1,16,3,1
4,1,17,3,1
4,1,18,3,1
4,1,19,3,1
4,1,20,3,1
4,1,21,3,1
4,1,22,3,1
4,1,23,3,1
4,2,0,3,1
4,2,1,3,1
4,2,2,3,1
4,2,3,3,1
4,2,4,3,1
4,2,5,3,1
4,2,6,3,1
4,2,7,3,1
4,2,8,3,1
4,2,9,3,1
4,2,10,3,1
4,2,11,3,1
4,2,12,3,1
4,2,13,3,1
4,2,14,3,1
4,2,15,3,1
4,2,16,3,1
4,2,17,3,1
4,2,18,3,1
4,2,19,3,1
4,2,20,3,1
4,2,21,3,1
4,2,22,3,1
4,2,23,3,1
4,3,0,3,1
4,3,1,3,1
4,3,2,3,1
4,3,3,3,1
4,3,4,3,1
4,3,5,3,1
4,3,6,3,1
4,3,7,3,1
4,3,8,3,1
4,3,9,3,1
4,3,10,3,1
4,3,11,3,1
4,3,12,3,1
4,3,13,3,1
4,3,14,3,1
4,3,15,3,1
4,3,16,3,1
4,3,17,3,1
4,3,18,3,1
4,3,19,3,1
4,3,20,3,1
4,3,21,3,1
4,3,22,3,1
4,3,23,3,1
4,4,0,3,1
4,4,1,3,1
4,4,2,3,1
4,4,3,3,1
4,4,4,3,1
4,4,5,3,1
4,4,6,3,1
4,4,7,3,1
4,4,8,3,1
4,4,9,3,1
4,4,10,3,1
4,4,11,3,1
4,4,12,3,1
4,4,13,3,1
4,4,14,3,1
4,4,15,3,1
4,4,16,3,1
4,4,17,3,1
4,4,18,3,1
4,4,19,3,1
4,4,20,3,1
4,4,21,3,1
4,4,22,3,1
4,4,23,3,1
4,5,0,3,1
4,5,1,3,1
4,5,2,3,1
4,5,3,3,1
4,5,4,3,1
4,5,5,3,1
4,5,6,3,1
4,5,7,3,1
4,5,8,3,1
4,5,9,3,1
4,5,10,3,1
4,5,11,3,1
4,5,12,3,1
4,5,13,3,1
4,5,14,3,1
4,5,15,3,1
4,5,16,3,1
4,5,17,3,1
4,5,18,3,1
4,5,19,3,1
4,5,20,3,1
4,5,21,3,1
4,5,22,3,1
4,5,23,3,1
4,6,0,3,1
4,6,1,3,1
4,6,2,3,1
4,6,3,3,1
4,6,4,3,1
4,6,5,3,1
4,6,6,3,1
4,6,7,3,1
4,6,8,3,1
4,6,9,3,1
4,6,10,3,1
4,6,11,3,1
4,6,12,3,1
4,6,13,3,1
4,6,14,3,1
4,6,15,3,1
4,6,16,3,1
4,6,17,3,1
4,6,18,3,1
4,6,19,3,1
4,6,20,3,1
4,6,21,3,1
4,6,22,3,1
4,6,23,3,1
4,7,0,3,1
4,7,1,3,1
4,7,2,3,1
4,7,3,3,1
4,7,4,3,1
4,7,5,3,1
4,7,6,3,1
4,7,7,3,1
4,7,8,3,1
4,7,9,3,1
4,7,10,3,1
4,7,11,3,1
4,7,12,3,1
4,7,13,3,1
4,7,14,3,1
4,7,15,3,1
4,7,16,3,1
4,7,17,3,1
4,7,18,3,1
4,7,19,3,1
4,7,20,3,1
4,7,21,3,1
4,7,22,3,1
4,7,23,3,1
4,8,0,3,1
4,8,1,3,1
4,8,2,3,1
4,8,3,3,1
4,8,4,3,1
4,8,5,3,1
4,8,6,3,1
4,8,7,3,1
4,8,8,3,1
4,8,9,3,1
4,8,10,3,1
4,8,11,3,1
4,8,12,3,1
4,8,13,3,1
4,8,14,3,1
4,8,15,3,1
4,8,16,3,1
4,8,17,3,1
4,8,18,3,1
4,8,19,3,1
4,8,20,3,1
4,8,21,3,1
4,8,22,3,1
4,8,23,3,1
4,9,0,3,1
4,9,1,3,1
4,9,2,3,1
4,9,3,3,1
4,9,4,3,1
4,9,5,3,1
4,9,6,3,1
4,9,7,3,1
4,9,8,3,1
4,9,9,3,1
4,9,10,3,1
4,9,11,3,1
4,9,12,3,1
4,9,13,3,1
4,9,14,3,1
4,9,15,3,1
4,9,16,3,1
4,9,17,3,1
4,9,18,3,1
4,9,19,3,1
4,9,20,3,1
4,9,21,3,1
4,9,22,3,1
4,9,23,3,1
4,10,0,3,1
4,10,1,3,1
4,10,2,3,1
4,10,3,3,1
4,10,4,3,1
4,10,5,3,1
4,10,6,3,1
4,10,7,3,1
4,10,8,3,1
4,10,9,3,1
4,10,10,3,1
4,10,11,3,1
4,10,12,3,1
4,10,13,3,1
4,10,14,3,1
4,10,15,3,1
4,10,16,3,1
4,10,17,3,1
4,10,18,3,1
4,10,19,3,1
4,10,20,3,1
4,10,21,3,1
4,10,22,3,1
4,10,23,3,1
4,11,0,3,1
4,11,1,3,1
4,11,2,3,1
4,11,3,3,1
4,11,4,3,1
4,11,5,3,1
4,11,6,3,1
4,11,7,3,1
4,11,8,3,1
4,11,9,3,1
4,11,10,3,1
4,11,11,3,1
4,11,12,3,1
4,11,13,3,1
4,11,14,3,1
4,11,15,3,1
4,11,16,3,1
4,11,17,3,1
4,11,18,3,1
4,11,19,3,1
4,11,20,3,1
4,11,21,3,1
4,11,22,3,1
4,11,23,3,1
4,12,0,3,1
4,12,1,3,1
4,12,2,3,1
4,12,3,3,1
4,12,4,3,1
4,12,5,3,1
4,12,6,3,1
4,12,7,3,1
4,12,8,3,1
4,12,9,3,1
4,12,10,3,1
4,12,11,3,1
4,12,12,3,1
4,12,13,3,1
4,12,14,3,1
4,12,15,3,1
4,12,16,3,1
4,12,17,3,1
4,12,18,3,1
4,12,19,3,1
4,12,20,3,1
4,12,21,3,1
4,12,22,3,1
4,12,23,3,1
4,13,0,3,1
4,13,1,3,1
4,13,2,3,1
4,13,3,3,1
4,13,4,3,1
4,13,5,3,1
4,13,6,3,1
4,13,7,3,1
4,13,8,3,1
4,13,9,3,1
4,13,10,3,1
4,13,11,3,1
4,13,12,3,1
4,13,13,3,1
4,13,14,3,1
4,13,15,3,1
4,13,16,3,1
4,13,17,3,1
4,13,18,3,1
4,13,19,3,1
4,13,20,3,1
4,13,21,3,1
4,13,22,3,1
4,13,23,3,1
4,14,0,3,1
4,14,1,3,1
4,14,2,3,1
4,14,3,3,1
4,14,4,3,1
4,14,5,3,1
4,14,6,3,1
4,14,7,3,1
4,14,8,3,1
4,14,9,3,1
4,14,10,3,1
4,14,11,3,1
4,14,12,3,1
4,14,13,3,1
4,14,14,3,1
4,14,15,3,1
4,14,16,3,1
4,14,17,3,1
4,14,18,3,1
4,14,19,3,1
4,14,20,3,1
4,14,21,3,1
4,14,22,3,1
4,14,23,3,1
4,15,0,3,1
4,15,1,3,1
4,15,2,3,1
4,15,3,3,1
4,15,4,3,1
4,15,5,3,1
4,15,6,3,1
4,15,7,3,1
4,15,8,3,1
4,15,9,3,1
4,15,10,3,1
4,15,11,3,1
4,15,12,3,1
4,15,13,3,1
4,15,14,3,1
4,15,15,3,1
4,15,16,3,1
4,15,17,3,1
4,15,18,3,1
4,15,19,3,1
4,15,20,3,1
4,15,21,3,1
4,15,22,3,1
4,15,23,3,1
4,0,0,4,1
4,0,1,4,1
4,0,2,4,1
4,0,3,4,1
4,0,4,4,1
4,0,5,4,1
4,0,6,4,1
4,0,7,4,1
4,0,8,4,1
4,0,9,4,1
4,0,10,4,1
4,0,11,4,1
4,0,12,4,1
4,0,13,4,1
4,0,14,4,1
4,0,15,4,1
4,0,16,4,1
4,0,17,4,1
4,0,18,4,1
4,0,19,4,1
4,0,20,4,1
4,0,21,4,1
4,0,22,4,1
4,0,23,4,1
4,1,0,4,1
4,1,1,4,1
4,1,2,4,1
4,1,3,4,1
4,1,4,4,1
4,1,5,4,1
4,1,6,4,1
4,1,7,4,1
4,1,8,4,1
4,1,9,4,1
4,1,10,4,1
4,1,11,4,1
4,1,12,4,1
4,1,13,4,1
4,1,14,4,1
4,1,15,4,1
4,1,16,4,1
4,1,17,4,1
4,1,18,4,1
4,1,19,4,1
4,1,20,4,1
4,1,21,4,1
4,1,22,4,1
4,1,23,4,1
4,2,0,4,1
4,2,1,4,1
4,2,2,4,1
4,2,3,4,1
4,2,4,4,1
4,2,5,4,1
4,2,6,4,1
4,2,7,4,1
4,2,8,4,1
4,2,9,4,1
4,2,10,4,1
4,2,11,4,1
4,2,12,4,1
4,2,13,4,1
4,2,14,4,1
4,2,15,4,1
4,2,16,4,1
4,2,17,4,1
4,2,18,4,1
4,2,19,4,1
4,2,20,4,1
4,2,21,4,1
4,2,22,4,1
4,2,23,4,1
4,3,0,4,1
4,3,1,4,1
4,3,2,4,1
4,3,3,4,1
4,3,4,4,1
4,3,5,4,1
4,3,6,4,1
4,3,7,4,1
4,3,8,4,1
4,3,9,4,1
4,3,10,4,1
4,3,11,4,1
4,3,12,4,1
4,3,13,4,1
4,3,14,4,1
4,3,15,4,1
4,3,16,4,1
4,3,17,4,1
4,3,18,4,1
4,3,19,4,1
4,3,20,4,1
4,3,21,4,1
4,3,22,4,1
4,3,23,4,1
4,4,0,4,1
4,4,1,4,1
4,4,2,4,1
4,4,3,4,1
4,4,4,4,1
4,4,5,4,1
4,4,6,4,1
4,4,7,4,1
4,4,8,4,1
4,4,9,4,1
4,4,10,4,1
4,4,11,4,1
4,4,12,4,1
4,4,13,4,1
4,4,14,4,1
4,4,15,4,1
4,4,16,4,1
4,4,17,4,1
4,4,18,4,1
4,4,19,4,1
4,4,20,4,1
4,4,21,4,1
4,4,22,4,1
4,4,23,4,1
4,5,0,4,1
4,5,1,4,1
4,5,2,4,1
4,5,3,4,1
4,5,4,4,1
4,5,5,4,1
4,5,6,4,1
4,5,7,4,1
4,5,8,4,1
4,5,9,4,1
4,5,10,4,1
4,5,11,4,1
4,5,12,4,1
4,5,13,4,1
4,5,14,4,1
4,5,15,4,1
4,5,16,4,1
4,5,17,4,1
4,5,18,4,1
4,5,19,4,1
4,5,20,4,1
4,5,21,4,1
4,5,22,4,1
4,5,23,4,1
4,6,0,4,1
4,6,1,4,1
4,6,2,4,1
4,6,3,4,1
4,6,4,4,1
4,6,5,4,1
4,6,6,4,1
4,6,7,4,1
4,6,8,4,1
4,6,9,4,1
4,6,10,4,1
4,6,11,4,1
4,6,12,4,1
4,6,13,4,1
4,6,14,4,1
4,6,15,4,1
4,6,16,4,1
4,6,17,4,1
4,6,18,4,1
4,6,19,4,1
4,6,20,4,1
4,6,21,4,1
4,6,22,4,1
4,6,23,4,1
4,7,0,4,1
4,7,1,4,1
4,7,2,4,1
4,7,3,4,1
4,7,4,4,1
4,7,5,4,1
4,7,6,4,1
4,7,7,4,1
4,7,8,4,1
4,7,9,4,1
4,7,10,4,1
4,7,11,4,1
4,7,12,4,1
4,7,13,4,1
4,7,14,4,1
4,7,15,4,1
4,7,16,4,1
4,7,17,4,1
4,7,18,4,1
4,7,19,4,1
4,7,20,4,1
4,7,21,4,1
4,7,22,4,1
4,7,23,4,1
4,8,0,4,1
4,8,1,4,1
4,8,2,4,1
4,8,3,4,1
4,8,4,4,1
4,8,5,4,1
4,8,6,4,1
4,8,7,4,1
4,8,8,4,1
4,8,9,4,1
4,8,10,4,1
4,8,11,4,1
4,8,12,4,1
4,8,13,4,1
4,8,14,4,1
4,8,15,4,1
4,8,16,4,1
4,8,17,4,1
4,8,18,4,1
4,8,19,4,1
4,8,20,4,1
4,8,21,4,1
4,8,22,4,1
4,8,23,4,1
4,9,0,4,1
4,9,1,4,1
4,9,2,4,1
4,9,3,4,1
4,9,4,4,1
4,9,5,4,1
4,9,6,4,1
4,9,7,4,1
4,9,8,4,1
4,9,9,4,1
4,9,10,4,1
4,9,11,4,1
4,9,12,4,1
4,9,13,4,1
4,9,14,4,1
4,9,15,4,1
4,9,16,4,1
4,9,17,4,1
4,9,18,4,1
4,9,19,4,1
4,9,20,4,1
4,9,21,4,1
4,9,22,4,1
4,9,23,4,1
4,10,0,4,1
4,10,1,4,1
4,10,2,4,1
4,10,3,4,1
4,10,4,4,1
4,10,5,4,1
4,10,6,4,1
4,10,7,4,1
4,10,8,4,1
4,10,9,4,1
4,10,10,4,1
4,10,11,4,1
4,10,12,4,1
4,10,13,4,1
4,10,14,4,1
4,10,15,4,1
4,10,16,4,1
4,10,17,4,1
4,10,18,4,1
4,10,19,4,1
4,10,20,4,1
4,10,21,4,1
4,10,22,4,1
4,10,23,4,1
4,11,0,4,1
4,11,1,4,1
4,11,2,4,1
4,11,3,4,1
4,11,4,4,1
4,11,5,4,1
4,11,6,4,1
4,11,7,4,1
4,11,8,4,1
4,11,9,4,1
4,11,10,4,1
4,11,11,4,1
4,11,12,4,1
4,11,13,4,1
4,11,14,4,1
4,11,15,4,1
4,11,16,4,1
4,11,17,4,1
4,11,18,4,1
4,11,19,4,1
4,11,20,4,1
4,11,21,4,1
4,11,22,4,1
4,11,23,4,1
4,12,0,4,1
4,12,1,4,1
4,12,2,4,1
4,12,3,4,1
4,12,4,4,1
4,12,5,4,1
4,12,6,4,1
4,12,7,4,1
4,12,8,4,1
4,12,9,4,1
4,12,10,4,1
4,12,11,4,1
4,12,12,4,1
4,12,13,4,1
4,12,14,4,1
4,12,15,4,1
4,12,16,4,1
4,12,17,4,1
4,12,18,4,1
4,12,19,4,1
4,12,20,4,1
4,12,21,4,1
4,12,22,4,1
4,12,23,4,1
4,0,0,5,1
4,0,1,5,1
4,0,2,5,1
4,0,3,5,1
4,0,4,5,1
4,0,5,5,1
4,0,6,5,1
4,0,7,5,1
4,0,8,5,1
4,0,9,5,1
4,0,10,5,1
4,0,11,5,1
4,0,12,5,1
4,0,13,5,1
4,0,14,5,1
4,0,15,5,1
4,0,16,5,1
4,0,17,5,1
4,0,18,5,1
4,0,19,5,1
4,0,20,5,1
4,0,21,5,1
4,0,22,5,1
4,0,23,5,1
4,1,0,5,1
4,1,1,5,1
4,1,2,5,1
4,1,3,5,1
4,1,4,5,1
4,1,5,5,1
4,1,6,5,1
4,1,7,5,1
4,1,8,5,1
4,1,9,5,1
4,1,10,5,1
4,1,11,5,1
4,1,12,5,1
4,1,13,5,1
4,1,14,5,1
4,1,15,5,1
4,1,16,5,1
4,1,17,5,1
4,1,18,5,1
4,1,19,5,1
4,1,20,5,1
4,1,21,5,1
4,1,22,5,1
4,1,23,5,1
4,2,0,5,1
4,2,1,5,1
4,2,2,5,1
4,2,3,5,1
4,2,4,5,1
4,2,5,5,1
4,2,6,5,1
4,2,7,5,1
4,2,8,5,1
4,2,9,5,1
4,2,10,5,1
4,2,11,5,1
4,2,12,5,1
4,2,13,5,1
4,2,14,5,1
4,2,15,5,1
4,2,16,5,1
4,2,17,5,1
4,2,18,5,1
4,2,19,5,1
4,2,20,5,1
4,2,21,5,1
4,2,22,5,1
4,2,23,5,1
4,3,0,5,1
4,3,1,5,1
4,3,2,5,1
4,3,3,5,1
4,3,4,5,1
4,3,5,5,1
4,3,6,5,1
4,3,7,5,1
4,3,8,5,1
4,3,9,5,1
4,3,10,5,1
4,3,11,5,1
4,3,12,5,1
4,3,13,5,1
4,3,14,5,1
4,3,15,5,1
4,3,16,5,1
4,3,17,5,1
4,3,18,5,1
4,3,19,5,1
4,3,20,5,1
4,3,21,5,1
4,3,22,5,1
4,3,23,5,1
4,4,0,5,1
4,4,1,5,1
4,4,2,5,1
4,4,3,5,1
4,4,4,5,1
4,4,5,5,1
4,4,6,5,1
4,4,7,5,1
4,4,8,5,1
4,4,9,5,1
4,4,10,5,1
4,4,11,5,1
4,4,12,5,1
4,4,13,5,1
4,4,14,5,1
4,4,15,5,1
4,4,16,5,1
4,4,17,5,1
4,4,18,5,1
4,4,19,5,1
4,4,20,5,1
4,4,21,5,1
4,4,22,5,1
4,4,23,5,1
4,5,0,5,1
4,5,1,5,1
4,5,2,5,1
4,5,3,5,1
4,5,4,5,1
4,5,5,5,1
4,5,6,5,1
4,5,7,5,1
4,5,8,5,1
4,5,9,5,1
4,5,10,5,1
4,5,11,5,1
4,5,12,5,1
4,5,13,5,1
4,5,14,5,1
4,5,15,5,1
4,5,16,5,1
4,5,17,5,1
4,5,18,5,1
4,5,19,5,1
4,5,20,5,1
4,5,21,5,1
4,5,22,5,1
4,5,23,5,1
4,6,0,5,1
4,6,1,5,1
4,6,2,5,1
4,6,3,5,1
4,6,4,5,1
4,6,5,5,1
4,6,6,5,1
4,6,7,5,1
4,6,8,5,1
4,6,9,5,1
4,6,10,5,1
4,6,11,5,1
4,6,12,5,1
4,6,13,5,1
4,6,14,5,1
4,6,15,5,1
4,6,16,5,1
4,6,17,5,1
4,6,18,5,1
4,6,19,5,1
4,6,20,5,1
4,6,21,5,1
4,6,22,5,1
4,6,23,5,1
4,7,0,5,1
4,7,1,5,1
4,7,2,5,1
4,7,3,5,1
4,7,4,5,1
4,7,5,5,1
4,7,6,5,1
4,7,7,5,1
4,7,8,5,1
4,7,9,5,1
4,7,10,5,1
4,7,11,5,1
4,7,12,5,1
4,7,13,5,1
4,7,14,5,1
4,7,15,5,1
4,7,16,5,1
4,7,17,5,1
4,7,18,5,1
4,7,19,5,1
4,7,20,5,1
4,7,21,5,1
4,7,22,5,1
4,7,23,5,1
4,8,0,5,1
4,8,1,5,1
4,8,2,5,1
4,8,3,5,1
4,8,4,5,1
4,8,5,5,1
4,8,6,5,1
4,8,7,5,1
4,8,8,5,1
4,8,9,5,1
4,8,10,5,1
4,8,11,5,1
4,8,12,5,1
4,8,13,5,1
4,8,14,5,1
4,8,15,5,1
4,8,16,5,1
4,8,17,5,1
4,8,18,5,1
4,8,19,5,1
4,8,20,5,1
4,8,21,5,1
4,8,22,5,1
4,8,23,5,1
4,9,0,5,1
4,9,1,5,1
4,9,2,5,1
4,9,3,5,1
4,9,4,5,1
4,9,5,5,1
4,9,6,5,1
4,9,7,5,1
4,9,8,5,1
4,9,9,5,1
4,9,10,5,1
4,9,11,5,1
4,9,12,5,1
4,9,13,5,1
4,9,14,5,1
4,9,15,5,1
4,9,16,5,1
4,9,17,5,1
4,9,18,5,1
4,9,19,5,1
4,9,20,5,1
4,9,21,5,1
4,9,22,5,1
4,9,23,5,1
4,0,0,6,1
4,0,1,6,1
4,0,2,6,1
4,0,3,6,1
4,0,4,6,1
4,0,5,6,1
4,0,6,6,1
4,0,7,6,1
4,0,8,6,1
4,0,9,6,1
4,0,10,6,1
4,0,11,6,1
4,0,12,6,1
4,0,13,6,1
4,0,14,6,1
4,0,15,6,1
4,0,16,6,1
4,0,17,6,1
4,0,18,6,1
4,0,19,6,1
4,0,20,6,1
4,0,21,6,1
4,0,22,6,1
4,0,23,6,1
4,1,0,6,1
4,1,1,6,1
4,1,2,6,1
4,1,3,6,1
4,1,4,6,1
4,1,5,6,1
4,1,6,6,1
4,1,7,6,1
4,1,8,6,1
4,1,9,6,1
4,1,10,6,1
4,1,11,6,1
4,1,12,6,1
4,1,13,6,1
4,1,14,6,1
4,1,15,6,1
4,1,16,6,1
4,1,17,6,1
4,1,18,6,1
4,1,19,6,1
4,1,20,6,1
4,1,21,6,1
4,1,22,6,1
4,1,23,6,1
4,2,0,6,1
4,2,1,6,1
4,2,2,6,1
4,2,3,6,1
4,2,4,6,1
4,2,5,6,1
4,2,6,6,1
4,2,7,6,1
4,2,8,6,1
4,2,9,6,1
4,2,10,6,1
4,2,11,6,1
4,2,12,6,1
4,2,13,6,1
4,2,14,6,1
4,2,15,6,1
4,2,16,6,1
4,2,17,6,1
4,2,18,6,1
4,2,19,6,1
4,2,20,6,1
4,2,21,6,1
4,2,22,6,1
4,2,23,6,1
4,3,0,6,1
4,3,1,6,1
4,3,2,6,1
4,3,3,6,1
4,3,4,6,1
4,3,5,6,1
4,3,6,6,1
4,3,7,6,1
4,3,8,6,1
4,3,9,6,1
4,3,10,6,1
4,3,11,6,1
4,3,12,6,1
4,3,13,6,1
4,3,14,6,1
4,3,15,6,1
4,3,16,6,1
4,3,17,6,1
4,3,18,6,1
4,3,19,6,1
4,3,20,6,1
4,3,21,6,1
4,3,22,6,1
4,3,23,6,1
4,4,0,6,1
4,4,1,6,1
4,4,2,6,1
4,4,3,6,1
4,4,4,6,1
4,4,5,6,1
4,4,6,6,1
4,4,7,6,1
4,4,8,6,1
4,4,9,6,1
4,4,10,6,1
4,4,11,6,1
4,4,12,6,1
4,4,13,6,1
4,4,14,6,1
4,4,15,6,1
4,4,16,6,1
4,4,17,6,1
4,4,18,6,1
4,4,19,6,1
4,4,20,6,1
4,4,21,6,1
4,4,22,6,1
4,4,23,6,1
4,5,0,6,1
4,5,1,6,1
4,5,2,6,1
4,5,3,6,1
4,5,4,6,1
4,5,5,6,1
4,5,6,6,1
4,5,7,6,1
4,5,8,6,1
4,5,9,6,1
4,5,10,6,1
4,5,11,6,1
4,5,12,6,1
4,5,13,6,1
4,5,14,6,1
4,5,15,6,1
4,5,16,6,1
4,5,17,6,1
4,5,18,6,1
4,5,19,6,1
4,5,20,6,1
4,5,21,6,1
4,5,22,6,1
4,5,23,6,1
4,6,0,6,1
4,6,1,6,1
4,6,2,6,1
4,6,3,6,1
4,6,4,6,1
4,6,5,6,1
4,6,6,6,1
4,6,7,6,1
4,6,8,6,1
4,6,9,6,1
4,6,10,6,1
4,6,11,6,1
4,6,12,6,1
4,6,13,6,1
4,6,14,6,1
4,6,15,6,1
4,6,16,6,1
4,6,17,6,1
4,6,18,6,1
4,6,19,6,1
4,6,20,6,1
4,6,21,6,1
4,6,22,6,1
4,6,23,6,1
4,0,0,7,1
4,0,1,7,1
4,0,2,7,1
4,0,3,7,1
4,0,4,7,1
4,0,5,7,1
4,0,6,7,1
4,0,7,7,1
4,0,8,7,1
4,0,9,7,1
4,0,10,7,1
4,0,11,7,1
4,0,12,7,1
4,0,13,7,1
4,0,14,7,1
4,0,15,7,1
4,0,16,7,1
4,0,17,7,1
4,0,18,7,1
4,0,19,7,1
4,0,20,7,1
4,0,21,7,1
4,0,22,7,1
4,0,23,7,1
4,1,0,7,1
4,1,1,7,1
4,1,2,7,1
4,1,3,7,1
4,1,4,7,1
4,1,5,7,1
4,1,6,7,1
4,1,7,7,1
4,1,8,7,1
4,1,9,7,1
4,1,10,7,1
4,1,11,7,1
4,1,12,7,1
4,1,13,7,1
4,1,14,7,1
4,1,15,7,1
4,1,16,7,1
4,1,17,7,1
4,1,18,7,1
4,1,19,7,1
4,1,20,7,1
4,1,21,7,1
4,1,22,7,1
4,1,23,7,1
4,2,0,7,1
4,2,1,7,1
4,2,2,7,1
4,2,3,7,1
4,2,4,7,1
4,2,5,7,1
4,2,6,7,1
4,2,7,7,1
4,2,8,7,1
4,2,9,7,1
4,2,10,7,1
4,2,11,7,1
4,2,12,7,1
4,2,13,7,1
4,2,14,7,1
4,2,15,7,1
4,2,16,7,1
4,2,17,7,1
4,2,18,7,1
4,2,19,7,1
4,2,20,7,1
4,2,21,7,1
4,2,22,7,1
4,2,23,7,1
4,3,0,7,1
4,3,1,7,1
4,3,2,7,1
4,3,3,7,1
4,3,4,7,1
4,3,5,7,1
4,3,6,7,1
4,3,7,7,1
4,3,8,7,1
4,3,9,7,1
4,3,10,7,1
4,3,11,7,1
4,3,12,7,1
4,3,13,7,1
4,3,14,7,1
4,3,15,7,1
4,3,16,7,1
4,3,17,7,1
4,3,18,7,1
4,3,19,7,1
4,3,20,7,1
4,3,21,7,1
4,3,22,7,1
4,3,23,7,1
4,0,0,8,1
4,0,1,8,1
4,0,2,8,1
4,0,3,8,1
4,0,4,8,1
4,0,5,8,1
4,0,6,8,1
4,0,7,8,1
4,0,8,8,1
4,0,9,8,1
4,0,10,8,1
4,0,11,8,1
4,0,12,8,1
4,0,13,8,1
4,0,14,8,1
4,0,15,8,1
4,0,16,8,1
4,0,17,8,1
4,0,18,8,1
4,0,19,8,1
4,0,20,8,1
4,0,21,8,1
4,0,22,8,1
4,0,23,8,1
4,0,0,1,2
4,0,1,1,2
4,0,2,1,2
4,0,3,1,2
4,0,4,1,2
4,0,5,1,2
4,0,6,1,2
4,0,7,1,2
4,0,8,1,2
4,0,9,1,2
4,0,10,1,2
4,0,11,1,2
4,0,12,1,2
4,0,13,1,2
4,0,14,1,2
4,0,15,1,2
4,0,16,1,2
4,0,17,1,2
4,0,18,1,2
4,0,19,1,2
4,0,20,1,2
4,0,21,1,2
4,0,22,1,2
4,1,0,1,2
4,1,1,1,2
4,1,2,1,2
4,1,3,1,2
4,1,4,1,2
4,1,5,1,2
4,1,6,1,2
4,1,7,1,2
4,1,8,1,2
4,1,9,1,2
4,1,10,1,2
4,1,11,1,2
4,1,12,1,2
4,1,13,1,2
4,1,14,1,2
4,1,15,1,2
4,1,16,1,2
4,1,17,1,2
4,1,18,1,2
4,1,19,1,2
4,1,20,1,2
4,1,21,1,2
4,1,22,1,2
4,2,0,1,2
4,2,1,1,2
4,2,2,1,2
4,2,3,1,2
4,2,4,1,2
4,2,5,1,2
4,2,6,1,2
4,2,7,1,2
4,2,8,1,2
4,2,9,1,2
4,2,10,1,2
4,2,11,1,2
4,2,12,1,2
4,2,13,1,2
4,2,14,1,2
4,2,15,1,2
4,2,16,1,2
4,2,17,1,2
4,2,18,1,2
4,2,19,1,2
4,2,20,1,2
4,2,21,1,2
4,2,22,1,2
4,3,0,1,2
4,3,1,1,2
4,3,2,1,2
4,3,3,1,2
4,3,4,1,2
4,3,5,1,2
4,3,6,1,2
4,3,7,1,2
4,3,8,1,2
4,3,9,1,2
4,3,10,1,2
4,3,11,1,2
4,3,12,1,2
4,3,13,1,2
4,3,14,1,2
4,3,15,1,2
4,3,16,1,2
4,3,17,1,2
4,3,18,1,2
4,3,19,1,2
4,3,20,1,2
4,3,21,1,2
4,3,22,1,2
4,4,0,1,2
4,4,1,1,2
4,4,2,1,2
4,4,3,1,2
4,4,4,1,2
4,4,5,1,2
4,4,6,1,2
4,4,7,1,2
4,4,8,1,2
4,4,9,1,2
4,4,10,1,2
4,4,11,1,2
4,4,12,1,2
4,4,13,1,2
4,4,14,1,2
4,4,15,1,2
4,4,16,1,2
4,4,17,1,2
4,4,18,1,2
4,4,19,1,2
4,4,20,1,2
4,4,21,1,2
4,4,22,1,2
4,5,0,1,2
4,5,1,1,2
4,5,2,1,2
4,5,3,1,2
4,5,4,1,2
4,5,5,1,2
4,5,6,1,2
4,5,7,1,2
4,5,8,1,2
4,5,9,1,2
4,5,10,1,2
4,5,11,1,2
4,5,12,1,2
4,5,13,1,2
4,5,14,1,2
4,5,15,1,2
4,5,16,1,2
4,5,17,1,2
4,5,18,1,2
4,5,19,1,2
4,5,20,1,2
4,5,21,1,2
4,5,22,1,2
4,6,0,1,2
4,6,1,1,2
4,6,2,1,2
4,6,3,1,2
4,6,4,1,2
4,6,5,1,2
4,6,6,1,2
4,6,7,1,2
4,6,8,1,2
4,6,9,1,2
4,6,10,1,2
4,6,11,1,2
4,6,12,1,2
4,6,13,1,2
4,6,14,1,2
4,6,15,1,2
4,6,16,1,2
4,6,17,1,2
4,6,18,1,2
4,6,19,1,2
4,6,20,1,2
4,6,21,1,2
4,6,22,1,2
4,7,0,1,2
4,7,1,1,2
4,7,2,1,2
4,7,3,1,2
4,7,4,1,2
4,7,5,1,2
4,7,6,1,2
4,7,7,1,2
4,7,8,1,2
4,7,9,1,2
4,7,10,1,2
4,7,11,1,2
4,7,12,1,2
4,7,13,1,2
4,7,14,1,2
4,7,15,1,2
4,7,16,1,2
4,7,17,1,2
4,7,18,1,2
4,7,19,1,2
4,7,20,1,2
4,7,21,1,2
4,7,22,1,2
4,8,0,1,2
4,8,1,1,2
4,8,2,1,2
4,8,3,1,2
4,8,4,1,2
4,8,5,1,2
4,8,6,1,2
4,8,7,1,2
4,8,8,1,2
4,8,9,1,2
4,8,10,1,2
4,8,11,1,2
4,8,12,1,2
4,8,13,1,2
4,8,14,1,2
4,8,15,1,2
4,8,16,1,2
4,8,17,1,2
4,8,18,1,2
4,8,19,1,2
4,8,20,1,2
4,8,21,1,2
4,8,22,1,2
4,9,0,1,2
4,9,1,1,2
4,9,2,1,2
4,9,3,1,2
4,9,4,1,2
4,9,5,1,2
4,9,6,1,2
4,9,7,1,2
4,9,8,1,2
4,9,9,1,2
4,9,10,1,2
4,9,11,1,2
4,9,12,1,2
4,9,13,1,2
4,9,14,1,2
4,9,15,1,2
4,9,16,1,2
4,9,17,1,2
4,9,18,1,2
4,9,19,1,2
4,9,20,1,2
4,9,21,1,2
4,9,22,1,2
4,10,0,1,2
4,10,1,1,2
4,10,2,1,2
4,10,3,1,2
4,10,4,1,2
4,10,5,1,2
4,10,6,1,2
4,10,7,1,2
4,10,8,1,2
4,10,9,1,2
4,10,10,1,2
4,10,11,1,2
4,10,12,1,2
4,10,13,1,2
4,10,14,1,2
4,10,15,1,2
4,10,16,1,2
4,10,17,1,2
4,10,18,1,2
4,10,19,1,2
4,10,20,1,2
4,10,21,1,2
4,10,22,1,2
4,11,0,1,2
4,11,1,1,2
4,11,2,1,2
4,11,3,1,2
4,11,4,1,2
4,11,5,1,2
4,11,6,1,2
4,11,7,1,2
4,11,8,1,2
4,11,9,1,2
4,11,10,1,2
4,11,11,1,2
4,11,12,1,2
4,11,13,1,2
4,11,14,1,2
4,11,15,1,2
4,11,16,1,2
4,11,17,1,2
4,11,18,1,2
4,11,19,1,2
4,11,20,1,2
4,11,21,1,2
4,11,22,1,2
4,12,0,1,2
4,12,1,1,2
4,12,2,1,2
4,12,3,1,2
4,12,4,1,2
4,12,5,1,2
4,12,6,1,2
4,12,7,1,2
4,12,8,1,2
4,12,9,1,2
4,12,10,1,2
4,12,11,1,2
4,12,12,1,2
4,12,13,1,2
4,12,14,1,2
4,12,15,1,2
4,12,16,1,2
4,12,17,1,2
4,12,18,1,2
4,12,19,1,2
4,12,20,1,2
4,12,21,1,2
4,12,22,1,2
4,13,0,1,2
4,13,1,1,2
4,13,2,1,2
4,13,3,1,2
4,13,4,1,2
4,13,5,1,2
4,13,6,1,2
4,13,7,1,2
4,13,8,1,2
4,13,9,1,2
4,13,10,1,2
4,13,11,1,2
4,13,12,1,2
4,13,13,1,2
4,13,14,1,2
4,13,15,1,2
4,13,16,1,2
4,13,17,1,2
4,13,18,1,2
4,13,19,1,2
4,13,20,1,2
4,13,21,1,2
4,13,22,1,2
4,14,0,1,2
4,14,1,1,2
4,14,2,1,2
4,14,3,1,2
4,14,4,1,2
4,14,5,1,2
4,14,6,1,2
4,14,7,1,2
4,14,8,1,2
4,14,9,1,2
4,14,10,1,2
4,14,11,1,2
4,14,12,1,2
4,14,13,1,2
4,14,14,1,2
4,14,15,1,2
4,14,16,1,2
4,14,17,1,2
4,14,18,1,2
4,14,19,1,2
4,14,20,1,2
4,14,21,1,2
4,14,22,1,2
4,15,0,1,2
4,15,1,1,2
4,15,2,1,2
4,15,3,1,2
4,15,4,1,2
4,15,5,1,2
4,15,6,1,2
4,15,7,1,2
4,15,8,1,2
4,15,9,1,2
4,15,10,1,2
4,15,11,1,2
4,15,12,1,2
4,15,13,1,2
4,15,14,1,2
4,15,15,1,2
4,15,16,1,2
4,15,17,1,2
4,15,18,1,2
4,15,19,1,2
4,15,20,1,2
4,15,21,1,2
4,15,22,1,2
4,16,0,1,2
4,16,1,1,2
4,16,2,1,2
4,16,3,1,2
4,16,4,1,2
4,16,5,1,2
4,16,6,1,2
4,16,7,1,2
4,16,8,1,2
4,16,9,1,2
4,16,10,1,2
4,16,11,1,2
4,16,12,1,2
4,16,13,1,2
4,16,14,1,2
4,16,15,1,2
4,16,16,1,2
4,16,17,1,2
4,16,18,1,2
4,16,19,1,2
4,16,20,1,2
4,16,21,1,2
4,16,22,1,2
4,17,0,1,2
4,17,1,1,2
4,17,2,1,2
4,17,3,1,2
4,17,4,1,2
4,17,5,1,2
4,17,6,1,2
4,17,7,1,2
4,17,8,1,2
4,17,9,1,2
4,17,10,1,2
4,17,11,1,2
4,17,12,1,2
4,17,13,1,2
4,17,14,1,2
4,17,15,1,2
4,17,16,1,2
4,17,17,1,2
4,17,18,1,2
4,17,19,1,2
4,17,20,1,2
4,17,21,1,2
4,17,22,1,2
4,18,0,1,2
4,18,1,1,2
4,18,2,1,2
4,18,3,1,2
4,18,4,1,2
4,18,5,1,2
4,18,6,1,2
4,18,7,1,2
4,18,8,1,2
4,18,9,1,2
4,18,10,1,2
4,18,11,1,2
4,18,12,1,2
4,18,13,1,2
4,18,14,1,2
4,18,15,1,2
4,18,16,1,2
4,18,17,1,2
4,18,18,1,2
4,18,19,1,2
4,18,20,1,2
4,18,21,1,2
4,18,22,1,2
4,19,0,1,2
4,19,1,1,2
4,19,2,1,2
4,19,3,1,2
4,19,4,1,2
4,19,5,1,2
4,19,6,1,2
4,19,7,1,2
4,19,8,1,2
4,19,9,1,2
4,19,10,1,2
4,19,11,1,2
4,19,12,1,2
4,19,13,1,2
4,19,14,1,2
4,19,15,1,2
4,19,16,1,2
4,19,17,1,2
4,19,18,1,2
4,19,19,1,2
4,19,20,1,2
4,19,21,1,2
4,19,22,1,2
4,20,0,1,2
4,20,1,1,2
4,20,2,1,2
4,20,3,1,2
4,20,4,1,2
4,20,5,1,2
4,20,6,1,2
4,20,7,1,2
4,20,8,1,2
4,20,9,1,2
4,20,10,1,2
4,20,11,1,2
4,20,12,1,2
4,20,13,1,2
4,20,14,1,2
4,20,15,1,2
4,20,16,1,2
4,20,17,1,2
4,20,18,1,2
4,20,19,1,2
4,20,20,1,2
4,20,21,1,2
4,20,22,1,2
4,21,0,1,2
4,21,1,1,2
4,21,2,1,2
4,21,3,1,2
4,21,4,1,2
4,21,5,1,2
4,21,6,1,2
4,21,7,1,2
4,21,8,1,2
4,21,9,1,2
4,21,10,1,2
4,21,11,1,2
4,21,12,1,2
4,21,13,1,2
4,21,14,1,2
4,21,15,1,2
4,21,16,1,2
4,21,17,1,2
4,21,18,1,2
4,21,19,1,2
4,21,20,1,2
4,21,21,1,2
4,21,22,1,2
4,0,0,2,2
4,0,1,2,2
4,0,2,2,2
4,0,3,2,2
4,0,4,2,2
4,0,5,2,2
4,0,6,2,2
4,0,7,2,2
4,0,8,2,2
4,0,9,2,2
4,0,10,2,2
4,0,11,2,2
4,0,12,2,2
4,0,13,2,2
4,0,14,2,2
4,0,15,2,2
4,0,16,2,2
4,0,17,2,2
4,0,18,2,2
4,0,19,2,2
4,0,20,2,2
4,0,21,2,2
4,0,22,2,2
4,1,0,2,2
4,1,1,2,2
4,1,2,2,2
4,1,3,2,2
4,1,4,2,2
4,1,5,2,2
4,1,6,2,2
4,1,7,2,2
4,1,8,2,2
4,1,9,2,2
4,1,10,2,2
4,1,11,2,2
4,1,12,2,2
4,1,13,2,2
4,1,14,2,2
4,1,15,2,2
4,1,16,2,2
4,1,17,2,2
4,1,18,2,2
4,1,19,2,2
4,1,20,2,2
4,1,21,2,2
4,1,22,2,2
4,2,0,2,2
4,2,1,2,2
4,2,2,2,2
4,2,3,2,2
4,2,4,2,2
4,2,5,2,2
4,2,6,2,2
4,2,7,2,2
4,2,8,2,2
4,2,9,2,2
4,2,10,2,2
4,2,11,2,2
4,2,12,2,2
4,2,13,2,2
4,2,14,2,2
4,2,15,2,2
4,2,16,2,2
4,2,17,2,2
4,2,18,2,2
4,2,19,2,2
4,2,20,2,2
4,2,21,2,2
4,2,22,2,2
4,3,0,2,2
4,3,1,2,2
4,3,2,2,2
4,3,3,2,2
4,3,4,2,2
4,3,5,2,2
4,3,6,2,2
4,3,7,2,2
4,3,8,2,2
4,3,9,2,2
4,3,10,2,2
4,3,11,2,2
4,3,12,2,2
4,3,13,2,2
4,3,14,2,2
4,3,15,2,2
4,3,16,2,2
4,3,17,2,2
4,3,18,2,2
4,3,19,2,2
4,3,20,2,2
4,3,21,2,2
4,3,22,2,2
4,4,0,2,2
4,4,1,2,2
4,4,2,2,2
4,4,3,2,2
4,4,4,2,2
4,4,5,2,2
4,4,6,2,2
4,4,7,2,2
4,4,8,2,2
4,4,9,2,2
4,4,10,2,2
4,4,11,2,2
4,4,12,2,2
4,4,13,2,2
4,4,14,2,2
4,4,15,2,2
4,4,16,2,2
4,4,17,2,2
4,4,18,2,2
4,4,19,2,2
4,4,20,2,2
4,4,21,2,2
4,4,22,2,2
4,5,0,2,2
4,5,1,2,2
4,5,2,2,2
4,5,3,2,2
4,5,4,2,2
4,5,5,2,2
4,5,6,2,2
4,5,7,2,2
4,5,8,2,2
4,5,9,2,2
4,5,10,2,2
4,5,11,2,2
4,5,12,2,2
4,5,13,2,2
4,5,14,2,2
4,5,15,2,2
4,5,16,2,2
4,5,17,2,2
4,5,18,2,2
4,5,19,2,2
4,5,20,2,2
4,5,21,2,2
4,5,22,2,2
4,6,0,2,2
4,6,1,2,2
4,6,2,2,2
4,6,3,2,2
4,6,4,2,2
4,6,5,2,2
4,6,6,2,2
4,6,7,2,2
4,6,8,2,2
4,6,9,2,2
4,6,10,2,2
4,6,11,2,2
4,6,12,2,2
4,6,13,2,2
4,6,14,2,2
4,6,15,2,2
4,6,16,2,2
4,6,17,2,2
4,6,18,2,2
4,6,19,2,2
4,6,20,2,2
4,6,21,2,2
4,6,22,2,2
4,7,0,2,2
4,7,1,2,2
4,7,2,2,2
4,7,3,2,2
4,7,4,2,2
4,7,5,2,2
4,7,6,2,2
4,7,7,2,2
4,7,8,2,2
4,7,9,2,2
4,7,10,2,2
4,7,11,2,2
4,7,12,2,2
4,7,13,2,2
4,7,14,2,2
4,7,15,2,2
4,7,16,2,2
4,7,17,2,2
4,7,18,2,2
4,7,19,2,2
4,7,20,2,2
4,7,21,2,2
4,7,22,2,2
4,8,0,2,2
4,8,1,2,2
4,8,2,2,2
4,8,3,2,2
4,8,4,2,2
4,8,5,2,2
4,8,6,2,2
4,8,7,2,2
4,8,8,2,2
4,8,9,2,2
4,8,10,2,2
4,8,11,2,2
4,8,12,2,2
4,8,13,2,2
4,8,14,2,2
4,8,15,2,2
4,8,16,2,2
4,8,17,2,2
4,8,18,2,2
4,8,19,2,2
4,8,20,2,2
4,8,21,2,2
4,8,22,2,2
4,9,0,2,2
4,9,1,2,2
4,9,2,2,2
4,9,3,2,2
4,9,4,2,2
4,9,5,2,2
4,9,6,2,2
4,9,7,2,2
4,9,8,2,2
4,9,9,2,2
4,9,10,2,2
4,9,11,2,2
4,9,12,2,2
4,9,13,2,2
4,9,14,2,2
4,9,15,2,2
4,9,16,2,2
4,9,17,2,2
4,9,18,2,2
4,9,19,2,2
4,9,20,2,2
4,9,21,2,2
4,9,22,2,2
4,10,0,2,2
4,10,1,2,2
4,10,2,2,2
4,10,3,2,2
4,10,4,2,2
4,10,5,2,2
4,10,6,2,2
4,10,7,2,2
4,10,8,2,2
4,10,9,2,2
4,10,10,2,2
4,10,11,2,2
4,10,12,2,2
4,10,13,2,2
4,10,14,2,2
4,10,15,2,2
4,10,16,2,2
4,10,17,2,2
4,10,18,2,2
4,10,19,2,2
4,10,20,2,2
4,10,21,2,2
4,10,22,2,2
4,11,0,2,2
4,11,1,2,2
4,11,2,2,2
4,11,3,2,2
4,11,4,2,2
4,11,5,2,2
4,11,6,2,2
4,11,7,2,2
4,11,8,2,2
4,11,9,2,2
4,11,10,2,2
4,11,11,2,2
4,11,12,2,2
4,11,13,2,2
4,11,14,2,2
4,11,15,2,2
4,11,16,2,2
4,11,17,2,2
4,11,18,2,2
4,11,19,2,2
4,11,20,2,2
4,11,21,2,2
4,11,22,2,2
4,12,0,2,2
4,12,1,2,2
4,12,2,2,2
4,12,3,2,2
4,12,4,2,2
4,12,5,2,2
4,12,6,2,2
4,12,7,2,2
4,12,8,2,2
4,12,9,2,2
4,12,10,2,2
4,12,11,2,2
4,12,12,2,2
4,12,13,2,2
4,12,14,2,2
4,12,15,2,2
4,12,16,2,2
4,12,17,2,2
4,12,18,2,2
4,12,19,2,2
4,12,20,2,2
4,12,21,2,2
4,12,22,2,2
4,13,0,2,2
4,13,1,2,2
4,13,2,2,2
4,13,3,2,2
4,13,4,2,2
4,13,5,2,2
4,13,6,2,2
4,13,7,2,2
4,13,8,2,2
4,13,9,2,2
4,13,10,2,2
4,13,11,2,2
4,13,12,2,2
4,13,13,2,2
4,13,14,2,2
4,13,15,2,2
4,13,16,2,2
4,13,17,2,2
4,13,18,2,2
4,13,19,2,2
4,13,20,2,2
4,13,21,2,2
4,13,22,2,2
4,14,0,2,2
4,14,1,2,2
4,14,2,2,2
4,14,3,2,2
4,14,4,2,2
4,14,5,2,2
4,14,6,2,2
4,14,7,2,2
4,14,8,2,2
4,14,9,2,2
4,14,10,2,2
4,14,11,2,2
4,14,12,2,2
4,14,13,2,2
4,14,14,2,2
4,14,15,2,2
4,14,16,2,2
4,14,17,2,2
4,14,18,2,2
4,14,19,2,2
4,14,20,2,2
4,14,21,2,2
4,14,22,2,2
4,15,0,2,2
4,15,1,2,2
4,15,2,2,2
4,15,3,2,2
4,15,4,2,2
4,15,5,2,2
4,15,6,2,2
4,15,7,2,2
4,15,8,2,2
4,15,9,2,2
4,15,10,2,2
4,15,11,2,2
4,15,12,2,2
4,15,13,2,2
4,15,14,2,2
4,15,15,2,2
4,15,16,2,2
4,15,17,2,2
4,15,18,2,2
4,15,19,2,2
4,15,20,2,2
4,15,21,2,2
4,15,22,2,2
4,16,0,2,2
4,16,1,2,2
4,16,2,2,2
4,16,3,2,2
4,16,4,2,2
4,16,5,2,2
4,16,6,2,2
4,16,7,2,2
4,16,8,2,2
4,16,9,2,2
4,16,10,2,2
4,16,11,2,2
4,16,12,2,2
4,16,13,2,2
4,16,14,2,2
4,16,15,2,2
4,16,16,2,2
4,16,17,2,2
4,16,18,2,2
4,16,19,2,2
4,16,20,2,2
4,16,21,2,2
4,16,22,2,2
4,17,0,2,2
4,17,1,2,2
4,17,2,2,2
4,17,3,2,2
4,17,4,2,2
4,17,5,2,2
4,17,6,2,2
4,17,7,2,2
4,17,8,2,2
4,17,9,2,2
4,17,10,2,2
4,17,11,2,2
4,17,12,2,2
4,17,13,2,2
4,17,14,2,2
4,17,15,2,2
4,17,16,2,2
4,17,17,2,2
4,17,18,2,2
4,17,19,2,2
4,17,20,2,2
4,17,21,2,2
4,17,22,2,2
4,18,0,2,2
4,18,1,2,2
4,18,2,2,2
4,18,3,2,2
4,18,4,2,2
4,18,5,2,2
4,18,6,2,2
4,18,7,2,2
4,18,8,2,2
4,18,9,2,2
4,18,10,2,2
4,18,11,2,2
4,18,12,2,2
4,18,13,2,2
4,18,14,2,2
4,18,15,2,2
4,18,16,2,2
4,18,17,2,2
4,18,18,2,2
4,18,19,2,2
4,18,20,2,2
4,18,21,2,2
4,18,22,2,2
4,0,0,3,2
4,0,1,3,2
4,0,2,3,2
4,0,3,3,2
4,0,4,3,2
4,0,5,3,2
4,0,6,3,2
4,0,7,3,2
4,0,8,3,2
4,0,9,3,2
4,0,10,3,2
4,0,11,3,2
4,0,12,3,2
4,0,13,3,2
4,0,14,3,2
4,0,15,3,2
4,0,16,3,2
4,0,17,3,2
4,0,18,3,2
4,0,19,3,2
4,0,20,3,2
4,0,21,3,2
4,0,22,3,2
4,1,0,3,2
4,1,1,3,2
4,1,2,3,2
4,1,3,3,2
4,1,4,3,2
4,1,5,3,2
4,1,6,3,2
4,1,7,3,2
4,1,8,3,2
4,1,9,3,2
4,1,10,3,2
4,1,11,3,2
4,1,12,3,2
4,1,13,3,2
4,1,14,3,2
4,1,15,3,2
4,1,16,3,2
4,1,17,3,2
4,1,18,3,2
4,1,19,3,2
4,1,20,3,2
4,1,21,3,2
4,1,22,3,2
4,2,0,3,2
4,2,1,3,2
4,2,2,3,2
4,2,3,3,2
4,2,4,3,2
4,2,5,3,2
4,2,6,3,2
4,2,7,3,2
4,2,8,3,2
4,2,9,3,2
4,2,10,3,2
4,2,11,3,2
4,2,12,3,2
4,2,13,3,2
4,2,14,3,2
4,2,15,3,2
4,2,16,3,2
4,2,17,3,2
4,2,18,3,2
4,2,19,3,2
4,2,20,3,2
4,2,21,3,2
4,2,22,3,2
4,3,0,3,2
4,3,1,3,2
4,3,2,3,2
4,3,3,3,2
4,3,4,3,2
4,3,5,3,2
4,3,6,3,2
4,3,7,3,2
4,3,8,3,2
4,3,9,3,2
4,3,10,3,2
4,3,11,3,2
4,3,12,3,2
4,3,13,3,2
4,3,14,3,2
4,3,15,3,2
4,3,16,3,2
4,3,17,3,2
4,3,18,3,2
4,3,19,3,2
4,3,20,3,2
4,3,21,3,2
4,3,22,3,2
4,4,0,3,2
4,4,1,3,2
4,4,2,3,2
4,4,3,3,2
4,4,4,3,2
4,4,5,3,2
4,4,6,3,2
4,4,7,3,2
4,4,8,3,2
4,4,9,3,2
4,4,10,3,2
4,4,11,3,2
4,4,12,3,2
4,4,13,3,2
4,4,14,3,2
4,4,15,3,2
4,4,16,3,2
4,4,17,3,2
4,4,18,3,2
4,4,19,3,2
4,4,20,3,2
4,4,21,3,2
4,4,22,3,2
4,5,0,3,2
4,5,1,3,2
4,5,2,3,2
4,5,3,3,2
4,5,4,3,2
4,5,5,3,2
4,5,6,3,2
4,5,7,3,2
4,5,8,3,2
4,5,9,3,2
4,5,10,3,2
4,5,11,3,2
4,5,12,3,2
4,5,13,3,2
4,5,14,3,2
4,5,15,3,2
4,5,16,3,2
4,5,17,3,2
4,5,18,3,2
4,5,19,3,2
4,5,20,3,2
4,5,21,3,2
4,5,22,3,2
4,6,0,3,2
4,6,1,3,2
4,6,2,3,2
4,6,3,3,2
4,6,4,3,2
4,6,5,3,2
4,6,6,3,2
4,6,7,3,2
4,6,8,3,2
4,6,9,3,2
4,6,10,3,2
4,6,11,3,2
4,6,12,3,2
4,6,13,3,2
4,6,14,3,2
4,6,15,3,2
4,6,16,3,2
4,6,17,3,2
4,6,18,3,2
4,6,19,3,2
4,6,20,3,2
4,6,21,3,2
4,6,22,3,2
4,7,0,3,2
4,7,1,3,2
4,7,2,3,2
4,7,3,3,2
4,7,4,3,2
4,7,5,3,2
4,7,6,3,2
4,7,7,3,2
4,7,8,3,2
4,7,9,3,2
4,7,10,3,2
4,7,11,3,2
4,7,12,3,2
4,7,13,3,2
4,7,14,3,2
4,7,15,3,2
4,7,16,3,2
4,7,17,3,2
4,7,18,3,2
4,7,19,3,2
4,7,20,3,2
4,7,21,3,2
4,7,22,3,2
4,8,0,3,2
4,8,1,3,2
4,8,2,3,2
4,8,3,3,2
4,8,4,3,2
4,8,5,3,2
4,8,6,3,2
4,8,7,3,2
4,8,8,3,2
4,8,9,3,2
4,8,10,3,2
4,8,11,3,2
4,8,12,3,2
4,8,13,3,2
4,8,14,3,2
4,8,15,3,2
4,8,16,3,2
4,8,17,3,2
4,8,18,3,2
4,8,19,3,2
4,8,20,3,2
4,8,21,3,2
4,8,22,3,2
4,9,0,3,2
4,9,1,3,2
4,9,2,3,2
4,9,3,3,2
4,9,4,3,2
4,9,5,3,2
4,9,6,3,2
4,9,7,3,2
4,9,8,3,2
4,9,9,3,2
4,9,10,3,2
4,9,11,3,2
4,9,12,3,2
4,9,13,3,2
4,9,14,3,2
4,9,15,3,2
4,9,16,3,2
4,9,17,3,2
4,9,18,3,2
4,9,19,3,2
4,9,20,3,2
4,9,21,3,2
4,9,22,3,2
4,10,0,3,2
4,10,1,3,2
4,10,2,3,2
4,10,3,3,2
4,10,4,3,2
4,10,5,3,2
4,10,6,3,2
4,10,7,3,2
4,10,8,3,2
4,10,9,3,2
4,10,10,3,2
4,10,11,3,2
4,10,12,3,2
4,10,13,3,2
4,10,14,3,2
4,10,15,3,2
4,10,16,3,2
4,10,17,3,2
4,10,18,3,2
4,10,19,3,2
4,10,20,3,2
4,10,21,3,2
4,10,22,3,2
4,11,0,3,2
4,11,1,3,2
4,11,2,3,2
4,11,3,3,2
4,11,4,3,2
4,11,5,3,2
4,11,6,3,2
4,11,7,3,2
4,11,8,3,2
4,11,9,3,2
4,11,10,3,2
4,11,11,3,2
4,11,12,3,2
4,11,13,3,2
4,11,14,3,2
4,11,15,3,2
4,11,16,3,2
4,11,17,3,2
4,11,18,3,2
4,11,19,3,2
4,11,20,3,2
4,11,21,3,2
4,11,22,3,2
4,12,0,3,2
4,12,1,3,2
4,12,2,3,2
4,12,3,3,2
4,12,4,3,2
4,12,5,3,2
4,12,6,3,2
4,12,7,3,2
4,12,8,3,2
4,12,9,3,2
4,12,10,3,2
4,12,11,3,2
4,12,12,3,2
4,12,13,3,2
4,12,14,3,2
4,12,15,3,2
4,12,16,3,2
4,12,17,3,2
4,12,18,3,2
4,12,19,3,2
4,12,20,3,2
4,12,21,3,2
4,12,22,3,2
4,13,0,3,2
4,13,1,3,2
4,13,2,3,2
4,13,3,3,2
4,13,4,3,2
4,13,5,3,2
4,13,6,3,2
4,13,7,3,2
4,13,8,3,2
4,13,9,3,2
4,13,10,3,2
4,13,11,3,2
4,13,12,3,2
4,13,13,3,2
4,13,14,3,2
4,13,15,3,2
4,13,16,3,2
4,13,17,3,2
4,13,18,3,2
4,13,19,3,2
4,13,20,3,2
4,13,21,3,2
4,13,22,3,2
4,14,0,3,2
4,14,1,3,2
4,14,2,3,2
4,14,3,3,2
4,14,4,3,2
4,14,5,3,2
4,14,6,3,2
4,14,7,3,2
4,14,8,3,2
4,14,9,3,2
4,14,10,3,2
4,14,11,3,2
4,14,12,3,2
4,14,13,3,2
4,14,14,3,2
4,14,15,3,2
4,14,16,3,2
4,14,17,3,2
4,14,18,3,2
4,14,19,3,2
4,14,20,3,2
4,14,21,3,2
4,14,22,3,2
4,15,0,3,2
4,15,1,3,2
4,15,2,3,2
4,15,3,3,2
4,15,4,3,2
4,15,5,3,2
4,15,6,3,2
4,15,7,3,2
4,15,8,3,2
4,15,9,3,2
4,15,10,3,2
4,15,11,3,2
4,15,12,3,2
4,15,13,3,2
4,15,14,3,2
4,15,15,3,2
4,15,16,3,2
4,15,17,3,2
4,15,18,3,2
4,15,19,3,2
4,15,20,3,2
4,15,21,3,2
4,15,22,3,2
4,0,0,4,2
4,0,1,4,2
4,0,2,4,2
4,0,3,4,2
4,0,4,4,2
4,0,5,4,2
4,0,6,4,2
4,0,7,4,2
4,0,8,4,2
4,0,9,4,2
4,0,10,4,2
4,0,11,4,2
4,0,12,4,2
4,0,13,4,2
4,0,14,4,2
4,0,15,4,2
4,0,16,4,2
4,0,17,4,2
4,0,18,4,2
4,0,19,4,2
4,0,20,4,2
4,0,21,4,2
4,0,22,4,2
4,1,0,4,2
4,1,1,4,2
4,1,2,4,2
4,1,3,4,2
4,1,4,4,2
4,1,5,4,2
4,1,6,4,2
4,1,7,4,2
4,1,8,4,2
4,1,9,4,2
4,1,10,4,2
4,1,11,4,2
4,1,12,4,2
4,1,13,4,2
4,1,14,4,2
4,1,15,4,2
4,1,16,4,2
4,1,17,4,2
4,1,18,4,2
4,1,19,4,2
4,1,20,4,2
4,1,21,4,2
4,1,22,4,2
4,2,0,4,2
4,2,1,4,2
4,2,2,4,2
4,2,3,4,2
4,2,4,4,2
4,2,5,4,2
4,2,6,4,2
4,2,7,4,2
4,2,8,4,2
4,2,9,4,2
4,2,10,4,2
4,2,11,4,2
4,2,12,4,2
4,2,13,4,2
4,2,14,4,2
4,2,15,4,2
4,2,16,4,2
4,2,17,4,2
4,2,18,4,2
4,2,19,4,2
4,2,20,4,2
4,2,21,4,2
4,2,22,4,2
4,3,0,4,2
4,3,1,4,2
4,3,2,4,2
4,3,3,4,2
4,3,4,4,2
4,3,5,4,2
4,3,6,4,2
4,3,7,4,2
4,3,8,4,2
4,3,9,4,2
4,3,10,4,2
4,3,11,4,2
4,3,12,4,2
4,3,13,4,2
4,3,14,4,2
4,3,15,4,2
4,3,16,4,2
4,3,17,4,2
4,3,18,4,2
4,3,19,4,2
4,3,20,4,2
4,3,21,4,2
4,3,22,4,2
4,4,0,4,2
4,4,1,4,2
4,4,2,4,2
4,4,3,4,2
4,4,4,4,2
4,4,5,4,2
4,4,6,4,2
4,4,7,4,2
4,4,8,4,2
4,4,9,4,2
4,4,10,4,2
4,4,11,4,2
4,4,12,4,2
4,4,13,4,2
4,4,14,4,2
4,4,15,4,2
4,4,16,4,2
4,4,17,4,2
4,4,18,4,2
4,4,19,4,2
4,4,20,4,2
4,4,21,4,2
4,4,22,4,2
4,5,0,4,2
4,5,1,4,2
4,5,2,4,2
4,5,3,4,2
4,5,4,4,2
4,5,5,4,2
4,5,6,4,2
4,5,7,4,2
4,5,8,4,2
4,5,9,4,2
4,5,10,4,2
4,5,11,4,2
4,5,12,4,2
4,5,13,4,2
4,5,14,4,2
4,5,15,4,2
4,5,16,4,2
4,5,17,4,2
4,5,18,4,2
4,5,19,4,2
4,5,20,4,2
4,5,21,4,2
4,5,22,4,2
4,6,0,4,2
4,6,1,4,2
4,6,2,4,2
4,6,3,4,2
4,6,4,4,2
4,6,5,4,2
4,6,6,4,2
4,6,7,4,2
4,6,8,4,2
4,6,9,4,2
4,6,10,4,2
4,6,11,4,2
4,6,12,4,2
4,6,13,4,2
4,6,14,4,2
4,6,15,4,2
4,6,16,4,2
4,6,17,4,2
4,6,18,4,2
4,6,19,4,2
4,6,20,4,2
4,6,21,4,2
4,6,22,4,2
4,7,0,4,2
4,7,1,4,2
4,7,2,4,2
4,7,3,4,2
4,7,4,4,2
4,7,5,4,2
4,7,6,4,2
4,7,7,4,2
4,7,8,4,2
4,7,9,4,2
4,7,10,4,2
4,7,11,4,2
4,7,12,4,2
4,7,13,4,2
4,7,14,4,2
4,7,15,4,2
4,7,16,4,2
4,7,17,4,2
4,7,18,4,2
4,7,19,4,2
4,7,20,4,2
4,7,21,4,2
4,7,22,4,2
4,8,0,4,2
4,8,1,4,2
4,8,2,4,2
4,8,3,4,2
4,8,4,4,2
4,8,5,4,2
4,8,6,4,2
4,8,7,4,2
4,8,8,4,2
4,8,9,4,2
4,8,10,4,2
4,8,11,4,2
4,8,12,4,2
4,8,13,4,2
4,8,14,4,2
4,8,15,4,2
4,8,16,4,2
4,8,17,4,2
4,8,18,4,2
4,8,19,4,2
4,8,20,4,2
4,8,21,4,2
4,8,22,4,2
4,9,0,4,2
4,9,1,4,2
4,9,2,4,2
4,9,3,4,2
4,9,4,4,2
4,9,5,4,2
4,9,6,4,2
4,9,7,4,2
4,9,8,4,2
4,9,9,4,2
4,9,10,4,2
4,9,11,4,2
4,9,12,4,2
4,9,13,4,2
4,9,14,4,2
4,9,15,4,2
4,9,16,4,2
4,9,17,4,2
4,9,18,4,2
4,9,19,4,2
4,9,20,4,2
4,9,21,4,2
4,9,22,4,2
4,10,0,4,2
4,10,1,4,2
4,10,2,4,2
4,10,3,4,2
4,10,4,4,2
4,10,5,4,2
4,10,6,4,2
4,10,7,4,2
4,10,8,4,2
4,10,9,4,2
4,10,10,4,2
4,10,11,4,2
4,10,12,4,2
4,10,13,4,2
4,10,14,4,2
4,10,15,4,2
4,10,16,4,2
4,10,17,4,2
4,10,18,4,2
4,10,19,4,2
4,10,20,4,2
4,10,21,4,2
4,10,22,4,2
4,11,0,4,2
4,11,1,4,2
4,11,2,4,2
4,11,3,4,2
4,11,4,4,2
4,11,5,4,2
4,11,6,4,2
4,11,7,4,2
4,11,8,4,2
4,11,9,4,2
4,11,10,4,2
4,11,11,4,2
4,11,12,4,2
4,11,13,4,2
4,11,14,4,2
4,11,15,4,2
4,11,16,4,2
4,11,17,4,2
4,11,18,4,2
4,11,19,4,2
4,11,20,4,2
4,11,21,4,2
4,11,22,4,2
4,12,0,4,2
4,12,1,4,2
4,12,2,4,2
4,12,3,4,2
4,12,4,4,2
4,12,5,4,2
4,12,6,4,2
4,12,7,4,2
4,12,8,4,2
4,12,9,4,2
4,12,10,4,2
4,12,11,4,2
4,12,12,4,2
4,12,13,4,2
4,12,14,4,2
4,12,15,4,2
4,12,16,4,2
4,12,17,4,2
4,12,18,4,2
4,12,19,4,2
4,12,20,4,2
4,12,21,4,2
4,12,22,4,2
4,0,0,5,2
4,0,1,5,2
4,0,2,5,2
4,0,3,5,2
4,0,4,5,2
4,0,5,5,2
4,0,6,5,2
4,0,7,5,2
4,0,8,5,2
4,0,9,5,2
4,0,10,5,2
4,0,11,5,2
4,0,12,5,2
4,0,13,5,2
4,0,14,5,2
4,0,15,5,2
4,0,16,5,2
4,0,17,5,2
4,0,18,5,2
4,0,19,5,2
4,0,20,5,2
4,0,21,5,2
4,0,22,5,2
4,1,0,5,2
4,1,1,5,2
4,1,2,5,2
4,1,3,5,2
4,1,4,5,2
4,1,5,5,2
4,1,6,5,2
4,1,7,5,2
4,1,8,5,2
4,1,9,5,2
4,1,10,5,2
4,1,11,5,2
4,1,12,5,2
4,1,13,5,2
4,1,14,5,2
4,1,15,5,2
4,1,16,5,2
4,1,17,5,2
4,1,18,5,2
4,1,19,5,2
4,1,20,5,2
4,1,21,5,2
4,1,22,5,2
4,2,0,5,2
4,2,1,5,2
4,2,2,5,2
4,2,3,5,2
4,2,4,5,2
4,2,5,5,2
4,2,6,5,2
4,2,7,5,2
4,2,8,5,2
4,2,9,5,2
4,2,10,5,2
4,2,11,5,2
4,2,12,5,2
4,2,13,5,2
4,2,14,5,2
4,2,15,5,2
4,2,16,5,2
4,2,17,5,2
4,2,18,5,2
4,2,19,5,2
4,2,20,5,2
4,2,21,5,2
4,2,22,5,2
4,3,0,5,2
4,3,1,5,2
4,3,2,5,2
4,3,3,5,2
4,3,4,5,2
4,3,5,5,2
4,3,6,5,2
4,3,7,5,2
4,3,8,5,2
4,3,9,5,2
4,3,10,5,2
4,3,11,5,2
4,3,12,5,2
4,3,13,5,2
4,3,14,5,2
4,3,15,5,2
4,3,16,5,2
4,3,17,5,2
4,3,18,5,2
4,3,19,5,2
4,3,20,5,2
4,3,21,5,2
4,3,22,5,2
4,4,0,5,2
4,4,1,5,2
4,4,2,5,2
4,4,3,5,2
4,4,4,5,2
4,4,5,5,2
4,4,6,5,2
4,4,7,5,2
4,4,8,5,2
4,4,9,5,2
4,4,10,5,2
4,4,11,5,2
4,4,12,5,2
4,4,13,5,2
4,4,14,5,2
4,4,15,5,2
4,4,16,5,2
4,4,17,5,2
4,4,18,5,2
4,4,19,5,2
4,4,20,5,2
4,4,21,5,2
4,4,22,5,2
4,5,0,5,2
4,5,1,5,2
4,5,2,5,2
4,5,3,5,2
4,5,4,5,2
4,5,5,5,2
4,5,6,5,2
4,5,7,5,2
4,5,8,5,2
4,5,9,5,2
4,5,10,5,2
4,5,11,5,2
4,5,12,5,2
4,5,13,5,2
4,5,14,5,2
4,5,15,5,2
4,5,16,5,2
4,5,17,5,2
4,5,18,5,2
4,5,19,5,2
4,5,20,5,2
4,5,21,5,2
4,5,22,5,2
4,6,0,5,2
4,6,1,5,2
4,6,2,5,2
4,6,3,5,2
4,6,4,5,2
4,6,5,5,2
4,6,6,5,2
4,6,7,5,2
4,6,8,5,2
4,6,9,5,2
4,6,10,5,2
4,6,11,5,2
4,6,12,5,2
4,6,13,5,2
4,6,14,5,2
4,6,15,5,2
4,6,16,5,2
4,6,17,5,2
4,6,18,5,2
4,6,19,5,2
4,6,20,5,2
4,6,21,5,2
4,6,22,5,2
4,7,0,5,2
4,7,1,5,2
4,7,2,5,2
4,7,3,5,2
4,7,4,5,2
4,7,5,5,2
4,7,6,5,2
4,7,7,5,2
4,7,8,5,2
4,7,9,5,2
4,7,10,5,2
4,7,11,5,2
4,7,12,5,2
4,7,13,5,2
4,7,14,5,2
4,7,15,5,2
4,7,16,5,2
4,7,17,5,2
4,7,18,5,2
4,7,19,5,2
4,7,20,5,2
4,7,21,5,2
4,7,22,5,2
4,8,0,5,2
4,8,1,5,2
4,8,2,5,2
4,8,3,5,2
4,8,4,5,2
4,8,5,5,2
4,8,6,5,2
4,8,7,5,2
4,8,8,5,2
4,8,9,5,2
4,8,10,5,2
4,8,11,5,2
4,8,12,5,2
4,8,13,5,2
4,8,14,5,2
4,8,15,5,2
4,8,16,5,2
4,8,17,5,2
4,8,18,5,2
4,8,19,5,2
4,8,20,5,2
4,8,21,5,2
4,8,22,5,2
4,9,0,5,2
4,9,1,5,2
4,9,2,5,2
4,9,3,5,2
4,9,4,5,2
4,9,5,5,2
4,9,6,5,2
4,9,7,5,2
4,9,8,5,2
4,9,9,5,2
4,9,10,5,2
4,9,11,5,2
4,9,12,5,2
4,9,13,5,2
4,9,14,5,2
4,9,15,5,2
4,9,16,5,2
4,9,17,5,2
4,9,18,5,2
4,9,19,5,2
4,9,20,5,2
4,9,21,5,2
4,9,22,5,2
4,0,0,6,2
4,0,1,6,2
4,0,2,6,2
4,0,3,6,2
4,0,4,6,2
4,0,5,6,2
4,0,6,6,2
4,0,7,6,2
4,0,8,6,2
4,0,9,6,2
4,0,10,6,2
4,0,11,6,2
4,0,12,6,2
4,0,13,6,2
4,0,14,6,2
4,0,15,6,2
4,0,16,6,2
4,0,17,6,2
4,0,18,6,2
4,0,19,6,2
4,0,20,6,2
4,0,21,6,2
4,0,22,6,2
4,1,0,6,2
4,1,1,6,2
4,1,2,6,2
4,1,3,6,2
4,1,4,6,2
4,1,5,6,2
4,1,6,6,2
4,1,7,6,2
4,1,8,6,2
4,1,9,6,2
4,1,10,6,2
4,1,11,6,2
4,1,12,6,2
4,1,13,6,2
4,1,14,6,2
4,1,15,6,2
4,1,16,6,2
4,1,17,6,2
4,1,18,6,2
4,1,19,6,2
4,1,20,6,2
4,1,21,6,2
4,1,22,6,2
4,2,0,6,2
4,2,1,6,2
4,2,2,6,2
4,2,3,6,2
4,2,4,6,2
4,2,5,6,2
4,2,6,6,2
4,2,7,6,2
4,2,8,6,2
4,2,9,6,2
4,2,10,6,2
4,2,11,6,2
4,2,12,6,2
4,2,13,6,2
4,2,14,6,2
4,2,15,6,2
4,2,16,6,2
4,2,17,6,2
4,2,18,6,2
4,2,19,6,2
4,2,20,6,2
4,2,21,6,2
4,2,22,6,2
4,3,0,6,2
4,3,1,6,2
4,3,2,6,2
4,3,3,6,2
4,3,4,6,2
4,3,5,6,2
4,3,6,6,2
4,3,7,6,2
4,3,8,6,2
4,3,9,6,2
4,3,10,6,2
4,3,11,6,2
4,3,12,6,2
4,3,13,6,2
4,3,14,6,2
4,3,15,6,2
4,3,16,6,2
4,3,17,6,2
4,3,18,6,2
4,3,19,6,2
4,3,20,6,2
4,3,21,6,2
4,3,22,6,2
4,4,0,6,2
4,4,1,6,2
4,4,2,6,2
4,4,3,6,2
4,4,4,6,2
4,4,5,6,2
4,4,6,6,2
4,4,7,6,2
4,4,8,6,2
4,4,9,6,2
4,4,10,6,2
4,4,11,6,2
4,4,12,6,2
4,4,13,6,2
4,4,14,6,2
4,4,15,6,2
4,4,16,6,2
4,4,17,6,2
4,4,18,6,2
4,4,19,6,2
4,4,20,6,2
4,4,21,6,2
4,4,22,6,2
4,5,0,6,2
4,5,1,6,2
4,5,2,6,2
4,5,3,6,2
4,5,4,6,2
4,5,5,6,2
4,5,6,6,2
4,5,7,6,2
4,5,8,6,2
4,5,9,6,2
4,5,10,6,2
4,5,11,6,2
4,5,12,6,2
4,5,13,6,2
4,5,14,6,2
4,5,15,6,2
4,5,16,6,2
4,5,17,6,2
4,5,18,6,2
4,5,19,6,2
4,5,20,6,2
4,5,21,6,2
4,5,22,6,2
4,6,0,6,2
4,6,1,6,2
4,6,2,6,2
4,6,3,6,2
4,6,4,6,2
4,6,5,6,2
4,6,6,6,2
4,6,7,6,2
4,6,8,6,2
4,6,9,6,2
4,6,10,6,2
4,6,11,6,2
4,6,12,6,2
4,6,13,6,2
4,6,14,6,2
4,6,15,6,2
4,6,16,6,2
4,6,17,6,2
4,6,18,6,2
4,6,19,6,2
4,6,20,6,2
4,6,21,6,2
4,6,22,6,2
4,0,0,7,2
4,0,1,7,2
4,0,2,7,2
4,0,3,7,2
4,0,4,7,2
4,0,5,7,2
4,0,6,7,2
4,0,7,7,2
4,0,8,7,2
4,0,9,7,2
4,0,10,7,2
4,0,11,7,2
4,0,12,7,2
4,0,13,7,2
4,0,14,7,2
4,0,15,7,2
4,0,16,7,2
4,0,17,7,2
4,0,18,7,2
4,0,19,7,2
4,0,20,7,2
4,0,21,7,2
4,0,22,7,2
4,1,0,7,2
4,1,1,7,2
4,1,2,7,2
4,1,3,7,2
4,1,4,7,2
4,1,5,7,2
4,1,6,7,2
4,1,7,7,2
4,1,8,7,2
4,1,9,7,2
4,1,10,7,2
4,1,11,7,2
4,1,12,7,2
4,1,13,7,2
4,1,14,7,2
4,1,15,7,2
4,1,16,7,2
4,1,17,7,2
4,1,18,7,2
4,1,19,7,2
4,1,20,7,2
4,1,21,7,2
4,1,22,7,2
4,2,0,7,2
4,2,1,7,2
4,2,2,7,2
4,2,3,7,2
4,2,4,7,2
4,2,5,7,2
4,2,6,7,2
4,2,7,7,2
4,2,8,7,2
4,2,9,7,2
4,2,10,7,2
4,2,11,7,2
4,2,12,7,2
4,2,13,7,2
4,2,14,7,2
4,2,15,7,2
4,2,16,7,2
4,2,17,7,2
4,2,18,7,2
4,2,19,7,2
4,2,20,7,2
4,2,21,7,2
4,2,22,7,2
4,3,0,7,2
4,3,1,7,2
4,3,2,7,2
4,3,3,7,2
4,3,4,7,2
4,3,5,7,2
4,3,6,7,2
4,3,7,7,2
4,3,8,7,2
4,3,9,7,2
4,3,10,7,2
4,3,11,7,2
4,3,12,7,2
4,3,13,7,2
4,3,14,7,2
4,3,15,7,2
4,3,16,7,2
4,3,17,7,2
4,3,18,7,2
4,3,19,7,2
4,3,20,7,2
4,3,21,7,2
4,3,22,7,2
4,0,0,8,2
4,0,1,8,2
4,0,2,8,2
4,0,3,8,2
4,0,4,8,2
4,0,5,8,2
4,0,6,8,2
4,0,7,8,2
4,0,8,8,2
4,0,9,8,2
4,0,10,8,2
4,0,11,8,2
4,0,12,8,2
4,0,13,8,2
4,0,14,8,2
4,0,15,8,2
4,0,16,8,2
4,0,17,8,2
4,0,18,8,2
4,0,19,8,2
4,0,20,8,2
4,0,21,8,2
4,0,22,8,2
4,0,0,1,3
4,0,1,1,3
4,0,2,1,3
4,0,3,1,3
4,0,4,1,3
4,0,5,1,3
4,0,6,1,3
4,0,7,1,3
4,0,8,1,3
4,0,9,1,3
4,0,10,1,3
4,0,11,1,3
4,0,12,1,3
4,0,13,1,3
4,0,14,1,3
4,0,15,1,3
4,0,16,1,3
4,0,17,1,3
4,0,18,1,3
4,0,19,1,3
4,0,20,1,3
4,0,21,1,3
4,1,0,1,3
4,1,1,1,3
4,1,2,1,3
4,1,3,1,3
4,1,4,1,3
4,1,5,1,3
4,1,6,1,3
4,1,7,1,3
4,1,8,1,3
4,1,9,1,3
4,1,10,1,3
4,1,11,1,3
4,1,12,1,3
4,1,13,1,3
4,1,14,1,3
4,1,15,1,3
4,1,16,1,3
4,1,17,1,3
4,1,18,1,3
4,1,19,1,3
4,1,20,1,3
4,1,21,1,3
4,2,0,1,3
4,2,1,1,3
4,2,2,1,3
4,2,3,1,3
4,2,4,1,3
4,2,5,1,3
4,2,6,1,3
4,2,7,1,3
4,2,8,1,3
4,2,9,1,3
4,2,10,1,3
4,2,11,1,3
4,2,12,1,3
4,2,13,1,3
4,2,14,1,3
4,2,15,1,3
4,2,16,1,3
4,2,17,1,3
4,2,18,1,3
4,2,19,1,3
4,2,20,1,3
4,2,21,1,3
4,3,0,1,3
4,3,1,1,3
4,3,2,1,3
4,3,3,1,3
4,3,4,1,3
4,3,5,1,3
4,3,6,1,3
4,3,7,1,3
4,3,8,1,3
4,3,9,1,3
4,3,10,1,3
4,3,11,1,3
4,3,12,1,3
4,3,13,1,3
4,3,14,1,3
4,3,15,1,3
4,3,16,1,3
4,3,17,1,3
4,3,18,1,3
4,3,19,1,3
4,3,20,1,3
4,3,21,1,3
4,4,0,1,3
4,4,1,1,3
4,4,2,1,3
4,4,3,1,3
4,4,4,1,3
4,4,5,1,3
4,4,6,1,3
4,4,7,1,3
4,4,8,1,3
4,4,9,1,3
4,4,10,1,3
4,4,11,1,3
4,4,12,1,3
4,4,13,1,3
4,4,14,1,3
4,4,15,1,3
4,4,16,1,3
4,4,17,1,3
4,4,18,1,3
4,4,19,1,3
4,4,20,1,3
4,4,21,1,3
4,5,0,1,3
4,5,1,1,3
4,5,2,1,3
4,5,3,1,3
4,5,4,1,3
4,5,5,1,3
4,5,6,1,3
4,5,7,1,3
4,5,8,1,3
4,5,9,1,3
4,5,10,1,3
4,5,11,1,3
4,5,12,1,3
4,5,13,1,3
4,5,14,1,3
4,5,15,1,3
4,5,16,1,3
4,5,17,1,3
4,5,18,1,3
4,5,19,1,3
4,5,20,1,3
4,5,21,1,3
4,6,0,1,3
4,6,1,1,3
4,6,2,1,3
4,6,3,1,3
4,6,4,1,3
4,6,5,1,3
4,6,6,1,3
4,6,7,1,3
4,6,8,1,3
4,6,9,1,3
4,6,10,1,3
4,6,11,1,3
4,6,12,1,3
4,6,13,1,3
4,6,14,1,3
4,6,15,1,3
4,6,16,1,3
4,6,17,1,3
4,6,18,1,3
4,6,19,1,3
4,6,20,1,3
4,6,21,1,3
4,7,0,1,3
4,7,1,1,3
4,7,2,1,3
4,7,3,1,3
4,7,4,1,3
4,7,5,1,3
4,7,6,1,3
4,7,7,1,3
4,7,8,1,3
4,7,9,1,3
4,7,10,1,3
4,7,11,1,3
4,7,12,1,3
4,7,13,1,3
4,7,14,1,3
4,7,15,1,3
4,7,16,1,3
4,7,17,1,3
4,7,18,1,3
4,7,19,1,3
4,7,20,1,3
4,7,21,1,3
4,8,0,1,3
4,8,1,1,3
4,8,2,1,3
4,8,3,1,3
4,8,4,1,3
4,8,5,1,3
4,8,6,1,3
4,8,7,1,3
4,8,8,1,3
4,8,9,1,3
4,8,10,1,3
4,8,11,1,3
4,8,12,1,3
4,8,13,1,3
4,8,14,1,3
4,8,15,1,3
4,8,16,1,3
4,8,17,1,3
4,8,18,1,3
4,8,19,1,3
4,8,20,1,3
4,8,21,1,3
4,9,0,1,3
4,9,1,1,3
4,9,2,1,3
4,9,3,1,3
4,9,4,1,3
4,9,5,1,3
4,9,6,1,3
4,9,7,1,3
4,9,8,1,3
4,9,9,1,3
4,9,10,1,3
4,9,11,1,3
4,9,12,1,3
4,9,13,1,3
4,9,14,1,3
4,9,15,1,3
4,9,16,1,3
4,9,17,1,3
4,9,18,1,3
4,9,19,1,3
4,9,20,1,3
4,9,21,1,3
4,10,0,1,3
4,10,1,1,3
4,10,2,1,3
4,10,3,1,3
4,10,4,1,3
4,10,5,1,3
4,10,6,1,3
4,10,7,1,3
4,10,8,1,3
4,10,9,1,3
4,10,10,1,3
4,10,11,1,3
4,10,12,1,3
4,10,13,1,3
4,10,14,1,3
4,10,15,1,3
4,10,16,1,3
4,10,17,1,3
4,10,18,1,3
4,10,19,1,3
4,10,20,1,3
4,10,21,1,3
4,11,0,1,3
4,11,1,1,3
4,11,2,1,3
4,11,3,1,3
4,11,4,1,3
4,11,5,1,3
4,11,6,1,3
4,11,7,1,3
4,11,8,1,3
4,11,9,1,3
4,11,10,1,3
4,11,11,1,3
4,11,12,1,3
4,11,13,1,3
4,11,14,1,3
4,11,15,1,3
4,11,16,1,3
4,11,17,1,3
4,11,18,1,3
4,11,19,1,3
4,11,20,1,3
4,11,21,1,3
4,12,0,1,3
4,12,1,1,3
4,12,2,1,3
4,12,3,1,3
4,12,4,1,3
4,12,5,1,3
4,12,6,1,3
4,12,7,1,3
4,12,8,1,3
4,12,9,1,3
4,12,10,1,3
4,12,11,1,3
4,12,12,1,3
4,12,13,1,3
4,12,14,1,3
4,12,15,1,3
4,12,16,1,3
4,12,17,1,3
4,12,18,1,3
4,12,19,1,3
4,12,20,1,3
4,12,21,1,3
4,13,0,1,3
4,13,1,1,3
4,13,2,1,3
4,13,3,1,3
4,13,4,1,3
4,13,5,1,3
4,13,6,1,3
4,13,7,1,3
4,13,8,1,3
4,13,9,1,3
4,13,10,1,3
4,13,11,1,3
4,13,12,1,3
4,13,13,1,3
4,13,14,1,3
4,13,15,1,3
4,13,16,1,3
4,13,17,1,3
4,13,18,1,3
4,13,19,1,3
4,13,20,1,3
4,13,21,1,3
4,14,0,1,3
4,14,1,1,3
4,14,2,1,3
4,14,3,1,3
4,14,4,1,3
4,14,5,1,3
4,14,6,1,3
4,14,7,1,3
4,14,8,1,3
4,14,9,1,3
4,14,10,1,3
4,14,11,1,3
4,14,12,1,3
4,14,13,1,3
4,14,14,1,3
4,14,15,1,3
4,14,16,1,3
4,14,17,1,3
4,14,18,1,3
4,14,19,1,3
4,14,20,1,3
4,14,21,1,3
4,15,0,1,3
4,15,1,1,3
4,15,2,1,3
4,15,3,1,3
4,15,4,1,3
4,15,5,1,3
4,15,6,1,3
4,15,7,1,3
4,15,8,1,3
4,15,9,1,3
4,15,10,1,3
4,15,11,1,3
4,15,12,1,3
4,15,13,1,3
4,15,14,1,3
4,15,15,1,3
4,15,16,1,3
4,15,17,1,3
4,15,18,1,3
4,15,19,1,3
4,15,20,1,3
4,15,21,1,3
4,16,0,1,3
4,16,1,1,3
4,16,2,1,3
4,16,3,1,3
4,16,4,1,3
4,16,5,1,3
4,16,6,1,3
4,16,7,1,3
4,16,8,1,3
4,16,9,1,3
4,16,10,1,3
4,16,11,1,3
4,16,12,1,3
4,16,13,1,3
4,16,14,1,3
4,16,15,1,3
4,16,16,1,3
4,16,17,1,3
4,16,18,1,3
4,16,19,1,3
4,16,20,1,3
4,16,21,1,3
4,17,0,1,3
4,17,1,1,3
4,17,2,1,3
4,17,3,1,3
4,17,4,1,3
4,17,5,1,3
4,17,6,1,3
4,17,7,1,3
4,17,8,1,3
4,17,9,1,3
4,17,10,1,3
4,17,11,1,3
4,17,12,1,3
4,17,13,1,3
4,17,14,1,3
4,17,15,1,3
4,17,16,1,3
4,17,17,1,3
4,17,18,1,3
4,17,19,1,3
4,17,20,1,3
4,17,21,1,3
4,18,0,1,3
4,18,1,1,3
4,18,2,1,3
4,18,3,1,3
4,18,4,1,3
4,18,5,1,3
4,18,6,1,3
4,18,7,1,3
4,18,8,1,3
4,18,9,1,3
4,18,10,1,3
4,18,11,1,3
4,18,12,1,3
4,18,13,1,3
4,18,14,1,3
4,18,15,1,3
4,18,16,1,3
4,18,17,1,3
4,18,18,1,3
4,18,19,1,3
4,18,20,1,3
4,18,21,1,3
4,19,0,1,3
4,19,1,1,3
4,19,2,1,3
4,19,3,1,3
4,19,4,1,3
4,19,5,1,3
4,19,6,1,3
4,19,7,1,3
4,19,8,1,3
4,19,9,1,3
4,19,10,1,3
4,19,11,1,3
4,19,12,1,3
4,19,13,1,3
4,19,14,1,3
4,19,15,1,3
4,19,16,1,3
4,19,17,1,3
4,19,18,1,3
4,19,19,1,3
4,19,20,1,3
4,19,21,1,3
4,20,0,1,3
4,20,1,1,3
4,20,2,1,3
4,20,3,1,3
4,20,4,1,3
4,20,5,1,3
4,20,6,1,3
4,20,7,1,3
4,20,8,1,3
4,20,9,1,3
4,20,10,1,3
4,20,11,1,3
4,20,12,1,3
4,20,13,1,3
4,20,14,1,3
4,20,15,1,3
4,20,16,1,3
4,20,17,1,3
4,20,18,1,3
4,20,19,1,3
4,20,20,1,3
4,20,21,1,3
4,21,0,1,3
4,21,1,1,3
4,21,2,1,3
4,21,3,1,3
4,21,4,1,3
4,21,5,1,3
4,21,6,1,3
4,21,7,1,3
4,21,8,1,3
4,21,9,1,3
4,21,10,1,3
4,21,11,1,3
4,21,12,1,3
4,21,13,1,3
4,21,14,1,3
4,21,15,1,3
4,21,16,1,3
4,21,17,1,3
4,21,18,1,3
4,21,19,1,3
4,21,20,1,3
4,21,21,1,3
4,0,0,2,3
4,0,1,2,3
4,0,2,2,3
4,0,3,2,3
4,0,4,2,3
4,0,5,2,3
4,0,6,2,3
4,0,7,2,3
4,0,8,2,3
4,0,9,2,3
4,0,10,2,3
4,0,11,2,3
4,0,12,2,3
4,0,13,2,3
4,0,14,2,3
4,0,15,2,3
4,0,16,2,3
4,0,17,2,3
4,0,18,2,3
4,0,19,2,3
4,0,20,2,3
4,0,21,2,3
4,1,0,2,3
4,1,1,2,3
4,1,2,2,3
4,1,3,2,3
4,1,4,2,3
4,1,5,2,3
4,1,6,2,3
4,1,7,2,3
4,1,8,2,3
4,1,9,2,3
4,1,10,2,3
4,1,11,2,3
4,1,12,2,3
4,1,13,2,3
4,1,14,2,3
4,1,15,2,3
4,1,16,2,3
4,1,17,2,3
4,1,18,2,3
4,1,19,2,3
4,1,20,2,3
4,1,21,2,3
4,2,0,2,3
4,2,1,2,3
4,2,2,2,3
4,2,3,2,3
4,2,4,2,3
4,2,5,2,3
4,2,6,2,3
4,2,7,2,3
4,2,8,2,3
4,2,9,2,3
4,2,10,2,3
4,2,11,2,3
4,2,12,2,3
4,2,13,2,3
4,2,14,2,3
4,2,15,2,3
4,2,16,2,3
4,2,17,2,3
4,2,18,2,3
4,2,19,2,3
4,2,20,2,3
4,2,21,2,3
4,3,0,2,3
4,3,1,2,3
4,3,2,2,3
4,3,3,2,3
4,3,4,2,3
4,3,5,2,3
4,3,6,2,3
4,3,7,2,3
4,3,8,2,3
4,3,9,2,3
4,3,10,2,3
4,3,11,2,3
4,3,12,2,3
4,3,13,2,3
4,3,14,2,3
4,3,15,2,3
4,3,16,2,3
4,3,17,2,3
4,3,18,2,3
4,3,19,2,3
4,3,20,2,3
4,3,21,2,3
4,4,0,2,3
4,4,1,2,3
4,4,2,2,3
4,4,3,2,3
4,4,4,2,3
4,4,5,2,3
4,4,6,2,3
4,4,7,2,3
4,4,8,2,3
4,4,9,2,3
4,4,10,2,3
4,4,11,2,3
4,4,12,2,3
4,4,13,2,3
4,4,14,2,3
4,4,15,2,3
4,4,16,2,3
4,4,17,2,3
4,4,18,2,3
4,4,19,2,3
4,4,20,2,3
4,4,21,2,3
4,5,0,2,3
4,5,1,2,3
4,5,2,2,3
4,5,3,2,3
4,5,4,2,3
4,5,5,2,3
4,5,6,2,3
4,5,7,2,3
4,5,8,2,3
4,5,9,2,3
4,5,10,2,3
4,5,11,2,3
4,5,12,2,3
4,5,13,2,3
4,5,14,2,3
4,5,15,2,3
4,5,16,2,3
4,5,17,2,3
4,5,18,2,3
4,5,19,2,3
4,5,20,2,3
4,5,21,2,3
4,6,0,2,3
4,6,1,2,3
4,6,2,2,3
4,6,3,2,3
4,6,4,2,3
4,6,5,2,3
4,6,6,2,3
4,6,7,2,3
4,6,8,2,3
4,6,9,2,3
4,6,10,2,3
4,6,11,2,3
4,6,12,2,3
4,6,13,2,3
4,6,14,2,3
4,6,15,2,3
4,6,16,2,3
4,6,17,2,3
4,6,18,2,3
4,6,19,2,3
4,6,20,2,3
4,6,21,2,3
4,7,0,2,3
4,7,1,2,3
4,7,2,2,3
4,7,3,2,3
4,7,4,2,3
4,7,5,2,3
4,7,6,2,3
4,7,7,2,3
4,7,8,2,3
4,7,9,2,3
4,7,10,2,3
4,7,11,2,3
4,7,12,2,3
4,7,13,2,3
4,7,14,2,3
4,7,15,2,3
4,7,16,2,3
4,7,17,2,3
4,7,18,2,3
4,7,19,2,3
4,7,20,2,3
4,7,21,2,3
4,8,0,2,3
4,8,1,2,3
4,8,2,2,3
4,8,3,2,3
4,8,4,2,3
4,8,5,2,3
4,8,6,2,3
4,8,7,2,3
4,8,8,2,3
4,8,9,2,3
4,8,10,2,3
4,8,11,2,3
4,8,12,2,3
4,8,13,2,3
4,8,14,2,3
4,8,15,2,3
4,8,16,2,3
4,8,17,2,3
4,8,18,2,3
4,8,19,2,3
4,8,20,2,3
4,8,21,2,3
4,9,0,2,3
4,9,1,2,3
4,9,2,2,3
4,9,3,2,3
4,9,4,2,3
4,9,5,2,3
4,9,6,2,3
4,9,7,2,3
4,9,8,2,3
4,9,9,2,3
4,9,10,2,3
4,9,11,2,3
4,9,12,2,3
4,9,13,2,3
4,9,14,2,3
4,9,15,2,3
4,9,16,2,3
4,9,17,2,3
4,9,18,2,3
4,9,19,2,3
4,9,20,2,3
4,9,21,2,3
4,10,0,2,3
4,10,1,2,3
4,10,2,2,3
4,10,3,2,3
4,10,4,2,3
4,10,5,2,3
4,10,6,2,3
4,10,7,2,3
4,10,8,2,3
4,10,9,2,3
4,10,10,2,3
4,10,11,2,3
4,10,12,2,3
4,10,13,2,3
4,10,14,2,3
4,10,15,2,3
4,10,16,2,3
4,10,17,2,3
4,10,18,2,3
4,10,19,2,3
4,10,20,2,3
4,10,21,2,3
4,11,0,2,3
4,11,1,2,3
4,11,2,2,3
4,11,3,2,3
4,11,4,2,3
4,11,5,2,3
4,11,6,2,3
4,11,7,2,3
4,11,8,2,3
4,11,9,2,3
4,11,10,2,3
4,11,11,2,3
4,11,12,2,3
4,11,13,2,3
4,11,14,2,3
4,11,15,2,3
4,11,16,2,3
4,11,17,2,3
4,11,18,2,3
4,11,19,2,3
4,11,20,2,3
4,11,21,2,3
4,12,0,2,3
4,12,1,2,3
4,12,2,2,3
4,12,3,2,3
4,12,4,2,3
4,12,5,2,3
4,12,6,2,3
4,12,7,2,3
4,12,8,2,3
4,12,9,2,3
4,12,10,2,3
4,12,11,2,3
4,12,12,2,3
4,12,13,2,3
4,12,14,2,3
4,12,15,2,3
4,12,16,2,3
4,12,17,2,3
4,12,18,2,3
4,12,19,2,3
4,12,20,2,3
4,12,21,2,3
4,13,0,2,3
4,13,1,2,3
4,13,2,2,3
4,13,3,2,3
4,13,4,2,3
4,13,5,2,3
4,13,6,2,3
4,13,7,2,3
4,13,8,2,3
4,13,9,2,3
4,13,10,2,3
4,13,11,2,3
4,13,12,2,3
4,13,13,2,3
4,13,14,2,3
4,13,15,2,3
4,13,16,2,3
4,13,17,2,3
4,13,18,2,3
4,13,19,2,3
4,13,20,2,3
4,13,21,2,3
4,14,0,2,3
4,14,1,2,3
4,14,2,2,3
4,14,3,2,3
4,14,4,2,3
4,14,5,2,3
4,14,6,2,3
4,14,7,2,3
4,14,8,2,3
4,14,9,2,3
4,14,10,2,3
4,14,11,2,3
4,14,12,2,3
4,14,13,2,3
4,14,14,2,3
4,14,15,2,3
4,14,16,2,3
4,14,17,2,3
4,14,18,2,3
4,14,19,2,3
4,14,20,2,3
4,14,21,2,3
4,15,0,2,3
4,15,1,2,3
4,15,2,2,3
4,15,3,2,3
4,15,4,2,3
4,15,5,2,3
4,15,6,2,3
4,15,7,2,3
4,15,8,2,3
4,15,9,2,3
4,15,10,2,3
4,15,11,2,3
4,15,12,2,3
4,15,13,2,3
4,15,14,2,3
4,15,15,2,3
4,15,16,2,3
4,15,17,2,3
4,15,18,2,3
4,15,19,2,3
4,15,20,2,3
4,15,21,2,3
4,16,0,2,3
4,16,1,2,3
4,16,2,2,3
4,16,3,2,3
4,16,4,2,3
4,16,5,2,3
4,16,6,2,3
4,16,7,2,3
4,16,8,2,3
4,16,9,2,3
4,16,10,2,3
4,16,11,2,3
4,16,12,2,3
4,16,13,2,3
4,16,14,2,3
4,16,15,2,3
4,16,16,2,3
4,16,17,2,3
4,16,18,2,3
4,16,19,2,3
4,16,20,2,3
4,16,21,2,3
4,17,0,2,3
4,17,1,2,3
4,17,2,2,3
4,17,3,2,3
4,17,4,2,3
4,17,5,2,3
4,17,6,2,3
4,17,7,2,3
4,17,8,2,3
4,17,9,2,3
4,17,10,2,3
4,17,11,2,3
4,17,12,2,3
4,17,13,2,3
4,17,14,2,3
4,17,15,2,3
4,17,16,2,3
4,17,17,2,3
4,17,18,2,3
4,17,19,2,3
4,17,20,2,3
4,17,21,2,3
4,18,0,2,3
4,18,1,2,3
4,18,2,2,3
4,18,3,2,3
4,18,4,2,3
4,18,5,2,3
4,18,6,2,3
4,18,7,2,3
4,18,8,2,3
4,18,9,2,3
4,18,10,2,3
4,18,11,2,3
4,18,12,2,3
4,18,13,2,3
4,18,14,2,3
4,18,15,2,3
4,18,16,2,3
4,18,17,2,3
4,18,18,2,3
4,18,19,2,3
4,18,20,2,3
4,18,21,2,3
4,0,0,3,3
4,0,1,3,3
4,0,2,3,3
4,0,3,3,3
4,0,4,3,3
4,0,5,3,3
4,0,6,3,3
4,0,7,3,3
4,0,8,3,3
4,0,9,3,3
4,0,10,3,3
4,0,11,3,3
4,0,12,3,3
4,0,13,3,3
4,0,14,3,3
4,0,15,3,3
4,0,16,3,3
4,0,17,3,3
4,0,18,3,3
4,0,19,3,3
4,0,20,3,3
4,0,21,3,3
4,1,0,3,3
4,1,1,3,3
4,1,2,3,3
4,1,3,3,3
4,1,4,3,3
4,1,5,3,3
4,1,6,3,3
4,1,7,3,3
4,1,8,3,3
4,1,9,3,3
4,1,10,3,3
4,1,11,3,3
4,1,12,3,3
4,1,13,3,3
4,1,14,3,3
4,1,15,3,3
4,1,16,3,3
4,1,17,3,3
4,1,18,3,3
4,1,19,3,3
4,1,20,3,3
4,1,21,3,3
4,2,0,3,3
4,2,1,3,3
4,2,2,3,3
4,2,3,3,3
4,2,4,3,3
4,2,5,3,3
4,2,6,3,3
4,2,7,3,3
4,2,8,3,3
4,2,9,3,3
4,2,10,3,3
4,2,11,3,3
4,2,12,3,3
4,2,13,3,3
4,2,14,3,3
4,2,15,3,3
4,2,16,3,3
4,2,17,3,3
4,2,18,3,3
4,2,19,3,3
4,2,20,3,3
4,2,21,3,3
4,3,0,3,3
4,3,1,3,3
4,3,2,3,3
4,3,3,3,3
4,3,4,3,3
4,3,5,3,3
4,3,6,3,3
4,3,7,3,3
4,3,8,3,3
4,3,9,3,3
4,3,10,3,3
4,3,11,3,3
4,3,12,3,3
4,3,13,3,3
4,3,14,3,3
4,3,15,3,3
4,3,16,3,3
4,3,17,3,3
4,3,18,3,3
4,3,19,3,3
4,3,20,3,3
4,3,21,3,3
4,4,0,3,3
4,4,1,3,3
4,4,2,3,3
4,4,3,3,3
4,4,4,3,3
4,4,5,3,3
4,4,6,3,3
4,4,7,3,3
4,4,8,3,3
4,4,9,3,3
4,4,10,3,3
4,4,11,3,3
4,4,12,3,3
4,4,13,3,3
4,4,14,3,3
4,4,15,3,3
4,4,16,3,3
4,4,17,3,3
4,4,18,3,3
4,4,19,3,3
4,4,20,3,3
4,4,21,3,3
4,5,0,3,3
4,5,1,3,3
4,5,2,3,3
4,5,3,3,3
4,5,4,3,3
4,5,5,3,3
4,5,6,3,3
4,5,7,3,3
4,5,8,3,3
4,5,9,3,3
4,5,10,3,3
4,5,11,3,3
4,5,12,3,3
4,5,13,3,3
4,5,14,3,3
4,5,15,3,3
4,5,16,3,3
4,5,17,3,3
4,5,18,3,3
4,5,19,3,3
4,5,20,3,3
4,5,21,3,3
4,6,0,3,3
4,6,1,3,3
4,6,2,3,3
4,6,3,3,3
4,6,4,3,3
4,6,5,3,3
4,6,6,3,3
4,6,7,3,3
4,6,8,3,3
4,6,9,3,3
4,6,10,3,3
4,6,11,3,3
4,6,12,3,3
4,6,13,3,3
4,6,14,3,3
4,6,15,3,3
4,6,16,3,3
4,6,17,3,3
4,6,18,3,3
4,6,19,3,3
4,6,20,3,3
4,6,21,3,3
4,7,0,3,3
4,7,1,3,3
4,7,2,3,3
4,7,3,3,3
4,7,4,3,3
4,7,5,3,3
4,7,6,3,3
4,7,7,3,3
4,7,8,3,3
4,7,9,3,3
4,7,10,3,3
4,7,11,3,3
4,7,12,3,3
4,7,13,3,3
4,7,14,3,3
4,7,15,3,3
4,7,16,3,3
4,7,17,3,3
4,7,18,3,3
4,7,19,3,3
4,7,20,3,3
4,7,21,3,3
4,8,0,3,3
4,8,1,3,3
4,8,2,3,3
4,8,3,3,3
4,8,4,3,3
4,8,5,3,3
4,8,6,3,3
4,8,7,3,3
4,8,8,3,3
4,8,9,3,3
4,8,10,3,3
4,8,11,3,3
4,8,12,3,3
4,8,13,3,3
4,8,14,3,3
4,8,15,3,3
4,8,16,3,3
4,8,17,3,3
4,8,18,3,3
4,8,19,3,3
4,8,20,3,3
4,8,21,3,3
4,9,0,3,3
4,9,1,3,3
4,9,2,3,3
4,9,3,3,3
4,9,4,3,3
4,9,5,3,3
4,9,6,3,3
4,9,7,3,3
4,9,8,3,3
4,9,9,3,3
4,9,10,3,3
4,9,11,3,3
4,9,12,3,3
4,9,13,3,3
4,9,14,3,3
4,9,15,3,3
4,9,16,3,3
4,9,17,3,3
4,9,18,3,3
4,9,19,3,3
4,9,20,3,3
4,9,21,3,3
4,10,0,3,3
4,10,1,3,3
4,10,2,3,3
4,10,3,3,3
4,10,4,3,3
4,10,5,3,3
4,10,6,3,3
4,10,7,3,3
4,10,8,3,3
4,10,9,3,3
4,10,10,3,3
4,10,11,3,3
4,10,12,3,3
4,10,13,3,3
4,10,14,3,3
4,10,15,3,3
4,10,16,3,3
4,10,17,3,3
4,10,18,3,3
4,10,19,3,3
4,10,20,3,3
4,10,21,3,3
4,11,0,3,3
4,11,1,3,3
4,11,2,3,3
4,11,3,3,3
4,11,4,3,3
4,11,5,3,3
4,11,6,3,3
4,11,7,3,3
4,11,8,3,3
4,11,9,3,3
4,11,10,3,3
4,11,11,3,3
4,11,12,3,3
4,11,13,3,3
4,11,14,3,3
4,11,15,3,3
4,11,16,3,3
4,11,17,3,3
4,11,18,3,3
4,11,19,3,3
4,11,20,3,3
4,11,21,3,3
4,12,0,3,3
4,12,1,3,3
4,12,2,3,3
4,12,3,3,3
4,12,4,3,3
4,12,5,3,3
4,12,6,3,3
4,12,7,3,3
4,12,8,3,3
4,12,9,3,3
4,12,10,3,3
4,12,11,3,3
4,12,12,3,3
4,12,13,3,3
4,12,14,3,3
4,12,15,3,3
4,12,16,3,3
4,12,17,3,3
4,12,18,3,3
4,12,19,3,3
4,12,20,3,3
4,12,21,3,3
4,13,0,3,3
4,13,1,3,3
4,13,2,3,3
4,13,3,3,3
4,13,4,3,3
4,13,5,3,3
4,13,6,3,3
4,13,7,3,3
4,13,8,3,3
4,13,9,3,3
4,13,10,3,3
4,13,11,3,3
4,13,12,3,3
4,13,13,3,3
4,13,14,3,3
4,13,15,3,3
4,13,16,3,3
4,13,17,3,3
4,13,18,3,3
4,13,19,3,3
4,13,20,3,3
4,13,21,3,3
4,14,0,3,3
4,14,1,3,3
4,14,2,3,3
4,14,3,3,3
4,14,4,3,3
4,14,5,3,3
4,14,6,3,3
4,14,7,3,3
4,14,8,3,3
4,14,9,3,3
4,14,10,3,3
4,14,11,3,3
4,14,12,3,3
4,14,13,3,3
4,14,14,3,3
4,14,15,3,3
4,14,16,3,3
4,14,17,3,3
4,14,18,3,3
4,14,19,3,3
4,14,20,3,3
4,14,21,3,3
4,15,0,3,3
4,15,1,3,3
4,15,2,3,3
4,15,3,3,3
4,15,4,3,3
4,15,5,3,3
4,15,6,3,3
4,15,7,3,3
4,15,8,3,3
4,15,9,3,3
4,15,10,3,3
4,15,11,3,3
4,15,12,3,3
4,15,13,3,3
4,15,14,3,3
4,15,15,3,3
4,15,16,3,3
4,15,17,3,3
4,15,18,3,3
4,15,19,3,3
4,15,20,3,3
4,15,21,3,3
4,0,0,4,3
4,0,1,4,3
4,0,2,4,3
4,0,3,4,3
4,0,4,4,3
4,0,5,4,3
4,0,6,4,3
4,0,7,4,3
4,0,8,4,3
4,0,9,4,3
4,0,10,4,3
4,0,11,4,3
4,0,12,4,3
4,0,13,4,3
4,0,14,4,3
4,0,15,4,3
4,0,16,4,3
4,0,17,4,3
4,0,18,4,3
4,0,19,4,3
4,0,20,4,3
4,0,21,4,3
4,1,0,4,3
4,1,1,4,3
4,1,2,4,3
4,1,3,4,3
4,1,4,4,3
4,1,5,4,3
4,1,6,4,3
4,1,7,4,3
4,1,8,4,3
4,1,9,4,3
4,1,10,4,3
4,1,11,4,3
4,1,12,4,3
4,1,13,4,3
4,1,14,4,3
4,1,15,4,3
4,1,16,4,3
4,1,17,4,3
4,1,18,4,3
4,1,19,4,3
4,1,20,4,3
4,1,21,4,3
4,2,0,4,3
4,2,1,4,3
4,2,2,4,3
4,2,3,4,3
4,2,4,4,3
4,2,5,4,3
4,2,6,4,3
4,2,7,4,3
4,2,8,4,3
4,2,9,4,3
4,2,10,4,3
4,2,11,4,3
4,2,12,4,3
4,2,13,4,3
4,2,14,4,3
4,2,15,4,3
4,2,16,4,3
4,2,17,4,3
4,2,18,4,3
4,2,19,4,3
4,2,20,4,3
4,2,21,4,3
4,3,0,4,3
4,3,1,4,3
4,3,2,4,3
4,3,3,4,3
4,3,4,4,3
4,3,5,4,3
4,3,6,4,3
4,3,7,4,3
4,3,8,4,3
4,3,9,4,3
4,3,10,4,3
4,3,11,4,3
4,3,12,4,3
4,3,13,4,3
4,3,14,4,3
4,3,15,4,3
4,3,16,4,3
4,3,17,4,3
4,3,18,4,3
4,3,19,4,3
4,3,20,4,3
4,3,21,4,3
4,4,0,4,3
4,4,1,4,3
4,4,2,4,3
4,4,3,4,3
4,4,4,4,3
4,4,5,4,3
4,4,6,4,3
4,4,7,4,3
4,4,8,4,3
4,4,9,4,3
4,4,10,4,3
4,4,11,4,3
4,4,12,4,3
4,4,13,4,3
4,4,14,4,3
4,4,15,4,3
4,4,16,4,3
4,4,17,4,3
4,4,18,4,3
4,4,19,4,3
4,4,20,4,3
4,4,21,4,3
4,5,0,4,3
4,5,1,4,3
4,5,2,4,3
4,5,3,4,3
4,5,4,4,3
4,5,5,4,3
4,5,6,4,3
4,5,7,4,3
4,5,8,4,3
4,5,9,4,3
4,5,10,4,3
4,5,11,4,3
4,5,12,4,3
4,5,13,4,3
4,5,14,4,3
4,5,15,4,3
4,5,16,4,3
4,5,17,4,3
4,5,18,4,3
4,5,19,4,3
4,5,20,4,3
4,5,21,4,3
4,6,0,4,3
4,6,1,4,3
4,6,2,4,3
4,6,3,4,3
4,6,4,4,3
4,6,5,4,3
4,6,6,4,3
4,6,7,4,3
4,6,8,4,3
4,6,9,4,3
4,6,10,4,3
4,6,11,4,3
4,6,12,4,3
4,6,13,4,3
4,6,14,4,3
4,6,15,4,3
4,6,16,4,3
4,6,17,4,3
4,6,18,4,3
4,6,19,4,3
4,6,20,4,3
4,6,21,4,3
4,7,0,4,3
4,7,1,4,3
4,7,2,4,3
4,7,3,4,3
4,7,4,4,3
4,7,5,4,3
4,7,6,4,3
4,7,7,4,3
4,7,8,4,3
4,7,9,4,3
4,7,10,4,3
4,7,11,4,3
4,7,12,4,3
4,7,13,4,3
4,7,14,4,3
4,7,15,4,3
4,7,16,4,3
4,7,17,4,3
4,7,18,4,3
4,7,19,4,3
4,7,20,4,3
4,7,21,4,3
4,8,0,4,3
4,8,1,4,3
4,8,2,4,3
4,8,3,4,3
4,8,4,4,3
4,8,5,4,3
4,8,6,4,3
4,8,7,4,3
4,8,8,4,3
4,8,9,4,3
4,8,10,4,3
4,8,11,4,3
4,8,12,4,3
4,8,13,4,3
4,8,14,4,3
4,8,15,4,3
4,8,16,4,3
4,8,17,4,3
4,8,18,4,3
4,8,19,4,3
4,8,20,4,3
4,8,21,4,3
4,9,0,4,3
4,9,1,4,3
4,9,2,4,3
4,9,3,4,3
4,9,4,4,3
4,9,5,4,3
4,9,6,4,3
4,9,7,4,3
4,9,8,4,3
4,9,9,4,3
4,9,10,4,3
4,9,11,4,3
4,9,12,4,3
4,9,13,4,3
4,9,14,4,3
4,9,15,4,3
4,9,16,4,3
4,9,17,4,3
4,9,18,4,3
4,9,19,4,3
4,9,20,4,3
4,9,21,4,3
4,10,0,4,3
4,10,1,4,3
4,10,2,4,3
4,10,3,4,3
4,10,4,4,3
4,10,5,4,3
4,10,6,4,3
4,10,7,4,3
4,10,8,4,3
4,10,9,4,3
4,10,10,4,3
4,10,11,4,3
4,10,12,4,3
4,10,13,4,3
4,10,14,4,3
4,10,15,4,3
4,10,16,4,3
4,10,17,4,3
4,10,18,4,3
4,10,19,4,3
4,10,20,4,3
4,10,21,4,3
4,11,0,4,3
4,11,1,4,3
4,11,2,4,3
4,11,3,4,3
4,11,4,4,3
4,11,5,4,3
4,11,6,4,3
4,11,7,4,3
4,11,8,4,3
4,11,9,4,3
4,11,10,4,3
4,11,11,4,3
4,11,12,4,3
4,11,13,4,3
4,11,14,4,3
4,11,15,4,3
4,11,16,4,3
4,11,17,4,3
4,11,18,4,3
4,11,19,4,3
4,11,20,4,3
4,11,21,4,3
4,12,0,4,3
4,12,1,4,3
4,12,2,4,3
4,12,3,4,3
4,12,4,4,3
4,12,5,4,3
4,12,6,4,3
4,12,7,4,3
4,12,8,4,3
4,12,9,4,3
4,12,10,4,3
4,12,11,4,3
4,12,12,4,3
4,12,13,4,3
4,12,14,4,3
4,12,15,4,3
4,12,16,4,3
4,12,17,4,3
4,12,18,4,3
4,12,19,4,3
4,12,20,4,3
4,12,21,4,3
4,0,0,5,3
4,0,1,5,3
4,0,2,5,3
4,0,3,5,3
4,0,4,5,3
4,0,5,5,3
4,0,6,5,3
4,0,7,5,3
4,0,8,5,3
4,0,9,5,3
4,0,10,5,3
4,0,11,5,3
4,0,12,5,3
4,0,13,5,3
4,0,14,5,3
4,0,15,5,3
4,0,16,5,3
4,0,17,5,3
4,0,18,5,3
4,0,19,5,3
4,0,20,5,3
4,0,21,5,3
4,1,0,5,3
4,1,1,5,3
4,1,2,5,3
4,1,3,5,3
4,1,4,5,3
4,1,5,5,3
4,1,6,5,3
4,1,7,5,3
4,1,8,5,3
4,1,9,5,3
4,1,10,5,3
4,1,11,5,3
4,1,12,5,3
4,1,13,5,3
4,1,14,5,3
4,1,15,5,3
4,1,16,5,3
4,1,17,5,3
4,1,18,5,3
4,1,19,5,3
4,1,20,5,3
4,1,21,5,3
4,2,0,5,3
4,2,1,5,3
4,2,2,5,3
4,2,3,5,3
4,2,4,5,3
4,2,5,5,3
4,2,6,5,3
4,2,7,5,3
4,2,8,5,3
4,2,9,5,3
4,2,10,5,3
4,2,11,5,3
4,2,12,5,3
4,2,13,5,3
4,2,14,5,3
4,2,15,5,3
4,2,16,5,3
4,2,17,5,3
4,2,18,5,3
4,2,19,5,3
4,2,20,5,3
4,2,21,5,3
4,3,0,5,3
4,3,1,5,3
4,3,2,5,3
4,3,3,5,3
4,3,4,5,3
4,3,5,5,3
4,3,6,5,3
4,3,7,5,3
4,3,8,5,3
4,3,9,5,3
4,3,10,5,3
4,3,11,5,3
4,3,12,5,3
4,3,13,5,3
4,3,14,5,3
4,3,15,5,3
4,3,16,5,3
4,3,17,5,3
4,3,18,5,3
4,3,19,5,3
4,3,20,5,3
4,3,21,5,3
4,4,0,5,3
4,4,1,5,3
4,4,2,5,3
4,4,3,5,3
4,4,4,5,3
4,4,5,5,3
4,4,6,5,3
4,4,7,5,3
4,4,8,5,3
4,4,9,5,3
4,4,10,5,3
4,4,11,5,3
4,4,12,5,3
4,4,13,5,3
4,4,14,5,3
4,4,15,5,3
4,4,16,5,3
4,4,17,5,3
4,4,18,5,3
4,4,19,5,3
4,4,20,5,3
4,4,21,5,3
4,5,0,5,3
4,5,1,5,3
4,5,2,5,3
4,5,3,5,3
4,5,4,5,3
4,5,5,5,3
4,5,6,5,3
4,5,7,5,3
4,5,8,5,3
4,5,9,5,3
4,5,10,5,3
4,5,11,5,3
4,5,12,5,3
4,5,13,5,3
4,5,14,5,3
4,5,15,5,3
4,5,16,5,3
4,5,17,5,3
4,5,18,5,3
4,5,19,5,3
4,5,20,5,3
4,5,21,5,3
4,6,0,5,3
4,6,1,5,3
4,6,2,5,3
4,6,3,5,3
4,6,4,5,3
4,6,5,5,3
4,6,6,5,3
4,6,7,5,3
4,6,8,5,3
4,6,9,5,3
4,6,10,5,3
4,6,11,5,3
4,6,12,5,3
4,6,13,5,3
4,6,14,5,3
4,6,15,5,3
4,6,16,5,3
4,6,17,5,3
4,6,18,5,3
4,6,19,5,3
4,6,20,5,3
4,6,21,5,3
4,7,0,5,3
4,7,1,5,3
4,7,2,5,3
4,7,3,5,3
4,7,4,5,3
4,7,5,5,3
4,7,6,5,3
4,7,7,5,3
4,7,8,5,3
4,7,9,5,3
4,7,10,5,3
4,7,11,5,3
4,7,12,5,3
4,7,13,5,3
4,7,14,5,3
4,7,15,5,3
4,7,16,5,3
4,7,17,5,3
4,7,18,5,3
4,7,19,5,3
4,7,20,5,3
4,7,21,5,3
4,8,0,5,3
4,8,1,5,3
4,8,2,5,3
4,8,3,5,3
4,8,4,5,3
4,8,5,5,3
4,8,6,5,3
4,8,7,5,3
4,8,8,5,3
4,8,9,5,3
4,8,10,5,3
4,8,11,5,3
4,8,12,5,3
4,8,13,5,3
4,8,14,5,3
4,8,15,5,3
4,8,16,5,3
4,8,17,5,3
4,8,18,5,3
4,8,19,5,3
4,8,20,5,3
4,8,21,5,3
4,9,0,5,3
4,9,1,5,3
4,9,2,5,3
4,9,3,5,3
4,9,4,5,3
4,9,5,5,3
4,9,6,5,3
4,9,7,5,3
4,9,8,5,3
4,9,9,5,3
4,9,10,5,3
4,9,11,5,3
4,9,12,5,3
4,9,13,5,3
4,9,14,5,3
4,9,15,5,3
4,9,16,5,3
4,9,17,5,3
4,9,18,5,3
4,9,19,5,3
4,9,20,5,3
4,9,21,5,3
4,0,0,6,3
4,0,1,6,3
4,0,2,6,3
4,0,3,6,3
4,0,4,6,3
4,0,5,6,3
4,0,6,6,3
4,0,7,6,3
4,0,8,6,3
4,0,9,6,3
4,0,10,6,3
4,0,11,6,3
4,0,12,6,3
4,0,13,6,3
4,0,14,6,3
4,0,15,6,3
4,0,16,6,3
4,0,17,6,3
4,0,18,6,3
4,0,19,6,3
4,0,20,6,3
4,0,21,6,3
4,1,0,6,3
4,1,1,6,3
4,1,2,6,3
4,1,3,6,3
4,1,4,6,3
4,1,5,6,3
4,1,6,6,3
4,1,7,6,3
4,1,8,6,3
4,1,9,6,3
4,1,10,6,3
4,1,11,6,3
4,1,12,6,3
4,1,13,6,3
4,1,14,6,3
4,1,15,6,3
4,1,16,6,3
4,1,17,6,3
4,1,18,6,3
4,1,19,6,3
4,1,20,6,3
4,1,21,6,3
4,2,0,6,3
4,2,1,6,3
4,2,2,6,3
4,2,3,6,3
4,2,4,6,3
4,2,5,6,3
4,2,6,6,3
4,2,7,6,3
4,2,8,6,3
4,2,9,6,3
4,2,10,6,3
4,2,11,6,3
4,2,12,6,3
4,2,13,6,3
4,2,14,6,3
4,2,15,6,3
4,2,16,6,3
4,2,17,6,3
4,2,18,6,3
4,2,19,6,3
4,2,20,6,3
4,2,21,6,3
4,3,0,6,3
4,3,1,6,3
4,3,2,6,3
4,3,3,6,3
4,3,4,6,3
4,3,5,6,3
4,3,6,6,3
4,3,7,6,3
4,3,8,6,3
4,3,9,6,3
4,3,10,6,3
4,3,11,6,3
4,3,12,6,3
4,3,13,6,3
4,3,14,6,3
4,3,15,6,3
4,3,16,6,3
4,3,17,6,3
4,3,18,6,3
4,3,19,6,3
4,3,20,6,3
4,3,21,6,3
4,4,0,6,3
4,4,1,6,3
4,4,2,6,3
4,4,3,6,3
4,4,4,6,3
4,4,5,6,3
4,4,6,6,3
4,4,7,6,3
4,4,8,6,3
4,4,9,6,3
4,4,10,6,3
4,4,11,6,3
4,4,12,6,3
4,4,13,6,3
4,4,14,6,3
4,4,15,6,3
4,4,16,6,3
4,4,17,6,3
4,4,18,6,3
4,4,19,6,3
4,4,20,6,3
4,4,21,6,3
4,5,0,6,3
4,5,1,6,3
4,5,2,6,3
4,5,3,6,3
4,5,4,6,3
4,5,5,6,3
4,5,6,6,3
4,5,7,6,3
4,5,8,6,3
4,5,9,6,3
4,5,10,6,3
4,5,11,6,3
4,5,12,6,3
4,5,13,6,3
4,5,14,6,3
4,5,15,6,3
4,5,16,6,3
4,5,17,6,3
4,5,18,6,3
4,5,19,6,3
4,5,20,6,3
4,5,21,6,3
4,6,0,6,3
4,6,1,6,3
4,6,2,6,3
4,6,3,6,3
4,6,4,6,3
4,6,5,6,3
4,6,6,6,3
4,6,7,6,3
4,6,8,6,3
4,6,9,6,3
4,6,10,6,3
4,6,11,6,3
4,6,12,6,3
4,6,13,6,3
4,6,14,6,3
4,6,15,6,3
4,6,16,6,3
4,6,17,6,3
4,6,18,6,3
4,6,19,6,3
4,6,20,6,3
4,6,21,6,3
4,0,0,7,3
4,0,1,7,3
4,0,2,7,3
4,0,3,7,3
4,0,4,7,3
4,0,5,7,3
4,0,6,7,3
4,0,7,7,3
4,0,8,7,3
4,0,9,7,3
4,0,10,7,3
4,0,11,7,3
4,0,12,7,3
4,0,13,7,3
4,0,14,7,3
4,0,15,7,3
4,0,16,7,3
4,0,17,7,3
4,0,18,7,3
4,0,19,7,3
4,0,20,7,3
4,0,21,7,3
4,1,0,7,3
4,1,1,7,3
4,1,2,7,3
4,1,3,7,3
4,1,4,7,3
4,1,5,7,3
4,1,6,7,3
4,1,7,7,3
4,1,8,7,3
4,1,9,7,3
4,1,10,7,3
4,1,11,7,3
4,1,12,7,3
4,1,13,7,3
4,1,14,7,3
4,1,15,7,3
4,1,16,7,3
4,1,17,7,3
4,1,18,7,3
4,1,19,7,3
4,1,20,7,3
4,1,21,7,3
4,2,0,7,3
4,2,1,7,3
4,2,2,7,3
4,2,3,7,3
4,2,4,7,3
4,2,5,7,3
4,2,6,7,3
4,2,7,7,3
4,2,8,7,3
4,2,9,7,3
4,2,10,7,3
4,2,11,7,3
4,2,12,7,3
4,2,13,7,3
4,2,14,7,3
4,2,15,7,3
4,2,16,7,3
4,2,17,7,3
4,2,18,7,3
4,2,19,7,3
4,2,20,7,3
4,2,21,7,3
4,3,0,7,3
4,3,1,7,3
4,3,2,7,3
4,3,3,7,3
4,3,4,7,3
4,3,5,7,3
4,3,6,7,3
4,3,7,7,3
4,3,8,7,3
4,3,9,7,3
4,3,10,7,3
4,3,11,7,3
4,3,12,7,3
4,3,13,7,3
4,3,14,7,3
4,3,15,7,3
4,3,16,7,3
4,3,17,7,3
4,3,18,7,3
4,3,19,7,3
4,3,20,7,3
4,3,21,7,3
4,0,0,8,3
4,0,1,8,3
4,0,2,8,3
4,0,3,8,3
4,0,4,8,3
4,0,5,8,3
4,0,6,8,3
4,0,7,8,3
4,0,8,8,3
4,0,9,8,3
4,0,10,8,3
4,0,11,8,3
4,0,12,8,3
4,0,13,8,3
4,0,14,8,3
4,0,15,8,3
4,0,16,8,3
4,0,17,8,3
4,0,18,8,3
4,0,19,8,3
4,0,20,8,3
4,0,21,8,3
4,0,0,1,4
4,0,1,1,4
4,0,2,1,4
4,0,3,1,4
4,0,4,1,4
4,0,5,1,4
4,0,6,1,4
4,0,7,1,4
4,0,8,1,4
4,0,9,1,4
4,0,10,1,4
4,0,11,1,4
4,0,12,1,4
4,0,13,1,4
4,0,14,1,4
4,0,15,1,4
4,0,16,1,4
4,0,17,1,4
4,0,18,1,4
4,0,19,1,4
4,0,20,1,4
4,1,0,1,4
4,1,1,1,4
4,1,2,1,4
4,1,3,1,4
4,1,4,1,4
4,1,5,1,4
4,1,6,1,4
4,1,7,1,4
4,1,8,1,4
4,1,9,1,4
4,1,10,1,4
4,1,11,1,4
4,1,12,1,4
4,1,13,1,4
4,1,14,1,4
4,1,15,1,4
4,1,16,1,4
4,1,17,1,4
4,1,18,1,4
4,1,19,1,4
4,1,20,1,4
4,2,0,1,4
4,2,1,1,4
4,2,2,1,4
4,2,3,1,4
4,2,4,1,4
4,2,5,1,4
4,2,6,1,4
4,2,7,1,4
4,2,8,1,4
4,2,9,1,4
4,2,10,1,4
4,2,11,1,4
4,2,12,1,4
4,2,13,1,4
4,2,14,1,4
4,2,15,1,4
4,2,16,1,4
4,2,17,1,4
4,2,18,1,4
4,2,19,1,4
4,2,20,1,4
4,3,0,1,4
4,3,1,1,4
4,3,2,1,4
4,3,3,1,4
4,3,4,1,4
4,3,5,1,4
4,3,6,1,4
4,3,7,1,4
4,3,8,1,4
4,3,9,1,4
4,3,10,1,4
4,3,11,1,4
4,3,12,1,4
4,3,13,1,4
4,3,14,1,4
4,3,15,1,4
4,3,16,1,4
4,3,17,1,4
4,3,18,1,4
4,3,19,1,4
4,3,20,1,4
4,4,0,1,4
4,4,1,1,4
4,4,2,1,4
4,4,3,1,4
4,4,4,1,4
4,4,5,1,4
4,4,6,1,4
4,4,7,1,4
4,4,8,1,4
4,4,9,1,4
4,4,10,1,4
4,4,11,1,4
4,4,12,1,4
4,4,13,1,4
4,4,14,1,4
4,4,15,1,4
4,4,16,1,4
4,4,17,1,4
4,4,18,1,4
4,4,19,1,4
4,4,20,1,4
4,5,0,1,4
4,5,1,1,4
4,5,2,1,4
4,5,3,1,4
4,5,4,1,4
4,5,5,1,4
4,5,6,1,4
4,5,7,1,4
4,5,8,1,4
4,5,9,1,4
4,5,10,1,4
4,5,11,1,4
4,5,12,1,4
4,5,13,1,4
4,5,14,1,4
4,5,15,1,4
4,5,16,1,4
4,5,17,1,4
4,5,18,1,4
4,5,19,1,4
4,5,20,1,4
4,6,0,1,4
4,6,1,1,4
4,6,2,1,4
4,6,3,1,4
4,6,4,1,4
4,6,5,1,4
4,6,6,1,4
4,6,7,1,4
4,6,8,1,4
4,6,9,1,4
4,6,10,1,4
4,6,11,1,4
4,6,12,1,4
4,6,13,1,4
4,6,14,1,4
4,6,15,1,4
4,6,16,1,4
4,6,17,1,4
4,6,18,1,4
4,6,19,1,4
4,6,20,1,4
4,7,0,1,4
4,7,1,1,4
4,7,2,1,4
4,7,3,1,4
4,7,4,1,4
4,7,5,1,4
4,7,6,1,4
4,7,7,1,4
4,7,8,1,4
4,7,9,1,4
4,7,10,1,4
4,7,11,1,4
4,7,12,1,4
4,7,13,1,4
4,7,14,1,4
4,7,15,1,4
4,7,16,1,4
4,7,17,1,4
4,7,18,1,4
4,7,19,1,4
4,7,20,1,4
4,8,0,1,4
4,8,1,1,4
4,8,2,1,4
4,8,3,1,4
4,8,4,1,4
4,8,5,1,4
4,8,6,1,4
4,8,7,1,4
4,8,8,1,4
4,8,9,1,4
4,8,10,1,4
4,8,11,1,4
4,8,12,1,4
4,8,13,1,4
4,8,14,1,4
4,8,15,1,4
4,8,16,1,4
4,8,17,1,4
4,8,18,1,4
4,8,19,1,4
4,8,20,1,4
4,9,0,1,4
4,9,1,1,4
4,9,2,1,4
4,9,3,1,4
4,9,4,1,4
4,9,5,1,4
4,9,6,1,4
4,9,7,1,4
4,9,8,1,4
4,9,9,1,4
4,9,10,1,4
4,9,11,1,4
4,9,12,1,4
4,9,13,1,4
4,9,14,1,4
4,9,15,1,4
4,9,16,1,4
4,9,17,1,4
4,9,18,1,4
4,9,19,1,4
4,9,20,1,4
4,10,0,1,4
4,10,1,1,4
4,10,2,1,4
4,10,3,1,4
4,10,4,1,4
4,10,5,1,4
4,10,6,1,4
4,10,7,1,4
4,10,8,1,4
4,10,9,1,4
4,10,10,1,4
4,10,11,1,4
4,10,12,1,4
4,10,13,1,4
4,10,14,1,4
4,10,15,1,4
4,10,16,1,4
4,10,17,1,4
4,10,18,1,4
4,10,19,1,4
4,10,20,1,4
4,11,0,1,4
4,11,1,1,4
4,11,2,1,4
4,11,3,1,4
4,11,4,1,4
4,11,5,1,4
4,11,6,1,4
4,11,7,1,4
4,11,8,1,4
4,11,9,1,4
4,11,10,1,4
4,11,11,1,4
4,11,12,1,4
4,11,13,1,4
4,11,14,1,4
4,11,15,1,4
4,11,16,1,4
4,11,17,1,4
4,11,18,1,4
4,11,19,1,4
4,11,20,1,4
4,12,0,1,4
4,12,1,1,4
4,12,2,1,4
4,12,3,1,4
4,12,4,1,4
4,12,5,1,4
4,12,6,1,4
4,12,7,1,4
4,12,8,1,4
4,12,9,1,4
4,12,10,1,4
4,12,11,1,4
4,12,12,1,4
4,12,13,1,4
4,12,14,1,4
4,12,15,1,4
4,12,16,1,4
4,12,17,1,4
4,12,18,1,4
4,12,19,1,4
4,12,20,1,4
4,13,0,1,4
4,13,1,1,4
4,13,2,1,4
4,13,3,1,4
4,13,4,1,4
4,13,5,1,4
4,13,6,1,4
4,13,7,1,4
4,13,8,1,4
4,13,9,1,4
4,13,10,1,4
4,13,11,1,4
4,13,12,1,4
4,13,13,1,4
4,13,14,1,4
4,13,15,1,4
4,13,16,1,4
4,13,17,1,4
4,13,18,1,4
4,13,19,1,4
4,13,20,1,4
4,14,0,1,4
4,14,1,1,4
4,14,2,1,4
4,14,3,1,4
4,14,4,1,4
4,14,5,1,4
4,14,6,1,4
4,14,7,1,4
4,14,8,1,4
4,14,9,1,4
4,14,10,1,4
4,14,11,1,4
4,14,12,1,4
4,14,13,1,4
4,14,14,1,4
4,14,15,1,4
4,14,16,1,4
4,14,17,1,4
4,14,18,1,4
4,14,19,1,4
4,14,20,1,4
4,15,0,1,4
4,15,1,1,4
4,15,2,1,4
4,15,3,1,4
4,15,4,1,4
4,15,5,1,4
4,15,6,1,4
4,15,7,1,4
4,15,8,1,4
4,15,9,1,4
4,15,10,1,4
4,15,11,1,4
4,15,12,1,4
4,15,13,1,4
4,15,14,1,4
4,15,15,1,4
4,15,16,1,4
4,15,17,1,4
4,15,18,1,4
4,15,19,1,4
4,15,20,1,4
4,16,0,1,4
4,16,1,1,4
4,16,2,1,4
4,16,3,1,4
4,16,4,1,4
4,16,5,1,4
4,16,6,1,4
4,16,7,1,4
4,16,8,1,4
4,16,9,1,4
4,16,10,1,4
4,16,11,1,4
4,16,12,1,4
4,16,13,1,4
4,16,14,1,4
4,16,15,1,4
4,16,16,1,4
4,16,17,1,4
4,16,18,1,4
4,16,19,1,4
4,16,20,1,4
4,17,0,1,4
4,17,1,1,4
4,17,2,1,4
4,17,3,1,4
4,17,4,1,4
4,17,5,1,4
4,17,6,1,4
4,17,7,1,4
4,17,8,1,4
4,17,9,1,4
4,17,10,1,4
4,17,11,1,4
4,17,12,1,4
4,17,13,1,4
4,17,14,1,4
4,17,15,1,4
4,17,16,1,4
4,17,17,1,4
4,17,18,1,4
4,17,19,1,4
4,17,20,1,4
4,18,0,1,4
4,18,1,1,4
4,18,2,1,4
4,18,3,1,4
4,18,4,1,4
4,18,5,1,4
4,18,6,1,4
4,18,7,1,4
4,18,8,1,4
4,18,9,1,4
4,18,10,1,4
4,18,11,1,4
4,18,12,1,4
4,18,13,1,4
4,18,14,1,4
4,18,15,1,4
4,18,16,1,4
4,18,17,1,4
4,18,18,1,4
4,18,19,1,4
4,18,20,1,4
4,19,0,1,4
4,19,1,1,4
4,19,2,1,4
4,19,3,1,4
4,19,4,1,4
4,19,5,1,4
4,19,6,1,4
4,19,7,1,4
4,19,8,1,4
4,19,9,1,4
4,19,10,1,4
4,19,11,1,4
4,19,12,1,4
4,19,13,1,4
4,19,14,1,4
4,19,15,1,4
4,19,16,1,4
4,19,17,1,4
4,19,18,1,4
4,19,19,1,4
4,19,20,1,4
4,20,0,1,4
4,20,1,1,4
4,20,2,1,4
4,20,3,1,4
4,20,4,1,4
4,20,5,1,4
4,20,6,1,4
4,20,7,1,4
4,20,8,1,4
4,20,9,1,4
4,20,10,1,4
4,20,11,1,4
4,20,12,1,4
4,20,13,1,4
4,20,14,1,4
4,20,15,1,4
4,20,16,1,4
4,20,17,1,4
4,20,18,1,4
4,20,19,1,4
4,20,20,1,4
4,21,0,1,4
4,21,1,1,4
4,21,2,1,4
4,21,3,1,4
4,21,4,1,4
4,21,5,1,4
4,21,6,1,4
4,21,7,1,4
4,21,8,1,4
4,21,9,1,4
4,21,10,1,4
4,21,11,1,4
4,21,12,1,4
4,21,13,1,4
4,21,14,1,4
4,21,15,1,4
4,21,16,1,4
4,21,17,1,4
4,21,18,1,4
4,21,19,1,4
4,21,20,1,4
4,0,0,2,4
4,0,1,2,4
4,0,2,2,4
4,0,3,2,4
4,0,4,2,4
4,0,5,2,4
4,0,6,2,4
4,0,7,2,4
4,0,8,2,4
4,0,9,2,4
4,0,10,2,4
4,0,11,2,4
4,0,12,2,4
4,0,13,2,4
4,0,14,2,4
4,0,15,2,4
4,0,16,2,4
4,0,17,2,4
4,0,18,2,4
4,0,19,2,4
4,0,20,2,4
4,1,0,2,4
4,1,1,2,4
4,1,2,2,4
4,1,3,2,4
4,1,4,2,4
4,1,5,2,4
4,1,6,2,4
4,1,7,2,4
4,1,8,2,4
4,1,9,2,4
4,1,10,2,4
4,1,11,2,4
4,1,12,2,4
4,1,13,2,4
4,1,14,2,4
4,1,15,2,4
4,1,16,2,4
4,1,17,2,4
4,1,18,2,4
4,1,19,2,4
4,1,20,2,4
4,2,0,2,4
4,2,1,2,4
4,2,2,2,4
4,2,3,2,4
4,2,4,2,4
4,2,5,2,4
4,2,6,2,4
4,2,7,2,4
4,2,8,2,4
4,2,9,2,4
4,2,10,2,4
4,2,11,2,4
4,2,12,2,4
4,2,13,2,4
4,2,14,2,4
4,2,15,2,4
4,2,16,2,4
4,2,17,2,4
4,2,18,2,4
4,2,19,2,4
4,2,20,2,4
4,3,0,2,4
4,3,1,2,4
4,3,2,2,4
4,3,3,2,4
4,3,4,2,4
4,3,5,2,4
4,3,6,2,4
4,3,7,2,4
4,3,8,2,4
4,3,9,2,4
4,3,10,2,4
4,3,11,2,4
4,3,12,2,4
4,3,13,2,4
4,3,14,2,4
4,3,15,2,4
4,3,16,2,4
4,3,17,2,4
4,3,18,2,4
4,3,19,2,4
4,3,20,2,4
4,4,0,2,4
4,4,1,2,4
4,4,2,2,4
4,4,3,2,4
4,4,4,2,4
4,4,5,2,4
4,4,6,2,4
4,4,7,2,4
4,4,8,2,4
4,4,9,2,4
4,4,10,2,4
4,4,11,2,4
4,4,12,2,4
4,4,13,2,4
4,4,14,2,4
4,4,15,2,4
4,4,16,2,4
4,4,17,2,4
4,4,18,2,4
4,4,19,2,4
4,4,20,2,4
4,5,0,2,4
4,5,1,2,4
4,5,2,2,4
4,5,3,2,4
4,5,4,2,4
4,5,5,2,4
4,5,6,2,4
4,5,7,2,4
4,5,8,2,4
4,5,9,2,4
4,5,10,2,4
4,5,11,2,4
4,5,12,2,4
4,5,13,2,4
4,5,14,2,4
4,5,15,2,4
4,5,16,2,4
4,5,17,2,4
4,5,18,2,4
4,5,19,2,4
4,5,20,2,4
4,6,0,2,4
4,6,1,2,4
4,6,2,2,4
4,6,3,2,4
4,6,4,2,4
4,6,5,2,4
4,6,6,2,4
4,6,7,2,4
4,6,8,2,4
4,6,9,2,4
4,6,10,2,4
4,6,11,2,4
4,6,12,2,4
4,6,13,2,4
4,6,14,2,4
4,6,15,2,4
4,6,16,2,4
4,6,17,2,4
4,6,18,2,4
4,6,19,2,4
4,6,20,2,4
4,7,0,2,4
4,7,1,2,4
4,7,2,2,4
4,7,3,2,4
4,7,4,2,4
4,7,5,2,4
4,7,6,2,4
4,7,7,2,4
4,7,8,2,4
4,7,9,2,4
4,7,10,2,4
4,7,11,2,4
4,7,12,2,4
4,7,13,2,4
4,7,14,2,4
4,7,15,2,4
4,7,16,2,4
4,7,17,2,4
4,7,18,2,4
4,7,19,2,4
4,7,20,2,4
4,8,0,2,4
4,8,1,2,4
4,8,2,2,4
4,8,3,2,4
4,8,4,2,4
4,8,5,2,4
4,8,6,2,4
4,8,7,2,4
4,8,8,2,4
4,8,9,2,4
4,8,10,2,4
4,8,11,2,4
4,8,12,2,4
4,8,13,2,4
4,8,14,2,4
4,8,15,2,4
4,8,16,2,4
4,8,17,2,4
4,8,18,2,4
4,8,19,2,4
4,8,20,2,4
4,9,0,2,4
4,9,1,2,4
4,9,2,2,4
4,9,3,2,4
4,9,4,2,4
4,9,5,2,4
4,9,6,2,4
4,9,7,2,4
4,9,8,2,4
4,9,9,2,4
4,9,10,2,4
4,9,11,2,4
4,9,12,2,4
4,9,13,2,4
4,9,14,2,4
4,9,15,2,4
4,9,16,2,4
4,9,17,2,4
4,9,18,2,4
4,9,19,2,4
4,9,20,2,4
4,10,0,2,4
4,10,1,2,4
4,10,2,2,4
4,10,3,2,4
4,10,4,2,4
4,10,5,2,4
4,10,6,2,4
4,10,7,2,4
4,10,8,2,4
4,10,9,2,4
4,10,10,2,4
4,10,11,2,4
4,10,12,2,4
4,10,13,2,4
4,10,14,2,4
4,10,15,2,4
4,10,16,2,4
4,10,17,2,4
4,10,18,2,4
4,10,19,2,4
4,10,20,2,4
4,11,0,2,4
4,11,1,2,4
4,11,2,2,4
4,11,3,2,4
4,11,4,2,4
4,11,5,2,4
4,11,6,2,4
4,11,7,2,4
4,11,8,2,4
4,11,9,2,4
4,11,10,2,4
4,11,11,2,4
4,11,12,2,4
4,11,13,2,4
4,11,14,2,4
4,11,15,2,4
4,11,16,2,4
4,11,17,2,4
4,11,18,2,4
4,11,19,2,4
4,11,20,2,4
4,12,0,2,4
4,12,1,2,4
4,12,2,2,4
4,12,3,2,4
4,12,4,2,4
4,12,5,2,4
4,12,6,2,4
4,12,7,2,4
4,12,8,2,4
4,12,9,2,4
4,12,10,2,4
4,12,11,2,4
4,12,12,2,4
4,12,13,2,4
4,12,14,2,4
4,12,15,2,4
4,12,16,2,4
4,12,17,2,4
4,12,18,2,4
4,12,19,2,4
4,12,20,2,4
4,13,0,2,4
4,13,1,2,4
4,13,2,2,4
4,13,3,2,4
4,13,4,2,4
4,13,5,2,4
4,13,6,2,4
4,13,7,2,4
4,13,8,2,4
4,13,9,2,4
4,13,10,2,4
4,13,11,2,4
4,13,12,2,4
4,13,13,2,4
4,13,14,2,4
4,13,15,2,4
4,13,16,2,4
4,13,17,2,4
4,13,18,2,4
4,13,19,2,4
4,13,20,2,4
4,14,0,2,4
4,14,1,2,4
4,14,2,2,4
4,14,3,2,4
4,14,4,2,4
4,14,5,2,4
4,14,6,2,4
4,14,7,2,4
4,14,8,2,4
4,14,9,2,4
4,14,10,2,4
4,14,11,2,4
4,14,12,2,4
4,14,13,2,4
4,14,14,2,4
4,14,15,2,4
4,14,16,2,4
4,14,17,2,4
4,14,18,2,4
4,14,19,2,4
4,14,20,2,4
4,15,0,2,4
4,15,1,2,4
4,15,2,2,4
4,15,3,2,4
4,15,4,2,4
4,15,5,2,4
4,15,6,2,4
4,15,7,2,4
4,15,8,2,4
4,15,9,2,4
4,15,10,2,4
4,15,11,2,4
4,15,12,2,4
4,15,13,2,4
4,15,14,2,4
4,15,15,2,4
4,15,16,2,4
4,15,17,2,4
4,15,18,2,4
4,15,19,2,4
4,15,20,2,4
4,16,0,2,4
4,16,1,2,4
4,16,2,2,4
4,16,3,2,4
4,16,4,2,4
4,16,5,2,4
4,16,6,2,4
4,16,7,2,4
4,16,8,2,4
4,16,9,2,4
4,16,10,2,4
4,16,11,2,4
4,16,12,2,4
4,16,13,2,4
4,16,14,2,4
4,16,15,2,4
4,16,16,2,4
4,16,17,2,4
4,16,18,2,4
4,16,19,2,4
4,16,20,2,4
4,17,0,2,4
4,17,1,2,4
4,17,2,2,4
4,17,3,2,4
4,17,4,2,4
4,17,5,2,4
4,17,6,2,4
4,17,7,2,4
4,17,8,2,4
4,17,9,2,4
4,17,10,2,4
4,17,11,2,4
4,17,12,2,4
4,17,13,2,4
4,17,14,2,4
4,17,15,2,4
4,17,16,2,4
4,17,17,2,4
4,17,18,2,4
4,17,19,2,4
4,17,20,2,4
4,18,0,2,4
4,18,1,2,4
4,18,2,2,4
4,18,3,2,4
4,18,4,2,4
4,18,5,2,4
4,18,6,2,4
4,18,7,2,4
4,18,8,2,4
4,18,9,2,4
4,18,10,2,4
4,18,11,2,4
4,18,12,2,4
4,18,13,2,4
4,18,14,2,4
4,18,15,2,4
4,18,16,2,4
4,18,17,2,4
4,18,18,2,4
4,18,19,2,4
4,18,20,2,4
4,0,0,3,4
4,0,1,3,4
4,0,2,3,4
4,0,3,3,4
4,0,4,3,4
4,0,5,3,4
4,0,6,3,4
4,0,7,3,4
4,0,8,3,4
4,0,9,3,4
4,0,10,3,4
4,0,11,3,4
4,0,12,3,4
4,0,13,3,4
4,0,14,3,4
4,0,15,3,4
4,0,16,3,4
4,0,17,3,4
4,0,18,3,4
4,0,19,3,4
4,0,20,3,4
4,1,0,3,4
4,1,1,3,4
4,1,2,3,4
4,1,3,3,4
4,1,4,3,4
4,1,5,3,4
4,1,6,3,4
4,1,7,3,4
4,1,8,3,4
4,1,9,3,4
4,1,10,3,4
4,1,11,3,4
4,1,12,3,4
4,1,13,3,4
4,1,14,3,4
4,1,15,3,4
4,1,16,3,4
4,1,17,3,4
4,1,18,3,4
4,1,19,3,4
4,1,20,3,4
4,2,0,3,4
4,2,1,3,4
4,2,2,3,4
4,2,3,3,4
4,2,4,3,4
4,2,5,3,4
4,2,6,3,4
4,2,7,3,4
4,2,8,3,4
4,2,9,3,4
4,2,10,3,4
4,2,11,3,4
4,2,12,3,4
4,2,13,3,4
4,2,14,3,4
4,2,15,3,4
4,2,16,3,4
4,2,17,3,4
4,2,18,3,4
4,2,19,3,4
4,2,20,3,4
4,3,0,3,4
4,3,1,3,4
4,3,2,3,4
4,3,3,3,4
4,3,4,3,4
4,3,5,3,4
4,3,6,3,4
4,3,7,3,4
4,3,8,3,4
4,3,9,3,4
4,3,10,3,4
4,3,11,3,4
4,3,12,3,4
4,3,13,3,4
4,3,14,3,4
4,3,15,3,4
4,3,16,3,4
4,3,17,3,4
4,3,18,3,4
4,3,19,3,4
4,3,20,3,4
4,4,0,3,4
4,4,1,3,4
4,4,2,3,4
4,4,3,3,4
4,4,4,3,4
4,4,5,3,4
4,4,6,3,4
4,4,7,3,4
4,4,8,3,4
4,4,9,3,4
4,4,10,3,4
4,4,11,3,4
4,4,12,3,4
4,4,13,3,4
4,4,14,3,4
4,4,15,3,4
4,4,16,3,4
4,4,17,3,4
4,4,18,3,4
4,4,19,3,4
4,4,20,3,4
4,5,0,3,4
4,5,1,3,4
4,5,2,3,4
4,5,3,3,4
4,5,4,3,4
4,5,5,3,4
4,5,6,3,4
4,5,7,3,4
4,5,8,3,4
4,5,9,3,4
4,5,10,3,4
4,5,11,3,4
4,5,12,3,4
4,5,13,3,4
4,5,14,3,4
4,5,15,3,4
4,5,16,3,4
4,5,17,3,4
4,5,18,3,4
4,5,19,3,4
4,5,20,3,4
4,6,0,3,4
4,6,1,3,4
4,6,2,3,4
4,6,3,3,4
4,6,4,3,4
4,6,5,3,4
4,6,6,3,4
4,6,7,3,4
4,6,8,3,4
4,6,9,3,4
4,6,10,3,4
4,6,11,3,4
4,6,12,3,4
4,6,13,3,4
4,6,14,3,4
4,6,15,3,4
4,6,16,3,4
4,6,17,3,4
4,6,18,3,4
4,6,19,3,4
4,6,20,3,4
4,7,0,3,4
4,7,1,3,4
4,7,2,3,4
4,7,3,3,4
4,7,4,3,4
4,7,5,3,4
4,7,6,3,4
4,7,7,3,4
4,7,8,3,4
4,7,9,3,4
4,7,10,3,4
4,7,11,3,4
4,7,12,3,4
4,7,13,3,4
4,7,14,3,4
4,7,15,3,4
4,7,16,3,4
4,7,17,3,4
4,7,18,3,4
4,7,19,3,4
4,7,20,3,4
4,8,0,3,4
4,8,1,3,4
4,8,2,3,4
4,8,3,3,4
4,8,4,3,4
4,8,5,3,4
4,8,6,3,4
4,8,7,3,4
4,8,8,3,4
4,8,9,3,4
4,8,10,3,4
4,8,11,3,4
4,8,12,3,4
4,8,13,3,4
4,8,14,3,4
4,8,15,3,4
4,8,16,3,4
4,8,17,3,4
4,8,18,3,4
4,8,19,3,4
4,8,20,3,4
4,9,0,3,4
4,9,1,3,4
4,9,2,3,4
4,9,3,3,4
4,9,4,3,4
4,9,5,3,4
4,9,6,3,4
4,9,7,3,4
4,9,8,3,4
4,9,9,3,4
4,9,10,3,4
4,9,11,3,4
4,9,12,3,4
4,9,13,3,4
4,9,14,3,4
4,9,15,3,4
4,9,16,3,4
4,9,17,3,4
4,9,18,3,4
4,9,19,3,4
4,9,20,3,4
4,10,0,3,4
4,10,1,3,4
4,10,2,3,4
4,10,3,3,4
4,10,4,3,4
4,10,5,3,4
4,10,6,3,4
4,10,7,3,4
4,10,8,3,4
4,10,9,3,4
4,10,10,3,4
4,10,11,3,4
4,10,12,3,4
4,10,13,3,4
4,10,14,3,4
4,10,15,3,4
4,10,16,3,4
4,10,17,3,4
4,10,18,3,4
4,10,19,3,4
4,10,20,3,4
4,11,0,3,4
4,11,1,3,4
4,11,2,3,4
4,11,3,3,4
4,11,4,3,4
4,11,5,3,4
4,11,6,3,4
4,11,7,3,4
4,11,8,3,4
4,11,9,3,4
4,11,10,3,4
4,11,11,3,4
4,11,12,3,4
4,11,13,3,4
4,11,14,3,4
4,11,15,3,4
4,11,16,3,4
4,11,17,3,4
4,11,18,3,4
4,11,19,3,4
4,11,20,3,4
4,12,0,3,4
4,12,1,3,4
4,12,2,3,4
4,12,3,3,4
4,12,4,3,4
4,12,5,3,4
4,12,6,3,4
4,12,7,3,4
4,12,8,3,4
4,12,9,3,4
4,12,10,3,4
4,12,11,3,4
4,12,12,3,4
4,12,13,3,4
4,12,14,3,4
4,12,15,3,4
4,12,16,3,4
4,12,17,3,4
4,12,18,3,4
4,12,19,3,4
4,12,20,3,4
4,13,0,3,4
4,13,1,3,4
4,13,2,3,4
4,13,3,3,4
4,13,4,3,4
4,13,5,3,4
4,13,6,3,4
4,13,7,3,4
4,13,8,3,4
4,13,9,3,4
4,13,10,3,4
4,13,11,3,4
4,13,12,3,4
4,13,13,3,4
4,13,14,3,4
4,13,15,3,4
4,13,16,3,4
4,13,17,3,4
4,13,18,3,4
4,13,19,3,4
4,13,20,3,4
4,14,0,3,4
4,14,1,3,4
4,14,2,3,4
4,14,3,3,4
4,14,4,3,4
4,14,5,3,4
4,14,6,3,4
4,14,7,3,4
4,14,8,3,4
4,14,9,3,4
4,14,10,3,4
4,14,11,3,4
4,14,12,3,4
4,14,13,3,4
4,14,14,3,4
4,14,15,3,4
4,14,16,3,4
4,14,17,3,4
4,14,18,3,4
4,14,19,3,4
4,14,20,3,4
4,15,0,3,4
4,15,1,3,4
4,15,2,3,4
4,15,3,3,4
4,15,4,3,4
4,15,5,3,4
4,15,6,3,4
4,15,7,3,4
4,15,8,3,4
4,15,9,3,4
4,15,10,3,4
4,15,11,3,4
4,15,12,3,4
4,15,13,3,4
4,15,14,3,4
4,15,15,3,4
4,15,16,3,4
4,15,17,3,4
4,15,18,3,4
4,15,19,3,4
4,15,20,3,4
4,0,0,4,4
4,0,1,4,4
4,0,2,4,4
4,0,3,4,4
4,0,4,4,4
4,0,5,4,4
4,0,6,4,4
4,0,7,4,4
4,0,8,4,4
4,0,9,4,4
4,0,10,4,4
4,0,11,4,4
4,0,12,4,4
4,0,13,4,4
4,0,14,4,4
4,0,15,4,4
4,0,16,4,4
4,0,17,4,4
4,0,18,4,4
4,0,19,4,4
4,0,20,4,4
4,1,0,4,4
4,1,1,4,4
4,1,2,4,4
4,1,3,4,4
4,1,4,4,4
4,1,5,4,4
4,1,6,4,4
4,1,7,4,4
4,1,8,4,4
4,1,9,4,4
4,1,10,4,4
4,1,11,4,4
4,1,12,4,4
4,1,13,4,4
4,1,14,4,4
4,1,15,4,4
4,1,16,4,4
4,1,17,4,4
4,1,18,4,4
4,1,19,4,4
4,1,20,4,4
4,2,0,4,4
4,2,1,4,4
4,2,2,4,4
4,2,3,4,4
4,2,4,4,4
4,2,5,4,4
4,2,6,4,4
4,2,7,4,4
4,2,8,4,4
4,2,9,4,4
4,2,10,4,4
4,2,11,4,4
4,2,12,4,4
4,2,13,4,4
4,2,14,4,4
4,2,15,4,4
4,2,16,4,4
4,2,17,4,4
4,2,18,4,4
4,2,19,4,4
4,2,20,4,4
4,3,0,4,4
4,3,1,4,4
4,3,2,4,4
4,3,3,4,4
4,3,4,4,4
4,3,5,4,4
4,3,6,4,4
4,3,7,4,4
4,3,8,4,4
4,3,9,4,4
4,3,10,4,4
4,3,11,4,4
4,3,12,4,4
4,3,13,4,4
4,3,14,4,4
4,3,15,4,4
4,3,16,4,4
4,3,17,4,4
4,3,18,4,4
4,3,19,4,4
4,3,20,4,4
4,4,0,4,4
4,4,1,4,4
4,4,2,4,4
4,4,3,4,4
4,4,4,4,4
4,4,5,4,4
4,4,6,4,4
4,4,7,4,4
4,4,8,4,4
4,4,9,4,4
4,4,10,4,4
4,4,11,4,4
4,4,12,4,4
4,4,13,4,4
4,4,14,4,4
4,4,15,4,4
4,4,16,4,4
4,4,17,4,4
4,4,18,4,4
4,4,19,4,4
4,4,20,4,4
4,5,0,4,4
4,5,1,4,4
4,5,2,4,4
4,5,3,4,4
4,5,4,4,4
4,5,5,4,4
4,5,6,4,4
4,5,7,4,4
4,5,8,4,4
4,5,9,4,4
4,5,10,4,4
4,5,11,4,4
4,5,12,4,4
4,5,13,4,4
4,5,14,4,4
4,5,15,4,4
4,5,16,4,4
4,5,17,4,4
4,5,18,4,4
4,5,19,4,4
4,5,20,4,4
4,6,0,4,4
4,6,1,4,4
4,6,2,4,4
4,6,3,4,4
4,6,4,4,4
4,6,5,4,4
4,6,6,4,4
4,6,7,4,4
4,6,8,4,4
4,6,9,4,4
4,6,10,4,4
4,6,11,4,4
4,6,12,4,4
4,6,13,4,4
4,6,14,4,4
4,6,15,4,4
4,6,16,4,4
4,6,17,4,4
4,6,18,4,4
4,6,19,4,4
4,6,20,4,4
4,7,0,4,4
4,7,1,4,4
4,7,2,4,4
4,7,3,4,4
4,7,4,4,4
4,7,5,4,4
4,7,6,4,4
4,7,7,4,4
4,7,8,4,4
4,7,9,4,4
4,7,10,4,4
4,7,11,4,4
4,7,12,4,4
4,7,13,4,4
4,7,14,4,4
4,7,15,4,4
4,7,16,4,4
4,7,17,4,4
4,7,18,4,4
4,7,19,4,4
4,7,20,4,4
4,8,0,4,4
4,8,1,4,4
4,8,2,4,4
4,8,3,4,4
4,8,4,4,4
4,8,5,4,4
4,8,6,4,4
4,8,7,4,4
4,8,8,4,4
4,8,9,4,4
4,8,10,4,4
4,8,11,4,4
4,8,12,4,4
4,8,13,4,4
4,8,14,4,4
4,8,15,4,4
4,8,16,4,4
4,8,17,4,4
4,8,18,4,4
4,8,19,4,4
4,8,20,4,4
4,9,0,4,4
4,9,1,4,4
4,9,2,4,4
4,9,3,4,4
4,9,4,4,4
4,9,5,4,4
4,9,6,4,4
4,9,7,4,4
4,9,8,4,4
4,9,9,4,4
4,9,10,4,4
4,9,11,4,4
4,9,12,4,4
4,9,13,4,4
4,9,14,4,4
4,9,15,4,4
4,9,16,4,4
4,9,17,4,4
4,9,18,4,4
4,9,19,4,4
4,9,20,4,4
4,10,0,4,4
4,10,1,4,4
4,10,2,4,4
4,10,3,4,4
4,10,4,4,4
4,10,5,4,4
4,10,6,4,4
4,10,7,4,4
4,10,8,4,4
4,10,9,4,4
4,10,10,4,4
4,10,11,4,4
4,10,12,4,4
4,10,13,4,4
4,10,14,4,4
4,10,15,4,4
4,10,16,4,4
4,10,17,4,4
4,10,18,4,4
4,10,19,4,4
4,10,20,4,4
4,11,0,4,4
4,11,1,4,4
4,11,2,4,4
4,11,3,4,4
4,11,4,4,4
4,11,5,4,4
4,11,6,4,4
4,11,7,4,4
4,11,8,4,4
4,11,9,4,4
4,11,10,4,4
4,11,11,4,4
4,11,12,4,4
4,11,13,4,4
4,11,14,4,4
4,11,15,4,4
4,11,16,4,4
4,11,17,4,4
4,11,18,4,4
4,11,19,4,4
4,11,20,4,4
4,12,0,4,4
4,12,1,4,4
4,12,2,4,4
4,12,3,4,4
4,12,4,4,4
4,12,5,4,4
4,12,6,4,4
4,12,7,4,4
4,12,8,4,4
4,12,9,4,4
4,12,10,4,4
4,12,11,4,4
4,12,12,4,4
4,12,13,4,4
4,12,14,4,4
4,12,15,4,4
4,12,16,4,4
4,12,17,4,4
4,12,18,4,4
4,12,19,4,4
4,12,20,4,4
4,0,0,5,4
4,0,1,5,4
4,0,2,5,4
4,0,3,5,4
4,0,4,5,4
4,0,5,5,4
4,0,6,5,4
4,0,7,5,4
4,0,8,5,4
4,0,9,5,4
4,0,10,5,4
4,0,11,5,4
4,0,12,5,4
4,0,13,5,4
4,0,14,5,4
4,0,15,5,4
4,0,16,5,4
4,0,17,5,4
4,0,18,5,4
4,0,19,5,4
4,0,20,5,4
4,1,0,5,4
4,1,1,5,4
4,1,2,5,4
4,1,3,5,4
4,1,4,5,4
4,1,5,5,4
4,1,6,5,4
4,1,7,5,4
4,1,8,5,4
4,1,9,5,4
4,1,10,5,4
4,1,11,5,4
4,1,12,5,4
4,1,13,5,4
4,1,14,5,4
4,1,15,5,4
4,1,16,5,4
4,1,17,5,4
4,1,18,5,4
4,1,19,5,4
4,1,20,5,4
4,2,0,5,4
4,2,1,5,4
4,2,2,5,4
4,2,3,5,4
4,2,4,5,4
4,2,5,5,4
4,2,6,5,4
4,2,7,5,4
4,2,8,5,4
4,2,9,5,4
4,2,10,5,4
4,2,11,5,4
4,2,12,5,4
4,2,13,5,4
4,2,14,5,4
4,2,15,5,4
4,2,16,5,4
4,2,17,5,4
4,2,18,5,4
4,2,19,5,4
4,2,20,5,4
4,3,0,5,4
4,3,1,5,4
4,3,2,5,4
4,3,3,5,4
4,3,4,5,4
4,3,5,5,4
4,3,6,5,4
4,3,7,5,4
4,3,8,5,4
4,3,9,5,4
4,3,10,5,4
4,3,11,5,4
4,3,12,5,4
4,3,13,5,4
4,3,14,5,4
4,3,15,5,4
4,3,16,5,4
4,3,17,5,4
4,3,18,5,4
4,3,19,5,4
4,3,20,5,4
4,4,0,5,4
4,4,1,5,4
4,4,2,5,4
4,4,3,5,4
4,4,4,5,4
4,4,5,5,4
4,4,6,5,4
4,4,7,5,4
4,4,8,5,4
4,4,9,5,4
4,4,10,5,4
4,4,11,5,4
4,4,12,5,4
4,4,13,5,4
4,4,14,5,4
4,4,15,5,4
4,4,16,5,4
4,4,17,5,4
4,4,18,5,4
4,4,19,5,4
4,4,20,5,4
4,5,0,5,4
4,5,1,5,4
4,5,2,5,4
4,5,3,5,4
4,5,4,5,4
4,5,5,5,4
4,5,6,5,4
4,5,7,5,4
4,5,8,5,4
4,5,9,5,4
4,5,10,5,4
4,5,11,5,4
4,5,12,5,4
4,5,13,5,4
4,5,14,5,4
4,5,15,5,4
4,5,16,5,4
4,5,17,5,4
4,5,18,5,4
4,5,19,5,4
4,5,20,5,4
4,6,0,5,4
4,6,1,5,4
4,6,2,5,4
4,6,3,5,4
4,6,4,5,4
4,6,5,5,4
4,6,6,5,4
4,6,7,5,4
4,6,8,5,4
4,6,9,5,4
4,6,10,5,4
4,6,11,5,4
4,6,12,5,4
4,6,13,5,4
4,6,14,5,4
4,6,15,5,4
4,6,16,5,4
4,6,17,5,4
4,6,18,5,4
4,6,19,5,4
4,6,20,5,4
4,7,0,5,4
4,7,1,5,4
4,7,2,5,4
4,7,3,5,4
4,7,4,5,4
4,7,5,5,4
4,7,6,5,4
4,7,7,5,4
4,7,8,5,4
4,7,9,5,4
4,7,10,5,4
4,7,11,5,4
4,7,12,5,4
4,7,13,5,4
4,7,14,5,4
4,7,15,5,4
4,7,16,5,4
4,7,17,5,4
4,7,18,5,4
4,7,19,5,4
4,7,20,5,4
4,8,0,5,4
4,8,1,5,4
4,8,2,5,4
4,8,3,5,4
4,8,4,5,4
4,8,5,5,4
4,8,6,5,4
4,8,7,5,4
4,8,8,5,4
4,8,9,5,4
4,8,10,5,4
4,8,11,5,4
4,8,12,5,4
4,8,13,5,4
4,8,14,5,4
4,8,15,5,4
4,8,16,5,4
4,8,17,5,4
4,8,18,5,4
4,8,19,5,4
4,8,20,5,4
4,9,0,5,4
4,9,1,5,4
4,9,2,5,4
4,9,3,5,4
4,9,4,5,4
4,9,5,5,4
4,9,6,5,4
4,9,7,5,4
4,9,8,5,4
4,9,9,5,4
4,9,10,5,4
4,9,11,5,4
4,9,12,5,4
4,9,13,5,4
4,9,14,5,4
4,9,15,5,4
4,9,16,5,4
4,9,17,5,4
4,9,18,5,4
4,9,19,5,4
4,9,20,5,4
4,0,0,6,4
4,0,1,6,4
4,0,2,6,4
4,0,3,6,4
4,0,4,6,4
4,0,5,6,4
4,0,6,6,4
4,0,7,6,4
4,0,8,6,4
4,0,9,6,4
4,0,10,6,4
4,0,11,6,4
4,0,12,6,4
4,0,13,6,4
4,0,14,6,4
4,0,15,6,4
4,0,16,6,4
4,0,17,6,4
4,0,18,6,4
4,0,19,6,4
4,0,20,6,4
4,1,0,6,4
4,1,1,6,4
4,1,2,6,4
4,1,3,6,4
4,1,4,6,4
4,1,5,6,4
4,1,6,6,4
4,1,7,6,4
4,1,8,6,4
4,1,9,6,4
4,1,10,6,4
4,1,11,6,4
4,1,12,6,4
4,1,13,6,4
4,1,14,6,4
4,1,15,6,4
4,1,16,6,4
4,1,17,6,4
4,1,18,6,4
4,1,19,6,4
4,1,20,6,4
4,2,0,6,4
4,2,1,6,4
4,2,2,6,4
4,2,3,6,4
4,2,4,6,4
4,2,5,6,4
4,2,6,6,4
4,2,7,6,4
4,2,8,6,4
4,2,9,6,4
4,2,10,6,4
4,2,11,6,4
4,2,12,6,4
4,2,13,6,4
4,2,14,6,4
4,2,15,6,4
4,2,16,6,4
4,2,17,6,4
4,2,18,6,4
4,2,19,6,4
4,2,20,6,4
4,3,0,6,4
4,3,1,6,4
4,3,2,6,4
4,3,3,6,4
4,3,4,6,4
4,3,5,6,4
4,3,6,6,4
4,3,7,6,4
4,3,8,6,4
4,3,9,6,4
4,3,10,6,4
4,3,11,6,4
4,3,12,6,4
4,3,13,6,4
4,3,14,6,4
4,3,15,6,4
4,3,16,6,4
4,3,17,6,4
4,3,18,6,4
4,3,19,6,4
4,3,20,6,4
4,4,0,6,4
4,4,1,6,4
4,4,2,6,4
4,4,3,6,4
4,4,4,6,4
4,4,5,6,4
4,4,6,6,4
4,4,7,6,4
4,4,8,6,4
4,4,9,6,4
4,4,10,6,4
4,4,11,6,4
4,4,12,6,4
4,4,13,6,4
4,4,14,6,4
4,4,15,6,4
4,4,16,6,4
4,4,17,6,4
4,4,18,6,4
4,4,19,6,4
4,4,20,6,4
4,5,0,6,4
4,5,1,6,4
4,5,2,6,4
4,5,3,6,4
4,5,4,6,4
4,5,5,6,4
4,5,6,6,4
4,5,7,6,4
4,5,8,6,4
4,5,9,6,4
4,5,10,6,4
4,5,11,6,4
4,5,12,6,4
4,5,13,6,4
4,5,14,6,4
4,5,15,6,4
4,5,16,6,4
4,5,17,6,4
4,5,18,6,4
4,5,19,6,4
4,5,20,6,4
4,6,0,6,4
4,6,1,6,4
4,6,2,6,4
4,6,3,6,4
4,6,4,6,4
4,6,5,6,4
4,6,6,6,4
4,6,7,6,4
4,6,8,6,4
4,6,9,6,4
4,6,10,6,4
4,6,11,6,4
4,6,12,6,4
4,6,13,6,4
4,6,14,6,4
4,6,15,6,4
4,6,16,6,4
4,6,17,6,4
4,6,18,6,4
4,6,19,6,4
4,6,20,6,4
4,0,0,7,4
4,0,1,7,4
4,0,2,7,4
4,0,3,7,4
4,0,4,7,4
4,0,5,7,4
4,0,6,7,4
4,0,7,7,4
4,0,8,7,4
4,0,9,7,4
4,0,10,7,4
4,0,11,7,4
4,0,12,7,4
4,0,13,7,4
4,0,14,7,4
4,0,15,7,4
4,0,16,7,4
4,0,17,7,4
4,0,18,7,4
4,0,19,7,4
4,0,20,7,4
4,1,0,7,4
4,1,1,7,4
4,1,2,7,4
4,1,3,7,4
4,1,4,7,4
4,1,5,7,4
4,1,6,7,4
4,1,7,7,4
4,1,8,7,4
4,1,9,7,4
4,1,10,7,4
4,1,11,7,4
4,1,12,7,4
4,1,13,7,4
4,1,14,7,4
4,1,15,7,4
4,1,16,7,4
4,1,17,7,4
4,1,18,7,4
4,1,19,7,4
4,1,20,7,4
4,2,0,7,4
4,2,1,7,4
4,2,2,7,4
4,2,3,7,4
4,2,4,7,4
4,2,5,7,4
4,2,6,7,4
4,2,7,7,4
4,2,8,7,4
4,2,9,7,4
4,2,10,7,4
4,2,11,7,4
4,2,12,7,4
4,2,13,7,4
4,2,14,7,4
4,2,15,7,4
4,2,16,7,4
4,2,17,7,4
4,2,18,7,4
4,2,19,7,4
4,2,20,7,4
4,3,0,7,4
4,3,1,7,4
4,3,2,7,4
4,3,3,7,4
4,3,4,7,4
4,3,5,7,4
4,3,6,7,4
4,3,7,7,4
4,3,8,7,4
4,3,9,7,4
4,3,10,7,4
4,3,11,7,4
4,3,12,7,4
4,3,13,7,4
4,3,14,7,4
4,3,15,7,4
4,3,16,7,4
4,3,17,7,4
4,3,18,7,4
4,3,19,7,4
4,3,20,7,4
4,0,0,8,4
4,0,1,8,4
4,0,2,8,4
4,0,3,8,4
4,0,4,8,4
4,0,5,8,4
4,0,6,8,4
4,0,7,8,4
4,0,8,8,4
4,0,9,8,4
4,0,10,8,4
4,0,11,8,4
4,0,12,8,4
4,0,13,8,4
4,0,14,8,4
4,0,15,8,4
4,0,16,8,4
4,0,17,8,4
4,0,18,8,4
4,0,19,8,4
4,0,20,8,4
4,0,0,1,5
4,0,1,1,5
4,0,2,1,5
4,0,3,1,5
4,0,4,1,5
4,0,5,1,5
4,0,6,1,5
4,0,7,1,5
4,0,8,1,5
4,0,9,1,5
4,0,10,1,5
4,0,11,1,5
4,0,12,1,5
4,0,13,1,5
4,0,14,1,5
4,0,15,1,5
4,0,16,1,5
4,0,17,1,5
4,0,18,1,5
4,0,19,1,5
4,1,0,1,5
4,1,1,1,5
4,1,2,1,5
4,1,3,1,5
4,1,4,1,5
4,1,5,1,5
4,1,6,1,5
4,1,7,1,5
4,1,8,1,5
4,1,9,1,5
4,1,10,1,5
4,1,11,1,5
4,1,12,1,5
4,1,13,1,5
4,1,14,1,5
4,1,15,1,5
4,1,16,1,5
4,1,17,1,5
4,1,18,1,5
4,1,19,1,5
4,2,0,1,5
4,2,1,1,5
4,2,2,1,5
4,2,3,1,5
4,2,4,1,5
4,2,5,1,5
4,2,6,1,5
4,2,7,1,5
4,2,8,1,5
4,2,9,1,5
4,2,10,1,5
4,2,11,1,5
4,2,12,1,5
4,2,13,1,5
4,2,14,1,5
4,2,15,1,5
4,2,16,1,5
4,2,17,1,5
4,2,18,1,5
4,2,19,1,5
4,3,0,1,5
4,3,1,1,5
4,3,2,1,5
4,3,3,1,5
4,3,4,1,5
4,3,5,1,5
4,3,6,1,5
4,3,7,1,5
4,3,8,1,5
4,3,9,1,5
4,3,10,1,5
4,3,11,1,5
4,3,12,1,5
4,3,13,1,5
4,3,14,1,5
4,3,15,1,5
4,3,16,1,5
4,3,17,1,5
4,3,18,1,5
4,3,19,1,5
4,4,0,1,5
4,4,1,1,5
4,4,2,1,5
4,4,3,1,5
4,4,4,1,5
4,4,5,1,5
4,4,6,1,5
4,4,7,1,5
4,4,8,1,5
4,4,9,1,5
4,4,10,1,5
4,4,11,1,5
4,4,12,1,5
4,4,13,1,5
4,4,14,1,5
4,4,15,1,5
4,4,16,1,5
4,4,17,1,5
4,4,18,1,5
4,4,19,1,5
4,5,0,1,5
4,5,1,1,5
4,5,2,1,5
4,5,3,1,5
4,5,4,1,5
4,5,5,1,5
4,5,6,1,5
4,5,7,1,5
4,5,8,1,5
4,5,9,1,5
4,5,10,1,5
4,5,11,1,5
4,5,12,1,5
4,5,13,1,5
4,5,14,1,5
4,5,15,1,5
4,5,16,1,5
4,5,17,1,5
4,5,18,1,5
4,5,19,1,5
4,6,0,1,5
4,6,1,1,5
4,6,2,1,5
4,6,3,1,5
4,6,4,1,5
4,6,5,1,5
4,6,6,1,5
4,6,7,1,5
4,6,8,1,5
4,6,9,1,5
4,6,10,1,5
4,6,11,1,5
4,6,12,1,5
4,6,13,1,5
4,6,14,1,5
4,6,15,1,5
4,6,16,1,5
4,6,17,1,5
4,6,18,1,5
4,6,19,1,5
4,7,0,1,5
4,7,1,1,5
4,7,2,1,5
4,7,3,1,5
4,7,4,1,5
4,7,5,1,5
4,7,6,1,5
4,7,7,1,5
4,7,8,1,5
4,7,9,1,5
4,7,10,1,5
4,7,11,1,5
4,7,12,1,5
4,7,13,1,5
4,7,14,1,5
4,7,15,1,5
4,7,16,1,5
4,7,17,1,5
4,7,18,1,5
4,7,19,1,5
4,8,0,1,5
4,8,1,1,5
4,8,2,1,5
4,8,3,1,5
4,8,4,1,5
4,8,5,1,5
4,8,6,1,5
4,8,7,1,5
4,8,8,1,5
4,8,9,1,5
4,8,10,1,5
4,8,11,1,5
4,8,12,1,5
4,8,13,1,5
4,8,14,1,5
4,8,15,1,5
4,8,16,1,5
4,8,17,1,5
4,8,18,1,5
4,8,19,1,5
4,9,0,1,5
4,9,1,1,5
4,9,2,1,5
4,9,3,1,5
4,9,4,1,5
4,9,5,1,5
4,9,6,1,5
4,9,7,1,5
4,9,8,1,5
4,9,9,1,5
4,9,10,1,5
4,9,11,1,5
4,9,12,1,5
4,9,13,1,5
4,9,14,1,5
4,9,15,1,5
4,9,16,1,5
4,9,17,1,5
4,9,18,1,5
4,9,19,1,5
4,10,0,1,5
4,10,1,1,5
4,10,2,1,5
4,10,3,1,5
4,10,4,1,5
4,10,5,1,5
4,10,6,1,5
4,10,7,1,5
4,10,8,1,5
4,10,9,1,5
4,10,10,1,5
4,10,11,1,5
4,10,12,1,5
4,10,13,1,5
4,10,14,1,5
4,10,15,1,5
4,10,16,1,5
4,10,17,1,5
4,10,18,1,5
4,10,19,1,5
4,11,0,1,5
4,11,1,1,5
4,11,2,1,5
4,11,3,1,5
4,11,4,1,5
4,11,5,1,5
4,11,6,1,5
4,11,7,1,5
4,11,8,1,5
4,11,9,1,5
4,11,10,1,5
4,11,11,1,5
4,11,12,1,5
4,11,13,1,5
4,11,14,1,5
4,11,15,1,5
4,11,16,1,5
4,11,17,1,5
4,11,18,1,5
4,11,19,1,5
4,12,0,1,5
4,12,1,1,5
4,12,2,1,5
4,12,3,1,5
4,12,4,1,5
4,12,5,1,5
4,12,6,1,5
4,12,7,1,5
4,12,8,1,5
4,12,9,1,5
4,12,10,1,5
4,12,11,1,5
4,12,12,1,5
4,12,13,1,5
4,12,14,1,5
4,12,15,1,5
4,12,16,1,5
4,12,17,1,5
4,12,18,1,5
4,12,19,1,5
4,13,0,1,5
4,13,1,1,5
4,13,2,1,5
4,13,3,1,5
4,13,4,1,5
4,13,5,1,5
4,13,6,1,5
4,13,7,1,5
4,13,8,1,5
4,13,9,1,5
4,13,10,1,5
4,13,11,1,5
4,13,12,1,5
4,13,13,1,5
4,13,14,1,5
4,13,15,1,5
4,13,16,1,5
4,13,17,1,5
4,13,18,1,5
4,13,19,1,5
4,14,0,1,5
4,14,1,1,5
4,14,2,1,5
4,14,3,1,5
4,14,4,1,5
4,14,5,1,5
4,14,6,1,5
4,14,7,1,5
4,14,8,1,5
4,14,9,1,5
4,14,10,1,5
4,14,11,1,5
4,14,12,1,5
4,14,13,1,5
4,14,14,1,5
4,14,15,1,5
4,14,16,1,5
4,14,17,1,5
4,14,18,1,5
4,14,19,1,5
4,15,0,1,5
4,15,1,1,5
4,15,2,1,5
4,15,3,1,5
4,15,4,1,5
4,15,5,1,5
4,15,6,1,5
4,15,7,1,5
4,15,8,1,5
4,15,9,1,5
4,15,10,1,5
4,15,11,1,5
4,15,12,1,5
4,15,13,1,5
4,15,14,1,5
4,15,15,1,5
4,15,16,1,5
4,15,17,1,5
4,15,18,1,5
4,15,19,1,5
4,16,0,1,5
4,16,1,1,5
4,16,2,1,5
4,16,3,1,5
4,16,4,1,5
4,16,5,1,5
4,16,6,1,5
4,16,7,1,5
4,16,8,1,5
4,16,9,1,5
4,16,10,1,5
4,16,11,1,5
4,16,12,1,5
4,16,13,1,5
4,16,14,1,5
4,16,15,1,5
4,16,16,1,5
4,16,17,1,5
4,16,18,1,5
4,16,19,1,5
4,17,0,1,5
4,17,1,1,5
4,17,2,1,5
4,17,3,1,5
4,17,4,1,5
4,17,5,1,5
4,17,6,1,5
4,17,7,1,5
4,17,8,1,5
4,17,9,1,5
4,17,10,1,5
4,17,11,1,5
4,17,12,1,5
4,17,13,1,5
4,17,14,1,5
4,17,15,1,5
4,17,16,1,5
4,17,17,1,5
4,17,18,1,5
4,17,19,1,5
4,18,0,1,5
4,18,1,1,5
4,18,2,1,5
4,18,3,1,5
4,18,4,1,5
4,18,5,1,5
4,18,6,1,5
4,18,7,1,5
4,18,8,1,5
4,18,9,1,5
4,18,10,1,5
4,18,11,1,5
4,18,12,1,5
4,18,13,1,5
4,18,14,1,5
4,18,15,1,5
4,18,16,1,5
4,18,17,1,5
4,18,18,1,5
4,18,19,1,5
4,19,0,1,5
4,19,1,1,5
4,19,2,1,5
4,19,3,1,5
4,19,4,1,5
4,19,5,1,5
4,19,6,1,5
4,19,7,1,5
4,19,8,1,5
4,19,9,1,5
4,19,10,1,5
4,19,11,1,5
4,19,12,1,5
4,19,13,1,5
4,19,14,1,5
4,19,15,1,5
4,19,16,1,5
4,19,17,1,5
4,19,18,1,5
4,19,19,1,5
4,20,0,1,5
4,20,1,1,5
4,20,2,1,5
4,20,3,1,5
4,20,4,1,5
4,20,5,1,5
4,20,6,1,5
4,20,7,1,5
4,20,8,1,5
4,20,9,1,5
4,20,10,1,5
4,20,11,1,5
4,20,12,1,5
4,20,13,1,5
4,20,14,1,5
4,20,15,1,5
4,20,16,1,5
4,20,17,1,5
4,20,18,1,5
4,20,19,1,5
4,21,0,1,5
4,21,1,1,5
4,21,2,1,5
4,21,3,1,5
4,21,4,1,5
4,21,5,1,5
4,21,6,1,5
4,21,7,1,5
4,21,8,1,5
4,21,9,1,5
4,21,10,1,5
4,21,11,1,5
4,21,12,1,5
4,21,13,1,5
4,21,14,1,5
4,21,15,1,5
4,21,16,1,5
4,21,17,1,5
4,21,18,1,5
4,21,19,1,5
4,0,0,2,5
4,0,1,2,5
4,0,2,2,5
4,0,3,2,5
4,0,4,2,5
4,0,5,2,5
4,0,6,2,5
4,0,7,2,5
4,0,8,2,5
4,0,9,2,5
4,0,10,2,5
4,0,11,2,5
4,0,12,2,5
4,0,13,2,5
4,0,14,2,5
4,0,15,2,5
4,0,16,2,5
4,0,17,2,5
4,0,18,2,5
4,0,19,2,5
4,1,0,2,5
4,1,1,2,5
4,1,2,2,5
4,1,3,2,5
4,1,4,2,5
4,1,5,2,5
4,1,6,2,5
4,1,7,2,5
4,1,8,2,5
4,1,9,2,5
4,1,10,2,5
4,1,11,2,5
4,1,12,2,5
4,1,13,2,5
4,1,14,2,5
4,1,15,2,5
4,1,16,2,5
4,1,17,2,5
4,1,18,2,5
4,1,19,2,5
4,2,0,2,5
4,2,1,2,5
4,2,2,2,5
4,2,3,2,5
4,2,4,2,5
4,2,5,2,5
4,2,6,2,5
4,2,7,2,5
4,2,8,2,5
4,2,9,2,5
4,2,10,2,5
4,2,11,2,5
4,2,12,2,5
4,2,13,2,5
4,2,14,2,5
4,2,15,2,5
4,2,16,2,5
4,2,17,2,5
4,2,18,2,5
4,2,19,2,5
4,3,0,2,5
4,3,1,2,5
4,3,2,2,5
4,3,3,2,5
4,3,4,2,5
4,3,5,2,5
4,3,6,2,5
4,3,7,2,5
4,3,8,2,5
4,3,9,2,5
4,3,10,2,5
4,3,11,2,5
4,3,12,2,5
4,3,13,2,5
4,3,14,2,5
4,3,15,2,5
4,3,16,2,5
4,3,17,2,5
4,3,18,2,5
4,3,19,2,5
4,4,0,2,5
4,4,1,2,5
4,4,2,2,5
4,4,3,2,5
4,4,4,2,5
4,4,5,2,5
4,4,6,2,5
4,4,7,2,5
4,4,8,2,5
4,4,9,2,5
4,4,10,2,5
4,4,11,2,5
4,4,12,2,5
4,4,13,2,5
4,4,14,2,5
4,4,15,2,5
4,4,16,2,5
4,4,17,2,5
4,4,18,2,5
4,4,19,2,5
4,5,0,2,5
4,5,1,2,5
4,5,2,2,5
4,5,3,2,5
4,5,4,2,5
4,5,5,2,5
4,5,6,2,5
4,5,7,2,5
4,5,8,2,5
4,5,9,2,5
4,5,10,2,5
4,5,11,2,5
4,5,12,2,5
4,5,13,2,5
4,5,14,2,5
4,5,15,2,5
4,5,16,2,5
4,5,17,2,5
4,5,18,2,5
4,5,19,2,5
4,6,0,2,5
4,6,1,2,5
4,6,2,2,5
4,6,3,2,5
4,6,4,2,5
4,6,5,2,5
4,6,6,2,5
4,6,7,2,5
4,6,8,2,5
4,6,9,2,5
4,6,10,2,5
4,6,11,2,5
4,6,12,2,5
4,6,13,2,5
4,6,14,2,5
4,6,15,2,5
4,6,16,2,5
4,6,17,2,5
4,6,18,2,5
4,6,19,2,5
4,7,0,2,5
4,7,1,2,5
4,7,2,2,5
4,7,3,2,5
4,7,4,2,5
4,7,5,2,5
4,7,6,2,5
4,7,7,2,5
4,7,8,2,5
4,7,9,2,5
4,7,10,2,5
4,7,11,2,5
4,7,12,2,5
4,7,13,2,5
4,7,14,2,5
4,7,15,2,5
4,7,16,2,5
4,7,17,2,5
4,7,18,2,5
4,7,19,2,5
4,8,0,2,5
4,8,1,2,5
4,8,2,2,5
4,8,3,2,5
4,8,4,2,5
4,8,5,2,5
4,8,6,2,5
4,8,7,2,5
4,8,8,2,5
4,8,9,2,5
4,8,10,2,5
4,8,11,2,5
4,8,12,2,5
4,8,13,2,5
4,8,14,2,5
4,8,15,2,5
4,8,16,2,5
4,8,17,2,5
4,8,18,2,5
4,8,19,2,5
4,9,0,2,5
4,9,1,2,5
4,9,2,2,5
4,9,3,2,5
4,9,4,2,5
4,9,5,2,5
4,9,6,2,5
4,9,7,2,5
4,9,8,2,5
4,9,9,2,5
4,9,10,2,5
4,9,11,2,5
4,9,12,2,5
4,9,13,2,5
4,9,14,2,5
4,9,15,2,5
4,9,16,2,5
4,9,17,2,5
4,9,18,2,5
4,9,19,2,5
4,10,0,2,5
4,10,1,2,5
4,10,2,2,5
4,10,3,2,5
4,10,4,2,5
4,10,5,2,5
4,10,6,2,5
4,10,7,2,5
4,10,8,2,5
4,10,9,2,5
4,10,10,2,5
4,10,11,2,5
4,10,12,2,5
4,10,13,2,5
4,10,14,2,5
4,10,15,2,5
4,10,16,2,5
4,10,17,2,5
4,10,18,2,5
4,10,19,2,5
4,11,0,2,5
4,11,1,2,5
4,11,2,2,5
4,11,3,2,5
4,11,4,2,5
4,11,5,2,5
4,11,6,2,5
4,11,7,2,5
4,11,8,2,5
4,11,9,2,5
4,11,10,2,5
4,11,11,2,5
4,11,12,2,5
4,11,13,2,5
4,11,14,2,5
4,11,15,2,5
4,11,16,2,5
4,11,17,2,5
4,11,18,2,5
4,11,19,2,5
4,12,0,2,5
4,12,1,2,5
4,12,2,2,5
4,12,3,2,5
4,12,4,2,5
4,12,5,2,5
4,12,6,2,5
4,12,7,2,5
4,12,8,2,5
4,12,9,2,5
4,12,10,2,5
4,12,11,2,5
4,12,12,2,5
4,12,13,2,5
4,12,14,2,5
4,12,15,2,5
4,12,16,2,5
4,12,17,2,5
4,12,18,2,5
4,12,19,2,5
4,13,0,2,5
4,13,1,2,5
4,13,2,2,5
4,13,3,2,5
4,13,4,2,5
4,13,5,2,5
4,13,6,2,5
4,13,7,2,5
4,13,8,2,5
4,13,9,2,5
4,13,10,2,5
4,13,11,2,5
4,13,12,2,5
4,13,13,2,5
4,13,14,2,5
4,13,15,2,5
4,13,16,2,5
4,13,17,2,5
4,13,18,2,5
4,13,19,2,5
4,14,0,2,5
4,14,1,2,5
4,14,2,2,5
4,14,3,2,5
4,14,4,2,5
4,14,5,2,5
4,14,6,2,5
4,14,7,2,5
4,14,8,2,5
4,14,9,2,5
4,14,10,2,5
4,14,11,2,5
4,14,12,2,5
4,14,13,2,5
4,14,14,2,5
4,14,15,2,5
4,14,16,2,5
4,14,17,2,5
4,14,18,2,5
4,14,19,2,5
4,15,0,2,5
4,15,1,2,5
4,15,2,2,5
4,15,3,2,5
4,15,4,2,5
4,15,5,2,5
4,15,6,2,5
4,15,7,2,5
4,15,8,2,5
4,15,9,2,5
4,15,10,2,5
4,15,11,2,5
4,15,12,2,5
4,15,13,2,5
4,15,14,2,5
4,15,15,2,5
4,15,16,2,5
4,15,17,2,5
4,15,18,2,5
4,15,19,2,5
4,16,0,2,5
4,16,1,2,5
4,16,2,2,5
4,16,3,2,5
4,16,4,2,5
4,16,5,2,5
4,16,6,2,5
4,16,7,2,5
4,16,8,2,5
4,16,9,2,5
4,16,10,2,5
4,16,11,2,5
4,16,12,2,5
4,16,13,2,5
4,16,14,2,5
4,16,15,2,5
4,16,16,2,5
4,16,17,2,5
4,16,18,2,5
4,16,19,2,5
4,17,0,2,5
4,17,1,2,5
4,17,2,2,5
4,17,3,2,5
4,17,4,2,5
4,17,5,2,5
4,17,6,2,5
4,17,7,2,5
4,17,8,2,5
4,17,9,2,5
4,17,10,2,5
4,17,11,2,5
4,17,12,2,5
4,17,13,2,5
4,17,14,2,5
4,17,15,2,5
4,17,16,2,5
4,17,17,2,5
4,17,18,2,5
4,17,19,2,5
4,18,0,2,5
4,18,1,2,5
4,18,2,2,5
4,18,3,2,5
4,18,4,2,5
4,18,5,2,5
4,18,6,2,5
4,18,7,2,5
4,18,8,2,5
4,18,9,2,5
4,18,10,2,5
4,18,11,2,5
4,18,12,2,5
4,18,13,2,5
4,18,14,2,5
4,18,15,2,5
4,18,16,2,5
4,18,17,2,5
4,18,18,2,5
4,18,19,2,5
4,0,0,3,5
4,0,1,3,5
4,0,2,3,5
4,0,3,3,5
4,0,4,3,5
4,0,5,3,5
4,0,6,3,5
4,0,7,3,5
4,0,8,3,5
4,0,9,3,5
4,0,10,3,5
4,0,11,3,5
4,0,12,3,5
4,0,13,3,5
4,0,14,3,5
4,0,15,3,5
4,0,16,3,5
4,0,17,3,5
4,0,18,3,5
4,0,19,3,5
4,1,0,3,5
4,1,1,3,5
4,1,2,3,5
4,1,3,3,5
4,1,4,3,5
4,1,5,3,5
4,1,6,3,5
4,1,7,3,5
4,1,8,3,5
4,1,9,3,5
4,1,10,3,5
4,1,11,3,5
4,1,12,3,5
4,1,13,3,5
4,1,14,3,5
4,1,15,3,5
4,1,16,3,5
4,1,17,3,5
4,1,18,3,5
4,1,19,3,5
4,2,0,3,5
4,2,1,3,5
4,2,2,3,5
4,2,3,3,5
4,2,4,3,5
4,2,5,3,5
4,2,6,3,5
4,2,7,3,5
4,2,8,3,5
4,2,9,3,5
4,2,10,3,5
4,2,11,3,5
4,2,12,3,5
4,2,13,3,5
4,2,14,3,5
4,2,15,3,5
4,2,16,3,5
4,2,17,3,5
4,2,18,3,5
4,2,19,3,5
4,3,0,3,5
4,3,1,3,5
4,3,2,3,5
4,3,3,3,5
4,3,4,3,5
4,3,5,3,5
4,3,6,3,5
4,3,7,3,5
4,3,8,3,5
4,3,9,3,5
4,3,10,3,5
4,3,11,3,5
4,3,12,3,5
4,3,13,3,5
4,3,14,3,5
4,3,15,3,5
4,3,16,3,5
4,3,17,3,5
4,3,18,3,5
4,3,19,3,5
4,4,0,3,5
4,4,1,3,5
4,4,2,3,5
4,4,3,3,5
4,4,4,3,5
4,4,5,3,5
4,4,6,3,5
4,4,7,3,5
4,4,8,3,5
4,4,9,3,5
4,4,10,3,5
4,4,11,3,5
4,4,12,3,5
4,4,13,3,5
4,4,14,3,5
4,4,15,3,5
4,4,16,3,5
4,4,17,3,5
4,4,18,3,5
4,4,19,3,5
4,5,0,3,5
4,5,1,3,5
4,5,2,3,5
4,5,3,3,5
4,5,4,3,5
4,5,5,3,5
4,5,6,3,5
4,5,7,3,5
4,5,8,3,5
4,5,9,3,5
4,5,10,3,5
4,5,11,3,5
4,5,12,3,5
4,5,13,3,5
4,5,14,3,5
4,5,15,3,5
4,5,16,3,5
4,5,17,3,5
4,5,18,3,5
4,5,19,3,5
4,6,0,3,5
4,6,1,3,5
4,6,2,3,5
4,6,3,3,5
4,6,4,3,5
4,6,5,3,5
4,6,6,3,5
4,6,7,3,5
4,6,8,3,5
4,6,9,3,5
4,6,10,3,5
4,6,11,3,5
4,6,12,3,5
4,6,13,3,5
4,6,14,3,5
4,6,15,3,5
4,6,16,3,5
4,6,17,3,5
4,6,18,3,5
4,6,19,3,5
4,7,0,3,5
4,7,1,3,5
4,7,2,3,5
4,7,3,3,5
4,7,4,3,5
4,7,5,3,5
4,7,6,3,5
4,7,7,3,5
4,7,8,3,5
4,7,9,3,5
4,7,10,3,5
4,7,11,3,5
4,7,12,3,5
4,7,13,3,5
4,7,14,3,5
4,7,15,3,5
4,7,16,3,5
4,7,17,3,5
4,7,18,3,5
4,7,19,3,5
4,8,0,3,5
4,8,1,3,5
4,8,2,3,5
4,8,3,3,5
4,8,4,3,5
4,8,5,3,5
4,8,6,3,5
4,8,7,3,5
4,8,8,3,5
4,8,9,3,5
4,8,10,3,5
4,8,11,3,5
4,8,12,3,5
4,8,13,3,5
4,8,14,3,5
4,8,15,3,5
4,8,16,3,5
4,8,17,3,5
4,8,18,3,5
4,8,19,3,5
4,9,0,3,5
4,9,1,3,5
4,9,2,3,5
4,9,3,3,5
4,9,4,3,5
4,9,5,3,5
4,9,6,3,5
4,9,7,3,5
4,9,8,3,5
4,9,9,3,5
4,9,10,3,5
4,9,11,3,5
4,9,12,3,5
4,9,13,3,5
4,9,14,3,5
4,9,15,3,5
4,9,16,3,5
4,9,17,3,5
4,9,18,3,5
4,9,19,3,5
4,10,0,3,5
4,10,1,3,5
4,10,2,3,5
4,10,3,3,5
4,10,4,3,5
4,10,5,3,5
4,10,6,3,5
4,10,7,3,5
4,10,8,3,5
4,10,9,3,5
4,10,10,3,5
4,10,11,3,5
4,10,12,3,5
4,10,13,3,5
4,10,14,3,5
4,10,15,3,5
4,10,16,3,5
4,10,17,3,5
4,10,18,3,5
4,10,19,3,5
4,11,0,3,5
4,11,1,3,5
4,11,2,3,5
4,11,3,3,5
4,11,4,3,5
4,11,5,3,5
4,11,6,3,5
4,11,7,3,5
4,11,8,3,5
4,11,9,3,5
4,11,10,3,5
4,11,11,3,5
4,11,12,3,5
4,11,13,3,5
4,11,14,3,5
4,11,15,3,5
4,11,16,3,5
4,11,17,3,5
4,11,18,3,5
4,11,19,3,5
4,12,0,3,5
4,12,1,3,5
4,12,2,3,5
4,12,3,3,5
4,12,4,3,5
4,12,5,3,5
4,12,6,3,5
4,12,7,3,5
4,12,8,3,5
4,12,9,3,5
4,12,10,3,5
4,12,11,3,5
4,12,12,3,5
4,12,13,3,5
4,12,14,3,5
4,12,15,3,5
4,12,16,3,5
4,12,17,3,5
4,12,18,3,5
4,12,19,3,5
4,13,0,3,5
4,13,1,3,5
4,13,2,3,5
4,13,3,3,5
4,13,4,3,5
4,13,5,3,5
4,13,6,3,5
4,13,7,3,5
4,13,8,3,5
4,13,9,3,5
4,13,10,3,5
4,13,11,3,5
4,13,12,3,5
4,13,13,3,5
4,13,14,3,5
4,13,15,3,5
4,13,16,3,5
4,13,17,3,5
4,13,18,3,5
4,13,19,3,5
4,14,0,3,5
4,14,1,3,5
4,14,2,3,5
4,14,3,3,5
4,14,4,3,5
4,14,5,3,5
4,14,6,3,5
4,14,7,3,5
4,14,8,3,5
4,14,9,3,5
4,14,10,3,5
4,14,11,3,5
4,14,12,3,5
4,14,13,3,5
4,14,14,3,5
4,14,15,3,5
4,14,16,3,5
4,14,17,3,5
4,14,18,3,5
4,14,19,3,5
4,15,0,3,5
4,15,1,3,5
4,15,2,3,5
4,15,3,3,5
4,15,4,3,5
4,15,5,3,5
4,15,6,3,5
4,15,7,3,5
4,15,8,3,5
4,15,9,3,5
4,15,10,3,5
4,15,11,3,5
4,15,12,3,5
4,15,13,3,5
4,15,14,3,5
4,15,15,3,5
4,15,16,3,5
4,15,17,3,5
4,15,18,3,5
4,15,19,3,5
4,0,0,4,5
4,0,1,4,5
4,0,2,4,5
4,0,3,4,5
4,0,4,4,5
4,0,5,4,5
4,0,6,4,5
4,0,7,4,5
4,0,8,4,5
4,0,9,4,5
4,0,10,4,5
4,0,11,4,5
4,0,12,4,5
4,0,13,4,5
4,0,14,4,5
4,0,15,4,5
4,0,16,4,5
4,0,17,4,5
4,0,18,4,5
4,0,19,4,5
4,1,0,4,5
4,1,1,4,5
4,1,2,4,5
4,1,3,4,5
4,1,4,4,5
4,1,5,4,5
4,1,6,4,5
4,1,7,4,5
4,1,8,4,5
4,1,9,4,5
4,1,10,4,5
4,1,11,4,5
4,1,12,4,5
4,1,13,4,5
4,1,14,4,5
4,1,15,4,5
4,1,16,4,5
4,1,17,4,5
4,1,18,4,5
4,1,19,4,5
4,2,0,4,5
4,2,1,4,5
4,2,2,4,5
4,2,3,4,5
4,2,4,4,5
4,2,5,4,5
4,2,6,4,5
4,2,7,4,5
4,2,8,4,5
4,2,9,4,5
4,2,10,4,5
4,2,11,4,5
4,2,12,4,5
4,2,13,4,5
4,2,14,4,5
4,2,15,4,5
4,2,16,4,5
4,2,17,4,5
4,2,18,4,5
4,2,19,4,5
4,3,0,4,5
4,3,1,4,5
4,3,2,4,5
4,3,3,4,5
4,3,4,4,5
4,3,5,4,5
4,3,6,4,5
4,3,7,4,5
4,3,8,4,5
4,3,9,4,5
4,3,10,4,5
4,3,11,4,5
4,3,12,4,5
4,3,13,4,5
4,3,14,4,5
4,3,15,4,5
4,3,16,4,5
4,3,17,4,5
4,3,18,4,5
4,3,19,4,5
4,4,0,4,5
4,4,1,4,5
4,4,2,4,5
4,4,3,4,5
4,4,4,4,5
4,4,5,4,5
4,4,6,4,5
4,4,7,4,5
4,4,8,4,5
4,4,9,4,5
4,4,10,4,5
4,4,11,4,5
4,4,12,4,5
4,4,13,4,5
4,4,14,4,5
4,4,15,4,5
4,4,16,4,5
4,4,17,4,5
4,4,18,4,5
4,4,19,4,5
4,5,0,4,5
4,5,1,4,5
4,5,2,4,5
4,5,3,4,5
4,5,4,4,5
4,5,5,4,5
4,5,6,4,5
4,5,7,4,5
4,5,8,4,5
4,5,9,4,5
4,5,10,4,5
4,5,11,4,5
4,5,12,4,5
4,5,13,4,5
4,5,14,4,5
4,5,15,4,5
4,5,16,4,5
4,5,17,4,5
4,5,18,4,5
4,5,19,4,5
4,6,0,4,5
4,6,1,4,5
4,6,2,4,5
4,6,3,4,5
4,6,4,4,5
4,6,5,4,5
4,6,6,4,5
4,6,7,4,5
4,6,8,4,5
4,6,9,4,5
4,6,10,4,5
4,6,11,4,5
4,6,12,4,5
4,6,13,4,5
4,6,14,4,5
4,6,15,4,5
4,6,16,4,5
4,6,17,4,5
4,6,18,4,5
4,6,19,4,5
4,7,0,4,5
4,7,1,4,5
4,7,2,4,5
4,7,3,4,5
4,7,4,4,5
4,7,5,4,5
4,7,6,4,5
4,7,7,4,5
4,7,8,4,5
4,7,9,4,5
4,7,10,4,5
4,7,11,4,5
4,7,12,4,5
4,7,13,4,5
4,7,14,4,5
4,7,15,4,5
4,7,16,4,5
4,7,17,4,5
4,7,18,4,5
4,7,19,4,5
4,8,0,4,5
4,8,1,4,5
4,8,2,4,5
4,8,3,4,5
4,8,4,4,5
4,8,5,4,5
4,8,6,4,5
4,8,7,4,5
4,8,8,4,5
4,8,9,4,5
4,8,10,4,5
4,8,11,4,5
4,8,12,4,5
4,8,13,4,5
4,8,14,4,5
4,8,15,4,5
4,8,16,4,5
4,8,17,4,5
4,8,18,4,5
4,8,19,4,5
4,9,0,4,5
4,9,1,4,5
4,9,2,4,5
4,9,3,4,5
4,9,4,4,5
4,9,5,4,5
4,9,6,4,5
4,9,7,4,5
4,9,8,4,5
4,9,9,4,5
4,9,10,4,5
4,9,11,4,5
4,9,12,4,5
4,9,13,4,5
4,9,14,4,5
4,9,15,4,5
4,9,16,4,5
4,9,17,4,5
4,9,18,4,5
4,9,19,4,5
4,10,0,4,5
4,10,1,4,5
4,10,2,4,5
4,10,3,4,5
4,10,4,4,5
4,10,5,4,5
4,10,6,4,5
4,10,7,4,5
4,10,8,4,5
4,10,9,4,5
4,10,10,4,5
4,10,11,4,5
4,10,12,4,5
4,10,13,4,5
4,10,14,4,5
4,10,15,4,5
4,10,16,4,5
4,10,17,4,5
4,10,18,4,5
4,10,19,4,5
4,11,0,4,5
4,11,1,4,5
4,11,2,4,5
4,11,3,4,5
4,11,4,4,5
4,11,5,4,5
4,11,6,4,5
4,11,7,4,5
4,11,8,4,5
4,11,9,4,5
4,11,10,4,5
4,11,11,4,5
4,11,12,4,5
4,11,13,4,5
4,11,14,4,5
4,11,15,4,5
4,11,16,4,5
4,11,17,4,5
4,11,18,4,5
4,11,19,4,5
4,12,0,4,5
4,12,1,4,5
4,12,2,4,5
4,12,3,4,5
4,12,4,4,5
4,12,5,4,5
4,12,6,4,5
4,12,7,4,5
4,12,8,4,5
4,12,9,4,5
4,12,10,4,5
4,12,11,4,5
4,12,12,4,5
4,12,13,4,5
4,12,14,4,5
4,12,15,4,5
4,12,16,4,5
4,12,17,4,5
4,12,18,4,5
4,12,19,4,5
4,0,0,5,5
4,0,1,5,5
4,0,2,5,5
4,0,3,5,5
4,0,4,5,5
4,0,5,5,5
4,0,6,5,5
4,0,7,5,5
4,0,8,5,5
4,0,9,5,5
4,0,10,5,5
4,0,11,5,5
4,0,12,5,5
4,0,13,5,5
4,0,14,5,5
4,0,15,5,5
4,0,16,5,5
4,0,17,5,5
4,0,18,5,5
4,0,19,5,5
4,1,0,5,5
4,1,1,5,5
4,1,2,5,5
4,1,3,5,5
4,1,4,5,5
4,1,5,5,5
4,1,6,5,5
4,1,7,5,5
4,1,8,5,5
4,1,9,5,5
4,1,10,5,5
4,1,11,5,5
4,1,12,5,5
4,1,13,5,5
4,1,14,5,5
4,1,15,5,5
4,1,16,5,5
4,1,17,5,5
4,1,18,5,5
4,1,19,5,5
4,2,0,5,5
4,2,1,5,5
4,2,2,5,5
4,2,3,5,5
4,2,4,5,5
4,2,5,5,5
4,2,6,5,5
4,2,7,5,5
4,2,8,5,5
4,2,9,5,5
4,2,10,5,5
4,2,11,5,5
4,2,12,5,5
4,2,13,5,5
4,2,14,5,5
4,2,15,5,5
4,2,16,5,5
4,2,17,5,5
4,2,18,5,5
4,2,19,5,5
4,3,0,5,5
4,3,1,5,5
4,3,2,5,5
4,3,3,5,5
4,3,4,5,5
4,3,5,5,5
4,3,6,5,5
4,3,7,5,5
4,3,8,5,5
4,3,9,5,5
4,3,10,5,5
4,3,11,5,5
4,3,12,5,5
4,3,13,5,5
4,3,14,5,5
4,3,15,5,5
4,3,16,5,5
4,3,17,5,5
4,3,18,5,5
4,3,19,5,5
4,4,0,5,5
4,4,1,5,5
4,4,2,5,5
4,4,3,5,5
4,4,4,5,5
4,4,5,5,5
4,4,6,5,5
4,4,7,5,5
4,4,8,5,5
4,4,9,5,5
4,4,10,5,5
4,4,11,5,5
4,4,12,5,5
4,4,13,5,5
4,4,14,5,5
4,4,15,5,5
4,4,16,5,5
4,4,17,5,5
4,4,18,5,5
4,4,19,5,5
4,5,0,5,5
4,5,1,5,5
4,5,2,5,5
4,5,3,5,5
4,5,4,5,5
4,5,5,5,5
4,5,6,5,5
4,5,7,5,5
4,5,8,5,5
4,5,9,5,5
4,5,10,5,5
4,5,11,5,5
4,5,12,5,5
4,5,13,5,5
4,5,14,5,5
4,5,15,5,5
4,5,16,5,5
4,5,17,5,5
4,5,18,5,5
4,5,19,5,5
4,6,0,5,5
4,6,1,5,5
4,6,2,5,5
4,6,3,5,5
4,6,4,5,5
4,6,5,5,5
4,6,6,5,5
4,6,7,5,5
4,6,8,5,5
4,6,9,5,5
4,6,10,5,5
4,6,11,5,5
4,6,12,5,5
4,6,13,5,5
4,6,14,5,5
4,6,15,5,5
4,6,16,5,5
4,6,17,5,5
4,6,18,5,5
4,6,19,5,5
4,7,0,5,5
4,7,1,5,5
4,7,2,5,5
4,7,3,5,5
4,7,4,5,5
4,7,5,5,5
4,7,6,5,5
4,7,7,5,5
4,7,8,5,5
4,7,9,5,5
4,7,10,5,5
4,7,11,5,5
4,7,12,5,5
4,7,13,5,5
4,7,14,5,5
4,7,15,5,5
4,7,16,5,5
4,7,17,5,5
4,7,18,5,5
4,7,19,5,5
4,8,0,5,5
4,8,1,5,5
4,8,2,5,5
4,8,3,5,5
4,8,4,5,5
4,8,5,5,5
4,8,6,5,5
4,8,7,5,5
4,8,8,5,5
4,8,9,5,5
4,8,10,5,5
4,8,11,5,5
4,8,12,5,5
4,8,13,5,5
4,8,14,5,5
4,8,15,5,5
4,8,16,5,5
4,8,17,5,5
4,8,18,5,5
4,8,19,5,5
4,9,0,5,5
4,9,1,5,5
4,9,2,5,5
4,9,3,5,5
4,9,4,5,5
4,9,5,5,5
4,9,6,5,5
4,9,7,5,5
4,9,8,5,5
4,9,9,5,5
4,9,10,5,5
4,9,11,5,5
4,9,12,5,5
4,9,13,5,5
4,9,14,5,5
4,9,15,5,5
4,9,16,5,5
4,9,17,5,5
4,9,18,5,5
4,9,19,5,5
4,0,0,6,5
4,0,1,6,5
4,0,2,6,5
4,0,3,6,5
4,0,4,6,5
4,0,5,6,5
4,0,6,6,5
4,0,7,6,5
4,0,8,6,5
4,0,9,6,5
4,0,10,6,5
4,0,11,6,5
4,0,12,6,5
4,0,13,6,5
4,0,14,6,5
4,0,15,6,5
4,0,16,6,5
4,0,17,6,5
4,0,18,6,5
4,0,19,6,5
4,1,0,6,5
4,1,1,6,5
4,1,2,6,5
4,1,3,6,5
4,1,4,6,5
4,1,5,6,5
4,1,6,6,5
4,1,7,6,5
4,1,8,6,5
4,1,9,6,5
4,1,10,6,5
4,1,11,6,5
4,1,12,6,5
4,1,13,6,5
4,1,14,6,5
4,1,15,6,5
4,1,16,6,5
4,1,17,6,5
4,1,18,6,5
4,1,19,6,5
4,2,0,6,5
4,2,1,6,5
4,2,2,6,5
4,2,3,6,5
4,2,4,6,5
4,2,5,6,5
4,2,6,6,5
4,2,7,6,5
4,2,8,6,5
4,2,9,6,5
4,2,10,6,5
4,2,11,6,5
4,2,12,6,5
4,2,13,6,5
4,2,14,6,5
4,2,15,6,5
4,2,16,6,5
4,2,17,6,5
4,2,18,6,5
4,2,19,6,5
4,3,0,6,5
4,3,1,6,5
4,3,2,6,5
4,3,3,6,5
4,3,4,6,5
4,3,5,6,5
4,3,6,6,5
4,3,7,6,5
4,3,8,6,5
4,3,9,6,5
4,3,10,6,5
4,3,11,6,5
4,3,12,6,5
4,3,13,6,5
4,3,14,6,5
4,3,15,6,5
4,3,16,6,5
4,3,17,6,5
4,3,18,6,5
4,3,19,6,5
4,4,0,6,5
4,4,1,6,5
4,4,2,6,5
4,4,3,6,5
4,4,4,6,5
4,4,5,6,5
4,4,6,6,5
4,4,7,6,5
4,4,8,6,5
4,4,9,6,5
4,4,10,6,5
4,4,11,6,5
4,4,12,6,5
4,4,13,6,5
4,4,14,6,5
4,4,15,6,5
4,4,16,6,5
4,4,17,6,5
4,4,18,6,5
4,4,19,6,5
4,5,0,6,5
4,5,1,6,5
4,5,2,6,5
4,5,3,6,5
4,5,4,6,5
4,5,5,6,5
4,5,6,6,5
4,5,7,6,5
4,5,8,6,5
4,5,9,6,5
4,5,10,6,5
4,5,11,6,5
4,5,12,6,5
4,5,13,6,5
4,5,14,6,5
4,5,15,6,5
4,5,16,6,5
4,5,17,6,5
4,5,18,6,5
4,5,19,6,5
4,6,0,6,5
4,6,1,6,5
4,6,2,6,5
4,6,3,6,5
4,6,4,6,5
4,6,5,6,5
4,6,6,6,5
4,6,7,6,5
4,6,8,6,5
4,6,9,6,5
4,6,10,6,5
4,6,11,6,5
4,6,12,6,5
4,6,13,6,5
4,6,14,6,5
4,6,15,6,5
4,6,16,6,5
4,6,17,6,5
4,6,18,6,5
4,6,19,6,5
4,0,0,7,5
4,0,1,7,5
4,0,2,7,5
4,0,3,7,5
4,0,4,7,5
4,0,5,7,5
4,0,6,7,5
4,0,7,7,5
4,0,8,7,5
4,0,9,7,5
4,0,10,7,5
4,0,11,7,5
4,0,12,7,5
4,0,13,7,5
4,0,14,7,5
4,0,15,7,5
4,0,16,7,5
4,0,17,7,5
4,0,18,7,5
4,0,19,7,5
4,1,0,7,5
4,1,1,7,5
4,1,2,7,5
4,1,3,7,5
4,1,4,7,5
4,1,5,7,5
4,1,6,7,5
4,1,7,7,5
4,1,8,7,5
4,1,9,7,5
4,1,10,7,5
4,1,11,7,5
4,1,12,7,5
4,1,13,7,5
4,1,14,7,5
4,1,15,7,5
4,1,16,7,5
4,1,17,7,5
4,1,18,7,5
4,1,19,7,5
4,2,0,7,5
4,2,1,7,5
4,2,2,7,5
4,2,3,7,5
4,2,4,7,5
4,2,5,7,5
4,2,6,7,5
4,2,7,7,5
4,2,8,7,5
4,2,9,7,5
4,2,10,7,5
4,2,11,7,5
4,2,12,7,5
4,2,13,7,5
4,2,14,7,5
4,2,15,7,5
4,2,16,7,5
4,2,17,7,5
4,2,18,7,5
4,2,19,7,5
4,3,0,7,5
4,3,1,7,5
4,3,2,7,5
4,3,3,7,5
4,3,4,7,5
4,3,5,7,5
4,3,6,7,5
4,3,7,7,5
4,3,8,7,5
4,3,9,7,5
4,3,10,7,5
4,3,11,7,5
4,3,12,7,5
4,3,13,7,5
4,3,14,7,5
4,3,15,7,5
4,3,16,7,5
4,3,17,7,5
4,3,18,7,5
4,3,19,7,5
4,0,0,8,5
4,0,1,8,5
4,0,2,8,5
4,0,3,8,5
4,0,4,8,5
4,0,5,8,5
4,0,6,8,5
4,0,7,8,5
4,0,8,8,5
4,0,9,8,5
4,0,10,8,5
4,0,11,8,5
4,0,12,8,5
4,0,13,8,5
4,0,14,8,5
4,0,15,8,5
4,0,16,8,5
4,0,17,8,5
4,0,18,8,5
4,0,19,8,5
4,0,0,1,6
4,0,1,1,6
4,0,2,1,6
4,0,3,1,6
4,0,4,1,6
4,0,5,1,6
4,0,6,1,6
4,0,7,1,6
4,0,8,1,6
4,0,9,1,6
4,0,10,1,6
4,0,11,1,6
4,0,12,1,6
4,0,13,1,6
4,0,14,1,6
4,0,15,1,6
4,0,16,1,6
4,0,17,1,6
4,0,18,1,6
4,1,0,1,6
4,1,1,1,6
4,1,2,1,6
4,1,3,1,6
4,1,4,1,6
4,1,5,1,6
4,1,6,1,6
4,1,7,1,6
4,1,8,1,6
4,1,9,1,6
4,1,10,1,6
4,1,11,1,6
4,1,12,1,6
4,1,13,1,6
4,1,14,1,6
4,1,15,1,6
4,1,16,1,6
4,1,17,1,6
4,1,18,1,6
4,2,0,1,6
4,2,1,1,6
4,2,2,1,6
4,2,3,1,6
4,2,4,1,6
4,2,5,1,6
4,2,6,1,6
4,2,7,1,6
4,2,8,1,6
4,2,9,1,6
4,2,10,1,6
4,2,11,1,6
4,2,12,1,6
4,2,13,1,6
4,2,14,1,6
4,2,15,1,6
4,2,16,1,6
4,2,17,1,6
4,2,18,1,6
4,3,0,1,6
4,3,1,1,6
4,3,2,1,6
4,3,3,1,6
4,3,4,1,6
4,3,5,1,6
4,3,6,1,6
4,3,7,1,6
4,3,8,1,6
4,3,9,1,6
4,3,10,1,6
4,3,11,1,6
4,3,12,1,6
4,3,13,1,6
4,3,14,1,6
4,3,15,1,6
4,3,16,1,6
4,3,17,1,6
4,3,18,1,6
4,4,0,1,6
4,4,1,1,6
4,4,2,1,6
4,4,3,1,6
4,4,4,1,6
4,4,5,1,6
4,4,6,1,6
4,4,7,1,6
4,4,8,1,6
4,4,9,1,6
4,4,10,1,6
4,4,11,1,6
4,4,12,1,6
4,4,13,1,6
4,4,14,1,6
4,4,15,1,6
4,4,16,1,6
4,4,17,1,6
4,4,18,1,6
4,5,0,1,6
4,5,1,1,6
4,5,2,1,6
4,5,3,1,6
4,5,4,1,6
4,5,5,1,6
4,5,6,1,6
4,5,7,1,6
4,5,8,1,6
4,5,9,1,6
4,5,10,1,6
4,5,11,1,6
4,5,12,1,6
4,5,13,1,6
4,5,14,1,6
4,5,15,1,6
4,5,16,1,6
4,5,17,1,6
4,5,18,1,6
4,6,0,1,6
4,6,1,1,6
4,6,2,1,6
4,6,3,1,6
4,6,4,1,6
4,6,5,1,6
4,6,6,1,6
4,6,7,1,6
4,6,8,1,6
4,6,9,1,6
4,6,10,1,6
4,6,11,1,6
4,6,12,1,6
4,6,13,1,6
4,6,14,1,6
4,6,15,1,6
4,6,16,1,6
4,6,17,1,6
4,6,18,1,6
4,7,0,1,6
4,7,1,1,6
4,7,2,1,6
4,7,3,1,6
4,7,4,1,6
4,7,5,1,6
4,7,6,1,6
4,7,7,1,6
4,7,8,1,6
4,7,9,1,6
4,7,10,1,6
4,7,11,1,6
4,7,12,1,6
4,7,13,1,6
4,7,14,1,6
4,7,15,1,6
4,7,16,1,6
4,7,17,1,6
4,7,18,1,6
4,8,0,1,6
4,8,1,1,6
4,8,2,1,6
4,8,3,1,6
4,8,4,1,6
4,8,5,1,6
4,8,6,1,6
4,8,7,1,6
4,8,8,1,6
4,8,9,1,6
4,8,10,1,6
4,8,11,1,6
4,8,12,1,6
4,8,13,1,6
4,8,14,1,6
4,8,15,1,6
4,8,16,1,6
4,8,17,1,6
4,8,18,1,6
4,9,0,1,6
4,9,1,1,6
4,9,2,1,6
4,9,3,1,6
4,9,4,1,6
4,9,5,1,6
4,9,6,1,6
4,9,7,1,6
4,9,8,1,6
4,9,9,1,6
4,9,10,1,6
4,9,11,1,6
4,9,12,1,6
4,9,13,1,6
4,9,14,1,6
4,9,15,1,6
4,9,16,1,6
4,9,17,1,6
4,9,18,1,6
4,10,0,1,6
4,10,1,1,6
4,10,2,1,6
4,10,3,1,6
4,10,4,1,6
4,10,5,1,6
4,10,6,1,6
4,10,7,1,6
4,10,8,1,6
4,10,9,1,6
4,10,10,1,6
4,10,11,1,6
4,10,12,1,6
4,10,13,1,6
4,10,14,1,6
4,10,15,1,6
4,10,16,1,6
4,10,17,1,6
4,10,18,1,6
4,11,0,1,6
4,11,1,1,6
4,11,2,1,6
4,11,3,1,6
4,11,4,1,6
4,11,5,1,6
4,11,6,1,6
4,11,7,1,6
4,11,8,1,6
4,11,9,1,6
4,11,10,1,6
4,11,11,1,6
4,11,12,1,6
4,11,13,1,6
4,11,14,1,6
4,11,15,1,6
4,11,16,1,6
4,11,17,1,6
4,11,18,1,6
4,12,0,1,6
4,12,1,1,6
4,12,2,1,6
4,12,3,1,6
4,12,4,1,6
4,12,5,1,6
4,12,6,1,6
4,12,7,1,6
4,12,8,1,6
4,12,9,1,6
4,12,10,1,6
4,12,11,1,6
4,12,12,1,6
4,12,13,1,6
4,12,14,1,6
4,12,15,1,6
4,12,16,1,6
4,12,17,1,6
4,12,18,1,6
4,13,0,1,6
4,13,1,1,6
4,13,2,1,6
4,13,3,1,6
4,13,4,1,6
4,13,5,1,6
4,13,6,1,6
4,13,7,1,6
4,13,8,1,6
4,13,9,1,6
4,13,10,1,6
4,13,11,1,6
4,13,12,1,6
4,13,13,1,6
4,13,14,1,6
4,13,15,1,6
4,13,16,1,6
4,13,17,1,6
4,13,18,1,6
4,14,0,1,6
4,14,1,1,6
4,14,2,1,6
4,14,3,1,6
4,14,4,1,6
4,14,5,1,6
4,14,6,1,6
4,14,7,1,6
4,14,8,1,6
4,14,9,1,6
4,14,10,1,6
4,14,11,1,6
4,14,12,1,6
4,14,13,1,6
4,14,14,1,6
4,14,15,1,6
4,14,16,1,6
4,14,17,1,6
4,14,18,1,6
4,15,0,1,6
4,15,1,1,6
4,15,2,1,6
4,15,3,1,6
4,15,4,1,6
4,15,5,1,6
4,15,6,1,6
4,15,7,1,6
4,15,8,1,6
4,15,9,1,6
4,15,10,1,6
4,15,11,1,6
4,15,12,1,6
4,15,13,1,6
4,15,14,1,6
4,15,15,1,6
4,15,16,1,6
4,15,17,1,6
4,15,18,1,6
4,16,0,1,6
4,16,1,1,6
4,16,2,1,6
4,16,3,1,6
4,16,4,1,6
4,16,5,1,6
4,16,6,1,6
4,16,7,1,6
4,16,8,1,6
4,16,9,1,6
4,16,10,1,6
4,16,11,1,6
4,16,12,1,6
4,16,13,1,6
4,16,14,1,6
4,16,15,1,6
4,16,16,1,6
4,16,17,1,6
4,16,18,1,6
4,17,0,1,6
4,17,1,1,6
4,17,2,1,6
4,17,3,1,6
4,17,4,1,6
4,17,5,1,6
4,17,6,1,6
4,17,7,1,6
4,17,8,1,6
4,17,9,1,6
4,17,10,1,6
4,17,11,1,6
4,17,12,1,6
4,17,13,1,6
4,17,14,1,6
4,17,15,1,6
4,17,16,1,6
4,17,17,1,6
4,17,18,1,6
4,18,0,1,6
4,18,1,1,6
4,18,2,1,6
4,18,3,1,6
4,18,4,1,6
4,18,5,1,6
4,18,6,1,6
4,18,7,1,6
4,18,8,1,6
4,18,9,1,6
4,18,10,1,6
4,18,11,1,6
4,18,12,1,6
4,18,13,1,6
4,18,14,1,6
4,18,15,1,6
4,18,16,1,6
4,18,17,1,6
4,18,18,1,6
4,19,0,1,6
4,19,1,1,6
4,19,2,1,6
4,19,3,1,6
4,19,4,1,6
4,19,5,1,6
4,19,6,1,6
4,19,7,1,6
4,19,8,1,6
4,19,9,1,6
4,19,10,1,6
4,19,11,1,6
4,19,12,1,6
4,19,13,1,6
4,19,14,1,6
4,19,15,1,6
4,19,16,1,6
4,19,17,1,6
4,19,18,1,6
4,20,0,1,6
4,20,1,1,6
4,20,2,1,6
4,20,3,1,6
4,20,4,1,6
4,20,5,1,6
4,20,6,1,6
4,20,7,1,6
4,20,8,1,6
4,20,9,1,6
4,20,10,1,6
4,20,11,1,6
4,20,12,1,6
4,20,13,1,6
4,20,14,1,6
4,20,15,1,6
4,20,16,1,6
4,20,17,1,6
4,20,18,1,6
4,21,0,1,6
4,21,1,1,6
4,21,2,1,6
4,21,3,1,6
4,21,4,1,6
4,21,5,1,6
4,21,6,1,6
4,21,7,1,6
4,21,8,1,6
4,21,9,1,6
4,21,10,1,6
4,21,11,1,6
4,21,12,1,6
4,21,13,1,6
4,21,14,1,6
4,21,15,1,6
4,21,16,1,6
4,21,17,1,6
4,21,18,1,6
4,0,0,2,6
4,0,1,2,6
4,0,2,2,6
4,0,3,2,6
4,0,4,2,6
4,0,5,2,6
4,0,6,2,6
4,0,7,2,6
4,0,8,2,6
4,0,9,2,6
4,0,10,2,6
4,0,11,2,6
4,0,12,2,6
4,0,13,2,6
4,0,14,2,6
4,0,15,2,6
4,0,16,2,6
4,0,17,2,6
4,0,18,2,6
4,1,0,2,6
4,1,1,2,6
4,1,2,2,6
4,1,3,2,6
4,1,4,2,6
4,1,5,2,6
4,1,6,2,6
4,1,7,2,6
4,1,8,2,6
4,1,9,2,6
4,1,10,2,6
4,1,11,2,6
4,1,12,2,6
4,1,13,2,6
4,1,14,2,6
4,1,15,2,6
4,1,16,2,6
4,1,17,2,6
4,1,18,2,6
4,2,0,2,6
4,2,1,2,6
4,2,2,2,6
4,2,3,2,6
4,2,4,2,6
4,2,5,2,6
4,2,6,2,6
4,2,7,2,6
4,2,8,2,6
4,2,9,2,6
4,2,10,2,6
4,2,11,2,6
4,2,12,2,6
4,2,13,2,6
4,2,14,2,6
4,2,15,2,6
4,2,16,2,6
4,2,17,2,6
4,2,18,2,6
4,3,0,2,6
4,3,1,2,6
4,3,2,2,6
4,3,3,2,6
4,3,4,2,6
4,3,5,2,6
4,3,6,2,6
4,3,7,2,6
4,3,8,2,6
4,3,9,2,6
4,3,10,2,6
4,3,11,2,6
4,3,12,2,6
4,3,13,2,6
4,3,14,2,6
4,3,15,2,6
4,3,16,2,6
4,3,17,2,6
4,3,18,2,6
4,4,0,2,6
4,4,1,2,6
4,4,2,2,6
4,4,3,2,6
4,4,4,2,6
4,4,5,2,6
4,4,6,2,6
4,4,7,2,6
4,4,8,2,6
4,4,9,2,6
4,4,10,2,6
4,4,11,2,6
4,4,12,2,6
4,4,13,2,6
4,4,14,2,6
4,4,15,2,6
4,4,16,2,6
4,4,17,2,6
4,4,18,2,6
4,5,0,2,6
4,5,1,2,6
4,5,2,2,6
4,5,3,2,6
4,5,4,2,6
4,5,5,2,6
4,5,6,2,6
4,5,7,2,6
4,5,8,2,6
4,5,9,2,6
4,5,10,2,6
4,5,11,2,6
4,5,12,2,6
4,5,13,2,6
4,5,14,2,6
4,5,15,2,6
4,5,16,2,6
4,5,17,2,6
4,5,18,2,6
4,6,0,2,6
4,6,1,2,6
4,6,2,2,6
4,6,3,2,6
4,6,4,2,6
4,6,5,2,6
4,6,6,2,6
4,6,7,2,6
4,6,8,2,6
4,6,9,2,6
4,6,10,2,6
4,6,11,2,6
4,6,12,2,6
4,6,13,2,6
4,6,14,2,6
4,6,15,2,6
4,6,16,2,6
4,6,17,2,6
4,6,18,2,6
4,7,0,2,6
4,7,1,2,6
4,7,2,2,6
4,7,3,2,6
4,7,4,2,6
4,7,5,2,6
4,7,6,2,6
4,7,7,2,6
4,7,8,2,6
4,7,9,2,6
4,7,10,2,6
4,7,11,2,6
4,7,12,2,6
4,7,13,2,6
4,7,14,2,6
4,7,15,2,6
4,7,16,2,6
4,7,17,2,6
4,7,18,2,6
4,8,0,2,6
4,8,1,2,6
4,8,2,2,6
4,8,3,2,6
4,8,4,2,6
4,8,5,2,6
4,8,6,2,6
4,8,7,2,6
4,8,8,2,6
4,8,9,2,6
4,8,10,2,6
4,8,11,2,6
4,8,12,2,6
4,8,13,2,6
4,8,14,2,6
4,8,15,2,6
4,8,16,2,6
4,8,17,2,6
4,8,18,2,6
4,9,0,2,6
4,9,1,2,6
4,9,2,2,6
4,9,3,2,6
4,9,4,2,6
4,9,5,2,6
4,9,6,2,6
4,9,7,2,6
4,9,8,2,6
4,9,9,2,6
4,9,10,2,6
4,9,11,2,6
4,9,12,2,6
4,9,13,2,6
4,9,14,2,6
4,9,15,2,6
4,9,16,2,6
4,9,17,2,6
4,9,18,2,6
4,10,0,2,6
4,10,1,2,6
4,10,2,2,6
4,10,3,2,6
4,10,4,2,6
4,10,5,2,6
4,10,6,2,6
4,10,7,2,6
4,10,8,2,6
4,10,9,2,6
4,10,10,2,6
4,10,11,2,6
4,10,12,2,6
4,10,13,2,6
4,10,14,2,6
4,10,15,2,6
4,10,16,2,6
4,10,17,2,6
4,10,18,2,6
4,11,0,2,6
4,11,1,2,6
4,11,2,2,6
4,11,3,2,6
4,11,4,2,6
4,11,5,2,6
4,11,6,2,6
4,11,7,2,6
4,11,8,2,6
4,11,9,2,6
4,11,10,2,6
4,11,11,2,6
4,11,12,2,6
4,11,13,2,6
4,11,14,2,6
4,11,15,2,6
4,11,16,2,6
4,11,17,2,6
4,11,18,2,6
4,12,0,2,6
4,12,1,2,6
4,12,2,2,6
4,12,3,2,6
4,12,4,2,6
4,12,5,2,6
4,12,6,2,6
4,12,7,2,6
4,12,8,2,6
4,12,9,2,6
4,12,10,2,6
4,12,11,2,6
4,12,12,2,6
4,12,13,2,6
4,12,14,2,6
4,12,15,2,6
4,12,16,2,6
4,12,17,2,6
4,12,18,2,6
4,13,0,2,6
4,13,1,2,6
4,13,2,2,6
4,13,3,2,6
4,13,4,2,6
4,13,5,2,6
4,13,6,2,6
4,13,7,2,6
4,13,8,2,6
4,13,9,2,6
4,13,10,2,6
4,13,11,2,6
4,13,12,2,6
4,13,13,2,6
4,13,14,2,6
4,13,15,2,6
4,13,16,2,6
4,13,17,2,6
4,13,18,2,6
4,14,0,2,6
4,14,1,2,6
4,14,2,2,6
4,14,3,2,6
4,14,4,2,6
4,14,5,2,6
4,14,6,2,6
4,14,7,2,6
4,14,8,2,6
4,14,9,2,6
4,14,10,2,6
4,14,11,2,6
4,14,12,2,6
4,14,13,2,6
4,14,14,2,6
4,14,15,2,6
4,14,16,2,6
4,14,17,2,6
4,14,18,2,6
4,15,0,2,6
4,15,1,2,6
4,15,2,2,6
4,15,3,2,6
4,15,4,2,6
4,15,5,2,6
4,15,6,2,6
4,15,7,2,6
4,15,8,2,6
4,15,9,2,6
4,15,10,2,6
4,15,11,2,6
4,15,12,2,6
4,15,13,2,6
4,15,14,2,6
4,15,15,2,6
4,15,16,2,6
4,15,17,2,6
4,15,18,2,6
4,16,0,2,6
4,16,1,2,6
4,16,2,2,6
4,16,3,2,6
4,16,4,2,6
4,16,5,2,6
4,16,6,2,6
4,16,7,2,6
4,16,8,2,6
4,16,9,2,6
4,16,10,2,6
4,16,11,2,6
4,16,12,2,6
4,16,13,2,6
4,16,14,2,6
4,16,15,2,6
4,16,16,2,6
4,16,17,2,6
4,16,18,2,6
4,17,0,2,6
4,17,1,2,6
4,17,2,2,6
4,17,3,2,6
4,17,4,2,6
4,17,5,2,6
4,17,6,2,6
4,17,7,2,6
4,17,8,2,6
4,17,9,2,6
4,17,10,2,6
4,17,11,2,6
4,17,12,2,6
4,17,13,2,6
4,17,14,2,6
4,17,15,2,6
4,17,16,2,6
4,17,17,2,6
4,17,18,2,6
4,18,0,2,6
4,18,1,2,6
4,18,2,2,6
4,18,3,2,6
4,18,4,2,6
4,18,5,2,6
4,18,6,2,6
4,18,7,2,6
4,18,8,2,6
4,18,9,2,6
4,18,10,2,6
4,18,11,2,6
4,18,12,2,6
4,18,13,2,6
4,18,14,2,6
4,18,15,2,6
4,18,16,2,6
4,18,17,2,6
4,18,18,2,6
4,0,0,3,6
4,0,1,3,6
4,0,2,3,6
4,0,3,3,6
4,0,4,3,6
4,0,5,3,6
4,0,6,3,6
4,0,7,3,6
4,0,8,3,6
4,0,9,3,6
4,0,10,3,6
4,0,11,3,6
4,0,12,3,6
4,0,13,3,6
4,0,14,3,6
4,0,15,3,6
4,0,16,3,6
4,0,17,3,6
4,0,18,3,6
4,1,0,3,6
4,1,1,3,6
4,1,2,3,6
4,1,3,3,6
4,1,4,3,6
4,1,5,3,6
4,1,6,3,6
4,1,7,3,6
4,1,8,3,6
4,1,9,3,6
4,1,10,3,6
4,1,11,3,6
4,1,12,3,6
4,1,13,3,6
4,1,14,3,6
4,1,15,3,6
4,1,16,3,6
4,1,17,3,6
4,1,18,3,6
4,2,0,3,6
4,2,1,3,6
4,2,2,3,6
4,2,3,3,6
4,2,4,3,6
4,2,5,3,6
4,2,6,3,6
4,2,7,3,6
4,2,8,3,6
4,2,9,3,6
4,2,10,3,6
4,2,11,3,6
4,2,12,3,6
4,2,13,3,6
4,2,14,3,6
4,2,15,3,6
4,2,16,3,6
4,2,17,3,6
4,2,18,3,6
4,3,0,3,6
4,3,1,3,6
4,3,2,3,6
4,3,3,3,6
4,3,4,3,6
4,3,5,3,6
4,3,6,3,6
4,3,7,3,6
4,3,8,3,6
4,3,9,3,6
4,3,10,3,6
4,3,11,3,6
4,3,12,3,6
4,3,13,3,6
4,3,14,3,6
4,3,15,3,6
4,3,16,3,6
4,3,17,3,6
4,3,18,3,6
4,4,0,3,6
4,4,1,3,6
4,4,2,3,6
4,4,3,3,6
4,4,4,3,6
4,4,5,3,6
4,4,6,3,6
4,4,7,3,6
4,4,8,3,6
4,4,9,3,6
4,4,10,3,6
4,4,11,3,6
4,4,12,3,6
4,4,13,3,6
4,4,14,3,6
4,4,15,3,6
4,4,16,3,6
4,4,17,3,6
4,4,18,3,6
4,5,0,3,6
4,5,1,3,6
4,5,2,3,6
4,5,3,3,6
4,5,4,3,6
4,5,5,3,6
4,5,6,3,6
4,5,7,3,6
4,5,8,3,6
4,5,9,3,6
4,5,10,3,6
4,5,11,3,6
4,5,12,3,6
4,5,13,3,6
4,5,14,3,6
4,5,15,3,6
4,5,16,3,6
4,5,17,3,6
4,5,18,3,6
4,6,0,3,6
4,6,1,3,6
4,6,2,3,6
4,6,3,3,6
4,6,4,3,6
4,6,5,3,6
4,6,6,3,6
4,6,7,3,6
4,6,8,3,6
4,6,9,3,6
4,6,10,3,6
4,6,11,3,6
4,6,12,3,6
4,6,13,3,6
4,6,14,3,6
4,6,15,3,6
4,6,16,3,6
4,6,17,3,6
4,6,18,3,6
4,7,0,3,6
4,7,1,3,6
4,7,2,3,6
4,7,3,3,6
4,7,4,3,6
4,7,5,3,6
4,7,6,3,6
4,7,7,3,6
4,7,8,3,6
4,7,9,3,6
4,7,10,3,6
4,7,11,3,6
4,7,12,3,6
4,7,13,3,6
4,7,14,3,6
4,7,15,3,6
4,7,16,3,6
4,7,17,3,6
4,7,18,3,6
4,8,0,3,6
4,8,1,3,6
4,8,2,3,6
4,8,3,3,6
4,8,4,3,6
4,8,5,3,6
4,8,6,3,6
4,8,7,3,6
4,8,8,3,6
4,8,9,3,6
4,8,10,3,6
4,8,11,3,6
4,8,12,3,6
4,8,13,3,6
4,8,14,3,6
4,8,15,3,6
4,8,16,3,6
4,8,17,3,6
4,8,18,3,6
4,9,0,3,6
4,9,1,3,6
4,9,2,3,6
4,9,3,3,6
4,9,4,3,6
4,9,5,3,6
4,9,6,3,6
4,9,7,3,6
4,9,8,3,6
4,9,9,3,6
4,9,10,3,6
4,9,11,3,6
4,9,12,3,6
4,9,13,3,6
4,9,14,3,6
4,9,15,3,6
4,9,16,3,6
4,9,17,3,6
4,9,18,3,6
4,10,0,3,6
4,10,1,3,6
4,10,2,3,6
4,10,3,3,6
4,10,4,3,6
4,10,5,3,6
4,10,6,3,6
4,10,7,3,6
4,10,8,3,6
4,10,9,3,6
4,10,10,3,6
4,10,11,3,6
4,10,12,3,6
4,10,13,3,6
4,10,14,3,6
4,10,15,3,6
4,10,16,3,6
4,10,17,3,6
4,10,18,3,6
4,11,0,3,6
4,11,1,3,6
4,11,2,3,6
4,11,3,3,6
4,11,4,3,6
4,11,5,3,6
4,11,6,3,6
4,11,7,3,6
4,11,8,3,6
4,11,9,3,6
4,11,10,3,6
4,11,11,3,6
4,11,12,3,6
4,11,13,3,6
4,11,14,3,6
4,11,15,3,6
4,11,16,3,6
4,11,17,3,6
4,11,18,3,6
4,12,0,3,6
4,12,1,3,6
4,12,2,3,6
4,12,3,3,6
4,12,4,3,6
4,12,5,3,6
4,12,6,3,6
4,12,7,3,6
4,12,8,3,6
4,12,9,3,6
4,12,10,3,6
4,12,11,3,6
4,12,12,3,6
4,12,13,3,6
4,12,14,3,6
4,12,15,3,6
4,12,16,3,6
4,12,17,3,6
4,12,18,3,6
4,13,0,3,6
4,13,1,3,6
4,13,2,3,6
4,13,3,3,6
4,13,4,3,6
4,13,5,3,6
4,13,6,3,6
4,13,7,3,6
4,13,8,3,6
4,13,9,3,6
4,13,10,3,6
4,13,11,3,6
4,13,12,3,6
4,13,13,3,6
4,13,14,3,6
4,13,15,3,6
4,13,16,3,6
4,13,17,3,6
4,13,18,3,6
4,14,0,3,6
4,14,1,3,6
4,14,2,3,6
4,14,3,3,6
4,14,4,3,6
4,14,5,3,6
4,14,6,3,6
4,14,7,3,6
4,14,8,3,6
4,14,9,3,6
4,14,10,3,6
4,14,11,3,6
4,14,12,3,6
4,14,13,3,6
4,14,14,3,6
4,14,15,3,6
4,14,16,3,6
4,14,17,3,6
4,14,18,3,6
4,15,0,3,6
4,15,1,3,6
4,15,2,3,6
4,15,3,3,6
4,15,4,3,6
4,15,5,3,6
4,15,6,3,6
4,15,7,3,6
4,15,8,3,6
4,15,9,3,6
4,15,10,3,6
4,15,11,3,6
4,15,12,3,6
4,15,13,3,6
4,15,14,3,6
4,15,15,3,6
4,15,16,3,6
4,15,17,3,6
4,15,18,3,6
4,0,0,4,6
4,0,1,4,6
4,0,2,4,6
4,0,3,4,6
4,0,4,4,6
4,0,5,4,6
4,0,6,4,6
4,0,7,4,6
4,0,8,4,6
4,0,9,4,6
4,0,10,4,6
4,0,11,4,6
4,0,12,4,6
4,0,13,4,6
4,0,14,4,6
4,0,15,4,6
4,0,16,4,6
4,0,17,4,6
4,0,18,4,6
4,1,0,4,6
4,1,1,4,6
4,1,2,4,6
4,1,3,4,6
4,1,4,4,6
4,1,5,4,6
4,1,6,4,6
4,1,7,4,6
4,1,8,4,6
4,1,9,4,6
4,1,10,4,6
4,1,11,4,6
4,1,12,4,6
4,1,13,4,6
4,1,14,4,6
4,1,15,4,6
4,1,16,4,6
4,1,17,4,6
4,1,18,4,6
4,2,0,4,6
4,2,1,4,6
4,2,2,4,6
4,2,3,4,6
4,2,4,4,6
4,2,5,4,6
4,2,6,4,6
4,2,7,4,6
4,2,8,4,6
4,2,9,4,6
4,2,10,4,6
4,2,11,4,6
4,2,12,4,6
4,2,13,4,6
4,2,14,4,6
4,2,15,4,6
4,2,16,4,6
4,2,17,4,6
4,2,18,4,6
4,3,0,4,6
4,3,1,4,6
4,3,2,4,6
4,3,3,4,6
4,3,4,4,6
4,3,5,4,6
4,3,6,4,6
4,3,7,4,6
4,3,8,4,6
4,3,9,4,6
4,3,10,4,6
4,3,11,4,6
4,3,12,4,6
4,3,13,4,6
4,3,14,4,6
4,3,15,4,6
4,3,16,4,6
4,3,17,4,6
4,3,18,4,6
4,4,0,4,6
4,4,1,4,6
4,4,2,4,6
4,4,3,4,6
4,4,4,4,6
4,4,5,4,6
4,4,6,4,6
4,4,7,4,6
4,4,8,4,6
4,4,9,4,6
4,4,10,4,6
4,4,11,4,6
4,4,12,4,6
4,4,13,4,6
4,4,14,4,6
4,4,15,4,6
4,4,16,4,6
4,4,17,4,6
4,4,18,4,6
4,5,0,4,6
4,5,1,4,6
4,5,2,4,6
4,5,3,4,6
4,5,4,4,6
4,5,5,4,6
4,5,6,4,6
4,5,7,4,6
4,5,8,4,6
4,5,9,4,6
4,5,10,4,6
4,5,11,4,6
4,5,12,4,6
4,5,13,4,6
4,5,14,4,6
4,5,15,4,6
4,5,16,4,6
4,5,17,4,6
4,5,18,4,6
4,6,0,4,6
4,6,1,4,6
4,6,2,4,6
4,6,3,4,6
4,6,4,4,6
4,6,5,4,6
4,6,6,4,6
4,6,7,4,6
4,6,8,4,6
4,6,9,4,6
4,6,10,4,6
4,6,11,4,6
4,6,12,4,6
4,6,13,4,6
4,6,14,4,6
4,6,15,4,6
4,6,16,4,6
4,6,17,4,6
4,6,18,4,6
4,7,0,4,6
4,7,1,4,6
4,7,2,4,6
4,7,3,4,6
4,7,4,4,6
4,7,5,4,6
4,7,6,4,6
4,7,7,4,6
4,7,8,4,6
4,7,9,4,6
4,7,10,4,6
4,7,11,4,6
4,7,12,4,6
4,7,13,4,6
4,7,14,4,6
4,7,15,4,6
4,7,16,4,6
4,7,17,4,6
4,7,18,4,6
4,8,0,4,6
4,8,1,4,6
4,8,2,4,6
4,8,3,4,6
4,8,4,4,6
4,8,5,4,6
4,8,6,4,6
4,8,7,4,6
4,8,8,4,6
4,8,9,4,6
4,8,10,4,6
4,8,11,4,6
4,8,12,4,6
4,8,13,4,6
4,8,14,4,6
4,8,15,4,6
4,8,16,4,6
4,8,17,4,6
4,8,18,4,6
4,9,0,4,6
4,9,1,4,6
4,9,2,4,6
4,9,3,4,6
4,9,4,4,6
4,9,5,4,6
4,9,6,4,6
4,9,7,4,6
4,9,8,4,6
4,9,9,4,6
4,9,10,4,6
4,9,11,4,6
4,9,12,4,6
4,9,13,4,6
4,9,14,4,6
4,9,15,4,6
4,9,16,4,6
4,9,17,4,6
4,9,18,4,6
4,10,0,4,6
4,10,1,4,6
4,10,2,4,6
4,10,3,4,6
4,10,4,4,6
4,10,5,4,6
4,10,6,4,6
4,10,7,4,6
4,10,8,4,6
4,10,9,4,6
4,10,10,4,6
4,10,11,4,6
4,10,12,4,6
4,10,13,4,6
4,10,14,4,6
4,10,15,4,6
4,10,16,4,6
4,10,17,4,6
4,10,18,4,6
4,11,0,4,6
4,11,1,4,6
4,11,2,4,6
4,11,3,4,6
4,11,4,4,6
4,11,5,4,6
4,11,6,4,6
4,11,7,4,6
4,11,8,4,6
4,11,9,4,6
4,11,10,4,6
4,11,11,4,6
4,11,12,4,6
4,11,13,4,6
4,11,14,4,6
4,11,15,4,6
4,11,16,4,6
4,11,17,4,6
4,11,18,4,6
4,12,0,4,6
4,12,1,4,6
4,12,2,4,6
4,12,3,4,6
4,12,4,4,6
4,12,5,4,6
4,12,6,4,6
4,12,7,4,6
4,12,8,4,6
4,12,9,4,6
4,12,10,4,6
4,12,11,4,6
4,12,12,4,6
4,12,13,4,6
4,12,14,4,6
4,12,15,4,6
4,12,16,4,6
4,12,17,4,6
4,12,18,4,6
4,0,0,5,6
4,0,1,5,6
4,0,2,5,6
4,0,3,5,6
4,0,4,5,6
4,0,5,5,6
4,0,6,5,6
4,0,7,5,6
4,0,8,5,6
4,0,9,5,6
4,0,10,5,6
4,0,11,5,6
4,0,12,5,6
4,0,13,5,6
4,0,14,5,6
4,0,15,5,6
4,0,16,5,6
4,0,17,5,6
4,0,18,5,6
4,1,0,5,6
4,1,1,5,6
4,1,2,5,6
4,1,3,5,6
4,1,4,5,6
4,1,5,5,6
4,1,6,5,6
4,1,7,5,6
4,1,8,5,6
4,1,9,5,6
4,1,10,5,6
4,1,11,5,6
4,1,12,5,6
4,1,13,5,6
4,1,14,5,6
4,1,15,5,6
4,1,16,5,6
4,1,17,5,6
4,1,18,5,6
4,2,0,5,6
4,2,1,5,6
4,2,2,5,6
4,2,3,5,6
4,2,4,5,6
4,2,5,5,6
4,2,6,5,6
4,2,7,5,6
4,2,8,5,6
4,2,9,5,6
4,2,10,5,6
4,2,11,5,6
4,2,12,5,6
4,2,13,5,6
4,2,14,5,6
4,2,15,5,6
4,2,16,5,6
4,2,17,5,6
4,2,18,5,6
4,3,0,5,6
4,3,1,5,6
4,3,2,5,6
4,3,3,5,6
4,3,4,5,6
4,3,5,5,6
4,3,6,5,6
4,3,7,5,6
4,3,8,5,6
4,3,9,5,6
4,3,10,5,6
4,3,11,5,6
4,3,12,5,6
4,3,13,5,6
4,3,14,5,6
4,3,15,5,6
4,3,16,5,6
4,3,17,5,6
4,3,18,5,6
4,4,0,5,6
4,4,1,5,6
4,4,2,5,6
4,4,3,5,6
4,4,4,5,6
4,4,5,5,6
4,4,6,5,6
4,4,7,5,6
4,4,8,5,6
4,4,9,5,6
4,4,10,5,6
4,4,11,5,6
4,4,12,5,6
4,4,13,5,6
4,4,14,5,6
4,4,15,5,6
4,4,16,5,6
4,4,17,5,6
4,4,18,5,6
4,5,0,5,6
4,5,1,5,6
4,5,2,5,6
4,5,3,5,6
4,5,4,5,6
4,5,5,5,6
4,5,6,5,6
4,5,7,5,6
4,5,8,5,6
4,5,9,5,6
4,5,10,5,6
4,5,11,5,6
4,5,12,5,6
4,5,13,5,6
4,5,14,5,6
4,5,15,5,6
4,5,16,5,6
4,5,17,5,6
4,5,18,5,6
4,6,0,5,6
4,6,1,5,6
4,6,2,5,6
4,6,3,5,6
4,6,4,5,6
4,6,5,5,6
4,6,6,5,6
4,6,7,5,6
4,6,8,5,6
4,6,9,5,6
4,6,10,5,6
4,6,11,5,6
4,6,12,5,6
4,6,13,5,6
4,6,14,5,6
4,6,15,5,6
4,6,16,5,6
4,6,17,5,6
4,6,18,5,6
4,7,0,5,6
4,7,1,5,6
4,7,2,5,6
4,7,3,5,6
4,7,4,5,6
4,7,5,5,6
4,7,6,5,6
4,7,7,5,6
4,7,8,5,6
4,7,9,5,6
4,7,10,5,6
4,7,11,5,6
4,7,12,5,6
4,7,13,5,6
4,7,14,5,6
4,7,15,5,6
4,7,16,5,6
4,7,17,5,6
4,7,18,5,6
4,8,0,5,6
4,8,1,5,6
4,8,2,5,6
4,8,3,5,6
4,8,4,5,6
4,8,5,5,6
4,8,6,5,6
4,8,7,5,6
4,8,8,5,6
4,8,9,5,6
4,8,10,5,6
4,8,11,5,6
4,8,12,5,6
4,8,13,5,6
4,8,14,5,6
4,8,15,5,6
4,8,16,5,6
4,8,17,5,6
4,8,18,5,6
4,9,0,5,6
4,9,1,5,6
4,9,2,5,6
4,9,3,5,6
4,9,4,5,6
4,9,5,5,6
4,9,6,5,6
4,9,7,5,6
4,9,8,5,6
4,9,9,5,6
4,9,10,5,6
4,9,11,5,6
4,9,12,5,6
4,9,13,5,6
4,9,14,5,6
4,9,15,5,6
4,9,16,5,6
4,9,17,5,6
4,9,18,5,6
4,0,0,6,6
4,0,1,6,6
4,0,2,6,6
4,0,3,6,6
4,0,4,6,6
4,0,5,6,6
4,0,6,6,6
4,0,7,6,6
4,0,8,6,6
4,0,9,6,6
4,0,10,6,6
4,0,11,6,6
4,0,12,6,6
4,0,13,6,6
4,0,14,6,6
4,0,15,6,6
4,0,16,6,6
4,0,17,6,6
4,0,18,6,6
4,1,0,6,6
4,1,1,6,6
4,1,2,6,6
4,1,3,6,6
4,1,4,6,6
4,1,5,6,6
4,1,6,6,6
4,1,7,6,6
4,1,8,6,6
4,1,9,6,6
4,1,10,6,6
4,1,11,6,6
4,1,12,6,6
4,1,13,6,6
4,1,14,6,6
4,1,15,6,6
4,1,16,6,6
4,1,17,6,6
4,1,18,6,6
4,2,0,6,6
4,2,1,6,6
4,2,2,6,6
4,2,3,6,6
4,2,4,6,6
4,2,5,6,6
4,2,6,6,6
4,2,7,6,6
4,2,8,6,6
4,2,9,6,6
4,2,10,6,6
4,2,11,6,6
4,2,12,6,6
4,2,13,6,6
4,2,14,6,6
4,2,15,6,6
4,2,16,6,6
4,2,17,6,6
4,2,18,6,6
4,3,0,6,6
4,3,1,6,6
4,3,2,6,6
4,3,3,6,6
4,3,4,6,6
4,3,5,6,6
4,3,6,6,6
4,3,7,6,6
4,3,8,6,6
4,3,9,6,6
4,3,10,6,6
4,3,11,6,6
4,3,12,6,6
4,3,13,6,6
4,3,14,6,6
4,3,15,6,6
4,3,16,6,6
4,3,17,6,6
4,3,18,6,6
4,4,0,6,6
4,4,1,6,6
4,4,2,6,6
4,4,3,6,6
4,4,4,6,6
4,4,5,6,6
4,4,6,6,6
4,4,7,6,6
4,4,8,6,6
4,4,9,6,6
4,4,10,6,6
4,4,11,6,6
4,4,12,6,6
4,4,13,6,6
4,4,14,6,6
4,4,15,6,6
4,4,16,6,6
4,4,17,6,6
4,4,18,6,6
4,5,0,6,6
4,5,1,6,6
4,5,2,6,6
4,5,3,6,6
4,5,4,6,6
4,5,5,6,6
4,5,6,6,6
4,5,7,6,6
4,5,8,6,6
4,5,9,6,6
4,5,10,6,6
4,5,11,6,6
4,5,12,6,6
4,5,13,6,6
4,5,14,6,6
4,5,15,6,6
4,5,16,6,6
4,5,17,6,6
4,5,18,6,6
4,6,0,6,6
4,6,1,6,6
4,6,2,6,6
4,6,3,6,6
4,6,4,6,6
4,6,5,6,6
4,6,6,6,6
4,6,7,6,6
4,6,8,6,6
4,6,9,6,6
4,6,10,6,6
4,6,11,6,6
4,6,12,6,6
4,6,13,6,6
4,6,14,6,6
4,6,15,6,6
4,6,16,6,6
4,6,17,6,6
4,6,18,6,6
4,0,0,7,6
4,0,1,7,6
4,0,2,7,6
4,0,3,7,6
4,0,4,7,6
4,0,5,7,6
4,0,6,7,6
4,0,7,7,6
4,0,8,7,6
4,0,9,7,6
4,0,10,7,6
4,0,11,7,6
4,0,12,7,6
4,0,13,7,6
4,0,14,7,6
4,0,15,7,6
4,0,16,7,6
4,0,17,7,6
4,0,18,7,6
4,1,0,7,6
4,1,1,7,6
4,1,2,7,6
4,1,3,7,6
4,1,4,7,6
4,1,5,7,6
4,1,6,7,6
4,1,7,7,6
4,1,8,7,6
4,1,9,7,6
4,1,10,7,6
4,1,11,7,6
4,1,12,7,6
4,1,13,7,6
4,1,14,7,6
4,1,15,7,6
4,1,16,7,6
4,1,17,7,6
4,1,18,7,6
4,2,0,7,6
4,2,1,7,6
4,2,2,7,6
4,2,3,7,6
4,2,4,7,6
4,2,5,7,6
4,2,6,7,6
4,2,7,7,6
4,2,8,7,6
4,2,9,7,6
4,2,10,7,6
4,2,11,7,6
4,2,12,7,6
4,2,13,7,6
4,2,14,7,6
4,2,15,7,6
4,2,16,7,6
4,2,17,7,6
4,2,18,7,6
4,3,0,7,6
4,3,1,7,6
4,3,2,7,6
4,3,3,7,6
4,3,4,7,6
4,3,5,7,6
4,3,6,7,6
4,3,7,7,6
4,3,8,7,6
4,3,9,7,6
4,3,10,7,6
4,3,11,7,6
4,3,12,7,6
4,3,13,7,6
4,3,14,7,6
4,3,15,7,6
4,3,16,7,6
4,3,17,7,6
4,3,18,7,6
4,0,0,8,6
4,0,1,8,6
4,0,2,8,6
4,0,3,8,6
4,0,4,8,6
4,0,5,8,6
4,0,6,8,6
4,0,7,8,6
4,0,8,8,6
4,0,9,8,6
4,0,10,8,6
4,0,11,8,6
4,0,12,8,6
4,0,13,8,6
4,0,14,8,6
4,0,15,8,6
4,0,16,8,6
4,0,17,8,6
4,0,18,8,6
4,0,0,1,7
4,0,1,1,7
4,0,2,1,7
4,0,3,1,7
4,0,4,1,7
4,0,5,1,7
4,0,6,1,7
4,0,7,1,7
4,0,8,1,7
4,0,9,1,7
4,0,10,1,7
4,0,11,1,7
4,0,12,1,7
4,0,13,1,7
4,0,14,1,7
4,0,15,1,7
4,0,16,1,7
4,0,17,1,7
4,1,0,1,7
4,1,1,1,7
4,1,2,1,7
4,1,3,1,7
4,1,4,1,7
4,1,5,1,7
4,1,6,1,7
4,1,7,1,7
4,1,8,1,7
4,1,9,1,7
4,1,10,1,7
4,1,11,1,7
4,1,12,1,7
4,1,13,1,7
4,1,14,1,7
4,1,15,1,7
4,1,16,1,7
4,1,17,1,7
4,2,0,1,7
4,2,1,1,7
4,2,2,1,7
4,2,3,1,7
4,2,4,1,7
4,2,5,1,7
4,2,6,1,7
4,2,7,1,7
4,2,8,1,7
4,2,9,1,7
4,2,10,1,7
4,2,11,1,7
4,2,12,1,7
4,2,13,1,7
4,2,14,1,7
4,2,15,1,7
4,2,16,1,7
4,2,17,1,7
4,3,0,1,7
4,3,1,1,7
4,3,2,1,7
4,3,3,1,7
4,3,4,1,7
4,3,5,1,7
4,3,6,1,7
4,3,7,1,7
4,3,8,1,7
4,3,9,1,7
4,3,10,1,7
4,3,11,1,7
4,3,12,1,7
4,3,13,1,7
4,3,14,1,7
4,3,15,1,7
4,3,16,1,7
4,3,17,1,7
4,4,0,1,7
4,4,1,1,7
4,4,2,1,7
4,4,3,1,7
4,4,4,1,7
4,4,5,1,7
4,4,6,1,7
4,4,7,1,7
4,4,8,1,7
4,4,9,1,7
4,4,10,1,7
4,4,11,1,7
4,4,12,1,7
4,4,13,1,7
4,4,14,1,7
4,4,15,1,7
4,4,16,1,7
4,4,17,1,7
4,5,0,1,7
4,5,1,1,7
4,5,2,1,7
4,5,3,1,7
4,5,4,1,7
4,5,5,1,7
4,5,6,1,7
4,5,7,1,7
4,5,8,1,7
4,5,9,1,7
4,5,10,1,7
4,5,11,1,7
4,5,12,1,7
4,5,13,1,7
4,5,14,1,7
4,5,15,1,7
4,5,16,1,7
4,5,17,1,7
4,6,0,1,7
4,6,1,1,7
4,6,2,1,7
4,6,3,1,7
4,6,4,1,7
4,6,5,1,7
4,6,6,1,7
4,6,7,1,7
4,6,8,1,7
4,6,9,1,7
4,6,10,1,7
4,6,11,1,7
4,6,12,1,7
4,6,13,1,7
4,6,14,1,7
4,6,15,1,7
4,6,16,1,7
4,6,17,1,7
4,7,0,1,7
4,7,1,1,7
4,7,2,1,7
4,7,3,1,7
4,7,4,1,7
4,7,5,1,7
4,7,6,1,7
4,7,7,1,7
4,7,8,1,7
4,7,9,1,7
4,7,10,1,7
4,7,11,1,7
4,7,12,1,7
4,7,13,1,7
4,7,14,1,7
4,7,15,1,7
4,7,16,1,7
4,7,17,1,7
4,8,0,1,7
4,8,1,1,7
4,8,2,1,7
4,8,3,1,7
4,8,4,1,7
4,8,5,1,7
4,8,6,1,7
4,8,7,1,7
4,8,8,1,7
4,8,9,1,7
4,8,10,1,7
4,8,11,1,7
4,8,12,1,7
4,8,13,1,7
4,8,14,1,7
4,8,15,1,7
4,8,16,1,7
4,8,17,1,7
4,9,0,1,7
4,9,1,1,7
4,9,2,1,7
4,9,3,1,7
4,9,4,1,7
4,9,5,1,7
4,9,6,1,7
4,9,7,1,7
4,9,8,1,7
4,9,9,1,7
4,9,10,1,7
4,9,11,1,7
4,9,12,1,7
4,9,13,1,7
4,9,14,1,7
4,9,15,1,7
4,9,16,1,7
4,9,17,1,7
4,10,0,1,7
4,10,1,1,7
4,10,2,1,7
4,10,3,1,7
4,10,4,1,7
4,10,5,1,7
4,10,6,1,7
4,10,7,1,7
4,10,8,1,7
4,10,9,1,7
4,10,10,1,7
4,10,11,1,7
4,10,12,1,7
4,10,13,1,7
4,10,14,1,7
4,10,15,1,7
4,10,16,1,7
4,10,17,1,7
4,11,0,1,7
4,11,1,1,7
4,11,2,1,7
4,11,3,1,7
4,11,4,1,7
4,11,5,1,7
4,11,6,1,7
4,11,7,1,7
4,11,8,1,7
4,11,9,1,7
4,11,10,1,7
4,11,11,1,7
4,11,12,1,7
4,11,13,1,7
4,11,14,1,7
4,11,15,1,7
4,11,16,1,7
4,11,17,1,7
4,12,0,1,7
4,12,1,1,7
4,12,2,1,7
4,12,3,1,7
4,12,4,1,7
4,12,5,1,7
4,12,6,1,7
4,12,7,1,7
4,12,8,1,7
4,12,9,1,7
4,12,10,1,7
4,12,11,1,7
4,12,12,1,7
4,12,13,1,7
4,12,14,1,7
4,12,15,1,7
4,12,16,1,7
4,12,17,1,7
4,13,0,1,7
4,13,1,1,7
4,13,2,1,7
4,13,3,1,7
4,13,4,1,7
4,13,5,1,7
4,13,6,1,7
4,13,7,1,7
4,13,8,1,7
4,13,9,1,7
4,13,10,1,7
4,13,11,1,7
4,13,12,1,7
4,13,13,1,7
4,13,14,1,7
4,13,15,1,7
4,13,16,1,7
4,13,17,1,7
4,14,0,1,7
4,14,1,1,7
4,14,2,1,7
4,14,3,1,7
4,14,4,1,7
4,14,5,1,7
4,14,6,1,7
4,14,7,1,7
4,14,8,1,7
4,14,9,1,7
4,14,10,1,7
4,14,11,1,7
4,14,12,1,7
4,14,13,1,7
4,14,14,1,7
4,14,15,1,7
4,14,16,1,7
4,14,17,1,7
4,15,0,1,7
4,15,1,1,7
4,15,2,1,7
4,15,3,1,7
4,15,4,1,7
4,15,5,1,7
4,15,6,1,7
4,15,7,1,7
4,15,8,1,7
4,15,9,1,7
4,15,10,1,7
4,15,11,1,7
4,15,12,1,7
4,15,13,1,7
4,15,14,1,7
4,15,15,1,7
4,15,16,1,7
4,15,17,1,7
4,16,0,1,7
4,16,1,1,7
4,16,2,1,7
4,16,3,1,7
4,16,4,1,7
4,16,5,1,7
4,16,6,1,7
4,16,7,1,7
4,16,8,1,7
4,16,9,1,7
4,16,10,1,7
4,16,11,1,7
4,16,12,1,7
4,16,13,1,7
4,16,14,1,7
4,16,15,1,7
4,16,16,1,7
4,16,17,1,7
4,17,0,1,7
4,17,1,1,7
4,17,2,1,7
4,17,3,1,7
4,17,4,1,7
4,17,5,1,7
4,17,6,1,7
4,17,7,1,7
4,17,8,1,7
4,17,9,1,7
4,17,10,1,7
4,17,11,1,7
4,17,12,1,7
4,17,13,1,7
4,17,14,1,7
4,17,15,1,7
4,17,16,1,7
4,17,17,1,7
4,18,0,1,7
4,18,1,1,7
4,18,2,1,7
4,18,3,1,7
4,18,4,1,7
4,18,5,1,7
4,18,6,1,7
4,18,7,1,7
4,18,8,1,7
4,18,9,1,7
4,18,10,1,7
4,18,11,1,7
4,18,12,1,7
4,18,13,1,7
4,18,14,1,7
4,18,15,1,7
4,18,16,1,7
4,18,17,1,7
4,19,0,1,7
4,19,1,1,7
4,19,2,1,7
4,19,3,1,7
4,19,4,1,7
4,19,5,1,7
4,19,6,1,7
4,19,7,1,7
4,19,8,1,7
4,19,9,1,7
4,19,10,1,7
4,19,11,1,7
4,19,12,1,7
4,19,13,1,7
4,19,14,1,7
4,19,15,1,7
4,19,16,1,7
4,19,17,1,7
4,20,0,1,7
4,20,1,1,7
4,20,2,1,7
4,20,3,1,7
4,20,4,1,7
4,20,5,1,7
4,20,6,1,7
4,20,7,1,7
4,20,8,1,7
4,20,9,1,7
4,20,10,1,7
4,20,11,1,7
4,20,12,1,7
4,20,13,1,7
4,20,14,1,7
4,20,15,1,7
4,20,16,1,7
4,20,17,1,7
4,21,0,1,7
4,21,1,1,7
4,21,2,1,7
4,21,3,1,7
4,21,4,1,7
4,21,5,1,7
4,21,6,1,7
4,21,7,1,7
4,21,8,1,7
4,21,9,1,7
4,21,10,1,7
4,21,11,1,7
4,21,12,1,7
4,21,13,1,7
4,21,14,1,7
4,21,15,1,7
4,21,16,1,7
4,21,17,1,7
4,0,0,2,7
4,0,1,2,7
4,0,2,2,7
4,0,3,2,7
4,0,4,2,7
4,0,5,2,7
4,0,6,2,7
4,0,7,2,7
4,0,8,2,7
4,0,9,2,7
4,0,10,2,7
4,0,11,2,7
4,0,12,2,7
4,0,13,2,7
4,0,14,2,7
4,0,15,2,7
4,0,16,2,7
4,0,17,2,7
4,1,0,2,7
4,1,1,2,7
4,1,2,2,7
4,1,3,2,7
4,1,4,2,7
4,1,5,2,7
4,1,6,2,7
4,1,7,2,7
4,1,8,2,7
4,1,9,2,7
4,1,10,2,7
4,1,11,2,7
4,1,12,2,7
4,1,13,2,7
4,1,14,2,7
4,1,15,2,7
4,1,16,2,7
4,1,17,2,7
4,2,0,2,7
4,2,1,2,7
4,2,2,2,7
4,2,3,2,7
4,2,4,2,7
4,2,5,2,7
4,2,6,2,7
4,2,7,2,7
4,2,8,2,7
4,2,9,2,7
4,2,10,2,7
4,2,11,2,7
4,2,12,2,7
4,2,13,2,7
4,2,14,2,7
4,2,15,2,7
4,2,16,2,7
4,2,17,2,7
4,3,0,2,7
4,3,1,2,7
4,3,2,2,7
4,3,3,2,7
4,3,4,2,7
4,3,5,2,7
4,3,6,2,7
4,3,7,2,7
4,3,8,2,7
4,3,9,2,7
4,3,10,2,7
4,3,11,2,7
4,3,12,2,7
4,3,13,2,7
4,3,14,2,7
4,3,15,2,7
4,3,16,2,7
4,3,17,2,7
4,4,0,2,7
4,4,1,2,7
4,4,2,2,7
4,4,3,2,7
4,4,4,2,7
4,4,5,2,7
4,4,6,2,7
4,4,7,2,7
4,4,8,2,7
4,4,9,2,7
4,4,10,2,7
4,4,11,2,7
4,4,12,2,7
4,4,13,2,7
4,4,14,2,7
4,4,15,2,7
4,4,16,2,7
4,4,17,2,7
4,5,0,2,7
4,5,1,2,7
4,5,2,2,7
4,5,3,2,7
4,5,4,2,7
4,5,5,2,7
4,5,6,2,7
4,5,7,2,7
4,5,8,2,7
4,5,9,2,7
4,5,10,2,7
4,5,11,2,7
4,5,12,2,7
4,5,13,2,7
4,5,14,2,7
4,5,15,2,7
4,5,16,2,7
4,5,17,2,7
4,6,0,2,7
4,6,1,2,7
4,6,2,2,7
4,6,3,2,7
4,6,4,2,7
4,6,5,2,7
4,6,6,2,7
4,6,7,2,7
4,6,8,2,7
4,6,9,2,7
4,6,10,2,7
4,6,11,2,7
4,6,12,2,7
4,6,13,2,7
4,6,14,2,7
4,6,15,2,7
4,6,16,2,7
4,6,17,2,7
4,7,0,2,7
4,7,1,2,7
4,7,2,2,7
4,7,3,2,7
4,7,4,2,7
4,7,5,2,7
4,7,6,2,7
4,7,7,2,7
4,7,8,2,7
4,7,9,2,7
4,7,10,2,7
4,7,11,2,7
4,7,12,2,7
4,7,13,2,7
4,7,14,2,7
4,7,15,2,7
4,7,16,2,7
4,7,17,2,7
4,8,0,2,7
4,8,1,2,7
4,8,2,2,7
4,8,3,2,7
4,8,4,2,7
4,8,5,2,7
4,8,6,2,7
4,8,7,2,7
4,8,8,2,7
4,8,9,2,7
4,8,10,2,7
4,8,11,2,7
4,8,12,2,7
4,8,13,2,7
4,8,14,2,7
4,8,15,2,7
4,8,16,2,7
4,8,17,2,7
4,9,0,2,7
4,9,1,2,7
4,9,2,2,7
4,9,3,2,7
4,9,4,2,7
4,9,5,2,7
4,9,6,2,7
4,9,7,2,7
4,9,8,2,7
4,9,9,2,7
4,9,10,2,7
4,9,11,2,7
4,9,12,2,7
4,9,13,2,7
4,9,14,2,7
4,9,15,2,7
4,9,16,2,7
4,9,17,2,7
4,10,0,2,7
4,10,1,2,7
4,10,2,2,7
4,10,3,2,7
4,10,4,2,7
4,10,5,2,7
4,10,6,2,7
4,10,7,2,7
4,10,8,2,7
4,10,9,2,7
4,10,10,2,7
4,10,11,2,7
4,10,12,2,7
4,10,13,2,7
4,10,14,2,7
4,10,15,2,7
4,10,16,2,7
4,10,17,2,7
4,11,0,2,7
4,11,1,2,7
4,11,2,2,7
4,11,3,2,7
4,11,4,2,7
4,11,5,2,7
4,11,6,2,7
4,11,7,2,7
4,11,8,2,7
4,11,9,2,7
4,11,10,2,7
4,11,11,2,7
4,11,12,2,7
4,11,13,2,7
4,11,14,2,7
4,11,15,2,7
4,11,16,2,7
4,11,17,2,7
4,12,0,2,7
4,12,1,2,7
4,12,2,2,7
4,12,3,2,7
4,12,4,2,7
4,12,5,2,7
4,12,6,2,7
4,12,7,2,7
4,12,8,2,7
4,12,9,2,7
4,12,10,2,7
4,12,11,2,7
4,12,12,2,7
4,12,13,2,7
4,12,14,2,7
4,12,15,2,7
4,12,16,2,7
4,12,17,2,7
4,13,0,2,7
4,13,1,2,7
4,13,2,2,7
4,13,3,2,7
4,13,4,2,7
4,13,5,2,7
4,13,6,2,7
4,13,7,2,7
4,13,8,2,7
4,13,9,2,7
4,13,10,2,7
4,13,11,2,7
4,13,12,2,7
4,13,13,2,7
4,13,14,2,7
4,13,15,2,7
4,13,16,2,7
4,13,17,2,7
4,14,0,2,7
4,14,1,2,7
4,14,2,2,7
4,14,3,2,7
4,14,4,2,7
4,14,5,2,7
4,14,6,2,7
4,14,7,2,7
4,14,8,2,7
4,14,9,2,7
4,14,10,2,7
4,14,11,2,7
4,14,12,2,7
4,14,13,2,7
4,14,14,2,7
4,14,15,2,7
4,14,16,2,7
4,14,17,2,7
4,15,0,2,7
4,15,1,2,7
4,15,2,2,7
4,15,3,2,7
4,15,4,2,7
4,15,5,2,7
4,15,6,2,7
4,15,7,2,7
4,15,8,2,7
4,15,9,2,7
4,15,10,2,7
4,15,11,2,7
4,15,12,2,7
4,15,13,2,7
4,15,14,2,7
4,15,15,2,7
4,15,16,2,7
4,15,17,2,7
4,16,0,2,7
4,16,1,2,7
4,16,2,2,7
4,16,3,2,7
4,16,4,2,7
4,16,5,2,7
4,16,6,2,7
4,16,7,2,7
4,16,8,2,7
4,16,9,2,7
4,16,10,2,7
4,16,11,2,7
4,16,12,2,7
4,16,13,2,7
4,16,14,2,7
4,16,15,2,7
4,16,16,2,7
4,16,17,2,7
4,17,0,2,7
4,17,1,2,7
4,17,2,2,7
4,17,3,2,7
4,17,4,2,7
4,17,5,2,7
4,17,6,2,7
4,17,7,2,7
4,17,8,2,7
4,17,9,2,7
4,17,10,2,7
4,17,11,2,7
4,17,12,2,7
4,17,13,2,7
4,17,14,2,7
4,17,15,2,7
4,17,16,2,7
4,17,17,2,7
4,18,0,2,7
4,18,1,2,7
4,18,2,2,7
4,18,3,2,7
4,18,4,2,7
4,18,5,2,7
4,18,6,2,7
4,18,7,2,7
4,18,8,2,7
4,18,9,2,7
4,18,10,2,7
4,18,11,2,7
4,18,12,2,7
4,18,13,2,7
4,18,14,2,7
4,18,15,2,7
4,18,16,2,7
4,18,17,2,7
4,0,0,3,7
4,0,1,3,7
4,0,2,3,7
4,0,3,3,7
4,0,4,3,7
4,0,5,3,7
4,0,6,3,7
4,0,7,3,7
4,0,8,3,7
4,0,9,3,7
4,0,10,3,7
4,0,11,3,7
4,0,12,3,7
4,0,13,3,7
4,0,14,3,7
4,0,15,3,7
4,0,16,3,7
4,0,17,3,7
4,1,0,3,7
4,1,1,3,7
4,1,2,3,7
4,1,3,3,7
4,1,4,3,7
4,1,5,3,7
4,1,6,3,7
4,1,7,3,7
4,1,8,3,7
4,1,9,3,7
4,1,10,3,7
4,1,11,3,7
4,1,12,3,7
4,1,13,3,7
4,1,14,3,7
4,1,15,3,7
4,1,16,3,7
4,1,17,3,7
4,2,0,3,7
4,2,1,3,7
4,2,2,3,7
4,2,3,3,7
4,2,4,3,7
4,2,5,3,7
4,2,6,3,7
4,2,7,3,7
4,2,8,3,7
4,2,9,3,7
4,2,10,3,7
4,2,11,3,7
4,2,12,3,7
4,2,13,3,7
4,2,14,3,7
4,2,15,3,7
4,2,16,3,7
4,2,17,3,7
4,3,0,3,7
4,3,1,3,7
4,3,2,3,7
4,3,3,3,7
4,3,4,3,7
4,3,5,3,7
4,3,6,3,7
4,3,7,3,7
4,3,8,3,7
4,3,9,3,7
4,3,10,3,7
4,3,11,3,7
4,3,12,3,7
4,3,13,3,7
4,3,14,3,7
4,3,15,3,7
4,3,16,3,7
4,3,17,3,7
4,4,0,3,7
4,4,1,3,7
4,4,2,3,7
4,4,3,3,7
4,4,4,3,7
4,4,5,3,7
4,4,6,3,7
4,4,7,3,7
4,4,8,3,7
4,4,9,3,7
4,4,10,3,7
4,4,11,3,7
4,4,12,3,7
4,4,13,3,7
4,4,14,3,7
4,4,15,3,7
4,4,16,3,7
4,4,17,3,7
4,5,0,3,7
4,5,1,3,7
4,5,2,3,7
4,5,3,3,7
4,5,4,3,7
4,5,5,3,7
4,5,6,3,7
4,5,7,3,7
4,5,8,3,7
4,5,9,3,7
4,5,10,3,7
4,5,11,3,7
4,5,12,3,7
4,5,13,3,7
4,5,14,3,7
4,5,15,3,7
4,5,16,3,7
4,5,17,3,7
4,6,0,3,7
4,6,1,3,7
4,6,2,3,7
4,6,3,3,7
4,6,4,3,7
4,6,5,3,7
4,6,6,3,7
4,6,7,3,7
4,6,8,3,7
4,6,9,3,7
4,6,10,3,7
4,6,11,3,7
4,6,12,3,7
4,6,13,3,7
4,6,14,3,7
4,6,15,3,7
4,6,16,3,7
4,6,17,3,7
4,7,0,3,7
4,7,1,3,7
4,7,2,3,7
4,7,3,3,7
4,7,4,3,7
4,7,5,3,7
4,7,6,3,7
4,7,7,3,7
4,7,8,3,7
4,7,9,3,7
4,7,10,3,7
4,7,11,3,7
4,7,12,3,7
4,7,13,3,7
4,7,14,3,7
4,7,15,3,7
4,7,16,3,7
4,7,17,3,7
4,8,0,3,7
4,8,1,3,7
4,8,2,3,7
4,8,3,3,7
4,8,4,3,7
4,8,5,3,7
4,8,6,3,7
4,8,7,3,7
4,8,8,3,7
4,8,9,3,7
4,8,10,3,7
4,8,11,3,7
4,8,12,3,7
4,8,13,3,7
4,8,14,3,7
4,8,15,3,7
4,8,16,3,7
4,8,17,3,7
4,9,0,3,7
4,9,1,3,7
4,9,2,3,7
4,9,3,3,7
4,9,4,3,7
4,9,5,3,7
4,9,6,3,7
4,9,7,3,7
4,9,8,3,7
4,9,9,3,7
4,9,10,3,7
4,9,11,3,7
4,9,12,3,7
4,9,13,3,7
4,9,14,3,7
4,9,15,3,7
4,9,16,3,7
4,9,17,3,7
4,10,0,3,7
4,10,1,3,7
4,10,2,3,7
4,10,3,3,7
4,10,4,3,7
4,10,5,3,7
4,10,6,3,7
4,10,7,3,7
4,10,8,3,7
4,10,9,3,7
4,10,10,3,7
4,10,11,3,7
4,10,12,3,7
4,10,13,3,7
4,10,14,3,7
4,10,15,3,7
4,10,16,3,7
4,10,17,3,7
4,11,0,3,7
4,11,1,3,7
4,11,2,3,7
4,11,3,3,7
4,11,4,3,7
4,11,5,3,7
4,11,6,3,7
4,11,7,3,7
4,11,8,3,7
4,11,9,3,7
4,11,10,3,7
4,11,11,3,7
4,11,12,3,7
4,11,13,3,7
4,11,14,3,7
4,11,15,3,7
4,11,16,3,7
4,11,17,3,7
4,12,0,3,7
4,12,1,3,7
4,12,2,3,7
4,12,3,3,7
4,12,4,3,7
4,12,5,3,7
4,12,6,3,7
4,12,7,3,7
4,12,8,3,7
4,12,9,3,7
4,12,10,3,7
4,12,11,3,7
4,12,12,3,7
4,12,13,3,7
4,12,14,3,7
4,12,15,3,7
4,12,16,3,7
4,12,17,3,7
4,13,0,3,7
4,13,1,3,7
4,13,2,3,7
4,13,3,3,7
4,13,4,3,7
4,13,5,3,7
4,13,6,3,7
4,13,7,3,7
4,13,8,3,7
4,13,9,3,7
4,13,10,3,7
4,13,11,3,7
4,13,12,3,7
4,13,13,3,7
4,13,14,3,7
4,13,15,3,7
4,13,16,3,7
4,13,17,3,7
4,14,0,3,7
4,14,1,3,7
4,14,2,3,7
4,14,3,3,7
4,14,4,3,7
4,14,5,3,7
4,14,6,3,7
4,14,7,3,7
4,14,8,3,7
4,14,9,3,7
4,14,10,3,7
4,14,11,3,7
4,14,12,3,7
4,14,13,3,7
4,14,14,3,7
4,14,15,3,7
4,14,16,3,7
4,14,17,3,7
4,15,0,3,7
4,15,1,3,7
4,15,2,3,7
4,15,3,3,7
4,15,4,3,7
4,15,5,3,7
4,15,6,3,7
4,15,7,3,7
4,15,8,3,7
4,15,9,3,7
4,15,10,3,7
4,15,11,3,7
4,15,12,3,7
4,15,13,3,7
4,15,14,3,7
4,15,15,3,7
4,15,16,3,7
4,15,17,3,7
4,0,0,4,7
4,0,1,4,7
4,0,2,4,7
4,0,3,4,7
4,0,4,4,7
4,0,5,4,7
4,0,6,4,7
4,0,7,4,7
4,0,8,4,7
4,0,9,4,7
4,0,10,4,7
4,0,11,4,7
4,0,12,4,7
4,0,13,4,7
4,0,14,4,7
4,0,15,4,7
4,0,16,4,7
4,0,17,4,7
4,1,0,4,7
4,1,1,4,7
4,1,2,4,7
4,1,3,4,7
4,1,4,4,7
4,1,5,4,7
4,1,6,4,7
4,1,7,4,7
4,1,8,4,7
4,1,9,4,7
4,1,10,4,7
4,1,11,4,7
4,1,12,4,7
4,1,13,4,7
4,1,14,4,7
4,1,15,4,7
4,1,16,4,7
4,1,17,4,7
4,2,0,4,7
4,2,1,4,7
4,2,2,4,7
4,2,3,4,7
4,2,4,4,7
4,2,5,4,7
4,2,6,4,7
4,2,7,4,7
4,2,8,4,7
4,2,9,4,7
4,2,10,4,7
4,2,11,4,7
4,2,12,4,7
4,2,13,4,7
4,2,14,4,7
4,2,15,4,7
4,2,16,4,7
4,2,17,4,7
4,3,0,4,7
4,3,1,4,7
4,3,2,4,7
4,3,3,4,7
4,3,4,4,7
4,3,5,4,7
4,3,6,4,7
4,3,7,4,7
4,3,8,4,7
4,3,9,4,7
4,3,10,4,7
4,3,11,4,7
4,3,12,4,7
4,3,13,4,7
4,3,14,4,7
4,3,15,4,7
4,3,16,4,7
4,3,17,4,7
4,4,0,4,7
4,4,1,4,7
4,4,2,4,7
4,4,3,4,7
4,4,4,4,7
4,4,5,4,7
4,4,6,4,7
4,4,7,4,7
4,4,8,4,7
4,4,9,4,7
4,4,10,4,7
4,4,11,4,7
4,4,12,4,7
4,4,13,4,7
4,4,14,4,7
4,4,15,4,7
4,4,16,4,7
4,4,17,4,7
4,5,0,4,7
4,5,1,4,7
4,5,2,4,7
4,5,3,4,7
4,5,4,4,7
4,5,5,4,7
4,5,6,4,7
4,5,7,4,7
4,5,8,4,7
4,5,9,4,7
4,5,10,4,7
4,5,11,4,7
4,5,12,4,7
4,5,13,4,7
4,5,14,4,7
4,5,15,4,7
4,5,16,4,7
4,5,17,4,7
4,6,0,4,7
4,6,1,4,7
4,6,2,4,7
4,6,3,4,7
4,6,4,4,7
4,6,5,4,7
4,6,6,4,7
4,6,7,4,7
4,6,8,4,7
4,6,9,4,7
4,6,10,4,7
4,6,11,4,7
4,6,12,4,7
4,6,13,4,7
4,6,14,4,7
4,6,15,4,7
4,6,16,4,7
4,6,17,4,7
4,7,0,4,7
4,7,1,4,7
4,7,2,4,7
4,7,3,4,7
4,7,4,4,7
4,7,5,4,7
4,7,6,4,7
4,7,7,4,7
4,7,8,4,7
4,7,9,4,7
4,7,10,4,7
4,7,11,4,7
4,7,12,4,7
4,7,13,4,7
4,7,14,4,7
4,7,15,4,7
4,7,16,4,7
4,7,17,4,7
4,8,0,4,7
4,8,1,4,7
4,8,2,4,7
4,8,3,4,7
4,8,4,4,7
4,8,5,4,7
4,8,6,4,7
4,8,7,4,7
4,8,8,4,7
4,8,9,4,7
4,8,10,4,7
4,8,11,4,7
4,8,12,4,7
4,8,13,4,7
4,8,14,4,7
4,8,15,4,7
4,8,16,4,7
4,8,17,4,7
4,9,0,4,7
4,9,1,4,7
4,9,2,4,7
4,9,3,4,7
4,9,4,4,7
4,9,5,4,7
4,9,6,4,7
4,9,7,4,7
4,9,8,4,7
4,9,9,4,7
4,9,10,4,7
4,9,11,4,7
4,9,12,4,7
4,9,13,4,7
4,9,14,4,7
4,9,15,4,7
4,9,16,4,7
4,9,17,4,7
4,10,0,4,7
4,10,1,4,7
4,10,2,4,7
4,10,3,4,7
4,10,4,4,7
4,10,5,4,7
4,10,6,4,7
4,10,7,4,7
4,10,8,4,7
4,10,9,4,7
4,10,10,4,7
4,10,11,4,7
4,10,12,4,7
4,10,13,4,7
4,10,14,4,7
4,10,15,4,7
4,10,16,4,7
4,10,17,4,7
4,11,0,4,7
4,11,1,4,7
4,11,2,4,7
4,11,3,4,7
4,11,4,4,7
4,11,5,4,7
4,11,6,4,7
4,11,7,4,7
4,11,8,4,7
4,11,9,4,7
4,11,10,4,7
4,11,11,4,7
4,11,12,4,7
4,11,13,4,7
4,11,14,4,7
4,11,15,4,7
4,11,16,4,7
4,11,17,4,7
4,12,0,4,7
4,12,1,4,7
4,12,2,4,7
4,12,3,4,7
4,12,4,4,7
4,12,5,4,7
4,12,6,4,7
4,12,7,4,7
4,12,8,4,7
4,12,9,4,7
4,12,10,4,7
4,12,11,4,7
4,12,12,4,7
4,12,13,4,7
4,12,14,4,7
4,12,15,4,7
4,12,16,4,7
4,12,17,4,7
4,0,0,5,7
4,0,1,5,7
4,0,2,5,7
4,0,3,5,7
4,0,4,5,7
4,0,5,5,7
4,0,6,5,7
4,0,7,5,7
4,0,8,5,7
4,0,9,5,7
4,0,10,5,7
4,0,11,5,7
4,0,12,5,7
4,0,13,5,7
4,0,14,5,7
4,0,15,5,7
4,0,16,5,7
4,0,17,5,7
4,1,0,5,7
4,1,1,5,7
4,1,2,5,7
4,1,3,5,7
4,1,4,5,7
4,1,5,5,7
4,1,6,5,7
4,1,7,5,7
4,1,8,5,7
4,1,9,5,7
4,1,10,5,7
4,1,11,5,7
4,1,12,5,7
4,1,13,5,7
4,1,14,5,7
4,1,15,5,7
4,1,16,5,7
4,1,17,5,7
4,2,0,5,7
4,2,1,5,7
4,2,2,5,7
4,2,3,5,7
4,2,4,5,7
4,2,5,5,7
4,2,6,5,7
4,2,7,5,7
4,2,8,5,7
4,2,9,5,7
4,2,10,5,7
4,2,11,5,7
4,2,12,5,7
4,2,13,5,7
4,2,14,5,7
4,2,15,5,7
4,2,16,5,7
4,2,17,5,7
4,3,0,5,7
4,3,1,5,7
4,3,2,5,7
4,3,3,5,7
4,3,4,5,7
4,3,5,5,7
4,3,6,5,7
4,3,7,5,7
4,3,8,5,7
4,3,9,5,7
4,3,10,5,7
4,3,11,5,7
4,3,12,5,7
4,3,13,5,7
4,3,14,5,7
4,3,15,5,7
4,3,16,5,7
4,3,17,5,7
4,4,0,5,7
4,4,1,5,7
4,4,2,5,7
4,4,3,5,7
4,4,4,5,7
4,4,5,5,7
4,4,6,5,7
4,4,7,5,7
4,4,8,5,7
4,4,9,5,7
4,4,10,5,7
4,4,11,5,7
4,4,12,5,7
4,4,13,5,7
4,4,14,5,7
4,4,15,5,7
4,4,16,5,7
4,4,17,5,7
4,5,0,5,7
4,5,1,5,7
4,5,2,5,7
4,5,3,5,7
4,5,4,5,7
4,5,5,5,7
4,5,6,5,7
4,5,7,5,7
4,5,8,5,7
4,5,9,5,7
4,5,10,5,7
4,5,11,5,7
4,5,12,5,7
4,5,13,5,7
4,5,14,5,7
4,5,15,5,7
4,5,16,5,7
4,5,17,5,7
4,6,0,5,7
4,6,1,5,7
4,6,2,5,7
4,6,3,5,7
4,6,4,5,7
4,6,5,5,7
4,6,6,5,7
4,6,7,5,7
4,6,8,5,7
4,6,9,5,7
4,6,10,5,7
4,6,11,5,7
4,6,12,5,7
4,6,13,5,7
4,6,14,5,7
4,6,15,5,7
4,6,16,5,7
4,6,17,5,7
4,7,0,5,7
4,7,1,5,7
4,7,2,5,7
4,7,3,5,7
4,7,4,5,7
4,7,5,5,7
4,7,6,5,7
4,7,7,5,7
4,7,8,5,7
4,7,9,5,7
4,7,10,5,7
4,7,11,5,7
4,7,12,5,7
4,7,13,5,7
4,7,14,5,7
4,7,15,5,7
4,7,16,5,7
4,7,17,5,7
4,8,0,5,7
4,8,1,5,7
4,8,2,5,7
4,8,3,5,7
4,8,4,5,7
4,8,5,5,7
4,8,6,5,7
4,8,7,5,7
4,8,8,5,7
4,8,9,5,7
4,8,10,5,7
4,8,11,5,7
4,8,12,5,7
4,8,13,5,7
4,8,14,5,7
4,8,15,5,7
4,8,16,5,7
4,8,17,5,7
4,9,0,5,7
4,9,1,5,7
4,9,2,5,7
4,9,3,5,7
4,9,4,5,7
4,9,5,5,7
4,9,6,5,7
4,9,7,5,7
4,9,8,5,7
4,9,9,5,7
4,9,10,5,7
4,9,11,5,7
4,9,12,5,7
4,9,13,5,7
4,9,14,5,7
4,9,15,5,7
4,9,16,5,7
4,9,17,5,7
4,0,0,6,7
4,0,1,6,7
4,0,2,6,7
4,0,3,6,7
4,0,4,6,7
4,0,5,6,7
4,0,6,6,7
4,0,7,6,7
4,0,8,6,7
4,0,9,6,7
4,0,10,6,7
4,0,11,6,7
4,0,12,6,7
4,0,13,6,7
4,0,14,6,7
4,0,15,6,7
4,0,16,6,7
4,0,17,6,7
4,1,0,6,7
4,1,1,6,7
4,1,2,6,7
4,1,3,6,7
4,1,4,6,7
4,1,5,6,7
4,1,6,6,7
4,1,7,6,7
4,1,8,6,7
4,1,9,6,7
4,1,10,6,7
4,1,11,6,7
4,1,12,6,7
4,1,13,6,7
4,1,14,6,7
4,1,15,6,7
4,1,16,6,7
4,1,17,6,7
4,2,0,6,7
4,2,1,6,7
4,2,2,6,7
4,2,3,6,7
4,2,4,6,7
4,2,5,6,7
4,2,6,6,7
4,2,7,6,7
4,2,8,6,7
4,2,9,6,7
4,2,10,6,7
4,2,11,6,7
4,2,12,6,7
4,2,13,6,7
4,2,14,6,7
4,2,15,6,7
4,2,16,6,7
4,2,17,6,7
4,3,0,6,7
4,3,1,6,7
4,3,2,6,7
4,3,3,6,7
4,3,4,6,7
4,3,5,6,7
4,3,6,6,7
4,3,7,6,7
4,3,8,6,7
4,3,9,6,7
4,3,10,6,7
4,3,11,6,7
4,3,12,6,7
4,3,13,6,7
4,3,14,6,7
4,3,15,6,7
4,3,16,6,7
4,3,17,6,7
4,4,0,6,7
4,4,1,6,7
4,4,2,6,7
4,4,3,6,7
4,4,4,6,7
4,4,5,6,7
4,4,6,6,7
4,4,7,6,7
4,4,8,6,7
4,4,9,6,7
4,4,10,6,7
4,4,11,6,7
4,4,12,6,7
4,4,13,6,7
4,4,14,6,7
4,4,15,6,7
4,4,16,6,7
4,4,17,6,7
4,5,0,6,7
4,5,1,6,7
4,5,2,6,7
4,5,3,6,7
4,5,4,6,7
4,5,5,6,7
4,5,6,6,7
4,5,7,6,7
4,5,8,6,7
4,5,9,6,7
4,5,10,6,7
4,5,11,6,7
4,5,12,6,7
4,5,13,6,7
4,5,14,6,7
4,5,15,6,7
4,5,16,6,7
4,5,17,6,7
4,6,0,6,7
4,6,1,6,7
4,6,2,6,7
4,6,3,6,7
4,6,4,6,7
4,6,5,6,7
4,6,6,6,7
4,6,7,6,7
4,6,8,6,7
4,6,9,6,7
4,6,10,6,7
4,6,11,6,7
4,6,12,6,7
4,6,13,6,7
4,6,14,6,7
4,6,15,6,7
4,6,16,6,7
4,6,17,6,7
4,0,0,7,7
4,0,1,7,7
4,0,2,7,7
4,0,3,7,7
4,0,4,7,7
4,0,5,7,7
4,0,6,7,7
4,0,7,7,7
4,0,8,7,7
4,0,9,7,7
4,0,10,7,7
4,0,11,7,7
4,0,12,7,7
4,0,13,7,7
4,0,14,7,7
4,0,15,7,7
4,0,16,7,7
4,0,17,7,7
4,1,0,7,7
4,1,1,7,7
4,1,2,7,7
4,1,3,7,7
4,1,4,7,7
4,1,5,7,7
4,1,6,7,7
4,1,7,7,7
4,1,8,7,7
4,1,9,7,7
4,1,10,7,7
4,1,11,7,7
4,1,12,7,7
4,1,13,7,7
4,1,14,7,7
4,1,15,7,7
4,1,16,7,7
4,1,17,7,7
4,2,0,7,7
4,2,1,7,7
4,2,2,7,7
4,2,3,7,7
4,2,4,7,7
4,2,5,7,7
4,2,6,7,7
4,2,7,7,7
4,2,8,7,7
4,2,9,7,7
4,2,10,7,7
4,2,11,7,7
4,2,12,7,7
4,2,13,7,7
4,2,14,7,7
4,2,15,7,7
4,2,16,7,7
4,2,17,7,7
4,3,0,7,7
4,3,1,7,7
4,3,2,7,7
4,3,3,7,7
4,3,4,7,7
4,3,5,7,7
4,3,6,7,7
4,3,7,7,7
4,3,8,7,7
4,3,9,7,7
4,3,10,7,7
4,3,11,7,7
4,3,12,7,7
4,3,13,7,7
4,3,14,7,7
4,3,15,7,7
4,3,16,7,7
4,3,17,7,7
4,0,0,8,7
4,0,1,8,7
4,0,2,8,7
4,0,3,8,7
4,0,4,8,7
4,0,5,8,7
4,0,6,8,7
4,0,7,8,7
4,0,8,8,7
4,0,9,8,7
4,0,10,8,7
4,0,11,8,7
4,0,12,8,7
4,0,13,8,7
4,0,14,8,7
4,0,15,8,7
4,0,16,8,7
4,0,17,8,7
4,0,0,1,8
4,0,1,1,8
4,0,2,1,8
4,0,3,1,8
4,0,4,1,8
4,0,5,1,8
4,0,6,1,8
4,0,7,1,8
4,0,8,1,8
4,0,9,1,8
4,0,10,1,8
4,0,11,1,8
4,0,12,1,8
4,0,13,1,8
4,0,14,1,8
4,0,15,1,8
4,0,16,1,8
4,1,0,1,8
4,1,1,1,8
4,1,2,1,8
4,1,3,1,8
4,1,4,1,8
4,1,5,1,8
4,1,6,1,8
4,1,7,1,8
4,1,8,1,8
4,1,9,1,8
4,1,10,1,8
4,1,11,1,8
4,1,12,1,8
4,1,13,1,8
4,1,14,1,8
4,1,15,1,8
4,1,16,1,8
4,2,0,1,8
4,2,1,1,8
4,2,2,1,8
4,2,3,1,8
4,2,4,1,8
4,2,5,1,8
4,2,6,1,8
4,2,7,1,8
4,2,8,1,8
4,2,9,1,8
4,2,10,1,8
4,2,11,1,8
4,2,12,1,8
4,2,13,1,8
4,2,14,1,8
4,2,15,1,8
4,2,16,1,8
4,3,0,1,8
4,3,1,1,8
4,3,2,1,8
4,3,3,1,8
4,3,4,1,8
4,3,5,1,8
4,3,6,1,8
4,3,7,1,8
4,3,8,1,8
4,3,9,1,8
4,3,10,1,8
4,3,11,1,8
4,3,12,1,8
4,3,13,1,8
4,3,14,1,8
4,3,15,1,8
4,3,16,1,8
4,4,0,1,8
4,4,1,1,8
4,4,2,1,8
4,4,3,1,8
4,4,4,1,8
4,4,5,1,8
4,4,6,1,8
4,4,7,1,8
4,4,8,1,8
4,4,9,1,8
4,4,10,1,8
4,4,11,1,8
4,4,12,1,8
4,4,13,1,8
4,4,14,1,8
4,4,15,1,8
4,4,16,1,8
4,5,0,1,8
4,5,1,1,8
4,5,2,1,8
4,5,3,1,8
4,5,4,1,8
4,5,5,1,8
4,5,6,1,8
4,5,7,1,8
4,5,8,1,8
4,5,9,1,8
4,5,10,1,8
4,5,11,1,8
4,5,12,1,8
4,5,13,1,8
4,5,14,1,8
4,5,15,1,8
4,5,16,1,8
4,6,0,1,8
4,6,1,1,8
4,6,2,1,8
4,6,3,1,8
4,6,4,1,8
4,6,5,1,8
4,6,6,1,8
4,6,7,1,8
4,6,8,1,8
4,6,9,1,8
4,6,10,1,8
4,6,11,1,8
4,6,12,1,8
4,6,13,1,8
4,6,14,1,8
4,6,15,1,8
4,6,16,1,8
4,7,0,1,8
4,7,1,1,8
4,7,2,1,8
4,7,3,1,8
4,7,4,1,8
4,7,5,1,8
4,7,6,1,8
4,7,7,1,8
4,7,8,1,8
4,7,9,1,8
4,7,10,1,8
4,7,11,1,8
4,7,12,1,8
4,7,13,1,8
4,7,14,1,8
4,7,15,1,8
4,7,16,1,8
4,8,0,1,8
4,8,1,1,8
4,8,2,1,8
4,8,3,1,8
4,8,4,1,8
4,8,5,1,8
4,8,6,1,8
4,8,7,1,8
4,8,8,1,8
4,8,9,1,8
4,8,10,1,8
4,8,11,1,8
4,8,12,1,8
4,8,13,1,8
4,8,14,1,8
4,8,15,1,8
4,8,16,1,8
4,9,0,1,8
4,9,1,1,8
4,9,2,1,8
4,9,3,1,8
4,9,4,1,8
4,9,5,1,8
4,9,6,1,8
4,9,7,1,8
4,9,8,1,8
4,9,9,1,8
4,9,10,1,8
4,9,11,1,8
4,9,12,1,8
4,9,13,1,8
4,9,14,1,8
4,9,15,1,8
4,9,16,1,8
4,10,0,1,8
4,10,1,1,8
4,10,2,1,8
4,10,3,1,8
4,10,4,1,8
4,10,5,1,8
4,10,6,1,8
4,10,7,1,8
4,10,8,1,8
4,10,9,1,8
4,10,10,1,8
4,10,11,1,8
4,10,12,1,8
4,10,13,1,8
4,10,14,1,8
4,10,15,1,8
4,10,16,1,8
4,11,0,1,8
4,11,1,1,8
4,11,2,1,8
4,11,3,1,8
4,11,4,1,8
4,11,5,1,8
4,11,6,1,8
4,11,7,1,8
4,11,8,1,8
4,11,9,1,8
4,11,10,1,8
4,11,11,1,8
4,11,12,1,8
4,11,13,1,8
4,11,14,1,8
4,11,15,1,8
4,11,16,1,8
4,12,0,1,8
4,12,1,1,8
4,12,2,1,8
4,12,3,1,8
4,12,4,1,8
4,12,5,1,8
4,12,6,1,8
4,12,7,1,8
4,12,8,1,8
4,12,9,1,8
4,12,10,1,8
4,12,11,1,8
4,12,12,1,8
4,12,13,1,8
4,12,14,1,8
4,12,15,1,8
4,12,16,1,8
4,13,0,1,8
4,13,1,1,8
4,13,2,1,8
4,13,3,1,8
4,13,4,1,8
4,13,5,1,8
4,13,6,1,8
4,13,7,1,8
4,13,8,1,8
4,13,9,1,8
4,13,10,1,8
4,13,11,1,8
4,13,12,1,8
4,13,13,1,8
4,13,14,1,8
4,13,15,1,8
4,13,16,1,8
4,14,0,1,8
4,14,1,1,8
4,14,2,1,8
4,14,3,1,8
4,14,4,1,8
4,14,5,1,8
4,14,6,1,8
4,14,7,1,8
4,14,8,1,8
4,14,9,1,8
4,14,10,1,8
4,14,11,1,8
4,14,12,1,8
4,14,13,1,8
4,14,14,1,8
4,14,15,1,8
4,14,16,1,8
4,15,0,1,8
4,15,1,1,8
4,15,2,1,8
4,15,3,1,8
4,15,4,1,8
4,15,5,1,8
4,15,6,1,8
4,15,7,1,8
4,15,8,1,8
4,15,9,1,8
4,15,10,1,8
4,15,11,1,8
4,15,12,1,8
4,15,13,1,8
4,15,14,1,8
4,15,15,1,8
4,15,16,1,8
4,16,0,1,8
4,16,1,1,8
4,16,2,1,8
4,16,3,1,8
4,16,4,1,8
4,16,5,1,8
4,16,6,1,8
4,16,7,1,8
4,16,8,1,8
4,16,9,1,8
4,16,10,1,8
4,16,11,1,8
4,16,12,1,8
4,16,13,1,8
4,16,14,1,8
4,16,15,1,8
4,16,16,1,8
4,17,0,1,8
4,17,1,1,8
4,17,2,1,8
4,17,3,1,8
4,17,4,1,8
4,17,5,1,8
4,17,6,1,8
4,17,7,1,8
4,17,8,1,8
4,17,9,1,8
4,17,10,1,8
4,17,11,1,8
4,17,12,1,8
4,17,13,1,8
4,17,14,1,8
4,17,15,1,8
4,17,16,1,8
4,18,0,1,8
4,18,1,1,8
4,18,2,1,8
4,18,3,1,8
4,18,4,1,8
4,18,5,1,8
4,18,6,1,8
4,18,7,1,8
4,18,8,1,8
4,18,9,1,8
4,18,10,1,8
4,18,11,1,8
4,18,12,1,8
4,18,13,1,8
4,18,14,1,8
4,18,15,1,8
4,18,16,1,8
4,19,0,1,8
4,19,1,1,8
4,19,2,1,8
4,19,3,1,8
4,19,4,1,8
4,19,5,1,8
4,19,6,1,8
4,19,7,1,8
4,19,8,1,8
4,19,9,1,8
4,19,10,1,8
4,19,11,1,8
4,19,12,1,8
4,19,13,1,8
4,19,14,1,8
4,19,15,1,8
4,19,16,1,8
4,20,0,1,8
4,20,1,1,8
4,20,2,1,8
4,20,3,1,8
4,20,4,1,8
4,20,5,1,8
4,20,6,1,8
4,20,7,1,8
4,20,8,1,8
4,20,9,1,8
4,20,10,1,8
4,20,11,1,8
4,20,12,1,8
4,20,13,1,8
4,20,14,1,8
4,20,15,1,8
4,20,16,1,8
4,21,0,1,8
4,21,1,1,8
4,21,2,1,8
4,21,3,1,8
4,21,4,1,8
4,21,5,1,8
4,21,6,1,8
4,21,7,1,8
4,21,8,1,8
4,21,9,1,8
4,21,10,1,8
4,21,11,1,8
4,21,12,1,8
4,21,13,1,8
4,21,14,1,8
4,21,15,1,8
4,21,16,1,8
4,0,0,2,8
4,0,1,2,8
4,0,2,2,8
4,0,3,2,8
4,0,4,2,8
4,0,5,2,8
4,0,6,2,8
4,0,7,2,8
4,0,8,2,8
4,0,9,2,8
4,0,10,2,8
4,0,11,2,8
4,0,12,2,8
4,0,13,2,8
4,0,14,2,8
4,0,15,2,8
4,0,16,2,8
4,1,0,2,8
4,1,1,2,8
4,1,2,2,8
4,1,3,2,8
4,1,4,2,8
4,1,5,2,8
4,1,6,2,8
4,1,7,2,8
4,1,8,2,8
4,1,9,2,8
4,1,10,2,8
4,1,11,2,8
4,1,12,2,8
4,1,13,2,8
4,1,14,2,8
4,1,15,2,8
4,1,16,2,8
4,2,0,2,8
4,2,1,2,8
4,2,2,2,8
4,2,3,2,8
4,2,4,2,8
4,2,5,2,8
4,2,6,2,8
4,2,7,2,8
4,2,8,2,8
4,2,9,2,8
4,2,10,2,8
4,2,11,2,8
4,2,12,2,8
4,2,13,2,8
4,2,14,2,8
4,2,15,2,8
4,2,16,2,8
4,3,0,2,8
4,3,1,2,8
4,3,2,2,8
4,3,3,2,8
4,3,4,2,8
4,3,5,2,8
4,3,6,2,8
4,3,7,2,8
4,3,8,2,8
4,3,9,2,8
4,3,10,2,8
4,3,11,2,8
4,3,12,2,8
4,3,13,2,8
4,3,14,2,8
4,3,15,2,8
4,3,16,2,8
4,4,0,2,8
4,4,1,2,8
4,4,2,2,8
4,4,3,2,8
4,4,4,2,8
4,4,5,2,8
4,4,6,2,8
4,4,7,2,8
4,4,8,2,8
4,4,9,2,8
4,4,10,2,8
4,4,11,2,8
4,4,12,2,8
4,4,13,2,8
4,4,14,2,8
4,4,15,2,8
4,4,16,2,8
4,5,0,2,8
4,5,1,2,8
4,5,2,2,8
4,5,3,2,8
4,5,4,2,8
4,5,5,2,8
4,5,6,2,8
4,5,7,2,8
4,5,8,2,8
4,5,9,2,8
4,5,10,2,8
4,5,11,2,8
4,5,12,2,8
4,5,13,2,8
4,5,14,2,8
4,5,15,2,8
4,5,16,2,8
4,6,0,2,8
4,6,1,2,8
4,6,2,2,8
4,6,3,2,8
4,6,4,2,8
4,6,5,2,8
4,6,6,2,8
4,6,7,2,8
4,6,8,2,8
4,6,9,2,8
4,6,10,2,8
4,6,11,2,8
4,6,12,2,8
4,6,13,2,8
4,6,14,2,8
4,6,15,2,8
4,6,16,2,8
4,7,0,2,8
4,7,1,2,8
4,7,2,2,8
4,7,3,2,8
4,7,4,2,8
4,7,5,2,8
4,7,6,2,8
4,7,7,2,8
4,7,8,2,8
4,7,9,2,8
4,7,10,2,8
4,7,11,2,8
4,7,12,2,8
4,7,13,2,8
4,7,14,2,8
4,7,15,2,8
4,7,16,2,8
4,8,0,2,8
4,8,1,2,8
4,8,2,2,8
4,8,3,2,8
4,8,4,2,8
4,8,5,2,8
4,8,6,2,8
4,8,7,2,8
4,8,8,2,8
4,8,9,2,8
4,8,10,2,8
4,8,11,2,8
4,8,12,2,8
4,8,13,2,8
4,8,14,2,8
4,8,15,2,8
4,8,16,2,8
4,9,0,2,8
4,9,1,2,8
4,9,2,2,8
4,9,3,2,8
4,9,4,2,8
4,9,5,2,8
4,9,6,2,8
4,9,7,2,8
4,9,8,2,8
4,9,9,2,8
4,9,10,2,8
4,9,11,2,8
4,9,12,2,8
4,9,13,2,8
4,9,14,2,8
4,9,15,2,8
4,9,16,2,8
4,10,0,2,8
4,10,1,2,8
4,10,2,2,8
4,10,3,2,8
4,10,4,2,8
4,10,5,2,8
4,10,6,2,8
4,10,7,2,8
4,10,8,2,8
4,10,9,2,8
4,10,10,2,8
4,10,11,2,8
4,10,12,2,8
4,10,13,2,8
4,10,14,2,8
4,10,15,2,8
4,10,16,2,8
4,11,0,2,8
4,11,1,2,8
4,11,2,2,8
4,11,3,2,8
4,11,4,2,8
4,11,5,2,8
4,11,6,2,8
4,11,7,2,8
4,11,8,2,8
4,11,9,2,8
4,11,10,2,8
4,11,11,2,8
4,11,12,2,8
4,11,13,2,8
4,11,14,2,8
4,11,15,2,8
4,11,16,2,8
4,12,0,2,8
4,12,1,2,8
4,12,2,2,8
4,12,3,2,8
4,12,4,2,8
4,12,5,2,8
4,12,6,2,8
4,12,7,2,8
4,12,8,2,8
4,12,9,2,8
4,12,10,2,8
4,12,11,2,8
4,12,12,2,8
4,12,13,2,8
4,12,14,2,8
4,12,15,2,8
4,12,16,2,8
4,13,0,2,8
4,13,1,2,8
4,13,2,2,8
4,13,3,2,8
4,13,4,2,8
4,13,5,2,8
4,13,6,2,8
4,13,7,2,8
4,13,8,2,8
4,13,9,2,8
4,13,10,2,8
4,13,11,2,8
4,13,12,2,8
4,13,13,2,8
4,13,14,2,8
4,13,15,2,8
4,13,16,2,8
4,14,0,2,8
4,14,1,2,8
4,14,2,2,8
4,14,3,2,8
4,14,4,2,8
4,14,5,2,8
4,14,6,2,8
4,14,7,2,8
4,14,8,2,8
4,14,9,2,8
4,14,10,2,8
4,14,11,2,8
4,14,12,2,8
4,14,13,2,8
4,14,14,2,8
4,14,15,2,8
4,14,16,2,8
4,15,0,2,8
4,15,1,2,8
4,15,2,2,8
4,15,3,2,8
4,15,4,2,8
4,15,5,2,8
4,15,6,2,8
4,15,7,2,8
4,15,8,2,8
4,15,9,2,8
4,15,10,2,8
4,15,11,2,8
4,15,12,2,8
4,15,13,2,8
4,15,14,2,8
4,15,15,2,8
4,15,16,2,8
4,16,0,2,8
4,16,1,2,8
4,16,2,2,8
4,16,3,2,8
4,16,4,2,8
4,16,5,2,8
4,16,6,2,8
4,16,7,2,8
4,16,8,2,8
4,16,9,2,8
4,16,10,2,8
4,16,11,2,8
4,16,12,2,8
4,16,13,2,8
4,16,14,2,8
4,16,15,2,8
4,16,16,2,8
4,17,0,2,8
4,17,1,2,8
4,17,2,2,8
4,17,3,2,8
4,17,4,2,8
4,17,5,2,8
4,17,6,2,8
4,17,7,2,8
4,17,8,2,8
4,17,9,2,8
4,17,10,2,8
4,17,11,2,8
4,17,12,2,8
4,17,13,2,8
4,17,14,2,8
4,17,15,2,8
4,17,16,2,8
4,18,0,2,8
4,18,1,2,8
4,18,2,2,8
4,18,3,2,8
4,18,4,2,8
4,18,5,2,8
4,18,6,2,8
4,18,7,2,8
4,18,8,2,8
4,18,9,2,8
4,18,10,2,8
4,18,11,2,8
4,18,12,2,8
4,18,13,2,8
4,18,14,2,8
4,18,15,2,8
4,18,16,2,8
4,0,0,3,8
4,0,1,3,8
4,0,2,3,8
4,0,3,3,8
4,0,4,3,8
4,0,5,3,8
4,0,6,3,8
4,0,7,3,8
4,0,8,3,8
4,0,9,3,8
4,0,10,3,8
4,0,11,3,8
4,0,12,3,8
4,0,13,3,8
4,0,14,3,8
4,0,15,3,8
4,0,16,3,8
4,1,0,3,8
4,1,1,3,8
4,1,2,3,8
4,1,3,3,8
4,1,4,3,8
4,1,5,3,8
4,1,6,3,8
4,1,7,3,8
4,1,8,3,8
4,1,9,3,8
4,1,10,3,8
4,1,11,3,8
4,1,12,3,8
4,1,13,3,8
4,1,14,3,8
4,1,15,3,8
4,1,16,3,8
4,2,0,3,8
4,2,1,3,8
4,2,2,3,8
4,2,3,3,8
4,2,4,3,8
4,2,5,3,8
4,2,6,3,8
4,2,7,3,8
4,2,8,3,8
4,2,9,3,8
4,2,10,3,8
4,2,11,3,8
4,2,12,3,8
4,2,13,3,8
4,2,14,3,8
4,2,15,3,8
4,2,16,3,8
4,3,0,3,8
4,3,1,3,8
4,3,2,3,8
4,3,3,3,8
4,3,4,3,8
4,3,5,3,8
4,3,6,3,8
4,3,7,3,8
4,3,8,3,8
4,3,9,3,8
4,3,10,3,8
4,3,11,3,8
4,3,12,3,8
4,3,13,3,8
4,3,14,3,8
4,3,15,3,8
4,3,16,3,8
4,4,0,3,8
4,4,1,3,8
4,4,2,3,8
4,4,3,3,8
4,4,4,3,8
4,4,5,3,8
4,4,6,3,8
4,4,7,3,8
4,4,8,3,8
4,4,9,3,8
4,4,10,3,8
4,4,11,3,8
4,4,12,3,8
4,4,13,3,8
4,4,14,3,8
4,4,15,3,8
4,4,16,3,8
4,5,0,3,8
4,5,1,3,8
4,5,2,3,8
4,5,3,3,8
4,5,4,3,8
4,5,5,3,8
4,5,6,3,8
4,5,7,3,8
4,5,8,3,8
4,5,9,3,8
4,5,10,3,8
4,5,11,3,8
4,5,12,3,8
4,5,13,3,8
4,5,14,3,8
4,5,15,3,8
4,5,16,3,8
4,6,0,3,8
4,6,1,3,8
4,6,2,3,8
4,6,3,3,8
4,6,4,3,8
4,6,5,3,8
4,6,6,3,8
4,6,7,3,8
4,6,8,3,8
4,6,9,3,8
4,6,10,3,8
4,6,11,3,8
4,6,12,3,8
4,6,13,3,8
4,6,14,3,8
4,6,15,3,8
4,6,16,3,8
4,7,0,3,8
4,7,1,3,8
4,7,2,3,8
4,7,3,3,8
4,7,4,3,8
4,7,5,3,8
4,7,6,3,8
4,7,7,3,8
4,7,8,3,8
4,7,9,3,8
4,7,10,3,8
4,7,11,3,8
4,7,12,3,8
4,7,13,3,8
4,7,14,3,8
4,7,15,3,8
4,7,16,3,8
4,8,0,3,8
4,8,1,3,8
4,8,2,3,8
4,8,3,3,8
4,8,4,3,8
4,8,5,3,8
4,8,6,3,8
4,8,7,3,8
4,8,8,3,8
4,8,9,3,8
4,8,10,3,8
4,8,11,3,8
4,8,12,3,8
4,8,13,3,8
4,8,14,3,8
4,8,15,3,8
4,8,16,3,8
4,9,0,3,8
4,9,1,3,8
4,9,2,3,8
4,9,3,3,8
4,9,4,3,8
4,9,5,3,8
4,9,6,3,8
4,9,7,3,8
4,9,8,3,8
4,9,9,3,8
4,9,10,3,8
4,9,11,3,8
4,9,12,3,8
4,9,13,3,8
4,9,14,3,8
4,9,15,3,8
4,9,16,3,8
4,10,0,3,8
4,10,1,3,8
4,10,2,3,8
4,10,3,3,8
4,10,4,3,8
4,10,5,3,8
4,10,6,3,8
4,10,7,3,8
4,10,8,3,8
4,10,9,3,8
4,10,10,3,8
4,10,11,3,8
4,10,12,3,8
4,10,13,3,8
4,10,14,3,8
4,10,15,3,8
4,10,16,3,8
4,11,0,3,8
4,11,1,3,8
4,11,2,3,8
4,11,3,3,8
4,11,4,3,8
4,11,5,3,8
4,11,6,3,8
4,11,7,3,8
4,11,8,3,8
4,11,9,3,8
4,11,10,3,8
4,11,11,3,8
4,11,12,3,8
4,11,13,3,8
4,11,14,3,8
4,11,15,3,8
4,11,16,3,8
4,12,0,3,8
4,12,1,3,8
4,12,2,3,8
4,12,3,3,8
4,12,4,3,8
4,12,5,3,8
4,12,6,3,8
4,12,7,3,8
4,12,8,3,8
4,12,9,3,8
4,12,10,3,8
4,12,11,3,8
4,12,12,3,8
4,12,13,3,8
4,12,14,3,8
4,12,15,3,8
4,12,16,3,8
4,13,0,3,8
4,13,1,3,8
4,13,2,3,8
4,13,3,3,8
4,13,4,3,8
4,13,5,3,8
4,13,6,3,8
4,13,7,3,8
4,13,8,3,8
4,13,9,3,8
4,13,10,3,8
4,13,11,3,8
4,13,12,3,8
4,13,13,3,8
4,13,14,3,8
4,13,15,3,8
4,13,16,3,8
4,14,0,3,8
4,14,1,3,8
4,14,2,3,8
4,14,3,3,8
4,14,4,3,8
4,14,5,3,8
4,14,6,3,8
4,14,7,3,8
4,14,8,3,8
4,14,9,3,8
4,14,10,3,8
4,14,11,3,8
4,14,12,3,8
4,14,13,3,8
4,14,14,3,8
4,14,15,3,8
4,14,16,3,8
4,15,0,3,8
4,15,1,3,8
4,15,2,3,8
4,15,3,3,8
4,15,4,3,8
4,15,5,3,8
4,15,6,3,8
4,15,7,3,8
4,15,8,3,8
4,15,9,3,8
4,15,10,3,8
4,15,11,3,8
4,15,12,3,8
4,15,13,3,8
4,15,14,3,8
4,15,15,3,8
4,15,16,3,8
4,0,0,4,8
4,0,1,4,8
4,0,2,4,8
4,0,3,4,8
4,0,4,4,8
4,0,5,4,8
4,0,6,4,8
4,0,7,4,8
4,0,8,4,8
4,0,9,4,8
4,0,10,4,8
4,0,11,4,8
4,0,12,4,8
4,0,13,4,8
4,0,14,4,8
4,0,15,4,8
4,0,16,4,8
4,1,0,4,8
4,1,1,4,8
4,1,2,4,8
4,1,3,4,8
4,1,4,4,8
4,1,5,4,8
4,1,6,4,8
4,1,7,4,8
4,1,8,4,8
4,1,9,4,8
4,1,10,4,8
4,1,11,4,8
4,1,12,4,8
4,1,13,4,8
4,1,14,4,8
4,1,15,4,8
4,1,16,4,8
4,2,0,4,8
4,2,1,4,8
4,2,2,4,8
4,2,3,4,8
4,2,4,4,8
4,2,5,4,8
4,2,6,4,8
4,2,7,4,8
4,2,8,4,8
4,2,9,4,8
4,2,10,4,8
4,2,11,4,8
4,2,12,4,8
4,2,13,4,8
4,2,14,4,8
4,2,15,4,8
4,2,16,4,8
4,3,0,4,8
4,3,1,4,8
4,3,2,4,8
4,3,3,4,8
4,3,4,4,8
4,3,5,4,8
4,3,6,4,8
4,3,7,4,8
4,3,8,4,8
4,3,9,4,8
4,3,10,4,8
4,3,11,4,8
4,3,12,4,8
4,3,13,4,8
4,3,14,4,8
4,3,15,4,8
4,3,16,4,8
4,4,0,4,8
4,4,1,4,8
4,4,2,4,8
4,4,3,4,8
4,4,4,4,8
4,4,5,4,8
4,4,6,4,8
4,4,7,4,8
4,4,8,4,8
4,4,9,4,8
4,4,10,4,8
4,4,11,4,8
4,4,12,4,8
4,4,13,4,8
4,4,14,4,8
4,4,15,4,8
4,4,16,4,8
4,5,0,4,8
4,5,1,4,8
4,5,2,4,8
4,5,3,4,8
4,5,4,4,8
4,5,5,4,8
4,5,6,4,8
4,5,7,4,8
4,5,8,4,8
4,5,9,4,8
4,5,10,4,8
4,5,11,4,8
4,5,12,4,8
4,5,13,4,8
4,5,14,4,8
4,5,15,4,8
4,5,16,4,8
4,6,0,4,8
4,6,1,4,8
4,6,2,4,8
4,6,3,4,8
4,6,4,4,8
4,6,5,4,8
4,6,6,4,8
4,6,7,4,8
4,6,8,4,8
4,6,9,4,8
4,6,10,4,8
4,6,11,4,8
4,6,12,4,8
4,6,13,4,8
4,6,14,4,8
4,6,15,4,8
4,6,16,4,8
4,7,0,4,8
4,7,1,4,8
4,7,2,4,8
4,7,3,4,8
4,7,4,4,8
4,7,5,4,8
4,7,6,4,8
4,7,7,4,8
4,7,8,4,8
4,7,9,4,8
4,7,10,4,8
4,7,11,4,8
4,7,12,4,8
4,7,13,4,8
4,7,14,4,8
4,7,15,4,8
4,7,16,4,8
4,8,0,4,8
4,8,1,4,8
4,8,2,4,8
4,8,3,4,8
4,8,4,4,8
4,8,5,4,8
4,8,6,4,8
4,8,7,4,8
4,8,8,4,8
4,8,9,4,8
4,8,10,4,8
4,8,11,4,8
4,8,12,4,8
4,8,13,4,8
4,8,14,4,8
4,8,15,4,8
4,8,16,4,8
4,9,0,4,8
4,9,1,4,8
4,9,2,4,8
4,9,3,4,8
4,9,4,4,8
4,9,5,4,8
4,9,6,4,8
4,9,7,4,8
4,9,8,4,8
4,9,9,4,8
4,9,10,4,8
4,9,11,4,8
4,9,12,4,8
4,9,13,4,8
4,9,14,4,8
4,9,15,4,8
4,9,16,4,8
4,10,0,4,8
4,10,1,4,8
4,10,2,4,8
4,10,3,4,8
4,10,4,4,8
4,10,5,4,8
4,10,6,4,8
4,10,7,4,8
4,10,8,4,8
4,10,9,4,8
4,10,10,4,8
4,10,11,4,8
4,10,12,4,8
4,10,13,4,8
4,10,14,4,8
4,10,15,4,8
4,10,16,4,8
4,11,0,4,8
4,11,1,4,8
4,11,2,4,8
4,11,3,4,8
4,11,4,4,8
4,11,5,4,8
4,11,6,4,8
4,11,7,4,8
4,11,8,4,8
4,11,9,4,8
4,11,10,4,8
4,11,11,4,8
4,11,12,4,8
4,11,13,4,8
4,11,14,4,8
4,11,15,4,8
4,11,16,4,8
4,12,0,4,8
4,12,1,4,8
4,12,2,4,8
4,12,3,4,8
4,12,4,4,8
4,12,5,4,8
4,12,6,4,8
4,12,7,4,8
4,12,8,4,8
4,12,9,4,8
4,12,10,4,8
4,12,11,4,8
4,12,12,4,8
4,12,13,4,8
4,12,14,4,8
4,12,15,4,8
4,12,16,4,8
4,0,0,5,8
4,0,1,5,8
4,0,2,5,8
4,0,3,5,8
4,0,4,5,8
4,0,5,5,8
4,0,6,5,8
4,0,7,5,8
4,0,8,5,8
4,0,9,5,8
4,0,10,5,8
4,0,11,5,8
4,0,12,5,8
4,0,13,5,8
4,0,14,5,8
4,0,15,5,8
4,0,16,5,8
4,1,0,5,8
4,1,1,5,8
4,1,2,5,8
4,1,3,5,8
4,1,4,5,8
4,1,5,5,8
4,1,6,5,8
4,1,7,5,8
4,1,8,5,8
4,1,9,5,8
4,1,10,5,8
4,1,11,5,8
4,1,12,5,8
4,1,13,5,8
4,1,14,5,8
4,1,15,5,8
4,1,16,5,8
4,2,0,5,8
4,2,1,5,8
4,2,2,5,8
4,2,3,5,8
4,2,4,5,8
4,2,5,5,8
4,2,6,5,8
4,2,7,5,8
4,2,8,5,8
4,2,9,5,8
4,2,10,5,8
4,2,11,5,8
4,2,12,5,8
4,2,13,5,8
4,2,14,5,8
4,2,15,5,8
4,2,16,5,8
4,3,0,5,8
4,3,1,5,8
4,3,2,5,8
4,3,3,5,8
4,3,4,5,8
4,3,5,5,8
4,3,6,5,8
4,3,7,5,8
4,3,8,5,8
4,3,9,5,8
4,3,10,5,8
4,3,11,5,8
4,3,12,5,8
4,3,13,5,8
4,3,14,5,8
4,3,15,5,8
4,3,16,5,8
4,4,0,5,8
4,4,1,5,8
4,4,2,5,8
4,4,3,5,8
4,4,4,5,8
4,4,5,5,8
4,4,6,5,8
4,4,7,5,8
4,4,8,5,8
4,4,9,5,8
4,4,10,5,8
4,4,11,5,8
4,4,12,5,8
4,4,13,5,8
4,4,14,5,8
4,4,15,5,8
4,4,16,5,8
4,5,0,5,8
4,5,1,5,8
4,5,2,5,8
4,5,3,5,8
4,5,4,5,8
4,5,5,5,8
4,5,6,5,8
4,5,7,5,8
4,5,8,5,8
4,5,9,5,8
4,5,10,5,8
4,5,11,5,8
4,5,12,5,8
4,5,13,5,8
4,5,14,5,8
4,5,15,5,8
4,5,16,5,8
4,6,0,5,8
4,6,1,5,8
4,6,2,5,8
4,6,3,5,8
4,6,4,5,8
4,6,5,5,8
4,6,6,5,8
4,6,7,5,8
4,6,8,5,8
4,6,9,5,8
4,6,10,5,8
4,6,11,5,8
4,6,12,5,8
4,6,13,5,8
4,6,14,5,8
4,6,15,5,8
4,6,16,5,8
4,7,0,5,8
4,7,1,5,8
4,7,2,5,8
4,7,3,5,8
4,7,4,5,8
4,7,5,5,8
4,7,6,5,8
4,7,7,5,8
4,7,8,5,8
4,7,9,5,8
4,7,10,5,8
4,7,11,5,8
4,7,12,5,8
4,7,13,5,8
4,7,14,5,8
4,7,15,5,8
4,7,16,5,8
4,8,0,5,8
4,8,1,5,8
4,8,2,5,8
4,8,3,5,8
4,8,4,5,8
4,8,5,5,8
4,8,6,5,8
4,8,7,5,8
4,8,8,5,8
4,8,9,5,8
4,8,10,5,8
4,8,11,5,8
4,8,12,5,8
4,8,13,5,8
4,8,14,5,8
4,8,15,5,8
4,8,16,5,8
4,9,0,5,8
4,9,1,5,8
4,9,2,5,8
4,9,3,5,8
4,9,4,5,8
4,9,5,5,8
4,9,6,5,8
4,9,7,5,8
4,9,8,5,8
4,9,9,5,8
4,9,10,5,8
4,9,11,5,8
4,9,12,5,8
4,9,13,5,8
4,9,14,5,8
4,9,15,5,8
4,9,16,5,8
4,0,0,6,8
4,0,1,6,8
4,0,2,6,8
4,0,3,6,8
4,0,4,6,8
4,0,5,6,8
4,0,6,6,8
4,0,7,6,8
4,0,8,6,8
4,0,9,6,8
4,0,10,6,8
4,0,11,6,8
4,0,12,6,8
4,0,13,6,8
4,0,14,6,8
4,0,15,6,8
4,0,16,6,8
4,1,0,6,8
4,1,1,6,8
4,1,2,6,8
4,1,3,6,8
4,1,4,6,8
4,1,5,6,8
4,1,6,6,8
4,1,7,6,8
4,1,8,6,8
4,1,9,6,8
4,1,10,6,8
4,1,11,6,8
4,1,12,6,8
4,1,13,6,8
4,1,14,6,8
4,1,15,6,8
4,1,16,6,8
4,2,0,6,8
4,2,1,6,8
4,2,2,6,8
4,2,3,6,8
4,2,4,6,8
4,2,5,6,8
4,2,6,6,8
4,2,7,6,8
4,2,8,6,8
4,2,9,6,8
4,2,10,6,8
4,2,11,6,8
4,2,12,6,8
4,2,13,6,8
4,2,14,6,8
4,2,15,6,8
4,2,16,6,8
4,3,0,6,8
4,3,1,6,8
4,3,2,6,8
4,3,3,6,8
4,3,4,6,8
4,3,5,6,8
4,3,6,6,8
4,3,7,6,8
4,3,8,6,8
4,3,9,6,8
4,3,10,6,8
4,3,11,6,8
4,3,12,6,8
4,3,13,6,8
4,3,14,6,8
4,3,15,6,8
4,3,16,6,8
4,4,0,6,8
4,4,1,6,8
4,4,2,6,8
4,4,3,6,8
4,4,4,6,8
4,4,5,6,8
4,4,6,6,8
4,4,7,6,8
4,4,8,6,8
4,4,9,6,8
4,4,10,6,8
4,4,11,6,8
4,4,12,6,8
4,4,13,6,8
4,4,14,6,8
4,4,15,6,8
4,4,16,6,8
4,5,0,6,8
4,5,1,6,8
4,5,2,6,8
4,5,3,6,8
4,5,4,6,8
4,5,5,6,8
4,5,6,6,8
4,5,7,6,8
4,5,8,6,8
4,5,9,6,8
4,5,10,6,8
4,5,11,6,8
4,5,12,6,8
4,5,13,6,8
4,5,14,6,8
4,5,15,6,8
4,5,16,6,8
4,6,0,6,8
4,6,1,6,8
4,6,2,6,8
4,6,3,6,8
4,6,4,6,8
4,6,5,6,8
4,6,6,6,8
4,6,7,6,8
4,6,8,6,8
4,6,9,6,8
4,6,10,6,8
4,6,11,6,8
4,6,12,6,8
4,6,13,6,8
4,6,14,6,8
4,6,15,6,8
4,6,16,6,8
4,0,0,7,8
4,0,1,7,8
4,0,2,7,8
4,0,3,7,8
4,0,4,7,8
4,0,5,7,8
4,0,6,7,8
4,0,7,7,8
4,0,8,7,8
4,0,9,7,8
4,0,10,7,8
4,0,11,7,8
4,0,12,7,8
4,0,13,7,8
4,0,14,7,8
4,0,15,7,8
4,0,16,7,8
4,1,0,7,8
4,1,1,7,8
4,1,2,7,8
4,1,3,7,8
4,1,4,7,8
4,1,5,7,8
4,1,6,7,8
4,1,7,7,8
4,1,8,7,8
4,1,9,7,8
4,1,10,7,8
4,1,11,7,8
4,1,12,7,8
4,1,13,7,8
4,1,14,7,8
4,1,15,7,8
4,1,16,7,8
4,2,0,7,8
4,2,1,7,8
4,2,2,7,8
4,2,3,7,8
4,2,4,7,8
4,2,5,7,8
4,2,6,7,8
4,2,7,7,8
4,2,8,7,8
4,2,9,7,8
4,2,10,7,8
4,2,11,7,8
4,2,12,7,8
4,2,13,7,8
4,2,14,7,8
4,2,15,7,8
4,2,16,7,8
4,3,0,7,8
4,3,1,7,8
4,3,2,7,8
4,3,3,7,8
4,3,4,7,8
4,3,5,7,8
4,3,6,7,8
4,3,7,7,8
4,3,8,7,8
4,3,9,7,8
4,3,10,7,8
4,3,11,7,8
4,3,12,7,8
4,3,13,7,8
4,3,14,7,8
4,3,15,7,8
4,3,16,7,8
4,0,0,8,8
4,0,1,8,8
4,0,2,8,8
4,0,3,8,8
4,0,4,8,8
4,0,5,8,8
4,0,6,8,8
4,0,7,8,8
4,0,8,8,8
4,0,9,8,8
4,0,10,8,8
4,0,11,8,8
4,0,12,8,8
4,0,13,8,8
4,0,14,8,8
4,0,15,8,8
4,0,16,8,8
4,0,0,1,9
4,0,1,1,9
4,0,2,1,9
4,0,3,1,9
4,0,4,1,9
4,0,5,1,9
4,0,6,1,9
4,0,7,1,9
4,0,8,1,9
4,0,9,1,9
4,0,10,1,9
4,0,11,1,9
4,0,12,1,9
4,0,13,1,9
4,0,14,1,9
4,0,15,1,9
4,1,0,1,9
4,1,1,1,9
4,1,2,1,9
4,1,3,1,9
4,1,4,1,9
4,1,5,1,9
4,1,6,1,9
4,1,7,1,9
4,1,8,1,9
4,1,9,1,9
4,1,10,1,9
4,1,11,1,9
4,1,12,1,9
4,1,13,1,9
4,1,14,1,9
4,1,15,1,9
4,2,0,1,9
4,2,1,1,9
4,2,2,1,9
4,2,3,1,9
4,2,4,1,9
4,2,5,1,9
4,2,6,1,9
4,2,7,1,9
4,2,8,1,9
4,2,9,1,9
4,2,10,1,9
4,2,11,1,9
4,2,12,1,9
4,2,13,1,9
4,2,14,1,9
4,2,15,1,9
4,3,0,1,9
4,3,1,1,9
4,3,2,1,9
4,3,3,1,9
4,3,4,1,9
4,3,5,1,9
4,3,6,1,9
4,3,7,1,9
4,3,8,1,9
4,3,9,1,9
4,3,10,1,9
4,3,11,1,9
4,3,12,1,9
4,3,13,1,9
4,3,14,1,9
4,3,15,1,9
4,4,0,1,9
4,4,1,1,9
4,4,2,1,9
4,4,3,1,9
4,4,4,1,9
4,4,5,1,9
4,4,6,1,9
4,4,7,1,9
4,4,8,1,9
4,4,9,1,9
4,4,10,1,9
4,4,11,1,9
4,4,12,1,9
4,4,13,1,9
4,4,14,1,9
4,4,15,1,9
4,5,0,1,9
4,5,1,1,9
4,5,2,1,9
4,5,3,1,9
4,5,4,1,9
4,5,5,1,9
4,5,6,1,9
4,5,7,1,9
4,5,8,1,9
4,5,9,1,9
4,5,10,1,9
4,5,11,1,9
4,5,12,1,9
4,5,13,1,9
4,5,14,1,9
4,5,15,1,9
4,6,0,1,9
4,6,1,1,9
4,6,2,1,9
4,6,3,1,9
4,6,4,1,9
4,6,5,1,9
4,6,6,1,9
4,6,7,1,9
4,6,8,1,9
4,6,9,1,9
4,6,10,1,9
4,6,11,1,9
4,6,12,1,9
4,6,13,1,9
4,6,14,1,9
4,6,15,1,9
4,7,0,1,9
4,7,1,1,9
4,7,2,1,9
4,7,3,1,9
4,7,4,1,9
4,7,5,1,9
4,7,6,1,9
4,7,7,1,9
4,7,8,1,9
4,7,9,1,9
4,7,10,1,9
4,7,11,1,9
4,7,12,1,9
4,7,13,1,9
4,7,14,1,9
4,7,15,1,9
4,8,0,1,9
4,8,1,1,9
4,8,2,1,9
4,8,3,1,9
4,8,4,1,9
4,8,5,1,9
4,8,6,1,9
4,8,7,1,9
4,8,8,1,9
4,8,9,1,9
4,8,10,1,9
4,8,11,1,9
4,8,12,1,9
4,8,13,1,9
4,8,14,1,9
4,8,15,1,9
4,9,0,1,9
4,9,1,1,9
4,9,2,1,9
4,9,3,1,9
4,9,4,1,9
4,9,5,1,9
4,9,6,1,9
4,9,7,1,9
4,9,8,1,9
4,9,9,1,9
4,9,10,1,9
4,9,11,1,9
4,9,12,1,9
4,9,13,1,9
4,9,14,1,9
4,9,15,1,9
4,10,0,1,9
4,10,1,1,9
4,10,2,1,9
4,10,3,1,9
4,10,4,1,9
4,10,5,1,9
4,10,6,1,9
4,10,7,1,9
4,10,8,1,9
4,10,9,1,9
4,10,10,1,9
4,10,11,1,9
4,10,12,1,9
4,10,13,1,9
4,10,14,1,9
4,10,15,1,9
4,11,0,1,9
4,11,1,1,9
4,11,2,1,9
4,11,3,1,9
4,11,4,1,9
4,11,5,1,9
4,11,6,1,9
4,11,7,1,9
4,11,8,1,9
4,11,9,1,9
4,11,10,1,9
4,11,11,1,9
4,11,12,1,9
4,11,13,1,9
4,11,14,1,9
4,11,15,1,9
4,12,0,1,9
4,12,1,1,9
4,12,2,1,9
4,12,3,1,9
4,12,4,1,9
4,12,5,1,9
4,12,6,1,9
4,12,7,1,9
4,12,8,1,9
4,12,9,1,9
4,12,10,1,9
4,12,11,1,9
4,12,12,1,9
4,12,13,1,9
4,12,14,1,9
4,12,15,1,9
4,13,0,1,9
4,13,1,1,9
4,13,2,1,9
4,13,3,1,9
4,13,4,1,9
4,13,5,1,9
4,13,6,1,9
4,13,7,1,9
4,13,8,1,9
4,13,9,1,9
4,13,10,1,9
4,13,11,1,9
4,13,12,1,9
4,13,13,1,9
4,13,14,1,9
4,13,15,1,9
4,14,0,1,9
4,14,1,1,9
4,14,2,1,9
4,14,3,1,9
4,14,4,1,9
4,14,5,1,9
4,14,6,1,9
4,14,7,1,9
4,14,8,1,9
4,14,9,1,9
4,14,10,1,9
4,14,11,1,9
4,14,12,1,9
4,14,13,1,9
4,14,14,1,9
4,14,15,1,9
4,15,0,1,9
4,15,1,1,9
4,15,2,1,9
4,15,3,1,9
4,15,4,1,9
4,15,5,1,9
4,15,6,1,9
4,15,7,1,9
4,15,8,1,9
4,15,9,1,9
4,15,10,1,9
4,15,11,1,9
4,15,12,1,9
4,15,13,1,9
4,15,14,1,9
4,15,15,1,9
4,16,0,1,9
4,16,1,1,9
4,16,2,1,9
4,16,3,1,9
4,16,4,1,9
4,16,5,1,9
4,16,6,1,9
4,16,7,1,9
4,16,8,1,9
4,16,9,1,9
4,16,10,1,9
4,16,11,1,9
4,16,12,1,9
4,16,13,1,9
4,16,14,1,9
4,16,15,1,9
4,17,0,1,9
4,17,1,1,9
4,17,2,1,9
4,17,3,1,9
4,17,4,1,9
4,17,5,1,9
4,17,6,1,9
4,17,7,1,9
4,17,8,1,9
4,17,9,1,9
4,17,10,1,9
4,17,11,1,9
4,17,12,1,9
4,17,13,1,9
4,17,14,1,9
4,17,15,1,9
4,18,0,1,9
4,18,1,1,9
4,18,2,1,9
4,18,3,1,9
4,18,4,1,9
4,18,5,1,9
4,18,6,1,9
4,18,7,1,9
4,18,8,1,9
4,18,9,1,9
4,18,10,1,9
4,18,11,1,9
4,18,12,1,9
4,18,13,1,9
4,18,14,1,9
4,18,15,1,9
4,19,0,1,9
4,19,1,1,9
4,19,2,1,9
4,19,3,1,9
4,19,4,1,9
4,19,5,1,9
4,19,6,1,9
4,19,7,1,9
4,19,8,1,9
4,19,9,1,9
4,19,10,1,9
4,19,11,1,9
4,19,12,1,9
4,19,13,1,9
4,19,14,1,9
4,19,15,1,9
4,20,0,1,9
4,20,1,1,9
4,20,2,1,9
4,20,3,1,9
4,20,4,1,9
4,20,5,1,9
4,20,6,1,9
4,20,7,1,9
4,20,8,1,9
4,20,9,1,9
4,20,10,1,9
4,20,11,1,9
4,20,12,1,9
4,20,13,1,9
4,20,14,1,9
4,20,15,1,9
4,21,0,1,9
4,21,1,1,9
4,21,2,1,9
4,21,3,1,9
4,21,4,1,9
4,21,5,1,9
4,21,6,1,9
4,21,7,1,9
4,21,8,1,9
4,21,9,1,9
4,21,10,1,9
4,21,11,1,9
4,21,12,1,9
4,21,13,1,9
4,21,14,1,9
4,21,15,1,9
4,0,0,2,9
4,0,1,2,9
4,0,2,2,9
4,0,3,2,9
4,0,4,2,9
4,0,5,2,9
4,0,6,2,9
4,0,7,2,9
4,0,8,2,9
4,0,9,2,9
4,0,10,2,9
4,0,11,2,9
4,0,12,2,9
4,0,13,2,9
4,0,14,2,9
4,0,15,2,9
4,1,0,2,9
4,1,1,2,9
4,1,2,2,9
4,1,3,2,9
4,1,4,2,9
4,1,5,2,9
4,1,6,2,9
4,1,7,2,9
4,1,8,2,9
4,1,9,2,9
4,1,10,2,9
4,1,11,2,9
4,1,12,2,9
4,1,13,2,9
4,1,14,2,9
4,1,15,2,9
4,2,0,2,9
4,2,1,2,9
4,2,2,2,9
4,2,3,2,9
4,2,4,2,9
4,2,5,2,9
4,2,6,2,9
4,2,7,2,9
4,2,8,2,9
4,2,9,2,9
4,2,10,2,9
4,2,11,2,9
4,2,12,2,9
4,2,13,2,9
4,2,14,2,9
4,2,15,2,9
4,3,0,2,9
4,3,1,2,9
4,3,2,2,9
4,3,3,2,9
4,3,4,2,9
4,3,5,2,9
4,3,6,2,9
4,3,7,2,9
4,3,8,2,9
4,3,9,2,9
4,3,10,2,9
4,3,11,2,9
4,3,12,2,9
4,3,13,2,9
4,3,14,2,9
4,3,15,2,9
4,4,0,2,9
4,4,1,2,9
4,4,2,2,9
4,4,3,2,9
4,4,4,2,9
4,4,5,2,9
4,4,6,2,9
4,4,7,2,9
4,4,8,2,9
4,4,9,2,9
4,4,10,2,9
4,4,11,2,9
4,4,12,2,9
4,4,13,2,9
4,4,14,2,9
4,4,15,2,9
4,5,0,2,9
4,5,1,2,9
4,5,2,2,9
4,5,3,2,9
4,5,4,2,9
4,5,5,2,9
4,5,6,2,9
4,5,7,2,9
4,5,8,2,9
4,5,9,2,9
4,5,10,2,9
4,5,11,2,9
4,5,12,2,9
4,5,13,2,9
4,5,14,2,9
4,5,15,2,9
4,6,0,2,9
4,6,1,2,9
4,6,2,2,9
4,6,3,2,9
4,6,4,2,9
4,6,5,2,9
4,6,6,2,9
4,6,7,2,9
4,6,8,2,9
4,6,9,2,9
4,6,10,2,9
4,6,11,2,9
4,6,12,2,9
4,6,13,2,9
4,6,14,2,9
4,6,15,2,9
4,7,0,2,9
4,7,1,2,9
4,7,2,2,9
4,7,3,2,9
4,7,4,2,9
4,7,5,2,9
4,7,6,2,9
4,7,7,2,9
4,7,8,2,9
4,7,9,2,9
4,7,10,2,9
4,7,11,2,9
4,7,12,2,9
4,7,13,2,9
4,7,14,2,9
4,7,15,2,9
4,8,0,2,9
4,8,1,2,9
4,8,2,2,9
4,8,3,2,9
4,8,4,2,9
4,8,5,2,9
4,8,6,2,9
4,8,7,2,9
4,8,8,2,9
4,8,9,2,9
4,8,10,2,9
4,8,11,2,9
4,8,12,2,9
4,8,13,2,9
4,8,14,2,9
4,8,15,2,9
4,9,0,2,9
4,9,1,2,9
4,9,2,2,9
4,9,3,2,9
4,9,4,2,9
4,9,5,2,9
4,9,6,2,9
4,9,7,2,9
4,9,8,2,9
4,9,9,2,9
4,9,10,2,9
4,9,11,2,9
4,9,12,2,9
4,9,13,2,9
4,9,14,2,9
4,9,15,2,9
4,10,0,2,9
4,10,1,2,9
4,10,2,2,9
4,10,3,2,9
4,10,4,2,9
4,10,5,2,9
4,10,6,2,9
4,10,7,2,9
4,10,8,2,9
4,10,9,2,9
4,10,10,2,9
4,10,11,2,9
4,10,12,2,9
4,10,13,2,9
4,10,14,2,9
4,10,15,2,9
4,11,0,2,9
4,11,1,2,9
4,11,2,2,9
4,11,3,2,9
4,11,4,2,9
4,11,5,2,9
4,11,6,2,9
4,11,7,2,9
4,11,8,2,9
4,11,9,2,9
4,11,10,2,9
4,11,11,2,9
4,11,12,2,9
4,11,13,2,9
4,11,14,2,9
4,11,15,2,9
4,12,0,2,9
4,12,1,2,9
4,12,2,2,9
4,12,3,2,9
4,12,4,2,9
4,12,5,2,9
4,12,6,2,9
4,12,7,2,9
4,12,8,2,9
4,12,9,2,9
4,12,10,2,9
4,12,11,2,9
4,12,12,2,9
4,12,13,2,9
4,12,14,2,9
4,12,15,2,9
4,13,0,2,9
4,13,1,2,9
4,13,2,2,9
4,13,3,2,9
4,13,4,2,9
4,13,5,2,9
4,13,6,2,9
4,13,7,2,9
4,13,8,2,9
4,13,9,2,9
4,13,10,2,9
4,13,11,2,9
4,13,12,2,9
4,13,13,2,9
4,13,14,2,9
4,13,15,2,9
4,14,0,2,9
4,14,1,2,9
4,14,2,2,9
4,14,3,2,9
4,14,4,2,9
4,14,5,2,9
4,14,6,2,9
4,14,7,2,9
4,14,8,2,9
4,14,9,2,9
4,14,10,2,9
4,14,11,2,9
4,14,12,2,9
4,14,13,2,9
4,14,14,2,9
4,14,15,2,9
4,15,0,2,9
4,15,1,2,9
4,15,2,2,9
4,15,3,2,9
4,15,4,2,9
4,15,5,2,9
4,15,6,2,9
4,15,7,2,9
4,15,8,2,9
4,15,9,2,9
4,15,10,2,9
4,15,11,2,9
4,15,12,2,9
4,15,13,2,9
4,15,14,2,9
4,15,15,2,9
4,16,0,2,9
4,16,1,2,9
4,16,2,2,9
4,16,3,2,9
4,16,4,2,9
4,16,5,2,9
4,16,6,2,9
4,16,7,2,9
4,16,8,2,9
4,16,9,2,9
4,16,10,2,9
4,16,11,2,9
4,16,12,2,9
4,16,13,2,9
4,16,14,2,9
4,16,15,2,9
4,17,0,2,9
4,17,1,2,9
4,17,2,2,9
4,17,3,2,9
4,17,4,2,9
4,17,5,2,9
4,17,6,2,9
4,17,7,2,9
4,17,8,2,9
4,17,9,2,9
4,17,10,2,9
4,17,11,2,9
4,17,12,2,9
4,17,13,2,9
4,17,14,2,9
4,17,15,2,9
4,18,0,2,9
4,18,1,2,9
4,18,2,2,9
4,18,3,2,9
4,18,4,2,9
4,18,5,2,9
4,18,6,2,9
4,18,7,2,9
4,18,8,2,9
4,18,9,2,9
4,18,10,2,9
4,18,11,2,9
4,18,12,2,9
4,18,13,2,9
4,18,14,2,9
4,18,15,2,9
4,0,0,3,9
4,0,1,3,9
4,0,2,3,9
4,0,3,3,9
4,0,4,3,9
4,0,5,3,9
4,0,6,3,9
4,0,7,3,9
4,0,8,3,9
4,0,9,3,9
4,0,10,3,9
4,0,11,3,9
4,0,12,3,9
4,0,13,3,9
4,0,14,3,9
4,0,15,3,9
4,1,0,3,9
4,1,1,3,9
4,1,2,3,9
4,1,3,3,9
4,1,4,3,9
4,1,5,3,9
4,1,6,3,9
4,1,7,3,9
4,1,8,3,9
4,1,9,3,9
4,1,10,3,9
4,1,11,3,9
4,1,12,3,9
4,1,13,3,9
4,1,14,3,9
4,1,15,3,9
4,2,0,3,9
4,2,1,3,9
4,2,2,3,9
4,2,3,3,9
4,2,4,3,9
4,2,5,3,9
4,2,6,3,9
4,2,7,3,9
4,2,8,3,9
4,2,9,3,9
4,2,10,3,9
4,2,11,3,9
4,2,12,3,9
4,2,13,3,9
4,2,14,3,9
4,2,15,3,9
4,3,0,3,9
4,3,1,3,9
4,3,2,3,9
4,3,3,3,9
4,3,4,3,9
4,3,5,3,9
4,3,6,3,9
4,3,7,3,9
4,3,8,3,9
4,3,9,3,9
4,3,10,3,9
4,3,11,3,9
4,3,12,3,9
4,3,13,3,9
4,3,14,3,9
4,3,15,3,9
4,4,0,3,9
4,4,1,3,9
4,4,2,3,9
4,4,3,3,9
4,4,4,3,9
4,4,5,3,9
4,4,6,3,9
4,4,7,3,9
4,4,8,3,9
4,4,9,3,9
4,4,10,3,9
4,4,11,3,9
4,4,12,3,9
4,4,13,3,9
4,4,14,3,9
4,4,15,3,9
4,5,0,3,9
4,5,1,3,9
4,5,2,3,9
4,5,3,3,9
4,5,4,3,9
4,5,5,3,9
4,5,6,3,9
4,5,7,3,9
4,5,8,3,9
4,5,9,3,9
4,5,10,3,9
4,5,11,3,9
4,5,12,3,9
4,5,13,3,9
4,5,14,3,9
4,5,15,3,9
4,6,0,3,9
4,6,1,3,9
4,6,2,3,9
4,6,3,3,9
4,6,4,3,9
4,6,5,3,9
4,6,6,3,9
4,6,7,3,9
4,6,8,3,9
4,6,9,3,9
4,6,10,3,9
4,6,11,3,9
4,6,12,3,9
4,6,13,3,9
4,6,14,3,9
4,6,15,3,9
4,7,0,3,9
4,7,1,3,9
4,7,2,3,9
4,7,3,3,9
4,7,4,3,9
4,7,5,3,9
4,7,6,3,9
4,7,7,3,9
4,7,8,3,9
4,7,9,3,9
4,7,10,3,9
4,7,11,3,9
4,7,12,3,9
4,7,13,3,9
4,7,14,3,9
4,7,15,3,9
4,8,0,3,9
4,8,1,3,9
4,8,2,3,9
4,8,3,3,9
4,8,4,3,9
4,8,5,3,9
4,8,6,3,9
4,8,7,3,9
4,8,8,3,9
4,8,9,3,9
4,8,10,3,9
4,8,11,3,9
4,8,12,3,9
4,8,13,3,9
4,8,14,3,9
4,8,15,3,9
4,9,0,3,9
4,9,1,3,9
4,9,2,3,9
4,9,3,3,9
4,9,4,3,9
4,9,5,3,9
4,9,6,3,9
4,9,7,3,9
4,9,8,3,9
4,9,9,3,9
4,9,10,3,9
4,9,11,3,9
4,9,12,3,9
4,9,13,3,9
4,9,14,3,9
4,9,15,3,9
4,10,0,3,9
4,10,1,3,9
4,10,2,3,9
4,10,3,3,9
4,10,4,3,9
4,10,5,3,9
4,10,6,3,9
4,10,7,3,9
4,10,8,3,9
4,10,9,3,9
4,10,10,3,9
4,10,11,3,9
4,10,12,3,9
4,10,13,3,9
4,10,14,3,9
4,10,15,3,9
4,11,0,3,9
4,11,1,3,9
4,11,2,3,9
4,11,3,3,9
4,11,4,3,9
4,11,5,3,9
4,11,6,3,9
4,11,7,3,9
4,11,8,3,9
4,11,9,3,9
4,11,10,3,9
4,11,11,3,9
4,11,12,3,9
4,11,13,3,9
4,11,14,3,9
4,11,15,3,9
4,12,0,3,9
4,12,1,3,9
4,12,2,3,9
4,12,3,3,9
4,12,4,3,9
4,12,5,3,9
4,12,6,3,9
4,12,7,3,9
4,12,8,3,9
4,12,9,3,9
4,12,10,3,9
4,12,11,3,9
4,12,12,3,9
4,12,13,3,9
4,12,14,3,9
4,12,15,3,9
4,13,0,3,9
4,13,1,3,9
4,13,2,3,9
4,13,3,3,9
4,13,4,3,9
4,13,5,3,9
4,13,6,3,9
4,13,7,3,9
4,13,8,3,9
4,13,9,3,9
4,13,10,3,9
4,13,11,3,9
4,13,12,3,9
4,13,13,3,9
4,13,14,3,9
4,13,15,3,9
4,14,0,3,9
4,14,1,3,9
4,14,2,3,9
4,14,3,3,9
4,14,4,3,9
4,14,5,3,9
4,14,6,3,9
4,14,7,3,9
4,14,8,3,9
4,14,9,3,9
4,14,10,3,9
4,14,11,3,9
4,14,12,3,9
4,14,13,3,9
4,14,14,3,9
4,14,15,3,9
4,15,0,3,9
4,15,1,3,9
4,15,2,3,9
4,15,3,3,9
4,15,4,3,9
4,15,5,3,9
4,15,6,3,9
4,15,7,3,9
4,15,8,3,9
4,15,9,3,9
4,15,10,3,9
4,15,11,3,9
4,15,12,3,9
4,15,13,3,9
4,15,14,3,9
4,15,15,3,9
4,0,0,4,9
4,0,1,4,9
4,0,2,4,9
4,0,3,4,9
4,0,4,4,9
4,0,5,4,9
4,0,6,4,9
4,0,7,4,9
4,0,8,4,9
4,0,9,4,9
4,0,10,4,9
4,0,11,4,9
4,0,12,4,9
4,0,13,4,9
4,0,14,4,9
4,0,15,4,9
4,1,0,4,9
4,1,1,4,9
4,1,2,4,9
4,1,3,4,9
4,1,4,4,9
4,1,5,4,9
4,1,6,4,9
4,1,7,4,9
4,1,8,4,9
4,1,9,4,9
4,1,10,4,9
4,1,11,4,9
4,1,12,4,9
4,1,13,4,9
4,1,14,4,9
4,1,15,4,9
4,2,0,4,9
4,2,1,4,9
4,2,2,4,9
4,2,3,4,9
4,2,4,4,9
4,2,5,4,9
4,2,6,4,9
4,2,7,4,9
4,2,8,4,9
4,2,9,4,9
4,2,10,4,9
4,2,11,4,9
4,2,12,4,9
4,2,13,4,9
4,2,14,4,9
4,2,15,4,9
4,3,0,4,9
4,3,1,4,9
4,3,2,4,9
4,3,3,4,9
4,3,4,4,9
4,3,5,4,9
4,3,6,4,9
4,3,7,4,9
4,3,8,4,9
4,3,9,4,9
4,3,10,4,9
4,3,11,4,9
4,3,12,4,9
4,3,13,4,9
4,3,14,4,9
4,3,15,4,9
4,4,0,4,9
4,4,1,4,9
4,4,2,4,9
4,4,3,4,9
4,4,4,4,9
4,4,5,4,9
4,4,6,4,9
4,4,7,4,9
4,4,8,4,9
4,4,9,4,9
4,4,10,4,9
4,4,11,4,9
4,4,12,4,9
4,4,13,4,9
4,4,14,4,9
4,4,15,4,9
4,5,0,4,9
4,5,1,4,9
4,5,2,4,9
4,5,3,4,9
4,5,4,4,9
4,5,5,4,9
4,5,6,4,9
4,5,7,4,9
4,5,8,4,9
4,5,9,4,9
4,5,10,4,9
4,5,11,4,9
4,5,12,4,9
4,5,13,4,9
4,5,14,4,9
4,5,15,4,9
4,6,0,4,9
4,6,1,4,9
4,6,2,4,9
4,6,3,4,9
4,6,4,4,9
4,6,5,4,9
4,6,6,4,9
4,6,7,4,9
4,6,8,4,9
4,6,9,4,9
4,6,10,4,9
4,6,11,4,9
4,6,12,4,9
4,6,13,4,9
4,6,14,4,9
4,6,15,4,9
4,7,0,4,9
4,7,1,4,9
4,7,2,4,9
4,7,3,4,9
4,7,4,4,9
4,7,5,4,9
4,7,6,4,9
4,7,7,4,9
4,7,8,4,9
4,7,9,4,9
4,7,10,4,9
4,7,11,4,9
4,7,12,4,9
4,7,13,4,9
4,7,14,4,9
4,7,15,4,9
4,8,0,4,9
4,8,1,4,9
4,8,2,4,9
4,8,3,4,9
4,8,4,4,9
4,8,5,4,9
4,8,6,4,9
4,8,7,4,9
4,8,8,4,9
4,8,9,4,9
4,8,10,4,9
4,8,11,4,9
4,8,12,4,9
4,8,13,4,9
4,8,14,4,9
4,8,15,4,9
4,9,0,4,9
4,9,1,4,9
4,9,2,4,9
4,9,3,4,9
4,9,4,4,9
4,9,5,4,9
4,9,6,4,9
4,9,7,4,9
4,9,8,4,9
4,9,9,4,9
4,9,10,4,9
4,9,11,4,9
4,9,12,4,9
4,9,13,4,9
4,9,14,4,9
4,9,15,4,9
4,10,0,4,9
4,10,1,4,9
4,10,2,4,9
4,10,3,4,9
4,10,4,4,9
4,10,5,4,9
4,10,6,4,9
4,10,7,4,9
4,10,8,4,9
4,10,9,4,9
4,10,10,4,9
4,10,11,4,9
4,10,12,4,9
4,10,13,4,9
4,10,14,4,9
4,10,15,4,9
4,11,0,4,9
4,11,1,4,9
4,11,2,4,9
4,11,3,4,9
4,11,4,4,9
4,11,5,4,9
4,11,6,4,9
4,11,7,4,9
4,11,8,4,9
4,11,9,4,9
4,11,10,4,9
4,11,11,4,9
4,11,12,4,9
4,11,13,4,9
4,11,14,4,9
4,11,15,4,9
4,12,0,4,9
4,12,1,4,9
4,12,2,4,9
4,12,3,4,9
4,12,4,4,9
4,12,5,4,9
4,12,6,4,9
4,12,7,4,9
4,12,8,4,9
4,12,9,4,9
4,12,10,4,9
4,12,11,4,9
4,12,12,4,9
4,12,13,4,9
4,12,14,4,9
4,12,15,4,9
4,0,0,5,9
4,0,1,5,9
4,0,2,5,9
4,0,3,5,9
4,0,4,5,9
4,0,5,5,9
4,0,6,5,9
4,0,7,5,9
4,0,8,5,9
4,0,9,5,9
4,0,10,5,9
4,0,11,5,9
4,0,12,5,9
4,0,13,5,9
4,0,14,5,9
4,0,15,5,9
4,1,0,5,9
4,1,1,5,9
4,1,2,5,9
4,1,3,5,9
4,1,4,5,9
4,1,5,5,9
4,1,6,5,9
4,1,7,5,9
4,1,8,5,9
4,1,9,5,9
4,1,10,5,9
4,1,11,5,9
4,1,12,5,9
4,1,13,5,9
4,1,14,5,9
4,1,15,5,9
4,2,0,5,9
4,2,1,5,9
4,2,2,5,9
4,2,3,5,9
4,2,4,5,9
4,2,5,5,9
4,2,6,5,9
4,2,7,5,9
4,2,8,5,9
4,2,9,5,9
4,2,10,5,9
4,2,11,5,9
4,2,12,5,9
4,2,13,5,9
4,2,14,5,9
4,2,15,5,9
4,3,0,5,9
4,3,1,5,9
4,3,2,5,9
4,3,3,5,9
4,3,4,5,9
4,3,5,5,9
4,3,6,5,9
4,3,7,5,9
4,3,8,5,9
4,3,9,5,9
4,3,10,5,9
4,3,11,5,9
4,3,12,5,9
4,3,13,5,9
4,3,14,5,9
4,3,15,5,9
4,4,0,5,9
4,4,1,5,9
4,4,2,5,9
4,4,3,5,9
4,4,4,5,9
4,4,5,5,9
4,4,6,5,9
4,4,7,5,9
4,4,8,5,9
4,4,9,5,9
4,4,10,5,9
4,4,11,5,9
4,4,12,5,9
4,4,13,5,9
4,4,14,5,9
4,4,15,5,9
4,5,0,5,9
4,5,1,5,9
4,5,2,5,9
4,5,3,5,9
4,5,4,5,9
4,5,5,5,9
4,5,6,5,9
4,5,7,5,9
4,5,8,5,9
4,5,9,5,9
4,5,10,5,9
4,5,11,5,9
4,5,12,5,9
4,5,13,5,9
4,5,14,5,9
4,5,15,5,9
4,6,0,5,9
4,6,1,5,9
4,6,2,5,9
4,6,3,5,9
4,6,4,5,9
4,6,5,5,9
4,6,6,5,9
4,6,7,5,9
4,6,8,5,9
4,6,9,5,9
4,6,10,5,9
4,6,11,5,9
4,6,12,5,9
4,6,13,5,9
4,6,14,5,9
4,6,15,5,9
4,7,0,5,9
4,7,1,5,9
4,7,2,5,9
4,7,3,5,9
4,7,4,5,9
4,7,5,5,9
4,7,6,5,9
4,7,7,5,9
4,7,8,5,9
4,7,9,5,9
4,7,10,5,9
4,7,11,5,9
4,7,12,5,9
4,7,13,5,9
4,7,14,5,9
4,7,15,5,9
4,8,0,5,9
4,8,1,5,9
4,8,2,5,9
4,8,3,5,9
4,8,4,5,9
4,8,5,5,9
4,8,6,5,9
4,8,7,5,9
4,8,8,5,9
4,8,9,5,9
4,8,10,5,9
4,8,11,5,9
4,8,12,5,9
4,8,13,5,9
4,8,14,5,9
4,8,15,5,9
4,9,0,5,9
4,9,1,5,9
4,9,2,5,9
4,9,3,5,9
4,9,4,5,9
4,9,5,5,9
4,9,6,5,9
4,9,7,5,9
4,9,8,5,9
4,9,9,5,9
4,9,10,5,9
4,9,11,5,9
4,9,12,5,9
4,9,13,5,9
4,9,14,5,9
4,9,15,5,9
4,0,0,6,9
4,0,1,6,9
4,0,2,6,9
4,0,3,6,9
4,0,4,6,9
4,0,5,6,9
4,0,6,6,9
4,0,7,6,9
4,0,8,6,9
4,0,9,6,9
4,0,10,6,9
4,0,11,6,9
4,0,12,6,9
4,0,13,6,9
4,0,14,6,9
4,0,15,6,9
4,1,0,6,9
4,1,1,6,9
4,1,2,6,9
4,1,3,6,9
4,1,4,6,9
4,1,5,6,9
4,1,6,6,9
4,1,7,6,9
4,1,8,6,9
4,1,9,6,9
4,1,10,6,9
4,1,11,6,9
4,1,12,6,9
4,1,13,6,9
4,1,14,6,9
4,1,15,6,9
4,2,0,6,9
4,2,1,6,9
4,2,2,6,9
4,2,3,6,9
4,2,4,6,9
4,2,5,6,9
4,2,6,6,9
4,2,7,6,9
4,2,8,6,9
4,2,9,6,9
4,2,10,6,9
4,2,11,6,9
4,2,12,6,9
4,2,13,6,9
4,2,14,6,9
4,2,15,6,9
4,3,0,6,9
4,3,1,6,9
4,3,2,6,9
4,3,3,6,9
4,3,4,6,9
4,3,5,6,9
4,3,6,6,9
4,3,7,6,9
4,3,8,6,9
4,3,9,6,9
4,3,10,6,9
4,3,11,6,9
4,3,12,6,9
4,3,13,6,9
4,3,14,6,9
4,3,15,6,9
4,4,0,6,9
4,4,1,6,9
4,4,2,6,9
4,4,3,6,9
4,4,4,6,9
4,4,5,6,9
4,4,6,6,9
4,4,7,6,9
4,4,8,6,9
4,4,9,6,9
4,4,10,6,9
4,4,11,6,9
4,4,12,6,9
4,4,13,6,9
4,4,14,6,9
4,4,15,6,9
4,5,0,6,9
4,5,1,6,9
4,5,2,6,9
4,5,3,6,9
4,5,4,6,9
4,5,5,6,9
4,5,6,6,9
4,5,7,6,9
4,5,8,6,9
4,5,9,6,9
4,5,10,6,9
4,5,11,6,9
4,5,12,6,9
4,5,13,6,9
4,5,14,6,9
4,5,15,6,9
4,6,0,6,9
4,6,1,6,9
4,6,2,6,9
4,6,3,6,9
4,6,4,6,9
4,6,5,6,9
4,6,6,6,9
4,6,7,6,9
4,6,8,6,9
4,6,9,6,9
4,6,10,6,9
4,6,11,6,9
4,6,12,6,9
4,6,13,6,9
4,6,14,6,9
4,6,15,6,9
4,0,0,7,9
4,0,1,7,9
4,0,2,7,9
4,0,3,7,9
4,0,4,7,9
4,0,5,7,9
4,0,6,7,9
4,0,7,7,9
4,0,8,7,9
4,0,9,7,9
4,0,10,7,9
4,0,11,7,9
4,0,12,7,9
4,0,13,7,9
4,0,14,7,9
4,0,15,7,9
4,1,0,7,9
4,1,1,7,9
4,1,2,7,9
4,1,3,7,9
4,1,4,7,9
4,1,5,7,9
4,1,6,7,9
4,1,7,7,9
4,1,8,7,9
4,1,9,7,9
4,1,10,7,9
4,1,11,7,9
4,1,12,7,9
4,1,13,7,9
4,1,14,7,9
4,1,15,7,9
4,2,0,7,9
4,2,1,7,9
4,2,2,7,9
4,2,3,7,9
4,2,4,7,9
4,2,5,7,9
4,2,6,7,9
4,2,7,7,9
4,2,8,7,9
4,2,9,7,9
4,2,10,7,9
4,2,11,7,9
4,2,12,7,9
4,2,13,7,9
4,2,14,7,9
4,2,15,7,9
4,3,0,7,9
4,3,1,7,9
4,3,2,7,9
4,3,3,7,9
4,3,4,7,9
4,3,5,7,9
4,3,6,7,9
4,3,7,7,9
4,3,8,7,9
4,3,9,7,9
4,3,10,7,9
4,3,11,7,9
4,3,12,7,9
4,3,13,7,9
4,3,14,7,9
4,3,15,7,9
4,0,0,8,9
4,0,1,8,9
4,0,2,8,9
4,0,3,8,9
4,0,4,8,9
4,0,5,8,9
4,0,6,8,9
4,0,7,8,9
4,0,8,8,9
4,0,9,8,9
4,0,10,8,9
4,0,11,8,9
4,0,12,8,9
4,0,13,8,9
4,0,14,8,9
4,0,15,8,9
4,0,0,1,10
4,0,1,1,10
4,0,2,1,10
4,0,3,1,10
4,0,4,1,10
4,0,5,1,10
4,0,6,1,10
4,0,7,1,10
4,0,8,1,10
4,0,9,1,10
4,0,10,1,10
4,0,11,1,10
4,0,12,1,10
4,0,13,1,10
4,0,14,1,10
4,1,0,1,10
4,1,1,1,10
4,1,2,1,10
4,1,3,1,10
4,1,4,1,10
4,1,5,1,10
4,1,6,1,10
4,1,7,1,10
4,1,8,1,10
4,1,9,1,10
4,1,10,1,10
4,1,11,1,10
4,1,12,1,10
4,1,13,1,10
4,1,14,1,10
4,2,0,1,10
4,2,1,1,10
4,2,2,1,10
4,2,3,1,10
4,2,4,1,10
4,2,5,1,10
4,2,6,1,10
4,2,7,1,10
4,2,8,1,10
4,2,9,1,10
4,2,10,1,10
4,2,11,1,10
4,2,12,1,10
4,2,13,1,10
4,2,14,1,10
4,3,0,1,10
4,3,1,1,10
4,3,2,1,10
4,3,3,1,10
4,3,4,1,10
4,3,5,1,10
4,3,6,1,10
4,3,7,1,10
4,3,8,1,10
4,3,9,1,10
4,3,10,1,10
4,3,11,1,10
4,3,12,1,10
4,3,13,1,10
4,3,14,1,10
4,4,0,1,10
4,4,1,1,10
4,4,2,1,10
4,4,3,1,10
4,4,4,1,10
4,4,5,1,10
4,4,6,1,10
4,4,7,1,10
4,4,8,1,10
4,4,9,1,10
4,4,10,1,10
4,4,11,1,10
4,4,12,1,10
4,4,13,1,10
4,4,14,1,10
4,5,0,1,10
4,5,1,1,10
4,5,2,1,10
4,5,3,1,10
4,5,4,1,10
4,5,5,1,10
4,5,6,1,10
4,5,7,1,10
4,5,8,1,10
4,5,9,1,10
4,5,10,1,10
4,5,11,1,10
4,5,12,1,10
4,5,13,1,10
4,5,14,1,10
4,6,0,1,10
4,6,1,1,10
4,6,2,1,10
4,6,3,1,10
4,6,4,1,10
4,6,5,1,10
4,6,6,1,10
4,6,7,1,10
4,6,8,1,10
4,6,9,1,10
4,6,10,1,10
4,6,11,1,10
4,6,12,1,10
4,6,13,1,10
4,6,14,1,10
4,7,0,1,10
4,7,1,1,10
4,7,2,1,10
4,7,3,1,10
4,7,4,1,10
4,7,5,1,10
4,7,6,1,10
4,7,7,1,10
4,7,8,1,10
4,7,9,1,10
4,7,10,1,10
4,7,11,1,10
4,7,12,1,10
4,7,13,1,10
4,7,14,1,10
4,8,0,1,10
4,8,1,1,10
4,8,2,1,10
4,8,3,1,10
4,8,4,1,10
4,8,5,1,10
4,8,6,1,10
4,8,7,1,10
4,8,8,1,10
4,8,9,1,10
4,8,10,1,10
4,8,11,1,10
4,8,12,1,10
4,8,13,1,10
4,8,14,1,10
4,9,0,1,10
4,9,1,1,10
4,9,2,1,10
4,9,3,1,10
4,9,4,1,10
4,9,5,1,10
4,9,6,1,10
4,9,7,1,10
4,9,8,1,10
4,9,9,1,10
4,9,10,1,10
4,9,11,1,10
4,9,12,1,10
4,9,13,1,10
4,9,14,1,10
4,10,0,1,10
4,10,1,1,10
4,10,2,1,10
4,10,3,1,10
4,10,4,1,10
4,10,5,1,10
4,10,6,1,10
4,10,7,1,10
4,10,8,1,10
4,10,9,1,10
4,10,10,1,10
4,10,11,1,10
4,10,12,1,10
4,10,13,1,10
4,10,14,1,10
4,11,0,1,10
4,11,1,1,10
4,11,2,1,10
4,11,3,1,10
4,11,4,1,10
4,11,5,1,10
4,11,6,1,10
4,11,7,1,10
4,11,8,1,10
4,11,9,1,10
4,11,10,1,10
4,11,11,1,10
4,11,12,1,10
4,11,13,1,10
4,11,14,1,10
4,12,0,1,10
4,12,1,1,10
4,12,2,1,10
4,12,3,1,10
4,12,4,1,10
4,12,5,1,10
4,12,6,1,10
4,12,7,1,10
4,12,8,1,10
4,12,9,1,10
4,12,10,1,10
4,12,11,1,10
4,12,12,1,10
4,12,13,1,10
4,12,14,1,10
4,13,0,1,10
4,13,1,1,10
4,13,2,1,10
4,13,3,1,10
4,13,4,1,10
4,13,5,1,10
4,13,6,1,10
4,13,7,1,10
4,13,8,1,10
4,13,9,1,10
4,13,10,1,10
4,13,11,1,10
4,13,12,1,10
4,13,13,1,10
4,13,14,1,10
4,14,0,1,10
4,14,1,1,10
4,14,2,1,10
4,14,3,1,10
4,14,4,1,10
4,14,5,1,10
4,14,6,1,10
4,14,7,1,10
4,14,8,1,10
4,14,9,1,10
4,14,10,1,10
4,14,11,1,10
4,14,12,1,10
4,14,13,1,10
4,14,14,1,10
4,15,0,1,10
4,15,1,1,10
4,15,2,1,10
4,15,3,1,10
4,15,4,1,10
4,15,5,1,10
4,15,6,1,10
4,15,7,1,10
4,15,8,1,10
4,15,9,1,10
4,15,10,1,10
4,15,11,1,10
4,15,12,1,10
4,15,13,1,10
4,15,14,1,10
4,16,0,1,10
4,16,1,1,10
4,16,2,1,10
4,16,3,1,10
4,16,4,1,10
4,16,5,1,10
4,16,6,1,10
4,16,7,1,10
4,16,8,1,10
4,16,9,1,10
4,16,10,1,10
4,16,11,1,10
4,16,12,1,10
4,16,13,1,10
4,16,14,1,10
4,17,0,1,10
4,17,1,1,10
4,17,2,1,10
4,17,3,1,10
4,17,4,1,10
4,17,5,1,10
4,17,6,1,10
4,17,7,1,10
4,17,8,1,10
4,17,9,1,10
4,17,10,1,10
4,17,11,1,10
4,17,12,1,10
4,17,13,1,10
4,17,14,1,10
4,18,0,1,10
4,18,1,1,10
4,18,2,1,10
4,18,3,1,10
4,18,4,1,10
4,18,5,1,10
4,18,6,1,10
4,18,7,1,10
4,18,8,1,10
4,18,9,1,10
4,18,10,1,10
4,18,11,1,10
4,18,12,1,10
4,18,13,1,10
4,18,14,1,10
4,19,0,1,10
4,19,1,1,10
4,19,2,1,10
4,19,3,1,10
4,19,4,1,10
4,19,5,1,10
4,19,6,1,10
4,19,7,1,10
4,19,8,1,10
4,19,9,1,10
4,19,10,1,10
4,19,11,1,10
4,19,12,1,10
4,19,13,1,10
4,19,14,1,10
4,20,0,1,10
4,20,1,1,10
4,20,2,1,10
4,20,3,1,10
4,20,4,1,10
4,20,5,1,10
4,20,6,1,10
4,20,7,1,10
4,20,8,1,10
4,20,9,1,10
4,20,10,1,10
4,20,11,1,10
4,20,12,1,10
4,20,13,1,10
4,20,14,1,10
4,21,0,1,10
4,21,1,1,10
4,21,2,1,10
4,21,3,1,10
4,21,4,1,10
4,21,5,1,10
4,21,6,1,10
4,21,7,1,10
4,21,8,1,10
4,21,9,1,10
4,21,10,1,10
4,21,11,1,10
4,21,12,1,10
4,21,13,1,10
4,21,14,1,10
4,0,0,2,10
4,0,1,2,10
4,0,2,2,10
4,0,3,2,10
4,0,4,2,10
4,0,5,2,10
4,0,6,2,10
4,0,7,2,10
4,0,8,2,10
4,0,9,2,10
4,0,10,2,10
4,0,11,2,10
4,0,12,2,10
4,0,13,2,10
4,0,14,2,10
4,1,0,2,10
4,1,1,2,10
4,1,2,2,10
4,1,3,2,10
4,1,4,2,10
4,1,5,2,10
4,1,6,2,10
4,1,7,2,10
4,1,8,2,10
4,1,9,2,10
4,1,10,2,10
4,1,11,2,10
4,1,12,2,10
4,1,13,2,10
4,1,14,2,10
4,2,0,2,10
4,2,1,2,10
4,2,2,2,10
4,2,3,2,10
4,2,4,2,10
4,2,5,2,10
4,2,6,2,10
4,2,7,2,10
4,2,8,2,10
4,2,9,2,10
4,2,10,2,10
4,2,11,2,10
4,2,12,2,10
4,2,13,2,10
4,2,14,2,10
4,3,0,2,10
4,3,1,2,10
4,3,2,2,10
4,3,3,2,10
4,3,4,2,10
4,3,5,2,10
4,3,6,2,10
4,3,7,2,10
4,3,8,2,10
4,3,9,2,10
4,3,10,2,10
4,3,11,2,10
4,3,12,2,10
4,3,13,2,10
4,3,14,2,10
4,4,0,2,10
4,4,1,2,10
4,4,2,2,10
4,4,3,2,10
4,4,4,2,10
4,4,5,2,10
4,4,6,2,10
4,4,7,2,10
4,4,8,2,10
4,4,9,2,10
4,4,10,2,10
4,4,11,2,10
4,4,12,2,10
4,4,13,2,10
4,4,14,2,10
4,5,0,2,10
4,5,1,2,10
4,5,2,2,10
4,5,3,2,10
4,5,4,2,10
4,5,5,2,10
4,5,6,2,10
4,5,7,2,10
4,5,8,2,10
4,5,9,2,10
4,5,10,2,10
4,5,11,2,10
4,5,12,2,10
4,5,13,2,10
4,5,14,2,10
4,6,0,2,10
4,6,1,2,10
4,6,2,2,10
4,6,3,2,10
4,6,4,2,10
4,6,5,2,10
4,6,6,2,10
4,6,7,2,10
4,6,8,2,10
4,6,9,2,10
4,6,10,2,10
4,6,11,2,10
4,6,12,2,10
4,6,13,2,10
4,6,14,2,10
4,7,0,2,10
4,7,1,2,10
4,7,2,2,10
4,7,3,2,10
4,7,4,2,10
4,7,5,2,10
4,7,6,2,10
4,7,7,2,10
4,7,8,2,10
4,7,9,2,10
4,7,10,2,10
4,7,11,2,10
4,7,12,2,10
4,7,13,2,10
4,7,14,2,10
4,8,0,2,10
4,8,1,2,10
4,8,2,2,10
4,8,3,2,10
4,8,4,2,10
4,8,5,2,10
4,8,6,2,10
4,8,7,2,10
4,8,8,2,10
4,8,9,2,10
4,8,10,2,10
4,8,11,2,10
4,8,12,2,10
4,8,13,2,10
4,8,14,2,10
4,9,0,2,10
4,9,1,2,10
4,9,2,2,10
4,9,3,2,10
4,9,4,2,10
4,9,5,2,10
4,9,6,2,10
4,9,7,2,10
4,9,8,2,10
4,9,9,2,10
4,9,10,2,10
4,9,11,2,10
4,9,12,2,10
4,9,13,2,10
4,9,14,2,10
4,10,0,2,10
4,10,1,2,10
4,10,2,2,10
4,10,3,2,10
4,10,4,2,10
4,10,5,2,10
4,10,6,2,10
4,10,7,2,10
4,10,8,2,10
4,10,9,2,10
4,10,10,2,10
4,10,11,2,10
4,10,12,2,10
4,10,13,2,10
4,10,14,2,10
4,11,0,2,10
4,11,1,2,10
4,11,2,2,10
4,11,3,2,10
4,11,4,2,10
4,11,5,2,10
4,11,6,2,10
4,11,7,2,10
4,11,8,2,10
4,11,9,2,10
4,11,10,2,10
4,11,11,2,10
4,11,12,2,10
4,11,13,2,10
4,11,14,2,10
4,12,0,2,10
4,12,1,2,10
4,12,2,2,10
4,12,3,2,10
4,12,4,2,10
4,12,5,2,10
4,12,6,2,10
4,12,7,2,10
4,12,8,2,10
4,12,9,2,10
4,12,10,2,10
4,12,11,2,10
4,12,12,2,10
4,12,13,2,10
4,12,14,2,10
4,13,0,2,10
4,13,1,2,10
4,13,2,2,10
4,13,3,2,10
4,13,4,2,10
4,13,5,2,10
4,13,6,2,10
4,13,7,2,10
4,13,8,2,10
4,13,9,2,10
4,13,10,2,10
4,13,11,2,10
4,13,12,2,10
4,13,13,2,10
4,13,14,2,10
4,14,0,2,10
4,14,1,2,10
4,14,2,2,10
4,14,3,2,10
4,14,4,2,10
4,14,5,2,10
4,14,6,2,10
4,14,7,2,10
4,14,8,2,10
4,14,9,2,10
4,14,10,2,10
4,14,11,2,10
4,14,12,2,10
4,14,13,2,10
4,14,14,2,10
4,15,0,2,10
4,15,1,2,10
4,15,2,2,10
4,15,3,2,10
4,15,4,2,10
4,15,5,2,10
4,15,6,2,10
4,15,7,2,10
4,15,8,2,10
4,15,9,2,10
4,15,10,2,10
4,15,11,2,10
4,15,12,2,10
4,15,13,2,10
4,15,14,2,10
4,16,0,2,10
4,16,1,2,10
4,16,2,2,10
4,16,3,2,10
4,16,4,2,10
4,16,5,2,10
4,16,6,2,10
4,16,7,2,10
4,16,8,2,10
4,16,9,2,10
4,16,10,2,10
4,16,11,2,10
4,16,12,2,10
4,16,13,2,10
4,16,14,2,10
4,17,0,2,10
4,17,1,2,10
4,17,2,2,10
4,17,3,2,10
4,17,4,2,10
4,17,5,2,10
4,17,6,2,10
4,17,7,2,10
4,17,8,2,10
4,17,9,2,10
4,17,10,2,10
4,17,11,2,10
4,17,12,2,10
4,17,13,2,10
4,17,14,2,10
4,18,0,2,10
4,18,1,2,10
4,18,2,2,10
4,18,3,2,10
4,18,4,2,10
4,18,5,2,10
4,18,6,2,10
4,18,7,2,10
4,18,8,2,10
4,18,9,2,10
4,18,10,2,10
4,18,11,2,10
4,18,12,2,10
4,18,13,2,10
4,18,14,2,10
4,0,0,3,10
4,0,1,3,10
4,0,2,3,10
4,0,3,3,10
4,0,4,3,10
4,0,5,3,10
4,0,6,3,10
4,0,7,3,10
4,0,8,3,10
4,0,9,3,10
4,0,10,3,10
4,0,11,3,10
4,0,12,3,10
4,0,13,3,10
4,0,14,3,10
4,1,0,3,10
4,1,1,3,10
4,1,2,3,10
4,1,3,3,10
4,1,4,3,10
4,1,5,3,10
4,1,6,3,10
4,1,7,3,10
4,1,8,3,10
4,1,9,3,10
4,1,10,3,10
4,1,11,3,10
4,1,12,3,10
4,1,13,3,10
4,1,14,3,10
4,2,0,3,10
4,2,1,3,10
4,2,2,3,10
4,2,3,3,10
4,2,4,3,10
4,2,5,3,10
4,2,6,3,10
4,2,7,3,10
4,2,8,3,10
4,2,9,3,10
4,2,10,3,10
4,2,11,3,10
4,2,12,3,10
4,2,13,3,10
4,2,14,3,10
4,3,0,3,10
4,3,1,3,10
4,3,2,3,10
4,3,3,3,10
4,3,4,3,10
4,3,5,3,10
4,3,6,3,10
4,3,7,3,10
4,3,8,3,10
4,3,9,3,10
4,3,10,3,10
4,3,11,3,10
4,3,12,3,10
4,3,13,3,10
4,3,14,3,10
4,4,0,3,10
4,4,1,3,10
4,4,2,3,10
4,4,3,3,10
4,4,4,3,10
4,4,5,3,10
4,4,6,3,10
4,4,7,3,10
4,4,8,3,10
4,4,9,3,10
4,4,10,3,10
4,4,11,3,10
4,4,12,3,10
4,4,13,3,10
4,4,14,3,10
4,5,0,3,10
4,5,1,3,10
4,5,2,3,10
4,5,3,3,10
4,5,4,3,10
4,5,5,3,10
4,5,6,3,10
4,5,7,3,10
4,5,8,3,10
4,5,9,3,10
4,5,10,3,10
4,5,11,3,10
4,5,12,3,10
4,5,13,3,10
4,5,14,3,10
4,6,0,3,10
4,6,1,3,10
4,6,2,3,10
4,6,3,3,10
4,6,4,3,10
4,6,5,3,10
4,6,6,3,10
4,6,7,3,10
4,6,8,3,10
4,6,9,3,10
4,6,10,3,10
4,6,11,3,10
4,6,12,3,10
4,6,13,3,10
4,6,14,3,10
4,7,0,3,10
4,7,1,3,10
4,7,2,3,10
4,7,3,3,10
4,7,4,3,10
4,7,5,3,10
4,7,6,3,10
4,7,7,3,10
4,7,8,3,10
4,7,9,3,10
4,7,10,3,10
4,7,11,3,10
4,7,12,3,10
4,7,13,3,10
4,7,14,3,10
4,8,0,3,10
4,8,1,3,10
4,8,2,3,10
4,8,3,3,10
4,8,4,3,10
4,8,5,3,10
4,8,6,3,10
4,8,7,3,10
4,8,8,3,10
4,8,9,3,10
4,8,10,3,10
4,8,11,3,10
4,8,12,3,10
4,8,13,3,10
4,8,14,3,10
4,9,0,3,10
4,9,1,3,10
4,9,2,3,10
4,9,3,3,10
4,9,4,3,10
4,9,5,3,10
4,9,6,3,10
4,9,7,3,10
4,9,8,3,10
4,9,9,3,10
4,9,10,3,10
4,9,11,3,10
4,9,12,3,10
4,9,13,3,10
4,9,14,3,10
4,10,0,3,10
4,10,1,3,10
4,10,2,3,10
4,10,3,3,10
4,10,4,3,10
4,10,5,3,10
4,10,6,3,10
4,10,7,3,10
4,10,8,3,10
4,10,9,3,10
4,10,10,3,10
4,10,11,3,10
4,10,12,3,10
4,10,13,3,10
4,10,14,3,10
4,11,0,3,10
4,11,1,3,10
4,11,2,3,10
4,11,3,3,10
4,11,4,3,10
4,11,5,3,10
4,11,6,3,10
4,11,7,3,10
4,11,8,3,10
4,11,9,3,10
4,11,10,3,10
4,11,11,3,10
4,11,12,3,10
4,11,13,3,10
4,11,14,3,10
4,12,0,3,10
4,12,1,3,10
4,12,2,3,10
4,12,3,3,10
4,12,4,3,10
4,12,5,3,10
4,12,6,3,10
4,12,7,3,10
4,12,8,3,10
4,12,9,3,10
4,12,10,3,10
4,12,11,3,10
4,12,12,3,10
4,12,13,3,10
4,12,14,3,10
4,13,0,3,10
4,13,1,3,10
4,13,2,3,10
4,13,3,3,10
4,13,4,3,10
4,13,5,3,10
4,13,6,3,10
4,13,7,3,10
4,13,8,3,10
4,13,9,3,10
4,13,10,3,10
4,13,11,3,10
4,13,12,3,10
4,13,13,3,10
4,13,14,3,10
4,14,0,3,10
4,14,1,3,10
4,14,2,3,10
4,14,3,3,10
4,14,4,3,10
4,14,5,3,10
4,14,6,3,10
4,14,7,3,10
4,14,8,3,10
4,14,9,3,10
4,14,10,3,10
4,14,11,3,10
4,14,12,3,10
4,14,13,3,10
4,14,14,3,10
4,15,0,3,10
4,15,1,3,10
4,15,2,3,10
4,15,3,3,10
4,15,4,3,10
4,15,5,3,10
4,15,6,3,10
4,15,7,3,10
4,15,8,3,10
4,15,9,3,10
4,15,10,3,10
4,15,11,3,10
4,15,12,3,10
4,15,13,3,10
4,15,14,3,10
4,0,0,4,10
4,0,1,4,10
4,0,2,4,10
4,0,3,4,10
4,0,4,4,10
4,0,5,4,10
4,0,6,4,10
4,0,7,4,10
4,0,8,4,10
4,0,9,4,10
4,0,10,4,10
4,0,11,4,10
4,0,12,4,10
4,0,13,4,10
4,0,14,4,10
4,1,0,4,10
4,1,1,4,10
4,1,2,4,10
4,1,3,4,10
4,1,4,4,10
4,1,5,4,10
4,1,6,4,10
4,1,7,4,10
4,1,8,4,10
4,1,9,4,10
4,1,10,4,10
4,1,11,4,10
4,1,12,4,10
4,1,13,4,10
4,1,14,4,10
4,2,0,4,10
4,2,1,4,10
4,2,2,4,10
4,2,3,4,10
4,2,4,4,10
4,2,5,4,10
4,2,6,4,10
4,2,7,4,10
4,2,8,4,10
4,2,9,4,10
4,2,10,4,10
4,2,11,4,10
4,2,12,4,10
4,2,13,4,10
4,2,14,4,10
4,3,0,4,10
4,3,1,4,10
4,3,2,4,10
4,3,3,4,10
4,3,4,4,10
4,3,5,4,10
4,3,6,4,10
4,3,7,4,10
4,3,8,4,10
4,3,9,4,10
4,3,10,4,10
4,3,11,4,10
4,3,12,4,10
4,3,13,4,10
4,3,14,4,10
4,4,0,4,10
4,4,1,4,10
4,4,2,4,10
4,4,3,4,10
4,4,4,4,10
4,4,5,4,10
4,4,6,4,10
4,4,7,4,10
4,4,8,4,10
4,4,9,4,10
4,4,10,4,10
4,4,11,4,10
4,4,12,4,10
4,4,13,4,10
4,4,14,4,10
4,5,0,4,10
4,5,1,4,10
4,5,2,4,10
4,5,3,4,10
4,5,4,4,10
4,5,5,4,10
4,5,6,4,10
4,5,7,4,10
4,5,8,4,10
4,5,9,4,10
4,5,10,4,10
4,5,11,4,10
4,5,12,4,10
4,5,13,4,10
4,5,14,4,10
4,6,0,4,10
4,6,1,4,10
4,6,2,4,10
4,6,3,4,10
4,6,4,4,10
4,6,5,4,10
4,6,6,4,10
4,6,7,4,10
4,6,8,4,10
4,6,9,4,10
4,6,10,4,10
4,6,11,4,10
4,6,12,4,10
4,6,13,4,10
4,6,14,4,10
4,7,0,4,10
4,7,1,4,10
4,7,2,4,10
4,7,3,4,10
4,7,4,4,10
4,7,5,4,10
4,7,6,4,10
4,7,7,4,10
4,7,8,4,10
4,7,9,4,10
4,7,10,4,10
4,7,11,4,10
4,7,12,4,10
4,7,13,4,10
4,7,14,4,10
4,8,0,4,10
4,8,1,4,10
4,8,2,4,10
4,8,3,4,10
4,8,4,4,10
4,8,5,4,10
4,8,6,4,10
4,8,7,4,10
4,8,8,4,10
4,8,9,4,10
4,8,10,4,10
4,8,11,4,10
4,8,12,4,10
4,8,13,4,10
4,8,14,4,10
4,9,0,4,10
4,9,1,4,10
4,9,2,4,10
4,9,3,4,10
4,9,4,4,10
4,9,5,4,10
4,9,6,4,10
4,9,7,4,10
4,9,8,4,10
4,9,9,4,10
4,9,10,4,10
4,9,11,4,10
4,9,12,4,10
4,9,13,4,10
4,9,14,4,10
4,10,0,4,10
4,10,1,4,10
4,10,2,4,10
4,10,3,4,10
4,10,4,4,10
4,10,5,4,10
4,10,6,4,10
4,10,7,4,10
4,10,8,4,10
4,10,9,4,10
4,10,10,4,10
4,10,11,4,10
4,10,12,4,10
4,10,13,4,10
4,10,14,4,10
4,11,0,4,10
4,11,1,4,10
4,11,2,4,10
4,11,3,4,10
4,11,4,4,10
4,11,5,4,10
4,11,6,4,10
4,11,7,4,10
4,11,8,4,10
4,11,9,4,10
4,11,10,4,10
4,11,11,4,10
4,11,12,4,10
4,11,13,4,10
4,11,14,4,10
4,12,0,4,10
4,12,1,4,10
4,12,2,4,10
4,12,3,4,10
4,12,4,4,10
4,12,5,4,10
4,12,6,4,10
4,12,7,4,10
4,12,8,4,10
4,12,9,4,10
4,12,10,4,10
4,12,11,4,10
4,12,12,4,10
4,12,13,4,10
4,12,14,4,10
4,0,0,5,10
4,0,1,5,10
4,0,2,5,10
4,0,3,5,10
4,0,4,5,10
4,0,5,5,10
4,0,6,5,10
4,0,7,5,10
4,0,8,5,10
4,0,9,5,10
4,0,10,5,10
4,0,11,5,10
4,0,12,5,10
4,0,13,5,10
4,0,14,5,10
4,1,0,5,10
4,1,1,5,10
4,1,2,5,10
4,1,3,5,10
4,1,4,5,10
4,1,5,5,10
4,1,6,5,10
4,1,7,5,10
4,1,8,5,10
4,1,9,5,10
4,1,10,5,10
4,1,11,5,10
4,1,12,5,10
4,1,13,5,10
4,1,14,5,10
4,2,0,5,10
4,2,1,5,10
4,2,2,5,10
4,2,3,5,10
4,2,4,5,10
4,2,5,5,10
4,2,6,5,10
4,2,7,5,10
4,2,8,5,10
4,2,9,5,10
4,2,10,5,10
4,2,11,5,10
4,2,12,5,10
4,2,13,5,10
4,2,14,5,10
4,3,0,5,10
4,3,1,5,10
4,3,2,5,10
4,3,3,5,10
4,3,4,5,10
4,3,5,5,10
4,3,6,5,10
4,3,7,5,10
4,3,8,5,10
4,3,9,5,10
4,3,10,5,10
4,3,11,5,10
4,3,12,5,10
4,3,13,5,10
4,3,14,5,10
4,4,0,5,10
4,4,1,5,10
4,4,2,5,10
4,4,3,5,10
4,4,4,5,10
4,4,5,5,10
4,4,6,5,10
4,4,7,5,10
4,4,8,5,10
4,4,9,5,10
4,4,10,5,10
4,4,11,5,10
4,4,12,5,10
4,4,13,5,10
4,4,14,5,10
4,5,0,5,10
4,5,1,5,10
4,5,2,5,10
4,5,3,5,10
4,5,4,5,10
4,5,5,5,10
4,5,6,5,10
4,5,7,5,10
4,5,8,5,10
4,5,9,5,10
4,5,10,5,10
4,5,11,5,10
4,5,12,5,10
4,5,13,5,10
4,5,14,5,10
4,6,0,5,10
4,6,1,5,10
4,6,2,5,10
4,6,3,5,10
4,6,4,5,10
4,6,5,5,10
4,6,6,5,10
4,6,7,5,10
4,6,8,5,10
4,6,9,5,10
4,6,10,5,10
4,6,11,5,10
4,6,12,5,10
4,6,13,5,10
4,6,14,5,10
4,7,0,5,10
4,7,1,5,10
4,7,2,5,10
4,7,3,5,10
4,7,4,5,10
4,7,5,5,10
4,7,6,5,10
4,7,7,5,10
4,7,8,5,10
4,7,9,5,10
4,7,10,5,10
4,7,11,5,10
4,7,12,5,10
4,7,13,5,10
4,7,14,5,10
4,8,0,5,10
4,8,1,5,10
4,8,2,5,10
4,8,3,5,10
4,8,4,5,10
4,8,5,5,10
4,8,6,5,10
4,8,7,5,10
4,8,8,5,10
4,8,9,5,10
4,8,10,5,10
4,8,11,5,10
4,8,12,5,10
4,8,13,5,10
4,8,14,5,10
4,9,0,5,10
4,9,1,5,10
4,9,2,5,10
4,9,3,5,10
4,9,4,5,10
4,9,5,5,10
4,9,6,5,10
4,9,7,5,10
4,9,8,5,10
4,9,9,5,10
4,9,10,5,10
4,9,11,5,10
4,9,12,5,10
4,9,13,5,10
4,9,14,5,10
4,0,0,6,10
4,0,1,6,10
4,0,2,6,10
4,0,3,6,10
4,0,4,6,10
4,0,5,6,10
4,0,6,6,10
4,0,7,6,10
4,0,8,6,10
4,0,9,6,10
4,0,10,6,10
4,0,11,6,10
4,0,12,6,10
4,0,13,6,10
4,0,14,6,10
4,1,0,6,10
4,1,1,6,10
4,1,2,6,10
4,1,3,6,10
4,1,4,6,10
4,1,5,6,10
4,1,6,6,10
4,1,7,6,10
4,1,8,6,10
4,1,9,6,10
4,1,10,6,10
4,1,11,6,10
4,1,12,6,10
4,1,13,6,10
4,1,14,6,10
4,2,0,6,10
4,2,1,6,10
4,2,2,6,10
4,2,3,6,10
4,2,4,6,10
4,2,5,6,10
4,2,6,6,10
4,2,7,6,10
4,2,8,6,10
4,2,9,6,10
4,2,10,6,10
4,2,11,6,10
4,2,12,6,10
4,2,13,6,10
4,2,14,6,10
4,3,0,6,10
4,3,1,6,10
4,3,2,6,10
4,3,3,6,10
4,3,4,6,10
4,3,5,6,10
4,3,6,6,10
4,3,7,6,10
4,3,8,6,10
4,3,9,6,10
4,3,10,6,10
4,3,11,6,10
4,3,12,6,10
4,3,13,6,10
4,3,14,6,10
4,4,0,6,10
4,4,1,6,10
4,4,2,6,10
4,4,3,6,10
4,4,4,6,10
4,4,5,6,10
4,4,6,6,10
4,4,7,6,10
4,4,8,6,10
4,4,9,6,10
4,4,10,6,10
4,4,11,6,10
4,4,12,6,10
4,4,13,6,10
4,4,14,6,10
4,5,0,6,10
4,5,1,6,10
4,5,2,6,10
4,5,3,6,10
4,5,4,6,10
4,5,5,6,10
4,5,6,6,10
4,5,7,6,10
4,5,8,6,10
4,5,9,6,10
4,5,10,6,10
4,5,11,6,10
4,5,12,6,10
4,5,13,6,10
4,5,14,6,10
4,6,0,6,10
4,6,1,6,10
4,6,2,6,10
4,6,3,6,10
4,6,4,6,10
4,6,5,6,10
4,6,6,6,10
4,6,7,6,10
4,6,8,6,10
4,6,9,6,10
4,6,10,6,10
4,6,11,6,10
4,6,12,6,10
4,6,13,6,10
4,6,14,6,10
4,0,0,7,10
4,0,1,7,10
4,0,2,7,10
4,0,3,7,10
4,0,4,7,10
4,0,5,7,10
4,0,6,7,10
4,0,7,7,10
4,0,8,7,10
4,0,9,7,10
4,0,10,7,10
4,0,11,7,10
4,0,12,7,10
4,0,13,7,10
4,0,14,7,10
4,1,0,7,10
4,1,1,7,10
4,1,2,7,10
4,1,3,7,10
4,1,4,7,10
4,1,5,7,10
4,1,6,7,10
4,1,7,7,10
4,1,8,7,10
4,1,9,7,10
4,1,10,7,10
4,1,11,7,10
4,1,12,7,10
4,1,13,7,10
4,1,14,7,10
4,2,0,7,10
4,2,1,7,10
4,2,2,7,10
4,2,3,7,10
4,2,4,7,10
4,2,5,7,10
4,2,6,7,10
4,2,7,7,10
4,2,8,7,10
4,2,9,7,10
4,2,10,7,10
4,2,11,7,10
4,2,12,7,10
4,2,13,7,10
4,2,14,7,10
4,3,0,7,10
4,3,1,7,10
4,3,2,7,10
4,3,3,7,10
4,3,4,7,10
4,3,5,7,10
4,3,6,7,10
4,3,7,7,10
4,3,8,7,10
4,3,9,7,10
4,3,10,7,10
4,3,11,7,10
4,3,12,7,10
4,3,13,7,10
4,3,14,7,10
4,0,0,8,10
4,0,1,8,10
4,0,2,8,10
4,0,3,8,10
4,0,4,8,10
4,0,5,8,10
4,0,6,8,10
4,0,7,8,10
4,0,8,8,10
4,0,9,8,10
4,0,10,8,10
4,0,11,8,10
4,0,12,8,10
4,0,13,8,10
4,0,14,8,10
4,0,0,1,11
4,0,1,1,11
4,0,2,1,11
4,0,3,1,11
4,0,4,1,11
4,0,5,1,11
4,0,6,1,11
4,0,7,1,11
4,0,8,1,11
4,0,9,1,11
4,0,10,1,11
4,0,11,1,11
4,0,12,1,11
4,0,13,1,11
4,1,0,1,11
4,1,1,1,11
4,1,2,1,11
4,1,3,1,11
4,1,4,1,11
4,1,5,1,11
4,1,6,1,11
4,1,7,1,11
4,1,8,1,11
4,1,9,1,11
4,1,10,1,11
4,1,11,1,11
4,1,12,1,11
4,1,13,1,11
4,2,0,1,11
4,2,1,1,11
4,2,2,1,11
4,2,3,1,11
4,2,4,1,11
4,2,5,1,11
4,2,6,1,11
4,2,7,1,11
4,2,8,1,11
4,2,9,1,11
4,2,10,1,11
4,2,11,1,11
4,2,12,1,11
4,2,13,1,11
4,3,0,1,11
4,3,1,1,11
4,3,2,1,11
4,3,3,1,11
4,3,4,1,11
4,3,5,1,11
4,3,6,1,11
4,3,7,1,11
4,3,8,1,11
4,3,9,1,11
4,3,10,1,11
4,3,11,1,11
4,3,12,1,11
4,3,13,1,11
4,4,0,1,11
4,4,1,1,11
4,4,2,1,11
4,4,3,1,11
4,4,4,1,11
4,4,5,1,11
4,4,6,1,11
4,4,7,1,11
4,4,8,1,11
4,4,9,1,11
4,4,10,1,11
4,4,11,1,11
4,4,12,1,11
4,4,13,1,11
4,5,0,1,11
4,5,1,1,11
4,5,2,1,11
4,5,3,1,11
4,5,4,1,11
4,5,5,1,11
4,5,6,1,11
4,5,7,1,11
4,5,8,1,11
4,5,9,1,11
4,5,10,1,11
4,5,11,1,11
4,5,12,1,11
4,5,13,1,11
4,6,0,1,11
4,6,1,1,11
4,6,2,1,11
4,6,3,1,11
4,6,4,1,11
4,6,5,1,11
4,6,6,1,11
4,6,7,1,11
4,6,8,1,11
4,6,9,1,11
4,6,10,1,11
4,6,11,1,11
4,6,12,1,11
4,6,13,1,11
4,7,0,1,11
4,7,1,1,11
4,7,2,1,11
4,7,3,1,11
4,7,4,1,11
4,7,5,1,11
4,7,6,1,11
4,7,7,1,11
4,7,8,1,11
4,7,9,1,11
4,7,10,1,11
4,7,11,1,11
4,7,12,1,11
4,7,13,1,11
4,8,0,1,11
4,8,1,1,11
4,8,2,1,11
4,8,3,1,11
4,8,4,1,11
4,8,5,1,11
4,8,6,1,11
4,8,7,1,11
4,8,8,1,11
4,8,9,1,11
4,8,10,1,11
4,8,11,1,11
4,8,12,1,11
4,8,13,1,11
4,9,0,1,11
4,9,1,1,11
4,9,2,1,11
4,9,3,1,11
4,9,4,1,11
4,9,5,1,11
4,9,6,1,11
4,9,7,1,11
4,9,8,1,11
4,9,9,1,11
4,9,10,1,11
4,9,11,1,11
4,9,12,1,11
4,9,13,1,11
4,10,0,1,11
4,10,1,1,11
4,10,2,1,11
4,10,3,1,11
4,10,4,1,11
4,10,5,1,11
4,10,6,1,11
4,10,7,1,11
4,10,8,1,11
4,10,9,1,11
4,10,10,1,11
4,10,11,1,11
4,10,12,1,11
4,10,13,1,11
4,11,0,1,11
4,11,1,1,11
4,11,2,1,11
4,11,3,1,11
4,11,4,1,11
4,11,5,1,11
4,11,6,1,11
4,11,7,1,11
4,11,8,1,11
4,11,9,1,11
4,11,10,1,11
4,11,11,1,11
4,11,12,1,11
4,11,13,1,11
4,12,0,1,11
4,12,1,1,11
4,12,2,1,11
4,12,3,1,11
4,12,4,1,11
4,12,5,1,11
4,12,6,1,11
4,12,7,1,11
4,12,8,1,11
4,12,9,1,11
4,12,10,1,11
4,12,11,1,11
4,12,12,1,11
4,12,13,1,11
4,13,0,1,11
4,13,1,1,11
4,13,2,1,11
4,13,3,1,11
4,13,4,1,11
4,13,5,1,11
4,13,6,1,11
4,13,7,1,11
4,13,8,1,11
4,13,9,1,11
4,13,10,1,11
4,13,11,1,11
4,13,12,1,11
4,13,13,1,11
4,14,0,1,11
4,14,1,1,11
4,14,2,1,11
4,14,3,1,11
4,14,4,1,11
4,14,5,1,11
4,14,6,1,11
4,14,7,1,11
4,14,8,1,11
4,14,9,1,11
4,14,10,1,11
4,14,11,1,11
4,14,12,1,11
4,14,13,1,11
4,15,0,1,11
4,15,1,1,11
4,15,2,1,11
4,15,3,1,11
4,15,4,1,11
4,15,5,1,11
4,15,6,1,11
4,15,7,1,11
4,15,8,1,11
4,15,9,1,11
4,15,10,1,11
4,15,11,1,11
4,15,12,1,11
4,15,13,1,11
4,16,0,1,11
4,16,1,1,11
4,16,2,1,11
4,16,3,1,11
4,16,4,1,11
4,16,5,1,11
4,16,6,1,11
4,16,7,1,11
4,16,8,1,11
4,16,9,1,11
4,16,10,1,11
4,16,11,1,11
4,16,12,1,11
4,16,13,1,11
4,17,0,1,11
4,17,1,1,11
4,17,2,1,11
4,17,3,1,11
4,17,4,1,11
4,17,5,1,11
4,17,6,1,11
4,17,7,1,11
4,17,8,1,11
4,17,9,1,11
4,17,10,1,11
4,17,11,1,11
4,17,12,1,11
4,17,13,1,11
4,18,0,1,11
4,18,1,1,11
4,18,2,1,11
4,18,3,1,11
4,18,4,1,11
4,18,5,1,11
4,18,6,1,11
4,18,7,1,11
4,18,8,1,11
4,18,9,1,11
4,18,10,1,11
4,18,11,1,11
4,18,12,1,11
4,18,13,1,11
4,19,0,1,11
4,19,1,1,11
4,19,2,1,11
4,19,3,1,11
4,19,4,1,11
4,19,5,1,11
4,19,6,1,11
4,19,7,1,11
4,19,8,1,11
4,19,9,1,11
4,19,10,1,11
4,19,11,1,11
4,19,12,1,11
4,19,13,1,11
4,20,0,1,11
4,20,1,1,11
4,20,2,1,11
4,20,3,1,11
4,20,4,1,11
4,20,5,1,11
4,20,6,1,11
4,20,7,1,11
4,20,8,1,11
4,20,9,1,11
4,20,10,1,11
4,20,11,1,11
4,20,12,1,11
4,20,13,1,11
4,21,0,1,11
4,21,1,1,11
4,21,2,1,11
4,21,3,1,11
4,21,4,1,11
4,21,5,1,11
4,21,6,1,11
4,21,7,1,11
4,21,8,1,11
4,21,9,1,11
4,21,10,1,11
4,21,11,1,11
4,21,12,1,11
4,21,13,1,11
4,0,0,2,11
4,0,1,2,11
4,0,2,2,11
4,0,3,2,11
4,0,4,2,11
4,0,5,2,11
4,0,6,2,11
4,0,7,2,11
4,0,8,2,11
4,0,9,2,11
4,0,10,2,11
4,0,11,2,11
4,0,12,2,11
4,0,13,2,11
4,1,0,2,11
4,1,1,2,11
4,1,2,2,11
4,1,3,2,11
4,1,4,2,11
4,1,5,2,11
4,1,6,2,11
4,1,7,2,11
4,1,8,2,11
4,1,9,2,11
4,1,10,2,11
4,1,11,2,11
4,1,12,2,11
4,1,13,2,11
4,2,0,2,11
4,2,1,2,11
4,2,2,2,11
4,2,3,2,11
4,2,4,2,11
4,2,5,2,11
4,2,6,2,11
4,2,7,2,11
4,2,8,2,11
4,2,9,2,11
4,2,10,2,11
4,2,11,2,11
4,2,12,2,11
4,2,13,2,11
4,3,0,2,11
4,3,1,2,11
4,3,2,2,11
4,3,3,2,11
4,3,4,2,11
4,3,5,2,11
4,3,6,2,11
4,3,7,2,11
4,3,8,2,11
4,3,9,2,11
4,3,10,2,11
4,3,11,2,11
4,3,12,2,11
4,3,13,2,11
4,4,0,2,11
4,4,1,2,11
4,4,2,2,11
4,4,3,2,11
4,4,4,2,11
4,4,5,2,11
4,4,6,2,11
4,4,7,2,11
4,4,8,2,11
4,4,9,2,11
4,4,10,2,11
4,4,11,2,11
4,4,12,2,11
4,4,13,2,11
4,5,0,2,11
4,5,1,2,11
4,5,2,2,11
4,5,3,2,11
4,5,4,2,11
4,5,5,2,11
4,5,6,2,11
4,5,7,2,11
4,5,8,2,11
4,5,9,2,11
4,5,10,2,11
4,5,11,2,11
4,5,12,2,11
4,5,13,2,11
4,6,0,2,11
4,6,1,2,11
4,6,2,2,11
4,6,3,2,11
4,6,4,2,11
4,6,5,2,11
4,6,6,2,11
4,6,7,2,11
4,6,8,2,11
4,6,9,2,11
4,6,10,2,11
4,6,11,2,11
4,6,12,2,11
4,6,13,2,11
4,7,0,2,11
4,7,1,2,11
4,7,2,2,11
4,7,3,2,11
4,7,4,2,11
4,7,5,2,11
4,7,6,2,11
4,7,7,2,11
4,7,8,2,11
4,7,9,2,11
4,7,10,2,11
4,7,11,2,11
4,7,12,2,11
4,7,13,2,11
4,8,0,2,11
4,8,1,2,11
4,8,2,2,11
4,8,3,2,11
4,8,4,2,11
4,8,5,2,11
4,8,6,2,11
4,8,7,2,11
4,8,8,2,11
4,8,9,2,11
4,8,10,2,11
4,8,11,2,11
4,8,12,2,11
4,8,13,2,11
4,9,0,2,11
4,9,1,2,11
4,9,2,2,11
4,9,3,2,11
4,9,4,2,11
4,9,5,2,11
4,9,6,2,11
4,9,7,2,11
4,9,8,2,11
4,9,9,2,11
4,9,10,2,11
4,9,11,2,11
4,9,12,2,11
4,9,13,2,11
4,10,0,2,11
4,10,1,2,11
4,10,2,2,11
4,10,3,2,11
4,10,4,2,11
4,10,5,2,11
4,10,6,2,11
4,10,7,2,11
4,10,8,2,11
4,10,9,2,11
4,10,10,2,11
4,10,11,2,11
4,10,12,2,11
4,10,13,2,11
4,11,0,2,11
4,11,1,2,11
4,11,2,2,11
4,11,3,2,11
4,11,4,2,11
4,11,5,2,11
4,11,6,2,11
4,11,7,2,11
4,11,8,2,11
4,11,9,2,11
4,11,10,2,11
4,11,11,2,11
4,11,12,2,11
4,11,13,2,11
4,12,0,2,11
4,12,1,2,11
4,12,2,2,11
4,12,3,2,11
4,12,4,2,11
4,12,5,2,11
4,12,6,2,11
4,12,7,2,11
4,12,8,2,11
4,12,9,2,11
4,12,10,2,11
4,12,11,2,11
4,12,12,2,11
4,12,13,2,11
4,13,0,2,11
4,13,1,2,11
4,13,2,2,11
4,13,3,2,11
4,13,4,2,11
4,13,5,2,11
4,13,6,2,11
4,13,7,2,11
4,13,8,2,11
4,13,9,2,11
4,13,10,2,11
4,13,11,2,11
4,13,12,2,11
4,13,13,2,11
4,14,0,2,11
4,14,1,2,11
4,14,2,2,11
4,14,3,2,11
4,14,4,2,11
4,14,5,2,11
4,14,6,2,11
4,14,7,2,11
4,14,8,2,11
4,14,9,2,11
4,14,10,2,11
4,14,11,2,11
4,14,12,2,11
4,14,13,2,11
4,15,0,2,11
4,15,1,2,11
4,15,2,2,11
4,15,3,2,11
4,15,4,2,11
4,15,5,2,11
4,15,6,2,11
4,15,7,2,11
4,15,8,2,11
4,15,9,2,11
4,15,10,2,11
4,15,11,2,11
4,15,12,2,11
4,15,13,2,11
4,16,0,2,11
4,16,1,2,11
4,16,2,2,11
4,16,3,2,11
4,16,4,2,11
4,16,5,2,11
4,16,6,2,11
4,16,7,2,11
4,16,8,2,11
4,16,9,2,11
4,16,10,2,11
4,16,11,2,11
4,16,12,2,11
4,16,13,2,11
4,17,0,2,11
4,17,1,2,11
4,17,2,2,11
4,17,3,2,11
4,17,4,2,11
4,17,5,2,11
4,17,6,2,11
4,17,7,2,11
4,17,8,2,11
4,17,9,2,11
4,17,10,2,11
4,17,11,2,11
4,17,12,2,11
4,17,13,2,11
4,18,0,2,11
4,18,1,2,11
4,18,2,2,11
4,18,3,2,11
4,18,4,2,11
4,18,5,2,11
4,18,6,2,11
4,18,7,2,11
4,18,8,2,11
4,18,9,2,11
4,18,10,2,11
4,18,11,2,11
4,18,12,2,11
4,18,13,2,11
4,0,0,3,11
4,0,1,3,11
4,0,2,3,11
4,0,3,3,11
4,0,4,3,11
4,0,5,3,11
4,0,6,3,11
4,0,7,3,11
4,0,8,3,11
4,0,9,3,11
4,0,10,3,11
4,0,11,3,11
4,0,12,3,11
4,0,13,3,11
4,1,0,3,11
4,1,1,3,11
4,1,2,3,11
4,1,3,3,11
4,1,4,3,11
4,1,5,3,11
4,1,6,3,11
4,1,7,3,11
4,1,8,3,11
4,1,9,3,11
4,1,10,3,11
4,1,11,3,11
4,1,12,3,11
4,1,13,3,11
4,2,0,3,11
4,2,1,3,11
4,2,2,3,11
4,2,3,3,11
4,2,4,3,11
4,2,5,3,11
4,2,6,3,11
4,2,7,3,11
4,2,8,3,11
4,2,9,3,11
4,2,10,3,11
4,2,11,3,11
4,2,12,3,11
4,2,13,3,11
4,3,0,3,11
4,3,1,3,11
4,3,2,3,11
4,3,3,3,11
4,3,4,3,11
4,3,5,3,11
4,3,6,3,11
4,3,7,3,11
4,3,8,3,11
4,3,9,3,11
4,3,10,3,11
4,3,11,3,11
4,3,12,3,11
4,3,13,3,11
4,4,0,3,11
4,4,1,3,11
4,4,2,3,11
4,4,3,3,11
4,4,4,3,11
4,4,5,3,11
4,4,6,3,11
4,4,7,3,11
4,4,8,3,11
4,4,9,3,11
4,4,10,3,11
4,4,11,3,11
4,4,12,3,11
4,4,13,3,11
4,5,0,3,11
4,5,1,3,11
4,5,2,3,11
4,5,3,3,11
4,5,4,3,11
4,5,5,3,11
4,5,6,3,11
4,5,7,3,11
4,5,8,3,11
4,5,9,3,11
4,5,10,3,11
4,5,11,3,11
4,5,12,3,11
4,5,13,3,11
4,6,0,3,11
4,6,1,3,11
4,6,2,3,11
4,6,3,3,11
4,6,4,3,11
4,6,5,3,11
4,6,6,3,11
4,6,7,3,11
4,6,8,3,11
4,6,9,3,11
4,6,10,3,11
4,6,11,3,11
4,6,12,3,11
4,6,13,3,11
4,7,0,3,11
4,7,1,3,11
4,7,2,3,11
4,7,3,3,11
4,7,4,3,11
4,7,5,3,11
4,7,6,3,11
4,7,7,3,11
4,7,8,3,11
4,7,9,3,11
4,7,10,3,11
4,7,11,3,11
4,7,12,3,11
4,7,13,3,11
4,8,0,3,11
4,8,1,3,11
4,8,2,3,11
4,8,3,3,11
4,8,4,3,11
4,8,5,3,11
4,8,6,3,11
4,8,7,3,11
4,8,8,3,11
4,8,9,3,11
4,8,10,3,11
4,8,11,3,11
4,8,12,3,11
4,8,13,3,11
4,9,0,3,11
4,9,1,3,11
4,9,2,3,11
4,9,3,3,11
4,9,4,3,11
4,9,5,3,11
4,9,6,3,11
4,9,7,3,11
4,9,8,3,11
4,9,9,3,11
4,9,10,3,11
4,9,11,3,11
4,9,12,3,11
4,9,13,3,11
4,10,0,3,11
4,10,1,3,11
4,10,2,3,11
4,10,3,3,11
4,10,4,3,11
4,10,5,3,11
4,10,6,3,11
4,10,7,3,11
4,10,8,3,11
4,10,9,3,11
4,10,10,3,11
4,10,11,3,11
4,10,12,3,11
4,10,13,3,11
4,11,0,3,11
4,11,1,3,11
4,11,2,3,11
4,11,3,3,11
4,11,4,3,11
4,11,5,3,11
4,11,6,3,11
4,11,7,3,11
4,11,8,3,11
4,11,9,3,11
4,11,10,3,11
4,11,11,3,11
4,11,12,3,11
4,11,13,3,11
4,12,0,3,11
4,12,1,3,11
4,12,2,3,11
4,12,3,3,11
4,12,4,3,11
4,12,5,3,11
4,12,6,3,11
4,12,7,3,11
4,12,8,3,11
4,12,9,3,11
4,12,10,3,11
4,12,11,3,11
4,12,12,3,11
4,12,13,3,11
4,13,0,3,11
4,13,1,3,11
4,13,2,3,11
4,13,3,3,11
4,13,4,3,11
4,13,5,3,11
4,13,6,3,11
4,13,7,3,11
4,13,8,3,11
4,13,9,3,11
4,13,10,3,11
4,13,11,3,11
4,13,12,3,11
4,13,13,3,11
4,14,0,3,11
4,14,1,3,11
4,14,2,3,11
4,14,3,3,11
4,14,4,3,11
4,14,5,3,11
4,14,6,3,11
4,14,7,3,11
4,14,8,3,11
4,14,9,3,11
4,14,10,3,11
4,14,11,3,11
4,14,12,3,11
4,14,13,3,11
4,15,0,3,11
4,15,1,3,11
4,15,2,3,11
4,15,3,3,11
4,15,4,3,11
4,15,5,3,11
4,15,6,3,11
4,15,7,3,11
4,15,8,3,11
4,15,9,3,11
4,15,10,3,11
4,15,11,3,11
4,15,12,3,11
4,15,13,3,11
4,0,0,4,11
4,0,1,4,11
4,0,2,4,11
4,0,3,4,11
4,0,4,4,11
4,0,5,4,11
4,0,6,4,11
4,0,7,4,11
4,0,8,4,11
4,0,9,4,11
4,0,10,4,11
4,0,11,4,11
4,0,12,4,11
4,0,13,4,11
4,1,0,4,11
4,1,1,4,11
4,1,2,4,11
4,1,3,4,11
4,1,4,4,11
4,1,5,4,11
4,1,6,4,11
4,1,7,4,11
4,1,8,4,11
4,1,9,4,11
4,1,10,4,11
4,1,11,4,11
4,1,12,4,11
4,1,13,4,11
4,2,0,4,11
4,2,1,4,11
4,2,2,4,11
4,2,3,4,11
4,2,4,4,11
4,2,5,4,11
4,2,6,4,11
4,2,7,4,11
4,2,8,4,11
4,2,9,4,11
4,2,10,4,11
4,2,11,4,11
4,2,12,4,11
4,2,13,4,11
4,3,0,4,11
4,3,1,4,11
4,3,2,4,11
4,3,3,4,11
4,3,4,4,11
4,3,5,4,11
4,3,6,4,11
4,3,7,4,11
4,3,8,4,11
4,3,9,4,11
4,3,10,4,11
4,3,11,4,11
4,3,12,4,11
4,3,13,4,11
4,4,0,4,11
4,4,1,4,11
4,4,2,4,11
4,4,3,4,11
4,4,4,4,11
4,4,5,4,11
4,4,6,4,11
4,4,7,4,11
4,4,8,4,11
4,4,9,4,11
4,4,10,4,11
4,4,11,4,11
4,4,12,4,11
4,4,13,4,11
4,5,0,4,11
4,5,1,4,11
4,5,2,4,11
4,5,3,4,11
4,5,4,4,11
4,5,5,4,11
4,5,6,4,11
4,5,7,4,11
4,5,8,4,11
4,5,9,4,11
4,5,10,4,11
4,5,11,4,11
4,5,12,4,11
4,5,13,4,11
4,6,0,4,11
4,6,1,4,11
4,6,2,4,11
4,6,3,4,11
4,6,4,4,11
4,6,5,4,11
4,6,6,4,11
4,6,7,4,11
4,6,8,4,11
4,6,9,4,11
4,6,10,4,11
4,6,11,4,11
4,6,12,4,11
4,6,13,4,11
4,7,0,4,11
4,7,1,4,11
4,7,2,4,11
4,7,3,4,11
4,7,4,4,11
4,7,5,4,11
4,7,6,4,11
4,7,7,4,11
4,7,8,4,11
4,7,9,4,11
4,7,10,4,11
4,7,11,4,11
4,7,12,4,11
4,7,13,4,11
4,8,0,4,11
4,8,1,4,11
4,8,2,4,11
4,8,3,4,11
4,8,4,4,11
4,8,5,4,11
4,8,6,4,11
4,8,7,4,11
4,8,8,4,11
4,8,9,4,11
4,8,10,4,11
4,8,11,4,11
4,8,12,4,11
4,8,13,4,11
4,9,0,4,11
4,9,1,4,11
4,9,2,4,11
4,9,3,4,11
4,9,4,4,11
4,9,5,4,11
4,9,6,4,11
4,9,7,4,11
4,9,8,4,11
4,9,9,4,11
4,9,10,4,11
4,9,11,4,11
4,9,12,4,11
4,9,13,4,11
4,10,0,4,11
4,10,1,4,11
4,10,2,4,11
4,10,3,4,11
4,10,4,4,11
4,10,5,4,11
4,10,6,4,11
4,10,7,4,11
4,10,8,4,11
4,10,9,4,11
4,10,10,4,11
4,10,11,4,11
4,10,12,4,11
4,10,13,4,11
4,11,0,4,11
4,11,1,4,11
4,11,2,4,11
4,11,3,4,11
4,11,4,4,11
4,11,5,4,11
4,11,6,4,11
4,11,7,4,11
4,11,8,4,11
4,11,9,4,11
4,11,10,4,11
4,11,11,4,11
4,11,12,4,11
4,11,13,4,11
4,12,0,4,11
4,12,1,4,11
4,12,2,4,11
4,12,3,4,11
4,12,4,4,11
4,12,5,4,11
4,12,6,4,11
4,12,7,4,11
4,12,8,4,11
4,12,9,4,11
4,12,10,4,11
4,12,11,4,11
4,12,12,4,11
4,12,13,4,11
4,0,0,5,11
4,0,1,5,11
4,0,2,5,11
4,0,3,5,11
4,0,4,5,11
4,0,5,5,11
4,0,6,5,11
4,0,7,5,11
4,0,8,5,11
4,0,9,5,11
4,0,10,5,11
4,0,11,5,11
4,0,12,5,11
4,0,13,5,11
4,1,0,5,11
4,1,1,5,11
4,1,2,5,11
4,1,3,5,11
4,1,4,5,11
4,1,5,5,11
4,1,6,5,11
4,1,7,5,11
4,1,8,5,11
4,1,9,5,11
4,1,10,5,11
4,1,11,5,11
4,1,12,5,11
4,1,13,5,11
4,2,0,5,11
4,2,1,5,11
4,2,2,5,11
4,2,3,5,11
4,2,4,5,11
4,2,5,5,11
4,2,6,5,11
4,2,7,5,11
4,2,8,5,11
4,2,9,5,11
4,2,10,5,11
4,2,11,5,11
4,2,12,5,11
4,2,13,5,11
4,3,0,5,11
4,3,1,5,11
4,3,2,5,11
4,3,3,5,11
4,3,4,5,11
4,3,5,5,11
4,3,6,5,11
4,3,7,5,11
4,3,8,5,11
4,3,9,5,11
4,3,10,5,11
4,3,11,5,11
4,3,12,5,11
4,3,13,5,11
4,4,0,5,11
4,4,1,5,11
4,4,2,5,11
4,4,3,5,11
4,4,4,5,11
4,4,5,5,11
4,4,6,5,11
4,4,7,5,11
4,4,8,5,11
4,4,9,5,11
4,4,10,5,11
4,4,11,5,11
4,4,12,5,11
4,4,13,5,11
4,5,0,5,11
4,5,1,5,11
4,5,2,5,11
4,5,3,5,11
4,5,4,5,11
4,5,5,5,11
4,5,6,5,11
4,5,7,5,11
4,5,8,5,11
4,5,9,5,11
4,5,10,5,11
4,5,11,5,11
4,5,12,5,11
4,5,13,5,11
4,6,0,5,11
4,6,1,5,11
4,6,2,5,11
4,6,3,5,11
4,6,4,5,11
4,6,5,5,11
4,6,6,5,11
4,6,7,5,11
4,6,8,5,11
4,6,9,5,11
4,6,10,5,11
4,6,11,5,11
4,6,12,5,11
4,6,13,5,11
4,7,0,5,11
4,7,1,5,11
4,7,2,5,11
4,7,3,5,11
4,7,4,5,11
4,7,5,5,11
4,7,6,5,11
4,7,7,5,11
4,7,8,5,11
4,7,9,5,11
4,7,10,5,11
4,7,11,5,11
4,7,12,5,11
4,7,13,5,11
4,8,0,5,11
4,8,1,5,11
4,8,2,5,11
4,8,3,5,11
4,8,4,5,11
4,8,5,5,11
4,8,6,5,11
4,8,7,5,11
4,8,8,5,11
4,8,9,5,11
4,8,10,5,11
4,8,11,5,11
4,8,12,5,11
4,8,13,5,11
4,9,0,5,11
4,9,1,5,11
4,9,2,5,11
4,9,3,5,11
4,9,4,5,11
4,9,5,5,11
4,9,6,5,11
4,9,7,5,11
4,9,8,5,11
4,9,9,5,11
4,9,10,5,11
4,9,11,5,11
4,9,12,5,11
4,9,13,5,11
4,0,0,6,11
4,0,1,6,11
4,0,2,6,11
4,0,3,6,11
4,0,4,6,11
4,0,5,6,11
4,0,6,6,11
4,0,7,6,11
4,0,8,6,11
4,0,9,6,11
4,0,10,6,11
4,0,11,6,11
4,0,12,6,11
4,0,13,6,11
4,1,0,6,11
4,1,1,6,11
4,1,2,6,11
4,1,3,6,11
4,1,4,6,11
4,1,5,6,11
4,1,6,6,11
4,1,7,6,11
4,1,8,6,11
4,1,9,6,11
4,1,10,6,11
4,1,11,6,11
4,1,12,6,11
4,1,13,6,11
4,2,0,6,11
4,2,1,6,11
4,2,2,6,11
4,2,3,6,11
4,2,4,6,11
4,2,5,6,11
4,2,6,6,11
4,2,7,6,11
4,2,8,6,11
4,2,9,6,11
4,2,10,6,11
4,2,11,6,11
4,2,12,6,11
4,2,13,6,11
4,3,0,6,11
4,3,1,6,11
4,3,2,6,11
4,3,3,6,11
4,3,4,6,11
4,3,5,6,11
4,3,6,6,11
4,3,7,6,11
4,3,8,6,11
4,3,9,6,11
4,3,10,6,11
4,3,11,6,11
4,3,12,6,11
4,3,13,6,11
4,4,0,6,11
4,4,1,6,11
4,4,2,6,11
4,4,3,6,11
4,4,4,6,11
4,4,5,6,11
4,4,6,6,11
4,4,7,6,11
4,4,8,6,11
4,4,9,6,11
4,4,10,6,11
4,4,11,6,11
4,4,12,6,11
4,4,13,6,11
4,5,0,6,11
4,5,1,6,11
4,5,2,6,11
4,5,3,6,11
4,5,4,6,11
4,5,5,6,11
4,5,6,6,11
4,5,7,6,11
4,5,8,6,11
4,5,9,6,11
4,5,10,6,11
4,5,11,6,11
4,5,12,6,11
4,5,13,6,11
4,6,0,6,11
4,6,1,6,11
4,6,2,6,11
4,6,3,6,11
4,6,4,6,11
4,6,5,6,11
4,6,6,6,11
4,6,7,6,11
4,6,8,6,11
4,6,9,6,11
4,6,10,6,11
4,6,11,6,11
4,6,12,6,11
4,6,13,6,11
4,0,0,7,11
4,0,1,7,11
4,0,2,7,11
4,0,3,7,11
4,0,4,7,11
4,0,5,7,11
4,0,6,7,11
4,0,7,7,11
4,0,8,7,11
4,0,9,7,11
4,0,10,7,11
4,0,11,7,11
4,0,12,7,11
4,0,13,7,11
4,1,0,7,11
4,1,1,7,11
4,1,2,7,11
4,1,3,7,11
4,1,4,7,11
4,1,5,7,11
4,1,6,7,11
4,1,7,7,11
4,1,8,7,11
4,1,9,7,11
4,1,10,7,11
4,1,11,7,11
4,1,12,7,11
4,1,13,7,11
4,2,0,7,11
4,2,1,7,11
4,2,2,7,11
4,2,3,7,11
4,2,4,7,11
4,2,5,7,11
4,2,6,7,11
4,2,7,7,11
4,2,8,7,11
4,2,9,7,11
4,2,10,7,11
4,2,11,7,11
4,2,12,7,11
4,2,13,7,11
4,3,0,7,11
4,3,1,7,11
4,3,2,7,11
4,3,3,7,11
4,3,4,7,11
4,3,5,7,11
4,3,6,7,11
4,3,7,7,11
4,3,8,7,11
4,3,9,7,11
4,3,10,7,11
4,3,11,7,11
4,3,12,7,11
4,3,13,7,11
4,0,0,8,11
4,0,1,8,11
4,0,2,8,11
4,0,3,8,11
4,0,4,8,11
4,0,5,8,11
4,0,6,8,11
4,0,7,8,11
4,0,8,8,11
4,0,9,8,11
4,0,10,8,11
4,0,11,8,11
4,0,12,8,11
4,0,13,8,11
4,0,0,1,12
4,0,1,1,12
4,0,2,1,12
4,0,3,1,12
4,0,4,1,12
4,0,5,1,12
4,0,6,1,12
4,0,7,1,12
4,0,8,1,12
4,0,9,1,12
4,0,10,1,12
4,0,11,1,12
4,0,12,1,12
4,1,0,1,12
4,1,1,1,12
4,1,2,1,12
4,1,3,1,12
4,1,4,1,12
4,1,5,1,12
4,1,6,1,12
4,1,7,1,12
4,1,8,1,12
4,1,9,1,12
4,1,10,1,12
4,1,11,1,12
4,1,12,1,12
4,2,0,1,12
4,2,1,1,12
4,2,2,1,12
4,2,3,1,12
4,2,4,1,12
4,2,5,1,12
4,2,6,1,12
4,2,7,1,12
4,2,8,1,12
4,2,9,1,12
4,2,10,1,12
4,2,11,1,12
4,2,12,1,12
4,3,0,1,12
4,3,1,1,12
4,3,2,1,12
4,3,3,1,12
4,3,4,1,12
4,3,5,1,12
4,3,6,1,12
4,3,7,1,12
4,3,8,1,12
4,3,9,1,12
4,3,10,1,12
4,3,11,1,12
4,3,12,1,12
4,4,0,1,12
4,4,1,1,12
4,4,2,1,12
4,4,3,1,12
4,4,4,1,12
4,4,5,1,12
4,4,6,1,12
4,4,7,1,12
4,4,8,1,12
4,4,9,1,12
4,4,10,1,12
4,4,11,1,12
4,4,12,1,12
4,5,0,1,12
4,5,1,1,12
4,5,2,1,12
4,5,3,1,12
4,5,4,1,12
4,5,5,1,12
4,5,6,1,12
4,5,7,1,12
4,5,8,1,12
4,5,9,1,12
4,5,10,1,12
4,5,11,1,12
4,5,12,1,12
4,6,0,1,12
4,6,1,1,12
4,6,2,1,12
4,6,3,1,12
4,6,4,1,12
4,6,5,1,12
4,6,6,1,12
4,6,7,1,12
4,6,8,1,12
4,6,9,1,12
4,6,10,1,12
4,6,11,1,12
4,6,12,1,12
4,7,0,1,12
4,7,1,1,12
4,7,2,1,12
4,7,3,1,12
4,7,4,1,12
4,7,5,1,12
4,7,6,1,12
4,7,7,1,12
4,7,8,1,12
4,7,9,1,12
4,7,10,1,12
4,7,11,1,12
4,7,12,1,12
4,8,0,1,12
4,8,1,1,12
4,8,2,1,12
4,8,3,1,12
4,8,4,1,12
4,8,5,1,12
4,8,6,1,12
4,8,7,1,12
4,8,8,1,12
4,8,9,1,12
4,8,10,1,12
4,8,11,1,12
4,8,12,1,12
4,9,0,1,12
4,9,1,1,12
4,9,2,1,12
4,9,3,1,12
4,9,4,1,12
4,9,5,1,12
4,9,6,1,12
4,9,7,1,12
4,9,8,1,12
4,9,9,1,12
4,9,10,1,12
4,9,11,1,12
4,9,12,1,12
4,10,0,1,12
4,10,1,1,12
4,10,2,1,12
4,10,3,1,12
4,10,4,1,12
4,10,5,1,12
4,10,6,1,12
4,10,7,1,12
4,10,8,1,12
4,10,9,1,12
4,10,10,1,12
4,10,11,1,12
4,10,12,1,12
4,11,0,1,12
4,11,1,1,12
4,11,2,1,12
4,11,3,1,12
4,11,4,1,12
4,11,5,1,12
4,11,6,1,12
4,11,7,1,12
4,11,8,1,12
4,11,9,1,12
4,11,10,1,12
4,11,11,1,12
4,11,12,1,12
4,12,0,1,12
4,12,1,1,12
4,12,2,1,12
4,12,3,1,12
4,12,4,1,12
4,12,5,1,12
4,12,6,1,12
4,12,7,1,12
4,12,8,1,12
4,12,9,1,12
4,12,10,1,12
4,12,11,1,12
4,12,12,1,12
4,13,0,1,12
4,13,1,1,12
4,13,2,1,12
4,13,3,1,12
4,13,4,1,12
4,13,5,1,12
4,13,6,1,12
4,13,7,1,12
4,13,8,1,12
4,13,9,1,12
4,13,10,1,12
4,13,11,1,12
4,13,12,1,12
4,14,0,1,12
4,14,1,1,12
4,14,2,1,12
4,14,3,1,12
4,14,4,1,12
4,14,5,1,12
4,14,6,1,12
4,14,7,1,12
4,14,8,1,12
4,14,9,1,12
4,14,10,1,12
4,14,11,1,12
4,14,12,1,12
4,15,0,1,12
4,15,1,1,12
4,15,2,1,12
4,15,3,1,12
4,15,4,1,12
4,15,5,1,12
4,15,6,1,12
4,15,7,1,12
4,15,8,1,12
4,15,9,1,12
4,15,10,1,12
4,15,11,1,12
4,15,12,1,12
4,16,0,1,12
4,16,1,1,12
4,16,2,1,12
4,16,3,1,12
4,16,4,1,12
4,16,5,1,12
4,16,6,1,12
4,16,7,1,12
4,16,8,1,12
4,16,9,1,12
4,16,10,1,12
4,16,11,1,12
4,16,12,1,12
4,17,0,1,12
4,17,1,1,12
4,17,2,1,12
4,17,3,1,12
4,17,4,1,12
4,17,5,1,12
4,17,6,1,12
4,17,7,1,12
4,17,8,1,12
4,17,9,1,12
4,17,10,1,12
4,17,11,1,12
4,17,12,1,12
4,18,0,1,12
4,18,1,1,12
4,18,2,1,12
4,18,3,1,12
4,18,4,1,12
4,18,5,1,12
4,18,6,1,12
4,18,7,1,12
4,18,8,1,12
4,18,9,1,12
4,18,10,1,12
4,18,11,1,12
4,18,12,1,12
4,19,0,1,12
4,19,1,1,12
4,19,2,1,12
4,19,3,1,12
4,19,4,1,12
4,19,5,1,12
4,19,6,1,12
4,19,7,1,12
4,19,8,1,12
4,19,9,1,12
4,19,10,1,12
4,19,11,1,12
4,19,12,1,12
4,20,0,1,12
4,20,1,1,12
4,20,2,1,12
4,20,3,1,12
4,20,4,1,12
4,20,5,1,12
4,20,6,1,12
4,20,7,1,12
4,20,8,1,12
4,20,9,1,12
4,20,10,1,12
4,20,11,1,12
4,20,12,1,12
4,21,0,1,12
4,21,1,1,12
4,21,2,1,12
4,21,3,1,12
4,21,4,1,12
4,21,5,1,12
4,21,6,1,12
4,21,7,1,12
4,21,8,1,12
4,21,9,1,12
4,21,10,1,12
4,21,11,1,12
4,21,12,1,12
4,0,0,2,12
4,0,1,2,12
4,0,2,2,12
4,0,3,2,12
4,0,4,2,12
4,0,5,2,12
4,0,6,2,12
4,0,7,2,12
4,0,8,2,12
4,0,9,2,12
4,0,10,2,12
4,0,11,2,12
4,0,12,2,12
4,1,0,2,12
4,1,1,2,12
4,1,2,2,12
4,1,3,2,12
4,1,4,2,12
4,1,5,2,12
4,1,6,2,12
4,1,7,2,12
4,1,8,2,12
4,1,9,2,12
4,1,10,2,12
4,1,11,2,12
4,1,12,2,12
4,2,0,2,12
4,2,1,2,12
4,2,2,2,12
4,2,3,2,12
4,2,4,2,12
4,2,5,2,12
4,2,6,2,12
4,2,7,2,12
4,2,8,2,12
4,2,9,2,12
4,2,10,2,12
4,2,11,2,12
4,2,12,2,12
4,3,0,2,12
4,3,1,2,12
4,3,2,2,12
4,3,3,2,12
4,3,4,2,12
4,3,5,2,12
4,3,6,2,12
4,3,7,2,12
4,3,8,2,12
4,3,9,2,12
4,3,10,2,12
4,3,11,2,12
4,3,12,2,12
4,4,0,2,12
4,4,1,2,12
4,4,2,2,12
4,4,3,2,12
4,4,4,2,12
4,4,5,2,12
4,4,6,2,12
4,4,7,2,12
4,4,8,2,12
4,4,9,2,12
4,4,10,2,12
4,4,11,2,12
4,4,12,2,12
4,5,0,2,12
4,5,1,2,12
4,5,2,2,12
4,5,3,2,12
4,5,4,2,12
4,5,5,2,12
4,5,6,2,12
4,5,7,2,12
4,5,8,2,12
4,5,9,2,12
4,5,10,2,12
4,5,11,2,12
4,5,12,2,12
4,6,0,2,12
4,6,1,2,12
4,6,2,2,12
4,6,3,2,12
4,6,4,2,12
4,6,5,2,12
4,6,6,2,12
4,6,7,2,12
4,6,8,2,12
4,6,9,2,12
4,6,10,2,12
4,6,11,2,12
4,6,12,2,12
4,7,0,2,12
4,7,1,2,12
4,7,2,2,12
4,7,3,2,12
4,7,4,2,12
4,7,5,2,12
4,7,6,2,12
4,7,7,2,12
4,7,8,2,12
4,7,9,2,12
4,7,10,2,12
4,7,11,2,12
4,7,12,2,12
4,8,0,2,12
4,8,1,2,12
4,8,2,2,12
4,8,3,2,12
4,8,4,2,12
4,8,5,2,12
4,8,6,2,12
4,8,7,2,12
4,8,8,2,12
4,8,9,2,12
4,8,10,2,12
4,8,11,2,12
4,8,12,2,12
4,9,0,2,12
4,9,1,2,12
4,9,2,2,12
4,9,3,2,12
4,9,4,2,12
4,9,5,2,12
4,9,6,2,12
4,9,7,2,12
4,9,8,2,12
4,9,9,2,12
4,9,10,2,12
4,9,11,2,12
4,9,12,2,12
4,10,0,2,12
4,10,1,2,12
4,10,2,2,12
4,10,3,2,12
4,10,4,2,12
4,10,5,2,12
4,10,6,2,12
4,10,7,2,12
4,10,8,2,12
4,10,9,2,12
4,10,10,2,12
4,10,11,2,12
4,10,12,2,12
4,11,0,2,12
4,11,1,2,12
4,11,2,2,12
4,11,3,2,12
4,11,4,2,12
4,11,5,2,12
4,11,6,2,12
4,11,7,2,12
4,11,8,2,12
4,11,9,2,12
4,11,10,2,12
4,11,11,2,12
4,11,12,2,12
4,12,0,2,12
4,12,1,2,12
4,12,2,2,12
4,12,3,2,12
4,12,4,2,12
4,12,5,2,12
4,12,6,2,12
4,12,7,2,12
4,12,8,2,12
4,12,9,2,12
4,12,10,2,12
4,12,11,2,12
4,12,12,2,12
4,13,0,2,12
4,13,1,2,12
4,13,2,2,12
4,13,3,2,12
4,13,4,2,12
4,13,5,2,12
4,13,6,2,12
4,13,7,2,12
4,13,8,2,12
4,13,9,2,12
4,13,10,2,12
4,13,11,2,12
4,13,12,2,12
4,14,0,2,12
4,14,1,2,12
4,14,2,2,12
4,14,3,2,12
4,14,4,2,12
4,14,5,2,12
4,14,6,2,12
4,14,7,2,12
4,14,8,2,12
4,14,9,2,12
4,14,10,2,12
4,14,11,2,12
4,14,12,2,12
4,15,0,2,12
4,15,1,2,12
4,15,2,2,12
4,15,3,2,12
4,15,4,2,12
4,15,5,2,12
4,15,6,2,12
4,15,7,2,12
4,15,8,2,12
4,15,9,2,12
4,15,10,2,12
4,15,11,2,12
4,15,12,2,12
4,16,0,2,12
4,16,1,2,12
4,16,2,2,12
4,16,3,2,12
4,16,4,2,12
4,16,5,2,12
4,16,6,2,12
4,16,7,2,12
4,16,8,2,12
4,16,9,2,12
4,16,10,2,12
4,16,11,2,12
4,16,12,2,12
4,17,0,2,12
4,17,1,2,12
4,17,2,2,12
4,17,3,2,12
4,17,4,2,12
4,17,5,2,12
4,17,6,2,12
4,17,7,2,12
4,17,8,2,12
4,17,9,2,12
4,17,10,2,12
4,17,11,2,12
4,17,12,2,12
4,18,0,2,12
4,18,1,2,12
4,18,2,2,12
4,18,3,2,12
4,18,4,2,12
4,18,5,2,12
4,18,6,2,12
4,18,7,2,12
4,18,8,2,12
4,18,9,2,12
4,18,10,2,12
4,18,11,2,12
4,18,12,2,12
4,0,0,3,12
4,0,1,3,12
4,0,2,3,12
4,0,3,3,12
4,0,4,3,12
4,0,5,3,12
4,0,6,3,12
4,0,7,3,12
4,0,8,3,12
4,0,9,3,12
4,0,10,3,12
4,0,11,3,12
4,0,12,3,12
4,1,0,3,12
4,1,1,3,12
4,1,2,3,12
4,1,3,3,12
4,1,4,3,12
4,1,5,3,12
4,1,6,3,12
4,1,7,3,12
4,1,8,3,12
4,1,9,3,12
4,1,10,3,12
4,1,11,3,12
4,1,12,3,12
4,2,0,3,12
4,2,1,3,12
4,2,2,3,12
4,2,3,3,12
4,2,4,3,12
4,2,5,3,12
4,2,6,3,12
4,2,7,3,12
4,2,8,3,12
4,2,9,3,12
4,2,10,3,12
4,2,11,3,12
4,2,12,3,12
4,3,0,3,12
4,3,1,3,12
4,3,2,3,12
4,3,3,3,12
4,3,4,3,12
4,3,5,3,12
4,3,6,3,12
4,3,7,3,12
4,3,8,3,12
4,3,9,3,12
4,3,10,3,12
4,3,11,3,12
4,3,12,3,12
4,4,0,3,12
4,4,1,3,12
4,4,2,3,12
4,4,3,3,12
4,4,4,3,12
4,4,5,3,12
4,4,6,3,12
4,4,7,3,12
4,4,8,3,12
4,4,9,3,12
4,4,10,3,12
4,4,11,3,12
4,4,12,3,12
4,5,0,3,12
4,5,1,3,12
4,5,2,3,12
4,5,3,3,12
4,5,4,3,12
4,5,5,3,12
4,5,6,3,12
4,5,7,3,12
4,5,8,3,12
4,5,9,3,12
4,5,10,3,12
4,5,11,3,12
4,5,12,3,12
4,6,0,3,12
4,6,1,3,12
4,6,2,3,12
4,6,3,3,12
4,6,4,3,12
4,6,5,3,12
4,6,6,3,12
4,6,7,3,12
4,6,8,3,12
4,6,9,3,12
4,6,10,3,12
4,6,11,3,12
4,6,12,3,12
4,7,0,3,12
4,7,1,3,12
4,7,2,3,12
4,7,3,3,12
4,7,4,3,12
4,7,5,3,12
4,7,6,3,12
4,7,7,3,12
4,7,8,3,12
4,7,9,3,12
4,7,10,3,12
4,7,11,3,12
4,7,12,3,12
4,8,0,3,12
4,8,1,3,12
4,8,2,3,12
4,8,3,3,12
4,8,4,3,12
4,8,5,3,12
4,8,6,3,12
4,8,7,3,12
4,8,8,3,12
4,8,9,3,12
4,8,10,3,12
4,8,11,3,12
4,8,12,3,12
4,9,0,3,12
4,9,1,3,12
4,9,2,3,12
4,9,3,3,12
4,9,4,3,12
4,9,5,3,12
4,9,6,3,12
4,9,7,3,12
4,9,8,3,12
4,9,9,3,12
4,9,10,3,12
4,9,11,3,12
4,9,12,3,12
4,10,0,3,12
4,10,1,3,12
4,10,2,3,12
4,10,3,3,12
4,10,4,3,12
4,10,5,3,12
4,10,6,3,12
4,10,7,3,12
4,10,8,3,12
4,10,9,3,12
4,10,10,3,12
4,10,11,3,12
4,10,12,3,12
4,11,0,3,12
4,11,1,3,12
4,11,2,3,12
4,11,3,3,12
4,11,4,3,12
4,11,5,3,12
4,11,6,3,12
4,11,7,3,12
4,11,8,3,12
4,11,9,3,12
4,11,10,3,12
4,11,11,3,12
4,11,12,3,12
4,12,0,3,12
4,12,1,3,12
4,12,2,3,12
4,12,3,3,12
4,12,4,3,12
4,12,5,3,12
4,12,6,3,12
4,12,7,3,12
4,12,8,3,12
4,12,9,3,12
4,12,10,3,12
4,12,11,3,12
4,12,12,3,12
4,13,0,3,12
4,13,1,3,12
4,13,2,3,12
4,13,3,3,12
4,13,4,3,12
4,13,5,3,12
4,13,6,3,12
4,13,7,3,12
4,13,8,3,12
4,13,9,3,12
4,13,10,3,12
4,13,11,3,12
4,13,12,3,12
4,14,0,3,12
4,14,1,3,12
4,14,2,3,12
4,14,3,3,12
4,14,4,3,12
4,14,5,3,12
4,14,6,3,12
4,14,7,3,12
4,14,8,3,12
4,14,9,3,12
4,14,10,3,12
4,14,11,3,12
4,14,12,3,12
4,15,0,3,12
4,15,1,3,12
4,15,2,3,12
4,15,3,3,12
4,15,4,3,12
4,15,5,3,12
4,15,6,3,12
4,15,7,3,12
4,15,8,3,12
4,15,9,3,12
4,15,10,3,12
4,15,11,3,12
4,15,12,3,12
4,0,0,4,12
4,0,1,4,12
4,0,2,4,12
4,0,3,4,12
4,0,4,4,12
4,0,5,4,12
4,0,6,4,12
4,0,7,4,12
4,0,8,4,12
4,0,9,4,12
4,0,10,4,12
4,0,11,4,12
4,0,12,4,12
4,1,0,4,12
4,1,1,4,12
4,1,2,4,12
4,1,3,4,12
4,1,4,4,12
4,1,5,4,12
4,1,6,4,12
4,1,7,4,12
4,1,8,4,12
4,1,9,4,12
4,1,10,4,12
4,1,11,4,12
4,1,12,4,12
4,2,0,4,12
4,2,1,4,12
4,2,2,4,12
4,2,3,4,12
4,2,4,4,12
4,2,5,4,12
4,2,6,4,12
4,2,7,4,12
4,2,8,4,12
4,2,9,4,12
4,2,10,4,12
4,2,11,4,12
4,2,12,4,12
4,3,0,4,12
4,3,1,4,12
4,3,2,4,12
4,3,3,4,12
4,3,4,4,12
4,3,5,4,12
4,3,6,4,12
4,3,7,4,12
4,3,8,4,12
4,3,9,4,12
4,3,10,4,12
4,3,11,4,12
4,3,12,4,12
4,4,0,4,12
4,4,1,4,12
4,4,2,4,12
4,4,3,4,12
4,4,4,4,12
4,4,5,4,12
4,4,6,4,12
4,4,7,4,12
4,4,8,4,12
4,4,9,4,12
4,4,10,4,12
4,4,11,4,12
4,4,12,4,12
4,5,0,4,12
4,5,1,4,12
4,5,2,4,12
4,5,3,4,12
4,5,4,4,12
4,5,5,4,12
4,5,6,4,12
4,5,7,4,12
4,5,8,4,12
4,5,9,4,12
4,5,10,4,12
4,5,11,4,12
4,5,12,4,12
4,6,0,4,12
4,6,1,4,12
4,6,2,4,12
4,6,3,4,12
4,6,4,4,12
4,6,5,4,12
4,6,6,4,12
4,6,7,4,12
4,6,8,4,12
4,6,9,4,12
4,6,10,4,12
4,6,11,4,12
4,6,12,4,12
4,7,0,4,12
4,7,1,4,12
4,7,2,4,12
4,7,3,4,12
4,7,4,4,12
4,7,5,4,12
4,7,6,4,12
4,7,7,4,12
4,7,8,4,12
4,7,9,4,12
4,7,10,4,12
4,7,11,4,12
4,7,12,4,12
4,8,0,4,12
4,8,1,4,12
4,8,2,4,12
4,8,3,4,12
4,8,4,4,12
4,8,5,4,12
4,8,6,4,12
4,8,7,4,12
4,8,8,4,12
4,8,9,4,12
4,8,10,4,12
4,8,11,4,12
4,8,12,4,12
4,9,0,4,12
4,9,1,4,12
4,9,2,4,12
4,9,3,4,12
4,9,4,4,12
4,9,5,4,12
4,9,6,4,12
4,9,7,4,12
4,9,8,4,12
4,9,9,4,12
4,9,10,4,12
4,9,11,4,12
4,9,12,4,12
4,10,0,4,12
4,10,1,4,12
4,10,2,4,12
4,10,3,4,12
4,10,4,4,12
4,10,5,4,12
4,10,6,4,12
4,10,7,4,12
4,10,8,4,12
4,10,9,4,12
4,10,10,4,12
4,10,11,4,12
4,10,12,4,12
4,11,0,4,12
4,11,1,4,12
4,11,2,4,12
4,11,3,4,12
4,11,4,4,12
4,11,5,4,12
4,11,6,4,12
4,11,7,4,12
4,11,8,4,12
4,11,9,4,12
4,11,10,4,12
4,11,11,4,12
4,11,12,4,12
4,12,0,4,12
4,12,1,4,12
4,12,2,4,12
4,12,3,4,12
4,12,4,4,12
4,12,5,4,12
4,12,6,4,12
4,12,7,4,12
4,12,8,4,12
4,12,9,4,12
4,12,10,4,12
4,12,11,4,12
4,12,12,4,12
4,0,0,5,12
4,0,1,5,12
4,0,2,5,12
4,0,3,5,12
4,0,4,5,12
4,0,5,5,12
4,0,6,5,12
4,0,7,5,12
4,0,8,5,12
4,0,9,5,12
4,0,10,5,12
4,0,11,5,12
4,0,12,5,12
4,1,0,5,12
4,1,1,5,12
4,1,2,5,12
4,1,3,5,12
4,1,4,5,12
4,1,5,5,12
4,1,6,5,12
4,1,7,5,12
4,1,8,5,12
4,1,9,5,12
4,1,10,5,12
4,1,11,5,12
4,1,12,5,12
4,2,0,5,12
4,2,1,5,12
4,2,2,5,12
4,2,3,5,12
4,2,4,5,12
4,2,5,5,12
4,2,6,5,12
4,2,7,5,12
4,2,8,5,12
4,2,9,5,12
4,2,10,5,12
4,2,11,5,12
4,2,12,5,12
4,3,0,5,12
4,3,1,5,12
4,3,2,5,12
4,3,3,5,12
4,3,4,5,12
4,3,5,5,12
4,3,6,5,12
4,3,7,5,12
4,3,8,5,12
4,3,9,5,12
4,3,10,5,12
4,3,11,5,12
4,3,12,5,12
4,4,0,5,12
4,4,1,5,12
4,4,2,5,12
4,4,3,5,12
4,4,4,5,12
4,4,5,5,12
4,4,6,5,12
4,4,7,5,12
4,4,8,5,12
4,4,9,5,12
4,4,10,5,12
4,4,11,5,12
4,4,12,5,12
4,5,0,5,12
4,5,1,5,12
4,5,2,5,12
4,5,3,5,12
4,5,4,5,12
4,5,5,5,12
4,5,6,5,12
4,5,7,5,12
4,5,8,5,12
4,5,9,5,12
4,5,10,5,12
4,5,11,5,12
4,5,12,5,12
4,6,0,5,12
4,6,1,5,12
4,6,2,5,12
4,6,3,5,12
4,6,4,5,12
4,6,5,5,12
4,6,6,5,12
4,6,7,5,12
4,6,8,5,12
4,6,9,5,12
4,6,10,5,12
4,6,11,5,12
4,6,12,5,12
4,7,0,5,12
4,7,1,5,12
4,7,2,5,12
4,7,3,5,12
4,7,4,5,12
4,7,5,5,12
4,7,6,5,12
4,7,7,5,12
4,7,8,5,12
4,7,9,5,12
4,7,10,5,12
4,7,11,5,12
4,7,12,5,12
4,8,0,5,12
4,8,1,5,12
4,8,2,5,12
4,8,3,5,12
4,8,4,5,12
4,8,5,5,12
4,8,6,5,12
4,8,7,5,12
4,8,8,5,12
4,8,9,5,12
4,8,10,5,12
4,8,11,5,12
4,8,12,5,12
4,9,0,5,12
4,9,1,5,12
4,9,2,5,12
4,9,3,5,12
4,9,4,5,12
4,9,5,5,12
4,9,6,5,12
4,9,7,5,12
4,9,8,5,12
4,9,9,5,12
4,9,10,5,12
4,9,11,5,12
4,9,12,5,12
4,0,0,6,12
4,0,1,6,12
4,0,2,6,12
4,0,3,6,12
4,0,4,6,12
4,0,5,6,12
4,0,6,6,12
4,0,7,6,12
4,0,8,6,12
4,0,9,6,12
4,0,10,6,12
4,0,11,6,12
4,0,12,6,12
4,1,0,6,12
4,1,1,6,12
4,1,2,6,12
4,1,3,6,12
4,1,4,6,12
4,1,5,6,12
4,1,6,6,12
4,1,7,6,12
4,1,8,6,12
4,1,9,6,12
4,1,10,6,12
4,1,11,6,12
4,1,12,6,12
4,2,0,6,12
4,2,1,6,12
4,2,2,6,12
4,2,3,6,12
4,2,4,6,12
4,2,5,6,12
4,2,6,6,12
4,2,7,6,12
4,2,8,6,12
4,2,9,6,12
4,2,10,6,12
4,2,11,6,12
4,2,12,6,12
4,3,0,6,12
4,3,1,6,12
4,3,2,6,12
4,3,3,6,12
4,3,4,6,12
4,3,5,6,12
4,3,6,6,12
4,3,7,6,12
4,3,8,6,12
4,3,9,6,12
4,3,10,6,12
4,3,11,6,12
4,3,12,6,12
4,4,0,6,12
4,4,1,6,12
4,4,2,6,12
4,4,3,6,12
4,4,4,6,12
4,4,5,6,12
4,4,6,6,12
4,4,7,6,12
4,4,8,6,12
4,4,9,6,12
4,4,10,6,12
4,4,11,6,12
4,4,12,6,12
4,5,0,6,12
4,5,1,6,12
4,5,2,6,12
4,5,3,6,12
4,5,4,6,12
4,5,5,6,12
4,5,6,6,12
4,5,7,6,12
4,5,8,6,12
4,5,9,6,12
4,5,10,6,12
4,5,11,6,12
4,5,12,6,12
4,6,0,6,12
4,6,1,6,12
4,6,2,6,12
4,6,3,6,12
4,6,4,6,12
4,6,5,6,12
4,6,6,6,12
4,6,7,6,12
4,6,8,6,12
4,6,9,6,12
4,6,10,6,12
4,6,11,6,12
4,6,12,6,12
4,0,0,7,12
4,0,1,7,12
4,0,2,7,12
4,0,3,7,12
4,0,4,7,12
4,0,5,7,12
4,0,6,7,12
4,0,7,7,12
4,0,8,7,12
4,0,9,7,12
4,0,10,7,12
4,0,11,7,12
4,0,12,7,12
4,1,0,7,12
4,1,1,7,12
4,1,2,7,12
4,1,3,7,12
4,1,4,7,12
4,1,5,7,12
4,1,6,7,12
4,1,7,7,12
4,1,8,7,12
4,1,9,7,12
4,1,10,7,12
4,1,11,7,12
4,1,12,7,12
4,2,0,7,12
4,2,1,7,12
4,2,2,7,12
4,2,3,7,12
4,2,4,7,12
4,2,5,7,12
4,2,6,7,12
4,2,7,7,12
4,2,8,7,12
4,2,9,7,12
4,2,10,7,12
4,2,11,7,12
4,2,12,7,12
4,3,0,7,12
4,3,1,7,12
4,3,2,7,12
4,3,3,7,12
4,3,4,7,12
4,3,5,7,12
4,3,6,7,12
4,3,7,7,12
4,3,8,7,12
4,3,9,7,12
4,3,10,7,12
4,3,11,7,12
4,3,12,7,12
4,0,0,8,12
4,0,1,8,12
4,0,2,8,12
4,0,3,8,12
4,0,4,8,12
4,0,5,8,12
4,0,6,8,12
4,0,7,8,12
4,0,8,8,12
4,0,9,8,12
4,0,10,8,12
4,0,11,8,12
4,0,12,8,12
4,0,0,1,13
4,0,1,1,13
4,0,2,1,13
4,0,3,1,13
4,0,4,1,13
4,0,5,1,13
4,0,6,1,13
4,0,7,1,13
4,0,8,1,13
4,0,9,1,13
4,0,10,1,13
4,0,11,1,13
4,1,0,1,13
4,1,1,1,13
4,1,2,1,13
4,1,3,1,13
4,1,4,1,13
4,1,5,1,13
4,1,6,1,13
4,1,7,1,13
4,1,8,1,13
4,1,9,1,13
4,1,10,1,13
4,1,11,1,13
4,2,0,1,13
4,2,1,1,13
4,2,2,1,13
4,2,3,1,13
4,2,4,1,13
4,2,5,1,13
4,2,6,1,13
4,2,7,1,13
4,2,8,1,13
4,2,9,1,13
4,2,10,1,13
4,2,11,1,13
4,3,0,1,13
4,3,1,1,13
4,3,2,1,13
4,3,3,1,13
4,3,4,1,13
4,3,5,1,13
4,3,6,1,13
4,3,7,1,13
4,3,8,1,13
4,3,9,1,13
4,3,10,1,13
4,3,11,1,13
4,4,0,1,13
4,4,1,1,13
4,4,2,1,13
4,4,3,1,13
4,4,4,1,13
4,4,5,1,13
4,4,6,1,13
4,4,7,1,13
4,4,8,1,13
4,4,9,1,13
4,4,10,1,13
4,4,11,1,13
4,5,0,1,13
4,5,1,1,13
4,5,2,1,13
4,5,3,1,13
4,5,4,1,13
4,5,5,1,13
4,5,6,1,13
4,5,7,1,13
4,5,8,1,13
4,5,9,1,13
4,5,10,1,13
4,5,11,1,13
4,6,0,1,13
4,6,1,1,13
4,6,2,1,13
4,6,3,1,13
4,6,4,1,13
4,6,5,1,13
4,6,6,1,13
4,6,7,1,13
4,6,8,1,13
4,6,9,1,13
4,6,10,1,13
4,6,11,1,13
4,7,0,1,13
4,7,1,1,13
4,7,2,1,13
4,7,3,1,13
4,7,4,1,13
4,7,5,1,13
4,7,6,1,13
4,7,7,1,13
4,7,8,1,13
4,7,9,1,13
4,7,10,1,13
4,7,11,1,13
4,8,0,1,13
4,8,1,1,13
4,8,2,1,13
4,8,3,1,13
4,8,4,1,13
4,8,5,1,13
4,8,6,1,13
4,8,7,1,13
4,8,8,1,13
4,8,9,1,13
4,8,10,1,13
4,8,11,1,13
4,9,0,1,13
4,9,1,1,13
4,9,2,1,13
4,9,3,1,13
4,9,4,1,13
4,9,5,1,13
4,9,6,1,13
4,9,7,1,13
4,9,8,1,13
4,9,9,1,13
4,9,10,1,13
4,9,11,1,13
4,10,0,1,13
4,10,1,1,13
4,10,2,1,13
4,10,3,1,13
4,10,4,1,13
4,10,5,1,13
4,10,6,1,13
4,10,7,1,13
4,10,8,1,13
4,10,9,1,13
4,10,10,1,13
4,10,11,1,13
4,11,0,1,13
4,11,1,1,13
4,11,2,1,13
4,11,3,1,13
4,11,4,1,13
4,11,5,1,13
4,11,6,1,13
4,11,7,1,13
4,11,8,1,13
4,11,9,1,13
4,11,10,1,13
4,11,11,1,13
4,12,0,1,13
4,12,1,1,13
4,12,2,1,13
4,12,3,1,13
4,12,4,1,13
4,12,5,1,13
4,12,6,1,13
4,12,7,1,13
4,12,8,1,13
4,12,9,1,13
4,12,10,1,13
4,12,11,1,13
4,13,0,1,13
4,13,1,1,13
4,13,2,1,13
4,13,3,1,13
4,13,4,1,13
4,13,5,1,13
4,13,6,1,13
4,13,7,1,13
4,13,8,1,13
4,13,9,1,13
4,13,10,1,13
4,13,11,1,13
4,14,0,1,13
4,14,1,1,13
4,14,2,1,13
4,14,3,1,13
4,14,4,1,13
4,14,5,1,13
4,14,6,1,13
4,14,7,1,13
4,14,8,1,13
4,14,9,1,13
4,14,10,1,13
4,14,11,1,13
4,15,0,1,13
4,15,1,1,13
4,15,2,1,13
4,15,3,1,13
4,15,4,1,13
4,15,5,1,13
4,15,6,1,13
4,15,7,1,13
4,15,8,1,13
4,15,9,1,13
4,15,10,1,13
4,15,11,1,13
4,16,0,1,13
4,16,1,1,13
4,16,2,1,13
4,16,3,1,13
4,16,4,1,13
4,16,5,1,13
4,16,6,1,13
4,16,7,1,13
4,16,8,1,13
4,16,9,1,13
4,16,10,1,13
4,16,11,1,13
4,17,0,1,13
4,17,1,1,13
4,17,2,1,13
4,17,3,1,13
4,17,4,1,13
4,17,5,1,13
4,17,6,1,13
4,17,7,1,13
4,17,8,1,13
4,17,9,1,13
4,17,10,1,13
4,17,11,1,13
4,18,0,1,13
4,18,1,1,13
4,18,2,1,13
4,18,3,1,13
4,18,4,1,13
4,18,5,1,13
4,18,6,1,13
4,18,7,1,13
4,18,8,1,13
4,18,9,1,13
4,18,10,1,13
4,18,11,1,13
4,19,0,1,13
4,19,1,1,13
4,19,2,1,13
4,19,3,1,13
4,19,4,1,13
4,19,5,1,13
4,19,6,1,13
4,19,7,1,13
4,19,8,1,13
4,19,9,1,13
4,19,10,1,13
4,19,11,1,13
4,20,0,1,13
4,20,1,1,13
4,20,2,1,13
4,20,3,1,13
4,20,4,1,13
4,20,5,1,13
4,20,6,1,13
4,20,7,1,13
4,20,8,1,13
4,20,9,1,13
4,20,10,1,13
4,20,11,1,13
4,21,0,1,13
4,21,1,1,13
4,21,2,1,13
4,21,3,1,13
4,21,4,1,13
4,21,5,1,13
4,21,6,1,13
4,21,7,1,13
4,21,8,1,13
4,21,9,1,13
4,21,10,1,13
4,21,11,1,13
4,0,0,2,13
4,0,1,2,13
4,0,2,2,13
4,0,3,2,13
4,0,4,2,13
4,0,5,2,13
4,0,6,2,13
4,0,7,2,13
4,0,8,2,13
4,0,9,2,13
4,0,10,2,13
4,0,11,2,13
4,1,0,2,13
4,1,1,2,13
4,1,2,2,13
4,1,3,2,13
4,1,4,2,13
4,1,5,2,13
4,1,6,2,13
4,1,7,2,13
4,1,8,2,13
4,1,9,2,13
4,1,10,2,13
4,1,11,2,13
4,2,0,2,13
4,2,1,2,13
4,2,2,2,13
4,2,3,2,13
4,2,4,2,13
4,2,5,2,13
4,2,6,2,13
4,2,7,2,13
4,2,8,2,13
4,2,9,2,13
4,2,10,2,13
4,2,11,2,13
4,3,0,2,13
4,3,1,2,13
4,3,2,2,13
4,3,3,2,13
4,3,4,2,13
4,3,5,2,13
4,3,6,2,13
4,3,7,2,13
4,3,8,2,13
4,3,9,2,13
4,3,10,2,13
4,3,11,2,13
4,4,0,2,13
4,4,1,2,13
4,4,2,2,13
4,4,3,2,13
4,4,4,2,13
4,4,5,2,13
4,4,6,2,13
4,4,7,2,13
4,4,8,2,13
4,4,9,2,13
4,4,10,2,13
4,4,11,2,13
4,5,0,2,13
4,5,1,2,13
4,5,2,2,13
4,5,3,2,13
4,5,4,2,13
4,5,5,2,13
4,5,6,2,13
4,5,7,2,13
4,5,8,2,13
4,5,9,2,13
4,5,10,2,13
4,5,11,2,13
4,6,0,2,13
4,6,1,2,13
4,6,2,2,13
4,6,3,2,13
4,6,4,2,13
4,6,5,2,13
4,6,6,2,13
4,6,7,2,13
4,6,8,2,13
4,6,9,2,13
4,6,10,2,13
4,6,11,2,13
4,7,0,2,13
4,7,1,2,13
4,7,2,2,13
4,7,3,2,13
4,7,4,2,13
4,7,5,2,13
4,7,6,2,13
4,7,7,2,13
4,7,8,2,13
4,7,9,2,13
4,7,10,2,13
4,7,11,2,13
4,8,0,2,13
4,8,1,2,13
4,8,2,2,13
4,8,3,2,13
4,8,4,2,13
4,8,5,2,13
4,8,6,2,13
4,8,7,2,13
4,8,8,2,13
4,8,9,2,13
4,8,10,2,13
4,8,11,2,13
4,9,0,2,13
4,9,1,2,13
4,9,2,2,13
4,9,3,2,13
4,9,4,2,13
4,9,5,2,13
4,9,6,2,13
4,9,7,2,13
4,9,8,2,13
4,9,9,2,13
4,9,10,2,13
4,9,11,2,13
4,10,0,2,13
4,10,1,2,13
4,10,2,2,13
4,10,3,2,13
4,10,4,2,13
4,10,5,2,13
4,10,6,2,13
4,10,7,2,13
4,10,8,2,13
4,10,9,2,13
4,10,10,2,13
4,10,11,2,13
4,11,0,2,13
4,11,1,2,13
4,11,2,2,13
4,11,3,2,13
4,11,4,2,13
4,11,5,2,13
4,11,6,2,13
4,11,7,2,13
4,11,8,2,13
4,11,9,2,13
4,11,10,2,13
4,11,11,2,13
4,12,0,2,13
4,12,1,2,13
4,12,2,2,13
4,12,3,2,13
4,12,4,2,13
4,12,5,2,13
4,12,6,2,13
4,12,7,2,13
4,12,8,2,13
4,12,9,2,13
4,12,10,2,13
4,12,11,2,13
4,13,0,2,13
4,13,1,2,13
4,13,2,2,13
4,13,3,2,13
4,13,4,2,13
4,13,5,2,13
4,13,6,2,13
4,13,7,2,13
4,13,8,2,13
4,13,9,2,13
4,13,10,2,13
4,13,11,2,13
4,14,0,2,13
4,14,1,2,13
4,14,2,2,13
4,14,3,2,13
4,14,4,2,13
4,14,5,2,13
4,14,6,2,13
4,14,7,2,13
4,14,8,2,13
4,14,9,2,13
4,14,10,2,13
4,14,11,2,13
4,15,0,2,13
4,15,1,2,13
4,15,2,2,13
4,15,3,2,13
4,15,4,2,13
4,15,5,2,13
4,15,6,2,13
4,15,7,2,13
4,15,8,2,13
4,15,9,2,13
4,15,10,2,13
4,15,11,2,13
4,16,0,2,13
4,16,1,2,13
4,16,2,2,13
4,16,3,2,13
4,16,4,2,13
4,16,5,2,13
4,16,6,2,13
4,16,7,2,13
4,16,8,2,13
4,16,9,2,13
4,16,10,2,13
4,16,11,2,13
4,17,0,2,13
4,17,1,2,13
4,17,2,2,13
4,17,3,2,13
4,17,4,2,13
4,17,5,2,13
4,17,6,2,13
4,17,7,2,13
4,17,8,2,13
4,17,9,2,13
4,17,10,2,13
4,17,11,2,13
4,18,0,2,13
4,18,1,2,13
4,18,2,2,13
4,18,3,2,13
4,18,4,2,13
4,18,5,2,13
4,18,6,2,13
4,18,7,2,13
4,18,8,2,13
4,18,9,2,13
4,18,10,2,13
4,18,11,2,13
4,0,0,3,13
4,0,1,3,13
4,0,2,3,13
4,0,3,3,13
4,0,4,3,13
4,0,5,3,13
4,0,6,3,13
4,0,7,3,13
4,0,8,3,13
4,0,9,3,13
4,0,10,3,13
4,0,11,3,13
4,1,0,3,13
4,1,1,3,13
4,1,2,3,13
4,1,3,3,13
4,1,4,3,13
4,1,5,3,13
4,1,6,3,13
4,1,7,3,13
4,1,8,3,13
4,1,9,3,13
4,1,10,3,13
4,1,11,3,13
4,2,0,3,13
4,2,1,3,13
4,2,2,3,13
4,2,3,3,13
4,2,4,3,13
4,2,5,3,13
4,2,6,3,13
4,2,7,3,13
4,2,8,3,13
4,2,9,3,13
4,2,10,3,13
4,2,11,3,13
4,3,0,3,13
4,3,1,3,13
4,3,2,3,13
4,3,3,3,13
4,3,4,3,13
4,3,5,3,13
4,3,6,3,13
4,3,7,3,13
4,3,8,3,13
4,3,9,3,13
4,3,10,3,13
4,3,11,3,13
4,4,0,3,13
4,4,1,3,13
4,4,2,3,13
4,4,3,3,13
4,4,4,3,13
4,4,5,3,13
4,4,6,3,13
4,4,7,3,13
4,4,8,3,13
4,4,9,3,13
4,4,10,3,13
4,4,11,3,13
4,5,0,3,13
4,5,1,3,13
4,5,2,3,13
4,5,3,3,13
4,5,4,3,13
4,5,5,3,13
4,5,6,3,13
4,5,7,3,13
4,5,8,3,13
4,5,9,3,13
4,5,10,3,13
4,5,11,3,13
4,6,0,3,13
4,6,1,3,13
4,6,2,3,13
4,6,3,3,13
4,6,4,3,13
4,6,5,3,13
4,6,6,3,13
4,6,7,3,13
4,6,8,3,13
4,6,9,3,13
4,6,10,3,13
4,6,11,3,13
4,7,0,3,13
4,7,1,3,13
4,7,2,3,13
4,7,3,3,13
4,7,4,3,13
4,7,5,3,13
4,7,6,3,13
4,7,7,3,13
4,7,8,3,13
4,7,9,3,13
4,7,10,3,13
4,7,11,3,13
4,8,0,3,13
4,8,1,3,13
4,8,2,3,13
4,8,3,3,13
4,8,4,3,13
4,8,5,3,13
4,8,6,3,13
4,8,7,3,13
4,8,8,3,13
4,8,9,3,13
4,8,10,3,13
4,8,11,3,13
4,9,0,3,13
4,9,1,3,13
4,9,2,3,13
4,9,3,3,13
4,9,4,3,13
4,9,5,3,13
4,9,6,3,13
4,9,7,3,13
4,9,8,3,13
4,9,9,3,13
4,9,10,3,13
4,9,11,3,13
4,10,0,3,13
4,10,1,3,13
4,10,2,3,13
4,10,3,3,13
4,10,4,3,13
4,10,5,3,13
4,10,6,3,13
4,10,7,3,13
4,10,8,3,13
4,10,9,3,13
4,10,10,3,13
4,10,11,3,13
4,11,0,3,13
4,11,1,3,13
4,11,2,3,13
4,11,3,3,13
4,11,4,3,13
4,11,5,3,13
4,11,6,3,13
4,11,7,3,13
4,11,8,3,13
4,11,9,3,13
4,11,10,3,13
4,11,11,3,13
4,12,0,3,13
4,12,1,3,13
4,12,2,3,13
4,12,3,3,13
4,12,4,3,13
4,12,5,3,13
4,12,6,3,13
4,12,7,3,13
4,12,8,3,13
4,12,9,3,13
4,12,10,3,13
4,12,11,3,13
4,13,0,3,13
4,13,1,3,13
4,13,2,3,13
4,13,3,3,13
4,13,4,3,13
4,13,5,3,13
4,13,6,3,13
4,13,7,3,13
4,13,8,3,13
4,13,9,3,13
4,13,10,3,13
4,13,11,3,13
4,14,0,3,13
4,14,1,3,13
4,14,2,3,13
4,14,3,3,13
4,14,4,3,13
4,14,5,3,13
4,14,6,3,13
4,14,7,3,13
4,14,8,3,13
4,14,9,3,13
4,14,10,3,13
4,14,11,3,13
4,15,0,3,13
4,15,1,3,13
4,15,2,3,13
4,15,3,3,13
4,15,4,3,13
4,15,5,3,13
4,15,6,3,13
4,15,7,3,13
4,15,8,3,13
4,15,9,3,13
4,15,10,3,13
4,15,11,3,13
4,0,0,4,13
4,0,1,4,13
4,0,2,4,13
4,0,3,4,13
4,0,4,4,13
4,0,5,4,13
4,0,6,4,13
4,0,7,4,13
4,0,8,4,13
4,0,9,4,13
4,0,10,4,13
4,0,11,4,13
4,1,0,4,13
4,1,1,4,13
4,1,2,4,13
4,1,3,4,13
4,1,4,4,13
4,1,5,4,13
4,1,6,4,13
4,1,7,4,13
4,1,8,4,13
4,1,9,4,13
4,1,10,4,13
4,1,11,4,13
4,2,0,4,13
4,2,1,4,13
4,2,2,4,13
4,2,3,4,13
4,2,4,4,13
4,2,5,4,13
4,2,6,4,13
4,2,7,4,13
4,2,8,4,13
4,2,9,4,13
4,2,10,4,13
4,2,11,4,13
4,3,0,4,13
4,3,1,4,13
4,3,2,4,13
4,3,3,4,13
4,3,4,4,13
4,3,5,4,13
4,3,6,4,13
4,3,7,4,13
4,3,8,4,13
4,3,9,4,13
4,3,10,4,13
4,3,11,4,13
4,4,0,4,13
4,4,1,4,13
4,4,2,4,13
4,4,3,4,13
4,4,4,4,13
4,4,5,4,13
4,4,6,4,13
4,4,7,4,13
4,4,8,4,13
4,4,9,4,13
4,4,10,4,13
4,4,11,4,13
4,5,0,4,13
4,5,1,4,13
4,5,2,4,13
4,5,3,4,13
4,5,4,4,13
4,5,5,4,13
4,5,6,4,13
4,5,7,4,13
4,5,8,4,13
4,5,9,4,13
4,5,10,4,13
4,5,11,4,13
4,6,0,4,13
4,6,1,4,13
4,6,2,4,13
4,6,3,4,13
4,6,4,4,13
4,6,5,4,13
4,6,6,4,13
4,6,7,4,13
4,6,8,4,13
4,6,9,4,13
4,6,10,4,13
4,6,11,4,13
4,7,0,4,13
4,7,1,4,13
4,7,2,4,13
4,7,3,4,13
4,7,4,4,13
4,7,5,4,13
4,7,6,4,13
4,7,7,4,13
4,7,8,4,13
4,7,9,4,13
4,7,10,4,13
4,7,11,4,13
4,8,0,4,13
4,8,1,4,13
4,8,2,4,13
4,8,3,4,13
4,8,4,4,13
4,8,5,4,13
4,8,6,4,13
4,8,7,4,13
4,8,8,4,13
4,8,9,4,13
4,8,10,4,13
4,8,11,4,13
4,9,0,4,13
4,9,1,4,13
4,9,2,4,13
4,9,3,4,13
4,9,4,4,13
4,9,5,4,13
4,9,6,4,13
4,9,7,4,13
4,9,8,4,13
4,9,9,4,13
4,9,10,4,13
4,9,11,4,13
4,10,0,4,13
4,10,1,4,13
4,10,2,4,13
4,10,3,4,13
4,10,4,4,13
4,10,5,4,13
4,10,6,4,13
4,10,7,4,13
4,10,8,4,13
4,10,9,4,13
4,10,10,4,13
4,10,11,4,13
4,11,0,4,13
4,11,1,4,13
4,11,2,4,13
4,11,3,4,13
4,11,4,4,13
4,11,5,4,13
4,11,6,4,13
4,11,7,4,13
4,11,8,4,13
4,11,9,4,13
4,11,10,4,13
4,11,11,4,13
4,12,0,4,13
4,12,1,4,13
4,12,2,4,13
4,12,3,4,13
4,12,4,4,13
4,12,5,4,13
4,12,6,4,13
4,12,7,4,13
4,12,8,4,13
4,12,9,4,13
4,12,10,4,13
4,12,11,4,13
4,0,0,5,13
4,0,1,5,13
4,0,2,5,13
4,0,3,5,13
4,0,4,5,13
4,0,5,5,13
4,0,6,5,13
4,0,7,5,13
4,0,8,5,13
4,0,9,5,13
4,0,10,5,13
4,0,11,5,13
4,1,0,5,13
4,1,1,5,13
4,1,2,5,13
4,1,3,5,13
4,1,4,5,13
4,1,5,5,13
4,1,6,5,13
4,1,7,5,13
4,1,8,5,13
4,1,9,5,13
4,1,10,5,13
4,1,11,5,13
4,2,0,5,13
4,2,1,5,13
4,2,2,5,13
4,2,3,5,13
4,2,4,5,13
4,2,5,5,13
4,2,6,5,13
4,2,7,5,13
4,2,8,5,13
4,2,9,5,13
4,2,10,5,13
4,2,11,5,13
4,3,0,5,13
4,3,1,5,13
4,3,2,5,13
4,3,3,5,13
4,3,4,5,13
4,3,5,5,13
4,3,6,5,13
4,3,7,5,13
4,3,8,5,13
4,3,9,5,13
4,3,10,5,13
4,3,11,5,13
4,4,0,5,13
4,4,1,5,13
4,4,2,5,13
4,4,3,5,13
4,4,4,5,13
4,4,5,5,13
4,4,6,5,13
4,4,7,5,13
4,4,8,5,13
4,4,9,5,13
4,4,10,5,13
4,4,11,5,13
4,5,0,5,13
4,5,1,5,13
4,5,2,5,13
4,5,3,5,13
4,5,4,5,13
4,5,5,5,13
4,5,6,5,13
4,5,7,5,13
4,5,8,5,13
4,5,9,5,13
4,5,10,5,13
4,5,11,5,13
4,6,0,5,13
4,6,1,5,13
4,6,2,5,13
4,6,3,5,13
4,6,4,5,13
4,6,5,5,13
4,6,6,5,13
4,6,7,5,13
4,6,8,5,13
4,6,9,5,13
4,6,10,5,13
4,6,11,5,13
4,7,0,5,13
4,7,1,5,13
4,7,2,5,13
4,7,3,5,13
4,7,4,5,13
4,7,5,5,13
4,7,6,5,13
4,7,7,5,13
4,7,8,5,13
4,7,9,5,13
4,7,10,5,13
4,7,11,5,13
4,8,0,5,13
4,8,1,5,13
4,8,2,5,13
4,8,3,5,13
4,8,4,5,13
4,8,5,5,13
4,8,6,5,13
4,8,7,5,13
4,8,8,5,13
4,8,9,5,13
4,8,10,5,13
4,8,11,5,13
4,9,0,5,13
4,9,1,5,13
4,9,2,5,13
4,9,3,5,13
4,9,4,5,13
4,9,5,5,13
4,9,6,5,13
4,9,7,5,13
4,9,8,5,13
4,9,9,5,13
4,9,10,5,13
4,9,11,5,13
4,0,0,6,13
4,0,1,6,13
4,0,2,6,13
4,0,3,6,13
4,0,4,6,13
4,0,5,6,13
4,0,6,6,13
4,0,7,6,13
4,0,8,6,13
4,0,9,6,13
4,0,10,6,13
4,0,11,6,13
4,1,0,6,13
4,1,1,6,13
4,1,2,6,13
4,1,3,6,13
4,1,4,6,13
4,1,5,6,13
4,1,6,6,13
4,1,7,6,13
4,1,8,6,13
4,1,9,6,13
4,1,10,6,13
4,1,11,6,13
4,2,0,6,13
4,2,1,6,13
4,2,2,6,13
4,2,3,6,13
4,2,4,6,13
4,2,5,6,13
4,2,6,6,13
4,2,7,6,13
4,2,8,6,13
4,2,9,6,13
4,2,10,6,13
4,2,11,6,13
4,3,0,6,13
4,3,1,6,13
4,3,2,6,13
4,3,3,6,13
4,3,4,6,13
4,3,5,6,13
4,3,6,6,13
4,3,7,6,13
4,3,8,6,13
4,3,9,6,13
4,3,10,6,13
4,3,11,6,13
4,4,0,6,13
4,4,1,6,13
4,4,2,6,13
4,4,3,6,13
4,4,4,6,13
4,4,5,6,13
4,4,6,6,13
4,4,7,6,13
4,4,8,6,13
4,4,9,6,13
4,4,10,6,13
4,4,11,6,13
4,5,0,6,13
4,5,1,6,13
4,5,2,6,13
4,5,3,6,13
4,5,4,6,13
4,5,5,6,13
4,5,6,6,13
4,5,7,6,13
4,5,8,6,13
4,5,9,6,13
4,5,10,6,13
4,5,11,6,13
4,6,0,6,13
4,6,1,6,13
4,6,2,6,13
4,6,3,6,13
4,6,4,6,13
4,6,5,6,13
4,6,6,6,13
4,6,7,6,13
4,6,8,6,13
4,6,9,6,13
4,6,10,6,13
4,6,11,6,13
4,0,0,7,13
4,0,1,7,13
4,0,2,7,13
4,0,3,7,13
4,0,4,7,13
4,0,5,7,13
4,0,6,7,13
4,0,7,7,13
4,0,8,7,13
4,0,9,7,13
4,0,10,7,13
4,0,11,7,13
4,1,0,7,13
4,1,1,7,13
4,1,2,7,13
4,1,3,7,13
4,1,4,7,13
4,1,5,7,13
4,1,6,7,13
4,1,7,7,13
4,1,8,7,13
4,1,9,7,13
4,1,10,7,13
4,1,11,7,13
4,2,0,7,13
4,2,1,7,13
4,2,2,7,13
4,2,3,7,13
4,2,4,7,13
4,2,5,7,13
4,2,6,7,13
4,2,7,7,13
4,2,8,7,13
4,2,9,7,13
4,2,10,7,13
4,2,11,7,13
4,3,0,7,13
4,3,1,7,13
4,3,2,7,13
4,3,3,7,13
4,3,4,7,13
4,3,5,7,13
4,3,6,7,13
4,3,7,7,13
4,3,8,7,13
4,3,9,7,13
4,3,10,7,13
4,3,11,7,13
4,0,0,8,13
4,0,1,8,13
4,0,2,8,13
4,0,3,8,13
4,0,4,8,13
4,0,5,8,13
4,0,6,8,13
4,0,7,8,13
4,0,8,8,13
4,0,9,8,13
4,0,10,8,13
4,0,11,8,13
4,0,0,1,14
4,0,1,1,14
4,0,2,1,14
4,0,3,1,14
4,0,4,1,14
4,0,5,1,14
4,0,6,1,14
4,0,7,1,14
4,0,8,1,14
4,0,9,1,14
4,0,10,1,14
4,1,0,1,14
4,1,1,1,14
4,1,2,1,14
4,1,3,1,14
4,1,4,1,14
4,1,5,1,14
4,1,6,1,14
4,1,7,1,14
4,1,8,1,14
4,1,9,1,14
4,1,10,1,14
4,2,0,1,14
4,2,1,1,14
4,2,2,1,14
4,2,3,1,14
4,2,4,1,14
4,2,5,1,14
4,2,6,1,14
4,2,7,1,14
4,2,8,1,14
4,2,9,1,14
4,2,10,1,14
4,3,0,1,14
4,3,1,1,14
4,3,2,1,14
4,3,3,1,14
4,3,4,1,14
4,3,5,1,14
4,3,6,1,14
4,3,7,1,14
4,3,8,1,14
4,3,9,1,14
4,3,10,1,14
4,4,0,1,14
4,4,1,1,14
4,4,2,1,14
4,4,3,1,14
4,4,4,1,14
4,4,5,1,14
4,4,6,1,14
4,4,7,1,14
4,4,8,1,14
4,4,9,1,14
4,4,10,1,14
4,5,0,1,14
4,5,1,1,14
4,5,2,1,14
4,5,3,1,14
4,5,4,1,14
4,5,5,1,14
4,5,6,1,14
4,5,7,1,14
4,5,8,1,14
4,5,9,1,14
4,5,10,1,14
4,6,0,1,14
4,6,1,1,14
4,6,2,1,14
4,6,3,1,14
4,6,4,1,14
4,6,5,1,14
4,6,6,1,14
4,6,7,1,14
4,6,8,1,14
4,6,9,1,14
4,6,10,1,14
4,7,0,1,14
4,7,1,1,14
4,7,2,1,14
4,7,3,1,14
4,7,4,1,14
4,7,5,1,14
4,7,6,1,14
4,7,7,1,14
4,7,8,1,14
4,7,9,1,14
4,7,10,1,14
4,8,0,1,14
4,8,1,1,14
4,8,2,1,14
4,8,3,1,14
4,8,4,1,14
4,8,5,1,14
4,8,6,1,14
4,8,7,1,14
4,8,8,1,14
4,8,9,1,14
4,8,10,1,14
4,9,0,1,14
4,9,1,1,14
4,9,2,1,14
4,9,3,1,14
4,9,4,1,14
4,9,5,1,14
4,9,6,1,14
4,9,7,1,14
4,9,8,1,14
4,9,9,1,14
4,9,10,1,14
4,10,0,1,14
4,10,1,1,14
4,10,2,1,14
4,10,3,1,14
4,10,4,1,14
4,10,5,1,14
4,10,6,1,14
4,10,7,1,14
4,10,8,1,14
4,10,9,1,14
4,10,10,1,14
4,11,0,1,14
4,11,1,1,14
4,11,2,1,14
4,11,3,1,14
4,11,4,1,14
4,11,5,1,14
4,11,6,1,14
4,11,7,1,14
4,11,8,1,14
4,11,9,1,14
4,11,10,1,14
4,12,0,1,14
4,12,1,1,14
4,12,2,1,14
4,12,3,1,14
4,12,4,1,14
4,12,5,1,14
4,12,6,1,14
4,12,7,1,14
4,12,8,1,14
4,12,9,1,14
4,12,10,1,14
4,13,0,1,14
4,13,1,1,14
4,13,2,1,14
4,13,3,1,14
4,13,4,1,14
4,13,5,1,14
4,13,6,1,14
4,13,7,1,14
4,13,8,1,14
4,13,9,1,14
4,13,10,1,14
4,14,0,1,14
4,14,1,1,14
4,14,2,1,14
4,14,3,1,14
4,14,4,1,14
4,14,5,1,14
4,14,6,1,14
4,14,7,1,14
4,14,8,1,14
4,14,9,1,14
4,14,10,1,14
4,15,0,1,14
4,15,1,1,14
4,15,2,1,14
4,15,3,1,14
4,15,4,1,14
4,15,5,1,14
4,15,6,1,14
4,15,7,1,14
4,15,8,1,14
4,15,9,1,14
4,15,10,1,14
4,16,0,1,14
4,16,1,1,14
4,16,2,1,14
4,16,3,1,14
4,16,4,1,14
4,16,5,1,14
4,16,6,1,14
4,16,7,1,14
4,16,8,1,14
4,16,9,1,14
4,16,10,1,14
4,17,0,1,14
4,17,1,1,14
4,17,2,1,14
4,17,3,1,14
4,17,4,1,14
4,17,5,1,14
4,17,6,1,14
4,17,7,1,14
4,17,8,1,14
4,17,9,1,14
4,17,10,1,14
4,18,0,1,14
4,18,1,1,14
4,18,2,1,14
4,18,3,1,14
4,18,4,1,14
4,18,5,1,14
4,18,6,1,14
4,18,7,1,14
4,18,8,1,14
4,18,9,1,14
4,18,10,1,14
4,19,0,1,14
4,19,1,1,14
4,19,2,1,14
4,19,3,1,14
4,19,4,1,14
4,19,5,1,14
4,19,6,1,14
4,19,7,1,14
4,19,8,1,14
4,19,9,1,14
4,19,10,1,14
4,20,0,1,14
4,20,1,1,14
4,20,2,1,14
4,20,3,1,14
4,20,4,1,14
4,20,5,1,14
4,20,6,1,14
4,20,7,1,14
4,20,8,1,14
4,20,9,1,14
4,20,10,1,14
4,21,0,1,14
4,21,1,1,14
4,21,2,1,14
4,21,3,1,14
4,21,4,1,14
4,21,5,1,14
4,21,6,1,14
4,21,7,1,14
4,21,8,1,14
4,21,9,1,14
4,21,10,1,14
4,0,0,2,14
4,0,1,2,14
4,0,2,2,14
4,0,3,2,14
4,0,4,2,14
4,0,5,2,14
4,0,6,2,14
4,0,7,2,14
4,0,8,2,14
4,0,9,2,14
4,0,10,2,14
4,1,0,2,14
4,1,1,2,14
4,1,2,2,14
4,1,3,2,14
4,1,4,2,14
4,1,5,2,14
4,1,6,2,14
4,1,7,2,14
4,1,8,2,14
4,1,9,2,14
4,1,10,2,14
4,2,0,2,14
4,2,1,2,14
4,2,2,2,14
4,2,3,2,14
4,2,4,2,14
4,2,5,2,14
4,2,6,2,14
4,2,7,2,14
4,2,8,2,14
4,2,9,2,14
4,2,10,2,14
4,3,0,2,14
4,3,1,2,14
4,3,2,2,14
4,3,3,2,14
4,3,4,2,14
4,3,5,2,14
4,3,6,2,14
4,3,7,2,14
4,3,8,2,14
4,3,9,2,14
4,3,10,2,14
4,4,0,2,14
4,4,1,2,14
4,4,2,2,14
4,4,3,2,14
4,4,4,2,14
4,4,5,2,14
4,4,6,2,14
4,4,7,2,14
4,4,8,2,14
4,4,9,2,14
4,4,10,2,14
4,5,0,2,14
4,5,1,2,14
4,5,2,2,14
4,5,3,2,14
4,5,4,2,14
4,5,5,2,14
4,5,6,2,14
4,5,7,2,14
4,5,8,2,14
4,5,9,2,14
4,5,10,2,14
4,6,0,2,14
4,6,1,2,14
4,6,2,2,14
4,6,3,2,14
4,6,4,2,14
4,6,5,2,14
4,6,6,2,14
4,6,7,2,14
4,6,8,2,14
4,6,9,2,14
4,6,10,2,14
4,7,0,2,14
4,7,1,2,14
4,7,2,2,14
4,7,3,2,14
4,7,4,2,14
4,7,5,2,14
4,7,6,2,14
4,7,7,2,14
4,7,8,2,14
4,7,9,2,14
4,7,10,2,14
4,8,0,2,14
4,8,1,2,14
4,8,2,2,14
4,8,3,2,14
4,8,4,2,14
4,8,5,2,14
4,8,6,2,14
4,8,7,2,14
4,8,8,2,14
4,8,9,2,14
4,8,10,2,14
4,9,0,2,14
4,9,1,2,14
4,9,2,2,14
4,9,3,2,14
4,9,4,2,14
4,9,5,2,14
4,9,6,2,14
4,9,7,2,14
4,9,8,2,14
4,9,9,2,14
4,9,10,2,14
4,10,0,2,14
4,10,1,2,14
4,10,2,2,14
4,10,3,2,14
4,10,4,2,14
4,10,5,2,14
4,10,6,2,14
4,10,7,2,14
4,10,8,2,14
4,10,9,2,14
4,10,10,2,14
4,11,0,2,14
4,11,1,2,14
4,11,2,2,14
4,11,3,2,14
4,11,4,2,14
4,11,5,2,14
4,11,6,2,14
4,11,7,2,14
4,11,8,2,14
4,11,9,2,14
4,11,10,2,14
4,12,0,2,14
4,12,1,2,14
4,12,2,2,14
4,12,3,2,14
4,12,4,2,14
4,12,5,2,14
4,12,6,2,14
4,12,7,2,14
4,12,8,2,14
4,12,9,2,14
4,12,10,2,14
4,13,0,2,14
4,13,1,2,14
4,13,2,2,14
4,13,3,2,14
4,13,4,2,14
4,13,5,2,14
4,13,6,2,14
4,13,7,2,14
4,13,8,2,14
4,13,9,2,14
4,13,10,2,14
4,14,0,2,14
4,14,1,2,14
4,14,2,2,14
4,14,3,2,14
4,14,4,2,14
4,14,5,2,14
4,14,6,2,14
4,14,7,2,14
4,14,8,2,14
4,14,9,2,14
4,14,10,2,14
4,15,0,2,14
4,15,1,2,14
4,15,2,2,14
4,15,3,2,14
4,15,4,2,14
4,15,5,2,14
4,15,6,2,14
4,15,7,2,14
4,15,8,2,14
4,15,9,2,14
4,15,10,2,14
4,16,0,2,14
4,16,1,2,14
4,16,2,2,14
4,16,3,2,14
4,16,4,2,14
4,16,5,2,14
4,16,6,2,14
4,16,7,2,14
4,16,8,2,14
4,16,9,2,14
4,16,10,2,14
4,17,0,2,14
4,17,1,2,14
4,17,2,2,14
4,17,3,2,14
4,17,4,2,14
4,17,5,2,14
4,17,6,2,14
4,17,7,2,14
4,17,8,2,14
4,17,9,2,14
4,17,10,2,14
4,18,0,2,14
4,18,1,2,14
4,18,2,2,14
4,18,3,2,14
4,18,4,2,14
4,18,5,2,14
4,18,6,2,14
4,18,7,2,14
4,18,8,2,14
4,18,9,2,14
4,18,10,2,14
4,0,0,3,14
4,0,1,3,14
4,0,2,3,14
4,0,3,3,14
4,0,4,3,14
4,0,5,3,14
4,0,6,3,14
4,0,7,3,14
4,0,8,3,14
4,0,9,3,14
4,0,10,3,14
4,1,0,3,14
4,1,1,3,14
4,1,2,3,14
4,1,3,3,14
4,1,4,3,14
4,1,5,3,14
4,1,6,3,14
4,1,7,3,14
4,1,8,3,14
4,1,9,3,14
4,1,10,3,14
4,2,0,3,14
4,2,1,3,14
4,2,2,3,14
4,2,3,3,14
4,2,4,3,14
4,2,5,3,14
4,2,6,3,14
4,2,7,3,14
4,2,8,3,14
4,2,9,3,14
4,2,10,3,14
4,3,0,3,14
4,3,1,3,14
4,3,2,3,14
4,3,3,3,14
4,3,4,3,14
4,3,5,3,14
4,3,6,3,14
4,3,7,3,14
4,3,8,3,14
4,3,9,3,14
4,3,10,3,14
4,4,0,3,14
4,4,1,3,14
4,4,2,3,14
4,4,3,3,14
4,4,4,3,14
4,4,5,3,14
4,4,6,3,14
4,4,7,3,14
4,4,8,3,14
4,4,9,3,14
4,4,10,3,14
4,5,0,3,14
4,5,1,3,14
4,5,2,3,14
4,5,3,3,14
4,5,4,3,14
4,5,5,3,14
4,5,6,3,14
4,5,7,3,14
4,5,8,3,14
4,5,9,3,14
4,5,10,3,14
4,6,0,3,14
4,6,1,3,14
4,6,2,3,14
4,6,3,3,14
4,6,4,3,14
4,6,5,3,14
4,6,6,3,14
4,6,7,3,14
4,6,8,3,14
4,6,9,3,14
4,6,10,3,14
4,7,0,3,14
4,7,1,3,14
4,7,2,3,14
4,7,3,3,14
4,7,4,3,14
4,7,5,3,14
4,7,6,3,14
4,7,7,3,14
4,7,8,3,14
4,7,9,3,14
4,7,10,3,14
4,8,0,3,14
4,8,1,3,14
4,8,2,3,14
4,8,3,3,14
4,8,4,3,14
4,8,5,3,14
4,8,6,3,14
4,8,7,3,14
4,8,8,3,14
4,8,9,3,14
4,8,10,3,14
4,9,0,3,14
4,9,1,3,14
4,9,2,3,14
4,9,3,3,14
4,9,4,3,14
4,9,5,3,14
4,9,6,3,14
4,9,7,3,14
4,9,8,3,14
4,9,9,3,14
4,9,10,3,14
4,10,0,3,14
4,10,1,3,14
4,10,2,3,14
4,10,3,3,14
4,10,4,3,14
4,10,5,3,14
4,10,6,3,14
4,10,7,3,14
4,10,8,3,14
4,10,9,3,14
4,10,10,3,14
4,11,0,3,14
4,11,1,3,14
4,11,2,3,14
4,11,3,3,14
4,11,4,3,14
4,11,5,3,14
4,11,6,3,14
4,11,7,3,14
4,11,8,3,14
4,11,9,3,14
4,11,10,3,14
4,12,0,3,14
4,12,1,3,14
4,12,2,3,14
4,12,3,3,14
4,12,4,3,14
4,12,5,3,14
4,12,6,3,14
4,12,7,3,14
4,12,8,3,14
4,12,9,3,14
4,12,10,3,14
4,13,0,3,14
4,13,1,3,14
4,13,2,3,14
4,13,3,3,14
4,13,4,3,14
4,13,5,3,14
4,13,6,3,14
4,13,7,3,14
4,13,8,3,14
4,13,9,3,14
4,13,10,3,14
4,14,0,3,14
4,14,1,3,14
4,14,2,3,14
4,14,3,3,14
4,14,4,3,14
4,14,5,3,14
4,14,6,3,14
4,14,7,3,14
4,14,8,3,14
4,14,9,3,14
4,14,10,3,14
4,15,0,3,14
4,15,1,3,14
4,15,2,3,14
4,15,3,3,14
4,15,4,3,14
4,15,5,3,14
4,15,6,3,14
4,15,7,3,14
4,15,8,3,14
4,15,9,3,14
4,15,10,3,14
4,0,0,4,14
4,0,1,4,14
4,0,2,4,14
4,0,3,4,14
4,0,4,4,14
4,0,5,4,14
4,0,6,4,14
4,0,7,4,14
4,0,8,4,14
4,0,9,4,14
4,0,10,4,14
4,1,0,4,14
4,1,1,4,14
4,1,2,4,14
4,1,3,4,14
4,1,4,4,14
4,1,5,4,14
4,1,6,4,14
4,1,7,4,14
4,1,8,4,14
4,1,9,4,14
4,1,10,4,14
4,2,0,4,14
4,2,1,4,14
4,2,2,4,14
4,2,3,4,14
4,2,4,4,14
4,2,5,4,14
4,2,6,4,14
4,2,7,4,14
4,2,8,4,14
4,2,9,4,14
4,2,10,4,14
4,3,0,4,14
4,3,1,4,14
4,3,2,4,14
4,3,3,4,14
4,3,4,4,14
4,3,5,4,14
4,3,6,4,14
4,3,7,4,14
4,3,8,4,14
4,3,9,4,14
4,3,10,4,14
4,4,0,4,14
4,4,1,4,14
4,4,2,4,14
4,4,3,4,14
4,4,4,4,14
4,4,5,4,14
4,4,6,4,14
4,4,7,4,14
4,4,8,4,14
4,4,9,4,14
4,4,10,4,14
4,5,0,4,14
4,5,1,4,14
4,5,2,4,14
4,5,3,4,14
4,5,4,4,14
4,5,5,4,14
4,5,6,4,14
4,5,7,4,14
4,5,8,4,14
4,5,9,4,14
4,5,10,4,14
4,6,0,4,14
4,6,1,4,14
4,6,2,4,14
4,6,3,4,14
4,6,4,4,14
4,6,5,4,14
4,6,6,4,14
4,6,7,4,14
4,6,8,4,14
4,6,9,4,14
4,6,10,4,14
4,7,0,4,14
4,7,1,4,14
4,7,2,4,14
4,7,3,4,14
4,7,4,4,14
4,7,5,4,14
4,7,6,4,14
4,7,7,4,14
4,7,8,4,14
4,7,9,4,14
4,7,10,4,14
4,8,0,4,14
4,8,1,4,14
4,8,2,4,14
4,8,3,4,14
4,8,4,4,14
4,8,5,4,14
4,8,6,4,14
4,8,7,4,14
4,8,8,4,14
4,8,9,4,14
4,8,10,4,14
4,9,0,4,14
4,9,1,4,14
4,9,2,4,14
4,9,3,4,14
4,9,4,4,14
4,9,5,4,14
4,9,6,4,14
4,9,7,4,14
4,9,8,4,14
4,9,9,4,14
4,9,10,4,14
4,10,0,4,14
4,10,1,4,14
4,10,2,4,14
4,10,3,4,14
4,10,4,4,14
4,10,5,4,14
4,10,6,4,14
4,10,7,4,14
4,10,8,4,14
4,10,9,4,14
4,10,10,4,14
4,11,0,4,14
4,11,1,4,14
4,11,2,4,14
4,11,3,4,14
4,11,4,4,14
4,11,5,4,14
4,11,6,4,14
4,11,7,4,14
4,11,8,4,14
4,11,9,4,14
4,11,10,4,14
4,12,0,4,14
4,12,1,4,14
4,12,2,4,14
4,12,3,4,14
4,12,4,4,14
4,12,5,4,14
4,12,6,4,14
4,12,7,4,14
4,12,8,4,14
4,12,9,4,14
4,12,10,4,14
4,0,0,5,14
4,0,1,5,14
4,0,2,5,14
4,0,3,5,14
4,0,4,5,14
4,0,5,5,14
4,0,6,5,14
4,0,7,5,14
4,0,8,5,14
4,0,9,5,14
4,0,10,5,14
4,1,0,5,14
4,1,1,5,14
4,1,2,5,14
4,1,3,5,14
4,1,4,5,14
4,1,5,5,14
4,1,6,5,14
4,1,7,5,14
4,1,8,5,14
4,1,9,5,14
4,1,10,5,14
4,2,0,5,14
4,2,1,5,14
4,2,2,5,14
4,2,3,5,14
4,2,4,5,14
4,2,5,5,14
4,2,6,5,14
4,2,7,5,14
4,2,8,5,14
4,2,9,5,14
4,2,10,5,14
4,3,0,5,14
4,3,1,5,14
4,3,2,5,14
4,3,3,5,14
4,3,4,5,14
4,3,5,5,14
4,3,6,5,14
4,3,7,5,14
4,3,8,5,14
4,3,9,5,14
4,3,10,5,14
4,4,0,5,14
4,4,1,5,14
4,4,2,5,14
4,4,3,5,14
4,4,4,5,14
4,4,5,5,14
4,4,6,5,14
4,4,7,5,14
4,4,8,5,14
4,4,9,5,14
4,4,10,5,14
4,5,0,5,14
4,5,1,5,14
4,5,2,5,14
4,5,3,5,14
4,5,4,5,14
4,5,5,5,14
4,5,6,5,14
4,5,7,5,14
4,5,8,5,14
4,5,9,5,14
4,5,10,5,14
4,6,0,5,14
4,6,1,5,14
4,6,2,5,14
4,6,3,5,14
4,6,4,5,14
4,6,5,5,14
4,6,6,5,14
4,6,7,5,14
4,6,8,5,14
4,6,9,5,14
4,6,10,5,14
4,7,0,5,14
4,7,1,5,14
4,7,2,5,14
4,7,3,5,14
4,7,4,5,14
4,7,5,5,14
4,7,6,5,14
4,7,7,5,14
4,7,8,5,14
4,7,9,5,14
4,7,10,5,14
4,8,0,5,14
4,8,1,5,14
4,8,2,5,14
4,8,3,5,14
4,8,4,5,14
4,8,5,5,14
4,8,6,5,14
4,8,7,5,14
4,8,8,5,14
4,8,9,5,14
4,8,10,5,14
4,9,0,5,14
4,9,1,5,14
4,9,2,5,14
4,9,3,5,14
4,9,4,5,14
4,9,5,5,14
4,9,6,5,14
4,9,7,5,14
4,9,8,5,14
4,9,9,5,14
4,9,10,5,14
4,0,0,6,14
4,0,1,6,14
4,0,2,6,14
4,0,3,6,14
4,0,4,6,14
4,0,5,6,14
4,0,6,6,14
4,0,7,6,14
4,0,8,6,14
4,0,9,6,14
4,0,10,6,14
4,1,0,6,14
4,1,1,6,14
4,1,2,6,14
4,1,3,6,14
4,1,4,6,14
4,1,5,6,14
4,1,6,6,14
4,1,7,6,14
4,1,8,6,14
4,1,9,6,14
4,1,10,6,14
4,2,0,6,14
4,2,1,6,14
4,2,2,6,14
4,2,3,6,14
4,2,4,6,14
4,2,5,6,14
4,2,6,6,14
4,2,7,6,14
4,2,8,6,14
4,2,9,6,14
4,2,10,6,14
4,3,0,6,14
4,3,1,6,14
4,3,2,6,14
4,3,3,6,14
4,3,4,6,14
4,3,5,6,14
4,3,6,6,14
4,3,7,6,14
4,3,8,6,14
4,3,9,6,14
4,3,10,6,14
4,4,0,6,14
4,4,1,6,14
4,4,2,6,14
4,4,3,6,14
4,4,4,6,14
4,4,5,6,14
4,4,6,6,14
4,4,7,6,14
4,4,8,6,14
4,4,9,6,14
4,4,10,6,14
4,5,0,6,14
4,5,1,6,14
4,5,2,6,14
4,5,3,6,14
4,5,4,6,14
4,5,5,6,14
4,5,6,6,14
4,5,7,6,14
4,5,8,6,14
4,5,9,6,14
4,5,10,6,14
4,6,0,6,14
4,6,1,6,14
4,6,2,6,14
4,6,3,6,14
4,6,4,6,14
4,6,5,6,14
4,6,6,6,14
4,6,7,6,14
4,6,8,6,14
4,6,9,6,14
4,6,10,6,14
4,0,0,7,14
4,0,1,7,14
4,0,2,7,14
4,0,3,7,14
4,0,4,7,14
4,0,5,7,14
4,0,6,7,14
4,0,7,7,14
4,0,8,7,14
4,0,9,7,14
4,0,10,7,14
4,1,0,7,14
4,1,1,7,14
4,1,2,7,14
4,1,3,7,14
4,1,4,7,14
4,1,5,7,14
4,1,6,7,14
4,1,7,7,14
4,1,8,7,14
4,1,9,7,14
4,1,10,7,14
4,2,0,7,14
4,2,1,7,14
4,2,2,7,14
4,2,3,7,14
4,2,4,7,14
4,2,5,7,14
4,2,6,7,14
4,2,7,7,14
4,2,8,7,14
4,2,9,7,14
4,2,10,7,14
4,3,0,7,14
4,3,1,7,14
4,3,2,7,14
4,3,3,7,14
4,3,4,7,14
4,3,5,7,14
4,3,6,7,14
4,3,7,7,14
4,3,8,7,14
4,3,9,7,14
4,3,10,7,14
4,0,0,8,14
4,0,1,8,14
4,0,2,8,14
4,0,3,8,14
4,0,4,8,14
4,0,5,8,14
4,0,6,8,14
4,0,7,8,14
4,0,8,8,14
4,0,9,8,14
4,0,10,8,14
4,0,0,1,15
4,0,1,1,15
4,0,2,1,15
4,0,3,1,15
4,0,4,1,15
4,0,5,1,15
4,0,6,1,15
4,0,7,1,15
4,0,8,1,15
4,0,9,1,15
4,1,0,1,15
4,1,1,1,15
4,1,2,1,15
4,1,3,1,15
4,1,4,1,15
4,1,5,1,15
4,1,6,1,15
4,1,7,1,15
4,1,8,1,15
4,1,9,1,15
4,2,0,1,15
4,2,1,1,15
4,2,2,1,15
4,2,3,1,15
4,2,4,1,15
4,2,5,1,15
4,2,6,1,15
4,2,7,1,15
4,2,8,1,15
4,2,9,1,15
4,3,0,1,15
4,3,1,1,15
4,3,2,1,15
4,3,3,1,15
4,3,4,1,15
4,3,5,1,15
4,3,6,1,15
4,3,7,1,15
4,3,8,1,15
4,3,9,1,15
4,4,0,1,15
4,4,1,1,15
4,4,2,1,15
4,4,3,1,15
4,4,4,1,15
4,4,5,1,15
4,4,6,1,15
4,4,7,1,15
4,4,8,1,15
4,4,9,1,15
4,5,0,1,15
4,5,1,1,15
4,5,2,1,15
4,5,3,1,15
4,5,4,1,15
4,5,5,1,15
4,5,6,1,15
4,5,7,1,15
4,5,8,1,15
4,5,9,1,15
4,6,0,1,15
4,6,1,1,15
4,6,2,1,15
4,6,3,1,15
4,6,4,1,15
4,6,5,1,15
4,6,6,1,15
4,6,7,1,15
4,6,8,1,15
4,6,9,1,15
4,7,0,1,15
4,7,1,1,15
4,7,2,1,15
4,7,3,1,15
4,7,4,1,15
4,7,5,1,15
4,7,6,1,15
4,7,7,1,15
4,7,8,1,15
4,7,9,1,15
4,8,0,1,15
4,8,1,1,15
4,8,2,1,15
4,8,3,1,15
4,8,4,1,15
4,8,5,1,15
4,8,6,1,15
4,8,7,1,15
4,8,8,1,15
4,8,9,1,15
4,9,0,1,15
4,9,1,1,15
4,9,2,1,15
4,9,3,1,15
4,9,4,1,15
4,9,5,1,15
4,9,6,1,15
4,9,7,1,15
4,9,8,1,15
4,9,9,1,15
4,10,0,1,15
4,10,1,1,15
4,10,2,1,15
4,10,3,1,15
4,10,4,1,15
4,10,5,1,15
4,10,6,1,15
4,10,7,1,15
4,10,8,1,15
4,10,9,1,15
4,11,0,1,15
4,11,1,1,15
4,11,2,1,15
4,11,3,1,15
4,11,4,1,15
4,11,5,1,15
4,11,6,1,15
4,11,7,1,15
4,11,8,1,15
4,11,9,1,15
4,12,0,1,15
4,12,1,1,15
4,12,2,1,15
4,12,3,1,15
4,12,4,1,15
4,12,5,1,15
4,12,6,1,15
4,12,7,1,15
4,12,8,1,15
4,12,9,1,15
4,13,0,1,15
4,13,1,1,15
4,13,2,1,15
4,13,3,1,15
4,13,4,1,15
4,13,5,1,15
4,13,6,1,15
4,13,7,1,15
4,13,8,1,15
4,13,9,1,15
4,14,0,1,15
4,14,1,1,15
4,14,2,1,15
4,14,3,1,15
4,14,4,1,15
4,14,5,1,15
4,14,6,1,15
4,14,7,1,15
4,14,8,1,15
4,14,9,1,15
4,15,0,1,15
4,15,1,1,15
4,15,2,1,15
4,15,3,1,15
4,15,4,1,15
4,15,5,1,15
4,15,6,1,15
4,15,7,1,15
4,15,8,1,15
4,15,9,1,15
4,16,0,1,15
4,16,1,1,15
4,16,2,1,15
4,16,3,1,15
4,16,4,1,15
4,16,5,1,15
4,16,6,1,15
4,16,7,1,15
4,16,8,1,15
4,16,9,1,15
4,17,0,1,15
4,17,1,1,15
4,17,2,1,15
4,17,3,1,15
4,17,4,1,15
4,17,5,1,15
4,17,6,1,15
4,17,7,1,15
4,17,8,1,15
4,17,9,1,15
4,18,0,1,15
4,18,1,1,15
4,18,2,1,15
4,18,3,1,15
4,18,4,1,15
4,18,5,1,15
4,18,6,1,15
4,18,7,1,15
4,18,8,1,15
4,18,9,1,15
4,19,0,1,15
4,19,1,1,15
4,19,2,1,15
4,19,3,1,15
4,19,4,1,15
4,19,5,1,15
4,19,6,1,15
4,19,7,1,15
4,19,8,1,15
4,19,9,1,15
4,20,0,1,15
4,20,1,1,15
4,20,2,1,15
4,20,3,1,15
4,20,4,1,15
4,20,5,1,15
4,20,6,1,15
4,20,7,1,15
4,20,8,1,15
4,20,9,1,15
4,21,0,1,15
4,21,1,1,15
4,21,2,1,15
4,21,3,1,15
4,21,4,1,15
4,21,5,1,15
4,21,6,1,15
4,21,7,1,15
4,21,8,1,15
4,21,9,1,15
4,0,0,2,15
4,0,1,2,15
4,0,2,2,15
4,0,3,2,15
4,0,4,2,15
4,0,5,2,15
4,0,6,2,15
4,0,7,2,15
4,0,8,2,15
4,0,9,2,15
4,1,0,2,15
4,1,1,2,15
4,1,2,2,15
4,1,3,2,15
4,1,4,2,15
4,1,5,2,15
4,1,6,2,15
4,1,7,2,15
4,1,8,2,15
4,1,9,2,15
4,2,0,2,15
4,2,1,2,15
4,2,2,2,15
4,2,3,2,15
4,2,4,2,15
4,2,5,2,15
4,2,6,2,15
4,2,7,2,15
4,2,8,2,15
4,2,9,2,15
4,3,0,2,15
4,3,1,2,15
4,3,2,2,15
4,3,3,2,15
4,3,4,2,15
4,3,5,2,15
4,3,6,2,15
4,3,7,2,15
4,3,8,2,15
4,3,9,2,15
4,4,0,2,15
4,4,1,2,15
4,4,2,2,15
4,4,3,2,15
4,4,4,2,15
4,4,5,2,15
4,4,6,2,15
4,4,7,2,15
4,4,8,2,15
4,4,9,2,15
4,5,0,2,15
4,5,1,2,15
4,5,2,2,15
4,5,3,2,15
4,5,4,2,15
4,5,5,2,15
4,5,6,2,15
4,5,7,2,15
4,5,8,2,15
4,5,9,2,15
4,6,0,2,15
4,6,1,2,15
4,6,2,2,15
4,6,3,2,15
4,6,4,2,15
4,6,5,2,15
4,6,6,2,15
4,6,7,2,15
4,6,8,2,15
4,6,9,2,15
4,7,0,2,15
4,7,1,2,15
4,7,2,2,15
4,7,3,2,15
4,7,4,2,15
4,7,5,2,15
4,7,6,2,15
4,7,7,2,15
4,7,8,2,15
4,7,9,2,15
4,8,0,2,15
4,8,1,2,15
4,8,2,2,15
4,8,3,2,15
4,8,4,2,15
4,8,5,2,15
4,8,6,2,15
4,8,7,2,15
4,8,8,2,15
4,8,9,2,15
4,9,0,2,15
4,9,1,2,15
4,9,2,2,15
4,9,3,2,15
4,9,4,2,15
4,9,5,2,15
4,9,6,2,15
4,9,7,2,15
4,9,8,2,15
4,9,9,2,15
4,10,0,2,15
4,10,1,2,15
4,10,2,2,15
4,10,3,2,15
4,10,4,2,15
4,10,5,2,15
4,10,6,2,15
4,10,7,2,15
4,10,8,2,15
4,10,9,2,15
4,11,0,2,15
4,11,1,2,15
4,11,2,2,15
4,11,3,2,15
4,11,4,2,15
4,11,5,2,15
4,11,6,2,15
4,11,7,2,15
4,11,8,2,15
4,11,9,2,15
4,12,0,2,15
4,12,1,2,15
4,12,2,2,15
4,12,3,2,15
4,12,4,2,15
4,12,5,2,15
4,12,6,2,15
4,12,7,2,15
4,12,8,2,15
4,12,9,2,15
4,13,0,2,15
4,13,1,2,15
4,13,2,2,15
4,13,3,2,15
4,13,4,2,15
4,13,5,2,15
4,13,6,2,15
4,13,7,2,15
4,13,8,2,15
4,13,9,2,15
4,14,0,2,15
4,14,1,2,15
4,14,2,2,15
4,14,3,2,15
4,14,4,2,15
4,14,5,2,15
4,14,6,2,15
4,14,7,2,15
4,14,8,2,15
4,14,9,2,15
4,15,0,2,15
4,15,1,2,15
4,15,2,2,15
4,15,3,2,15
4,15,4,2,15
4,15,5,2,15
4,15,6,2,15
4,15,7,2,15
4,15,8,2,15
4,15,9,2,15
4,16,0,2,15
4,16,1,2,15
4,16,2,2,15
4,16,3,2,15
4,16,4,2,15
4,16,5,2,15
4,16,6,2,15
4,16,7,2,15
4,16,8,2,15
4,16,9,2,15
4,17,0,2,15
4,17,1,2,15
4,17,2,2,15
4,17,3,2,15
4,17,4,2,15
4,17,5,2,15
4,17,6,2,15
4,17,7,2,15
4,17,8,2,15
4,17,9,2,15
4,18,0,2,15
4,18,1,2,15
4,18,2,2,15
4,18,3,2,15
4,18,4,2,15
4,18,5,2,15
4,18,6,2,15
4,18,7,2,15
4,18,8,2,15
4,18,9,2,15
4,0,0,3,15
4,0,1,3,15
4,0,2,3,15
4,0,3,3,15
4,0,4,3,15
4,0,5,3,15
4,0,6,3,15
4,0,7,3,15
4,0,8,3,15
4,0,9,3,15
4,1,0,3,15
4,1,1,3,15
4,1,2,3,15
4,1,3,3,15
4,1,4,3,15
4,1,5,3,15
4,1,6,3,15
4,1,7,3,15
4,1,8,3,15
4,1,9,3,15
4,2,0,3,15
4,2,1,3,15
4,2,2,3,15
4,2,3,3,15
4,2,4,3,15
4,2,5,3,15
4,2,6,3,15
4,2,7,3,15
4,2,8,3,15
4,2,9,3,15
4,3,0,3,15
4,3,1,3,15
4,3,2,3,15
4,3,3,3,15
4,3,4,3,15
4,3,5,3,15
4,3,6,3,15
4,3,7,3,15
4,3,8,3,15
4,3,9,3,15
4,4,0,3,15
4,4,1,3,15
4,4,2,3,15
4,4,3,3,15
4,4,4,3,15
4,4,5,3,15
4,4,6,3,15
4,4,7,3,15
4,4,8,3,15
4,4,9,3,15
4,5,0,3,15
4,5,1,3,15
4,5,2,3,15
4,5,3,3,15
4,5,4,3,15
4,5,5,3,15
4,5,6,3,15
4,5,7,3,15
4,5,8,3,15
4,5,9,3,15
4,6,0,3,15
4,6,1,3,15
4,6,2,3,15
4,6,3,3,15
4,6,4,3,15
4,6,5,3,15
4,6,6,3,15
4,6,7,3,15
4,6,8,3,15
4,6,9,3,15
4,7,0,3,15
4,7,1,3,15
4,7,2,3,15
4,7,3,3,15
4,7,4,3,15
4,7,5,3,15
4,7,6,3,15
4,7,7,3,15
4,7,8,3,15
4,7,9,3,15
4,8,0,3,15
4,8,1,3,15
4,8,2,3,15
4,8,3,3,15
4,8,4,3,15
4,8,5,3,15
4,8,6,3,15
4,8,7,3,15
4,8,8,3,15
4,8,9,3,15
4,9,0,3,15
4,9,1,3,15
4,9,2,3,15
4,9,3,3,15
4,9,4,3,15
4,9,5,3,15
4,9,6,3,15
4,9,7,3,15
4,9,8,3,15
4,9,9,3,15
4,10,0,3,15
4,10,1,3,15
4,10,2,3,15
4,10,3,3,15
4,10,4,3,15
4,10,5,3,15
4,10,6,3,15
4,10,7,3,15
4,10,8,3,15
4,10,9,3,15
4,11,0,3,15
4,11,1,3,15
4,11,2,3,15
4,11,3,3,15
4,11,4,3,15
4,11,5,3,15
4,11,6,3,15
4,11,7,3,15
4,11,8,3,15
4,11,9,3,15
4,12,0,3,15
4,12,1,3,15
4,12,2,3,15
4,12,3,3,15
4,12,4,3,15
4,12,5,3,15
4,12,6,3,15
4,12,7,3,15
4,12,8,3,15
4,12,9,3,15
4,13,0,3,15
4,13,1,3,15
4,13,2,3,15
4,13,3,3,15
4,13,4,3,15
4,13,5,3,15
4,13,6,3,15
4,13,7,3,15
4,13,8,3,15
4,13,9,3,15
4,14,0,3,15
4,14,1,3,15
4,14,2,3,15
4,14,3,3,15
4,14,4,3,15
4,14,5,3,15
4,14,6,3,15
4,14,7,3,15
4,14,8,3,15
4,14,9,3,15
4,15,0,3,15
4,15,1,3,15
4,15,2,3,15
4,15,3,3,15
4,15,4,3,15
4,15,5,3,15
4,15,6,3,15
4,15,7,3,15
4,15,8,3,15
4,15,9,3,15
4,0,0,4,15
4,0,1,4,15
4,0,2,4,15
4,0,3,4,15
4,0,4,4,15
4,0,5,4,15
4,0,6,4,15
4,0,7,4,15
4,0,8,4,15
4,0,9,4,15
4,1,0,4,15
4,1,1,4,15
4,1,2,4,15
4,1,3,4,15
4,1,4,4,15
4,1,5,4,15
4,1,6,4,15
4,1,7,4,15
4,1,8,4,15
4,1,9,4,15
4,2,0,4,15
4,2,1,4,15
4,2,2,4,15
4,2,3,4,15
4,2,4,4,15
4,2,5,4,15
4,2,6,4,15
4,2,7,4,15
4,2,8,4,15
4,2,9,4,15
4,3,0,4,15
4,3,1,4,15
4,3,2,4,15
4,3,3,4,15
4,3,4,4,15
4,3,5,4,15
4,3,6,4,15
4,3,7,4,15
4,3,8,4,15
4,3,9,4,15
4,4,0,4,15
4,4,1,4,15
4,4,2,4,15
4,4,3,4,15
4,4,4,4,15
4,4,5,4,15
4,4,6,4,15
4,4,7,4,15
4,4,8,4,15
4,4,9,4,15
4,5,0,4,15
4,5,1,4,15
4,5,2,4,15
4,5,3,4,15
4,5,4,4,15
4,5,5,4,15
4,5,6,4,15
4,5,7,4,15
4,5,8,4,15
4,5,9,4,15
4,6,0,4,15
4,6,1,4,15
4,6,2,4,15
4,6,3,4,15
4,6,4,4,15
4,6,5,4,15
4,6,6,4,15
4,6,7,4,15
4,6,8,4,15
4,6,9,4,15
4,7,0,4,15
4,7,1,4,15
4,7,2,4,15
4,7,3,4,15
4,7,4,4,15
4,7,5,4,15
4,7,6,4,15
4,7,7,4,15
4,7,8,4,15
4,7,9,4,15
4,8,0,4,15
4,8,1,4,15
4,8,2,4,15
4,8,3,4,15
4,8,4,4,15
4,8,5,4,15
4,8,6,4,15
4,8,7,4,15
4,8,8,4,15
4,8,9,4,15
4,9,0,4,15
4,9,1,4,15
4,9,2,4,15
4,9,3,4,15
4,9,4,4,15
4,9,5,4,15
4,9,6,4,15
4,9,7,4,15
4,9,8,4,15
4,9,9,4,15
4,10,0,4,15
4,10,1,4,15
4,10,2,4,15
4,10,3,4,15
4,10,4,4,15
4,10,5,4,15
4,10,6,4,15
4,10,7,4,15
4,10,8,4,15
4,10,9,4,15
4,11,0,4,15
4,11,1,4,15
4,11,2,4,15
4,11,3,4,15
4,11,4,4,15
4,11,5,4,15
4,11,6,4,15
4,11,7,4,15
4,11,8,4,15
4,11,9,4,15
4,12,0,4,15
4,12,1,4,15
4,12,2,4,15
4,12,3,4,15
4,12,4,4,15
4,12,5,4,15
4,12,6,4,15
4,12,7,4,15
4,12,8,4,15
4,12,9,4,15
4,0,0,5,15
4,0,1,5,15
4,0,2,5,15
4,0,3,5,15
4,0,4,5,15
4,0,5,5,15
4,0,6,5,15
4,0,7,5,15
4,0,8,5,15
4,0,9,5,15
4,1,0,5,15
4,1,1,5,15
4,1,2,5,15
4,1,3,5,15
4,1,4,5,15
4,1,5,5,15
4,1,6,5,15
4,1,7,5,15
4,1,8,5,15
4,1,9,5,15
4,2,0,5,15
4,2,1,5,15
4,2,2,5,15
4,2,3,5,15
4,2,4,5,15
4,2,5,5,15
4,2,6,5,15
4,2,7,5,15
4,2,8,5,15
4,2,9,5,15
4,3,0,5,15
4,3,1,5,15
4,3,2,5,15
4,3,3,5,15
4,3,4,5,15
4,3,5,5,15
4,3,6,5,15
4,3,7,5,15
4,3,8,5,15
4,3,9,5,15
4,4,0,5,15
4,4,1,5,15
4,4,2,5,15
4,4,3,5,15
4,4,4,5,15
4,4,5,5,15
4,4,6,5,15
4,4,7,5,15
4,4,8,5,15
4,4,9,5,15
4,5,0,5,15
4,5,1,5,15
4,5,2,5,15
4,5,3,5,15
4,5,4,5,15
4,5,5,5,15
4,5,6,5,15
4,5,7,5,15
4,5,8,5,15
4,5,9,5,15
4,6,0,5,15
4,6,1,5,15
4,6,2,5,15
4,6,3,5,15
4,6,4,5,15
4,6,5,5,15
4,6,6,5,15
4,6,7,5,15
4,6,8,5,15
4,6,9,5,15
4,7,0,5,15
4,7,1,5,15
4,7,2,5,15
4,7,3,5,15
4,7,4,5,15
4,7,5,5,15
4,7,6,5,15
4,7,7,5,15
4,7,8,5,15
4,7,9,5,15
4,8,0,5,15
4,8,1,5,15
4,8,2,5,15
4,8,3,5,15
4,8,4,5,15
4,8,5,5,15
4,8,6,5,15
4,8,7,5,15
4,8,8,5,15
4,8,9,5,15
4,9,0,5,15
4,9,1,5,15
4,9,2,5,15
4,9,3,5,15
4,9,4,5,15
4,9,5,5,15
4,9,6,5,15
4,9,7,5,15
4,9,8,5,15
4,9,9,5,15
4,0,0,6,15
4,0,1,6,15
4,0,2,6,15
4,0,3,6,15
4,0,4,6,15
4,0,5,6,15
4,0,6,6,15
4,0,7,6,15
4,0,8,6,15
4,0,9,6,15
4,1,0,6,15
4,1,1,6,15
4,1,2,6,15
4,1,3,6,15
4,1,4,6,15
4,1,5,6,15
4,1,6,6,15
4,1,7,6,15
4,1,8,6,15
4,1,9,6,15
4,2,0,6,15
4,2,1,6,15
4,2,2,6,15
4,2,3,6,15
4,2,4,6,15
4,2,5,6,15
4,2,6,6,15
4,2,7,6,15
4,2,8,6,15
4,2,9,6,15
4,3,0,6,15
4,3,1,6,15
4,3,2,6,15
4,3,3,6,15
4,3,4,6,15
4,3,5,6,15
4,3,6,6,15
4,3,7,6,15
4,3,8,6,15
4,3,9,6,15
4,4,0,6,15
4,4,1,6,15
4,4,2,6,15
4,4,3,6,15
4,4,4,6,15
4,4,5,6,15
4,4,6,6,15
4,4,7,6,15
4,4,8,6,15
4,4,9,6,15
4,5,0,6,15
4,5,1,6,15
4,5,2,6,15
4,5,3,6,15
4,5,4,6,15
4,5,5,6,15
4,5,6,6,15
4,5,7,6,15
4,5,8,6,15
4,5,9,6,15
4,6,0,6,15
4,6,1,6,15
4,6,2,6,15
4,6,3,6,15
4,6,4,6,15
4,6,5,6,15
4,6,6,6,15
4,6,7,6,15
4,6,8,6,15
4,6,9,6,15
4,0,0,7,15
4,0,1,7,15
4,0,2,7,15
4,0,3,7,15
4,0,4,7,15
4,0,5,7,15
4,0,6,7,15
4,0,7,7,15
4,0,8,7,15
4,0,9,7,15
4,1,0,7,15
4,1,1,7,15
4,1,2,7,15
4,1,3,7,15
4,1,4,7,15
4,1,5,7,15
4,1,6,7,15
4,1,7,7,15
4,1,8,7,15
4,1,9,7,15
4,2,0,7,15
4,2,1,7,15
4,2,2,7,15
4,2,3,7,15
4,2,4,7,15
4,2,5,7,15
4,2,6,7,15
4,2,7,7,15
4,2,8,7,15
4,2,9,7,15
4,3,0,7,15
4,3,1,7,15
4,3,2,7,15
4,3,3,7,15
4,3,4,7,15
4,3,5,7,15
4,3,6,7,15
4,3,7,7,15
4,3,8,7,15
4,3,9,7,15
4,0,0,8,15
4,0,1,8,15
4,0,2,8,15
4,0,3,8,15
4,0,4,8,15
4,0,5,8,15
4,0,6,8,15
4,0,7,8,15
4,0,8,8,15
4,0,9,8,15
4,0,0,1,16
4,0,1,1,16
4,0,2,1,16
4,0,3,1,16
4,0,4,1,16
4,0,5,1,16
4,0,6,1,16
4,0,7,1,16
4,0,8,1,16
4,1,0,1,16
4,1,1,1,16
4,1,2,1,16
4,1,3,1,16
4,1,4,1,16
4,1,5,1,16
4,1,6,1,16
4,1,7,1,16
4,1,8,1,16
4,2,0,1,16
4,2,1,1,16
4,2,2,1,16
4,2,3,1,16
4,2,4,1,16
4,2,5,1,16
4,2,6,1,16
4,2,7,1,16
4,2,8,1,16
4,3,0,1,16
4,3,1,1,16
4,3,2,1,16
4,3,3,1,16
4,3,4,1,16
4,3,5,1,16
4,3,6,1,16
4,3,7,1,16
4,3,8,1,16
4,4,0,1,16
4,4,1,1,16
4,4,2,1,16
4,4,3,1,16
4,4,4,1,16
4,4,5,1,16
4,4,6,1,16
4,4,7,1,16
4,4,8,1,16
4,5,0,1,16
4,5,1,1,16
4,5,2,1,16
4,5,3,1,16
4,5,4,1,16
4,5,5,1,16
4,5,6,1,16
4,5,7,1,16
4,5,8,1,16
4,6,0,1,16
4,6,1,1,16
4,6,2,1,16
4,6,3,1,16
4,6,4,1,16
4,6,5,1,16
4,6,6,1,16
4,6,7,1,16
4,6,8,1,16
4,7,0,1,16
4,7,1,1,16
4,7,2,1,16
4,7,3,1,16
4,7,4,1,16
4,7,5,1,16
4,7,6,1,16
4,7,7,1,16
4,7,8,1,16
4,8,0,1,16
4,8,1,1,16
4,8,2,1,16
4,8,3,1,16
4,8,4,1,16
4,8,5,1,16
4,8,6,1,16
4,8,7,1,16
4,8,8,1,16
4,9,0,1,16
4,9,1,1,16
4,9,2,1,16
4,9,3,1,16
4,9,4,1,16
4,9,5,1,16
4,9,6,1,16
4,9,7,1,16
4,9,8,1,16
4,10,0,1,16
4,10,1,1,16
4,10,2,1,16
4,10,3,1,16
4,10,4,1,16
4,10,5,1,16
4,10,6,1,16
4,10,7,1,16
4,10,8,1,16
4,11,0,1,16
4,11,1,1,16
4,11,2,1,16
4,11,3,1,16
4,11,4,1,16
4,11,5,1,16
4,11,6,1,16
4,11,7,1,16
4,11,8,1,16
4,12,0,1,16
4,12,1,1,16
4,12,2,1,16
4,12,3,1,16
4,12,4,1,16
4,12,5,1,16
4,12,6,1,16
4,12,7,1,16
4,12,8,1,16
4,13,0,1,16
4,13,1,1,16
4,13,2,1,16
4,13,3,1,16
4,13,4,1,16
4,13,5,1,16
4,13,6,1,16
4,13,7,1,16
4,13,8,1,16
4,14,0,1,16
4,14,1,1,16
4,14,2,1,16
4,14,3,1,16
4,14,4,1,16
4,14,5,1,16
4,14,6,1,16
4,14,7,1,16
4,14,8,1,16
4,15,0,1,16
4,15,1,1,16
4,15,2,1,16
4,15,3,1,16
4,15,4,1,16
4,15,5,1,16
4,15,6,1,16
4,15,7,1,16
4,15,8,1,16
4,16,0,1,16
4,16,1,1,16
4,16,2,1,16
4,16,3,1,16
4,16,4,1,16
4,16,5,1,16
4,16,6,1,16
4,16,7,1,16
4,16,8,1,16
4,17,0,1,16
4,17,1,1,16
4,17,2,1,16
4,17,3,1,16
4,17,4,1,16
4,17,5,1,16
4,17,6,1,16
4,17,7,1,16
4,17,8,1,16
4,18,0,1,16
4,18,1,1,16
4,18,2,1,16
4,18,3,1,16
4,18,4,1,16
4,18,5,1,16
4,18,6,1,16
4,18,7,1,16
4,18,8,1,16
4,19,0,1,16
4,19,1,1,16
4,19,2,1,16
4,19,3,1,16
4,19,4,1,16
4,19,5,1,16
4,19,6,1,16
4,19,7,1,16
4,19,8,1,16
4,20,0,1,16
4,20,1,1,16
4,20,2,1,16
4,20,3,1,16
4,20,4,1,16
4,20,5,1,16
4,20,6,1,16
4,20,7,1,16
4,20,8,1,16
4,21,0,1,16
4,21,1,1,16
4,21,2,1,16
4,21,3,1,16
4,21,4,1,16
4,21,5,1,16
4,21,6,1,16
4,21,7,1,16
4,21,8,1,16
4,0,0,2,16
4,0,1,2,16
4,0,2,2,16
4,0,3,2,16
4,0,4,2,16
4,0,5,2,16
4,0,6,2,16
4,0,7,2,16
4,0,8,2,16
4,1,0,2,16
4,1,1,2,16
4,1,2,2,16
4,1,3,2,16
4,1,4,2,16
4,1,5,2,16
4,1,6,2,16
4,1,7,2,16
4,1,8,2,16
4,2,0,2,16
4,2,1,2,16
4,2,2,2,16
4,2,3,2,16
4,2,4,2,16
4,2,5,2,16
4,2,6,2,16
4,2,7,2,16
4,2,8,2,16
4,3,0,2,16
4,3,1,2,16
4,3,2,2,16
4,3,3,2,16
4,3,4,2,16
4,3,5,2,16
4,3,6,2,16
4,3,7,2,16
4,3,8,2,16
4,4,0,2,16
4,4,1,2,16
4,4,2,2,16
4,4,3,2,16
4,4,4,2,16
4,4,5,2,16
4,4,6,2,16
4,4,7,2,16
4,4,8,2,16
4,5,0,2,16
4,5,1,2,16
4,5,2,2,16
4,5,3,2,16
4,5,4,2,16
4,5,5,2,16
4,5,6,2,16
4,5,7,2,16
4,5,8,2,16
4,6,0,2,16
4,6,1,2,16
4,6,2,2,16
4,6,3,2,16
4,6,4,2,16
4,6,5,2,16
4,6,6,2,16
4,6,7,2,16
4,6,8,2,16
4,7,0,2,16
4,7,1,2,16
4,7,2,2,16
4,7,3,2,16
4,7,4,2,16
4,7,5,2,16
4,7,6,2,16
4,7,7,2,16
4,7,8,2,16
4,8,0,2,16
4,8,1,2,16
4,8,2,2,16
4,8,3,2,16
4,8,4,2,16
4,8,5,2,16
4,8,6,2,16
4,8,7,2,16
4,8,8,2,16
4,9,0,2,16
4,9,1,2,16
4,9,2,2,16
4,9,3,2,16
4,9,4,2,16
4,9,5,2,16
4,9,6,2,16
4,9,7,2,16
4,9,8,2,16
4,10,0,2,16
4,10,1,2,16
4,10,2,2,16
4,10,3,2,16
4,10,4,2,16
4,10,5,2,16
4,10,6,2,16
4,10,7,2,16
4,10,8,2,16
4,11,0,2,16
4,11,1,2,16
4,11,2,2,16
4,11,3,2,16
4,11,4,2,16
4,11,5,2,16
4,11,6,2,16
4,11,7,2,16
4,11,8,2,16
4,12,0,2,16
4,12,1,2,16
4,12,2,2,16
4,12,3,2,16
4,12,4,2,16
4,12,5,2,16
4,12,6,2,16
4,12,7,2,16
4,12,8,2,16
4,13,0,2,16
4,13,1,2,16
4,13,2,2,16
4,13,3,2,16
4,13,4,2,16
4,13,5,2,16
4,13,6,2,16
4,13,7,2,16
4,13,8,2,16
4,14,0,2,16
4,14,1,2,16
4,14,2,2,16
4,14,3,2,16
4,14,4,2,16
4,14,5,2,16
4,14,6,2,16
4,14,7,2,16
4,14,8,2,16
4,15,0,2,16
4,15,1,2,16
4,15,2,2,16
4,15,3,2,16
4,15,4,2,16
4,15,5,2,16
4,15,6,2,16
4,15,7,2,16
4,15,8,2,16
4,16,0,2,16
4,16,1,2,16
4,16,2,2,16
4,16,3,2,16
4,16,4,2,16
4,16,5,2,16
4,16,6,2,16
4,16,7,2,16
4,16,8,2,16
4,17,0,2,16
4,17,1,2,16
4,17,2,2,16
4,17,3,2,16
4,17,4,2,16
4,17,5,2,16
4,17,6,2,16
4,17,7,2,16
4,17,8,2,16
4,18,0,2,16
4,18,1,2,16
4,18,2,2,16
4,18,3,2,16
4,18,4,2,16
4,18,5,2,16
4,18,6,2,16
4,18,7,2,16
4,18,8,2,16
4,0,0,3,16
4,0,1,3,16
4,0,2,3,16
4,0,3,3,16
4,0,4,3,16
4,0,5,3,16
4,0,6,3,16
4,0,7,3,16
4,0,8,3,16
4,1,0,3,16
4,1,1,3,16
4,1,2,3,16
4,1,3,3,16
4,1,4,3,16
4,1,5,3,16
4,1,6,3,16
4,1,7,3,16
4,1,8,3,16
4,2,0,3,16
4,2,1,3,16
4,2,2,3,16
4,2,3,3,16
4,2,4,3,16
4,2,5,3,16
4,2,6,3,16
4,2,7,3,16
4,2,8,3,16
4,3,0,3,16
4,3,1,3,16
4,3,2,3,16
4,3,3,3,16
4,3,4,3,16
4,3,5,3,16
4,3,6,3,16
4,3,7,3,16
4,3,8,3,16
4,4,0,3,16
4,4,1,3,16
4,4,2,3,16
4,4,3,3,16
4,4,4,3,16
4,4,5,3,16
4,4,6,3,16
4,4,7,3,16
4,4,8,3,16
4,5,0,3,16
4,5,1,3,16
4,5,2,3,16
4,5,3,3,16
4,5,4,3,16
4,5,5,3,16
4,5,6,3,16
4,5,7,3,16
4,5,8,3,16
4,6,0,3,16
4,6,1,3,16
4,6,2,3,16
4,6,3,3,16
4,6,4,3,16
4,6,5,3,16
4,6,6,3,16
4,6,7,3,16
4,6,8,3,16
4,7,0,3,16
4,7,1,3,16
4,7,2,3,16
4,7,3,3,16
4,7,4,3,16
4,7,5,3,16
4,7,6,3,16
4,7,7,3,16
4,7,8,3,16
4,8,0,3,16
4,8,1,3,16
4,8,2,3,16
4,8,3,3,16
4,8,4,3,16
4,8,5,3,16
4,8,6,3,16
4,8,7,3,16
4,8,8,3,16
4,9,0,3,16
4,9,1,3,16
4,9,2,3,16
4,9,3,3,16
4,9,4,3,16
4,9,5,3,16
4,9,6,3,16
4,9,7,3,16
4,9,8,3,16
4,10,0,3,16
4,10,1,3,16
4,10,2,3,16
4,10,3,3,16
4,10,4,3,16
4,10,5,3,16
4,10,6,3,16
4,10,7,3,16
4,10,8,3,16
4,11,0,3,16
4,11,1,3,16
4,11,2,3,16
4,11,3,3,16
4,11,4,3,16
4,11,5,3,16
4,11,6,3,16
4,11,7,3,16
4,11,8,3,16
4,12,0,3,16
4,12,1,3,16
4,12,2,3,16
4,12,3,3,16
4,12,4,3,16
4,12,5,3,16
4,12,6,3,16
4,12,7,3,16
4,12,8,3,16
4,13,0,3,16
4,13,1,3,16
4,13,2,3,16
4,13,3,3,16
4,13,4,3,16
4,13,5,3,16
4,13,6,3,16
4,13,7,3,16
4,13,8,3,16
4,14,0,3,16
4,14,1,3,16
4,14,2,3,16
4,14,3,3,16
4,14,4,3,16
4,14,5,3,16
4,14,6,3,16
4,14,7,3,16
4,14,8,3,16
4,15,0,3,16
4,15,1,3,16
4,15,2,3,16
4,15,3,3,16
4,15,4,3,16
4,15,5,3,16
4,15,6,3,16
4,15,7,3,16
4,15,8,3,16
4,0,0,4,16
4,0,1,4,16
4,0,2,4,16
4,0,3,4,16
4,0,4,4,16
4,0,5,4,16
4,0,6,4,16
4,0,7,4,16
4,0,8,4,16
4,1,0,4,16
4,1,1,4,16
4,1,2,4,16
4,1,3,4,16
4,1,4,4,16
4,1,5,4,16
4,1,6,4,16
4,1,7,4,16
4,1,8,4,16
4,2,0,4,16
4,2,1,4,16
4,2,2,4,16
4,2,3,4,16
4,2,4,4,16
4,2,5,4,16
4,2,6,4,16
4,2,7,4,16
4,2,8,4,16
4,3,0,4,16
4,3,1,4,16
4,3,2,4,16
4,3,3,4,16
4,3,4,4,16
4,3,5,4,16
4,3,6,4,16
4,3,7,4,16
4,3,8,4,16
4,4,0,4,16
4,4,1,4,16
4,4,2,4,16
4,4,3,4,16
4,4,4,4,16
4,4,5,4,16
4,4,6,4,16
4,4,7,4,16
4,4,8,4,16
4,5,0,4,16
4,5,1,4,16
4,5,2,4,16
4,5,3,4,16
4,5,4,4,16
4,5,5,4,16
4,5,6,4,16
4,5,7,4,16
4,5,8,4,16
4,6,0,4,16
4,6,1,4,16
4,6,2,4,16
4,6,3,4,16
4,6,4,4,16
4,6,5,4,16
4,6,6,4,16
4,6,7,4,16
4,6,8,4,16
4,7,0,4,16
4,7,1,4,16
4,7,2,4,16
4,7,3,4,16
4,7,4,4,16
4,7,5,4,16
4,7,6,4,16
4,7,7,4,16
4,7,8,4,16
4,8,0,4,16
4,8,1,4,16
4,8,2,4,16
4,8,3,4,16
4,8,4,4,16
4,8,5,4,16
4,8,6,4,16
4,8,7,4,16
4,8,8,4,16
4,9,0,4,16
4,9,1,4,16
4,9,2,4,16
4,9,3,4,16
4,9,4,4,16
4,9,5,4,16
4,9,6,4,16
4,9,7,4,16
4,9,8,4,16
4,10,0,4,16
4,10,1,4,16
4,10,2,4,16
4,10,3,4,16
4,10,4,4,16
4,10,5,4,16
4,10,6,4,16
4,10,7,4,16
4,10,8,4,16
4,11,0,4,16
4,11,1,4,16
4,11,2,4,16
4,11,3,4,16
4,11,4,4,16
4,11,5,4,16
4,11,6,4,16
4,11,7,4,16
4,11,8,4,16
4,12,0,4,16
4,12,1,4,16
4,12,2,4,16
4,12,3,4,16
4,12,4,4,16
4,12,5,4,16
4,12,6,4,16
4,12,7,4,16
4,12,8,4,16
4,0,0,5,16
4,0,1,5,16
4,0,2,5,16
4,0,3,5,16
4,0,4,5,16
4,0,5,5,16
4,0,6,5,16
4,0,7,5,16
4,0,8,5,16
4,1,0,5,16
4,1,1,5,16
4,1,2,5,16
4,1,3,5,16
4,1,4,5,16
4,1,5,5,16
4,1,6,5,16
4,1,7,5,16
4,1,8,5,16
4,2,0,5,16
4,2,1,5,16
4,2,2,5,16
4,2,3,5,16
4,2,4,5,16
4,2,5,5,16
4,2,6,5,16
4,2,7,5,16
4,2,8,5,16
4,3,0,5,16
4,3,1,5,16
4,3,2,5,16
4,3,3,5,16
4,3,4,5,16
4,3,5,5,16
4,3,6,5,16
4,3,7,5,16
4,3,8,5,16
4,4,0,5,16
4,4,1,5,16
4,4,2,5,16
4,4,3,5,16
4,4,4,5,16
4,4,5,5,16
4,4,6,5,16
4,4,7,5,16
4,4,8,5,16
4,5,0,5,16
4,5,1,5,16
4,5,2,5,16
4,5,3,5,16
4,5,4,5,16
4,5,5,5,16
4,5,6,5,16
4,5,7,5,16
4,5,8,5,16
4,6,0,5,16
4,6,1,5,16
4,6,2,5,16
4,6,3,5,16
4,6,4,5,16
4,6,5,5,16
4,6,6,5,16
4,6,7,5,16
4,6,8,5,16
4,7,0,5,16
4,7,1,5,16
4,7,2,5,16
4,7,3,5,16
4,7,4,5,16
4,7,5,5,16
4,7,6,5,16
4,7,7,5,16
4,7,8,5,16
4,8,0,5,16
4,8,1,5,16
4,8,2,5,16
4,8,3,5,16
4,8,4,5,16
4,8,5,5,16
4,8,6,5,16
4,8,7,5,16
4,8,8,5,16
4,9,0,5,16
4,9,1,5,16
4,9,2,5,16
4,9,3,5,16
4,9,4,5,16
4,9,5,5,16
4,9,6,5,16
4,9,7,5,16
4,9,8,5,16
4,0,0,6,16
4,0,1,6,16
4,0,2,6,16
4,0,3,6,16
4,0,4,6,16
4,0,5,6,16
4,0,6,6,16
4,0,7,6,16
4,0,8,6,16
4,1,0,6,16
4,1,1,6,16
4,1,2,6,16
4,1,3,6,16
4,1,4,6,16
4,1,5,6,16
4,1,6,6,16
4,1,7,6,16
4,1,8,6,16
4,2,0,6,16
4,2,1,6,16
4,2,2,6,16
4,2,3,6,16
4,2,4,6,16
4,2,5,6,16
4,2,6,6,16
4,2,7,6,16
4,2,8,6,16
4,3,0,6,16
4,3,1,6,16
4,3,2,6,16
4,3,3,6,16
4,3,4,6,16
4,3,5,6,16
4,3,6,6,16
4,3,7,6,16
4,3,8,6,16
4,4,0,6,16
4,4,1,6,16
4,4,2,6,16
4,4,3,6,16
4,4,4,6,16
4,4,5,6,16
4,4,6,6,16
4,4,7,6,16
4,4,8,6,16
4,5,0,6,16
4,5,1,6,16
4,5,2,6,16
4,5,3,6,16
4,5,4,6,16
4,5,5,6,16
4,5,6,6,16
4,5,7,6,16
4,5,8,6,16
4,6,0,6,16
4,6,1,6,16
4,6,2,6,16
4,6,3,6,16
4,6,4,6,16
4,6,5,6,16
4,6,6,6,16
4,6,7,6,16
4,6,8,6,16
4,0,0,7,16
4,0,1,7,16
4,0,2,7,16
4,0,3,7,16
4,0,4,7,16
4,0,5,7,16
4,0,6,7,16
4,0,7,7,16
4,0,8,7,16
4,1,0,7,16
4,1,1,7,16
4,1,2,7,16
4,1,3,7,16
4,1,4,7,16
4,1,5,7,16
4,1,6,7,16
4,1,7,7,16
4,1,8,7,16
4,2,0,7,16
4,2,1,7,16
4,2,2,7,16
4,2,3,7,16
4,2,4,7,16
4,2,5,7,16
4,2,6,7,16
4,2,7,7,16
4,2,8,7,16
4,3,0,7,16
4,3,1,7,16
4,3,2,7,16
4,3,3,7,16
4,3,4,7,16
4,3,5,7,16
4,3,6,7,16
4,3,7,7,16
4,3,8,7,16
4,0,0,8,16
4,0,1,8,16
4,0,2,8,16
4,0,3,8,16
4,0,4,8,16
4,0,5,8,16
4,0,6,8,16
4,0,7,8,16
4,0,8,8,16
4,0,0,1,17
4,0,1,1,17
4,0,2,1,17
4,0,3,1,17
4,0,4,1,17
4,0,5,1,17
4,0,6,1,17
4,0,7,1,17
4,1,0,1,17
4,1,1,1,17
4,1,2,1,17
4,1,3,1,17
4,1,4,1,17
4,1,5,1,17
4,1,6,1,17
4,1,7,1,17
4,2,0,1,17
4,2,1,1,17
4,2,2,1,17
4,2,3,1,17
4,2,4,1,17
4,2,5,1,17
4,2,6,1,17
4,2,7,1,17
4,3,0,1,17
4,3,1,1,17
4,3,2,1,17
4,3,3,1,17
4,3,4,1,17
4,3,5,1,17
4,3,6,1,17
4,3,7,1,17
4,4,0,1,17
4,4,1,1,17
4,4,2,1,17
4,4,3,1,17
4,4,4,1,17
4,4,5,1,17
4,4,6,1,17
4,4,7,1,17
4,5,0,1,17
4,5,1,1,17
4,5,2,1,17
4,5,3,1,17
4,5,4,1,17
4,5,5,1,17
4,5,6,1,17
4,5,7,1,17
4,6,0,1,17
4,6,1,1,17
4,6,2,1,17
4,6,3,1,17
4,6,4,1,17
4,6,5,1,17
4,6,6,1,17
4,6,7,1,17
4,7,0,1,17
4,7,1,1,17
4,7,2,1,17
4,7,3,1,17
4,7,4,1,17
4,7,5,1,17
4,7,6,1,17
4,7,7,1,17
4,8,0,1,17
4,8,1,1,17
4,8,2,1,17
4,8,3,1,17
4,8,4,1,17
4,8,5,1,17
4,8,6,1,17
4,8,7,1,17
4,9,0,1,17
4,9,1,1,17
4,9,2,1,17
4,9,3,1,17
4,9,4,1,17
4,9,5,1,17
4,9,6,1,17
4,9,7,1,17
4,10,0,1,17
4,10,1,1,17
4,10,2,1,17
4,10,3,1,17
4,10,4,1,17
4,10,5,1,17
4,10,6,1,17
4,10,7,1,17
4,11,0,1,17
4,11,1,1,17
4,11,2,1,17
4,11,3,1,17
4,11,4,1,17
4,11,5,1,17
4,11,6,1,17
4,11,7,1,17
4,12,0,1,17
4,12,1,1,17
4,12,2,1,17
4,12,3,1,17
4,12,4,1,17
4,12,5,1,17
4,12,6,1,17
4,12,7,1,17
4,13,0,1,17
4,13,1,1,17
4,13,2,1,17
4,13,3,1,17
4,13,4,1,17
4,13,5,1,17
4,13,6,1,17
4,13,7,1,17
4,14,0,1,17
4,14,1,1,17
4,14,2,1,17
4,14,3,1,17
4,14,4,1,17
4,14,5,1,17
4,14,6,1,17
4,14,7,1,17
4,15,0,1,17
4,15,1,1,17
4,15,2,1,17
4,15,3,1,17
4,15,4,1,17
4,15,5,1,17
4,15,6,1,17
4,15,7,1,17
4,16,0,1,17
4,16,1,1,17
4,16,2,1,17
4,16,3,1,17
4,16,4,1,17
4,16,5,1,17
4,16,6,1,17
4,16,7,1,17
4,17,0,1,17
4,17,1,1,17
4,17,2,1,17
4,17,3,1,17
4,17,4,1,17
4,17,5,1,17
4,17,6,1,17
4,17,7,1,17
4,18,0,1,17
4,18,1,1,17
4,18,2,1,17
4,18,3,1,17
4,18,4,1,17
4,18,5,1,17
4,18,6,1,17
4,18,7,1,17
4,19,0,1,17
4,19,1,1,17
4,19,2,1,17
4,19,3,1,17
4,19,4,1,17
4,19,5,1,17
4,19,6,1,17
4,19,7,1,17
4,20,0,1,17
4,20,1,1,17
4,20,2,1,17
4,20,3,1,17
4,20,4,1,17
4,20,5,1,17
4,20,6,1,17
4,20,7,1,17
4,21,0,1,17
4,21,1,1,17
4,21,2,1,17
4,21,3,1,17
4,21,4,1,17
4,21,5,1,17
4,21,6,1,17
4,21,7,1,17
4,0,0,2,17
4,0,1,2,17
4,0,2,2,17
4,0,3,2,17
4,0,4,2,17
4,0,5,2,17
4,0,6,2,17
4,0,7,2,17
4,1,0,2,17
4,1,1,2,17
4,1,2,2,17
4,1,3,2,17
4,1,4,2,17
4,1,5,2,17
4,1,6,2,17
4,1,7,2,17
4,2,0,2,17
4,2,1,2,17
4,2,2,2,17
4,2,3,2,17
4,2,4,2,17
4,2,5,2,17
4,2,6,2,17
4,2,7,2,17
4,3,0,2,17
4,3,1,2,17
4,3,2,2,17
4,3,3,2,17
4,3,4,2,17
4,3,5,2,17
4,3,6,2,17
4,3,7,2,17
4,4,0,2,17
4,4,1,2,17
4,4,2,2,17
4,4,3,2,17
4,4,4,2,17
4,4,5,2,17
4,4,6,2,17
4,4,7,2,17
4,5,0,2,17
4,5,1,2,17
4,5,2,2,17
4,5,3,2,17
4,5,4,2,17
4,5,5,2,17
4,5,6,2,17
4,5,7,2,17
4,6,0,2,17
4,6,1,2,17
4,6,2,2,17
4,6,3,2,17
4,6,4,2,17
4,6,5,2,17
4,6,6,2,17
4,6,7,2,17
4,7,0,2,17
4,7,1,2,17
4,7,2,2,17
4,7,3,2,17
4,7,4,2,17
4,7,5,2,17
4,7,6,2,17
4,7,7,2,17
4,8,0,2,17
4,8,1,2,17
4,8,2,2,17
4,8,3,2,17
4,8,4,2,17
4,8,5,2,17
4,8,6,2,17
4,8,7,2,17
4,9,0,2,17
4,9,1,2,17
4,9,2,2,17
4,9,3,2,17
4,9,4,2,17
4,9,5,2,17
4,9,6,2,17
4,9,7,2,17
4,10,0,2,17
4,10,1,2,17
4,10,2,2,17
4,10,3,2,17
4,10,4,2,17
4,10,5,2,17
4,10,6,2,17
4,10,7,2,17
4,11,0,2,17
4,11,1,2,17
4,11,2,2,17
4,11,3,2,17
4,11,4,2,17
4,11,5,2,17
4,11,6,2,17
4,11,7,2,17
4,12,0,2,17
4,12,1,2,17
4,12,2,2,17
4,12,3,2,17
4,12,4,2,17
4,12,5,2,17
4,12,6,2,17
4,12,7,2,17
4,13,0,2,17
4,13,1,2,17
4,13,2,2,17
4,13,3,2,17
4,13,4,2,17
4,13,5,2,17
4,13,6,2,17
4,13,7,2,17
4,14,0,2,17
4,14,1,2,17
4,14,2,2,17
4,14,3,2,17
4,14,4,2,17
4,14,5,2,17
4,14,6,2,17
4,14,7,2,17
4,15,0,2,17
4,15,1,2,17
4,15,2,2,17
4,15,3,2,17
4,15,4,2,17
4,15,5,2,17
4,15,6,2,17
4,15,7,2,17
4,16,0,2,17
4,16,1,2,17
4,16,2,2,17
4,16,3,2,17
4,16,4,2,17
4,16,5,2,17
4,16,6,2,17
4,16,7,2,17
4,17,0,2,17
4,17,1,2,17
4,17,2,2,17
4,17,3,2,17
4,17,4,2,17
4,17,5,2,17
4,17,6,2,17
4,17,7,2,17
4,18,0,2,17
4,18,1,2,17
4,18,2,2,17
4,18,3,2,17
4,18,4,2,17
4,18,5,2,17
4,18,6,2,17
4,18,7,2,17
4,0,0,3,17
4,0,1,3,17
4,0,2,3,17
4,0,3,3,17
4,0,4,3,17
4,0,5,3,17
4,0,6,3,17
4,0,7,3,17
4,1,0,3,17
4,1,1,3,17
4,1,2,3,17
4,1,3,3,17
4,1,4,3,17
4,1,5,3,17
4,1,6,3,17
4,1,7,3,17
4,2,0,3,17
4,2,1,3,17
4,2,2,3,17
4,2,3,3,17
4,2,4,3,17
4,2,5,3,17
4,2,6,3,17
4,2,7,3,17
4,3,0,3,17
4,3,1,3,17
4,3,2,3,17
4,3,3,3,17
4,3,4,3,17
4,3,5,3,17
4,3,6,3,17
4,3,7,3,17
4,4,0,3,17
4,4,1,3,17
4,4,2,3,17
4,4,3,3,17
4,4,4,3,17
4,4,5,3,17
4,4,6,3,17
4,4,7,3,17
4,5,0,3,17
4,5,1,3,17
4,5,2,3,17
4,5,3,3,17
4,5,4,3,17
4,5,5,3,17
4,5,6,3,17
4,5,7,3,17
4,6,0,3,17
4,6,1,3,17
4,6,2,3,17
4,6,3,3,17
4,6,4,3,17
4,6,5,3,17
4,6,6,3,17
4,6,7,3,17
4,7,0,3,17
4,7,1,3,17
4,7,2,3,17
4,7,3,3,17
4,7,4,3,17
4,7,5,3,17
4,7,6,3,17
4,7,7,3,17
4,8,0,3,17
4,8,1,3,17
4,8,2,3,17
4,8,3,3,17
4,8,4,3,17
4,8,5,3,17
4,8,6,3,17
4,8,7,3,17
4,9,0,3,17
4,9,1,3,17
4,9,2,3,17
4,9,3,3,17
4,9,4,3,17
4,9,5,3,17
4,9,6,3,17
4,9,7,3,17
4,10,0,3,17
4,10,1,3,17
4,10,2,3,17
4,10,3,3,17
4,10,4,3,17
4,10,5,3,17
4,10,6,3,17
4,10,7,3,17
4,11,0,3,17
4,11,1,3,17
4,11,2,3,17
4,11,3,3,17
4,11,4,3,17
4,11,5,3,17
4,11,6,3,17
4,11,7,3,17
4,12,0,3,17
4,12,1,3,17
4,12,2,3,17
4,12,3,3,17
4,12,4,3,17
4,12,5,3,17
4,12,6,3,17
4,12,7,3,17
4,13,0,3,17
4,13,1,3,17
4,13,2,3,17
4,13,3,3,17
4,13,4,3,17
4,13,5,3,17
4,13,6,3,17
4,13,7,3,17
4,14,0,3,17
4,14,1,3,17
4,14,2,3,17
4,14,3,3,17
4,14,4,3,17
4,14,5,3,17
4,14,6,3,17
4,14,7,3,17
4,15,0,3,17
4,15,1,3,17
4,15,2,3,17
4,15,3,3,17
4,15,4,3,17
4,15,5,3,17
4,15,6,3,17
4,15,7,3,17
4,0,0,4,17
4,0,1,4,17
4,0,2,4,17
4,0,3,4,17
4,0,4,4,17
4,0,5,4,17
4,0,6,4,17
4,0,7,4,17
4,1,0,4,17
4,1,1,4,17
4,1,2,4,17
4,1,3,4,17
4,1,4,4,17
4,1,5,4,17
4,1,6,4,17
4,1,7,4,17
4,2,0,4,17
4,2,1,4,17
4,2,2,4,17
4,2,3,4,17
4,2,4,4,17
4,2,5,4,17
4,2,6,4,17
4,2,7,4,17
4,3,0,4,17
4,3,1,4,17
4,3,2,4,17
4,3,3,4,17
4,3,4,4,17
4,3,5,4,17
4,3,6,4,17
4,3,7,4,17
4,4,0,4,17
4,4,1,4,17
4,4,2,4,17
4,4,3,4,17
4,4,4,4,17
4,4,5,4,17
4,4,6,4,17
4,4,7,4,17
4,5,0,4,17
4,5,1,4,17
4,5,2,4,17
4,5,3,4,17
4,5,4,4,17
4,5,5,4,17
4,5,6,4,17
4,5,7,4,17
4,6,0,4,17
4,6,1,4,17
4,6,2,4,17
4,6,3,4,17
4,6,4,4,17
4,6,5,4,17
4,6,6,4,17
4,6,7,4,17
4,7,0,4,17
4,7,1,4,17
4,7,2,4,17
4,7,3,4,17
4,7,4,4,17
4,7,5,4,17
4,7,6,4,17
4,7,7,4,17
4,8,0,4,17
4,8,1,4,17
4,8,2,4,17
4,8,3,4,17
4,8,4,4,17
4,8,5,4,17
4,8,6,4,17
4,8,7,4,17
4,9,0,4,17
4,9,1,4,17
4,9,2,4,17
4,9,3,4,17
4,9,4,4,17
4,9,5,4,17
4,9,6,4,17
4,9,7,4,17
4,10,0,4,17
4,10,1,4,17
4,10,2,4,17
4,10,3,4,17
4,10,4,4,17
4,10,5,4,17
4,10,6,4,17
4,10,7,4,17
4,11,0,4,17
4,11,1,4,17
4,11,2,4,17
4,11,3,4,17
4,11,4,4,17
4,11,5,4,17
4,11,6,4,17
4,11,7,4,17
4,12,0,4,17
4,12,1,4,17
4,12,2,4,17
4,12,3,4,17
4,12,4,4,17
4,12,5,4,17
4,12,6,4,17
4,12,7,4,17
4,0,0,5,17
4,0,1,5,17
4,0,2,5,17
4,0,3,5,17
4,0,4,5,17
4,0,5,5,17
4,0,6,5,17
4,0,7,5,17
4,1,0,5,17
4,1,1,5,17
4,1,2,5,17
4,1,3,5,17
4,1,4,5,17
4,1,5,5,17
4,1,6,5,17
4,1,7,5,17
4,2,0,5,17
4,2,1,5,17
4,2,2,5,17
4,2,3,5,17
4,2,4,5,17
4,2,5,5,17
4,2,6,5,17
4,2,7,5,17
4,3,0,5,17
4,3,1,5,17
4,3,2,5,17
4,3,3,5,17
4,3,4,5,17
4,3,5,5,17
4,3,6,5,17
4,3,7,5,17
4,4,0,5,17
4,4,1,5,17
4,4,2,5,17
4,4,3,5,17
4,4,4,5,17
4,4,5,5,17
4,4,6,5,17
4,4,7,5,17
4,5,0,5,17
4,5,1,5,17
4,5,2,5,17
4,5,3,5,17
4,5,4,5,17
4,5,5,5,17
4,5,6,5,17
4,5,7,5,17
4,6,0,5,17
4,6,1,5,17
4,6,2,5,17
4,6,3,5,17
4,6,4,5,17
4,6,5,5,17
4,6,6,5,17
4,6,7,5,17
4,7,0,5,17
4,7,1,5,17
4,7,2,5,17
4,7,3,5,17
4,7,4,5,17
4,7,5,5,17
4,7,6,5,17
4,7,7,5,17
4,8,0,5,17
4,8,1,5,17
4,8,2,5,17
4,8,3,5,17
4,8,4,5,17
4,8,5,5,17
4,8,6,5,17
4,8,7,5,17
4,9,0,5,17
4,9,1,5,17
4,9,2,5,17
4,9,3,5,17
4,9,4,5,17
4,9,5,5,17
4,9,6,5,17
4,9,7,5,17
4,0,0,6,17
4,0,1,6,17
4,0,2,6,17
4,0,3,6,17
4,0,4,6,17
4,0,5,6,17
4,0,6,6,17
4,0,7,6,17
4,1,0,6,17
4,1,1,6,17
4,1,2,6,17
4,1,3,6,17
4,1,4,6,17
4,1,5,6,17
4,1,6,6,17
4,1,7,6,17
4,2,0,6,17
4,2,1,6,17
4,2,2,6,17
4,2,3,6,17
4,2,4,6,17
4,2,5,6,17
4,2,6,6,17
4,2,7,6,17
4,3,0,6,17
4,3,1,6,17
4,3,2,6,17
4,3,3,6,17
4,3,4,6,17
4,3,5,6,17
4,3,6,6,17
4,3,7,6,17
4,4,0,6,17
4,4,1,6,17
4,4,2,6,17
4,4,3,6,17
4,4,4,6,17
4,4,5,6,17
4,4,6,6,17
4,4,7,6,17
4,5,0,6,17
4,5,1,6,17
4,5,2,6,17
4,5,3,6,17
4,5,4,6,17
4,5,5,6,17
4,5,6,6,17
4,5,7,6,17
4,6,0,6,17
4,6,1,6,17
4,6,2,6,17
4,6,3,6,17
4,6,4,6,17
4,6,5,6,17
4,6,6,6,17
4,6,7,6,17
4,0,0,7,17
4,0,1,7,17
4,0,2,7,17
4,0,3,7,17
4,0,4,7,17
4,0,5,7,17
4,0,6,7,17
4,0,7,7,17
4,1,0,7,17
4,1,1,7,17
4,1,2,7,17
4,1,3,7,17
4,1,4,7,17
4,1,5,7,17
4,1,6,7,17
4,1,7,7,17
4,2,0,7,17
4,2,1,7,17
4,2,2,7,17
4,2,3,7,17
4,2,4,7,17
4,2,5,7,17
4,2,6,7,17
4,2,7,7,17
4,3,0,7,17
4,3,1,7,17
4,3,2,7,17
4,3,3,7,17
4,3,4,7,17
4,3,5,7,17
4,3,6,7,17
4,3,7,7,17
4,0,0,8,17
4,0,1,8,17
4,0,2,8,17
4,0,3,8,17
4,0,4,8,17
4,0,5,8,17
4,0,6,8,17
4,0,7,8,17
4,0,0,1,18
4,0,1,1,18
4,0,2,1,18
4,0,3,1,18
4,0,4,1,18
4,0,5,1,18
4,0,6,1,18
4,1,0,1,18
4,1,1,1,18
4,1,2,1,18
4,1,3,1,18
4,1,4,1,18
4,1,5,1,18
4,1,6,1,18
4,2,0,1,18
4,2,1,1,18
4,2,2,1,18
4,2,3,1,18
4,2,4,1,18
4,2,5,1,18
4,2,6,1,18
4,3,0,1,18
4,3,1,1,18
4,3,2,1,18
4,3,3,1,18
4,3,4,1,18
4,3,5,1,18
4,3,6,1,18
4,4,0,1,18
4,4,1,1,18
4,4,2,1,18
4,4,3,1,18
4,4,4,1,18
4,4,5,1,18
4,4,6,1,18
4,5,0,1,18
4,5,1,1,18
4,5,2,1,18
4,5,3,1,18
4,5,4,1,18
4,5,5,1,18
4,5,6,1,18
4,6,0,1,18
4,6,1,1,18
4,6,2,1,18
4,6,3,1,18
4,6,4,1,18
4,6,5,1,18
4,6,6,1,18
4,7,0,1,18
4,7,1,1,18
4,7,2,1,18
4,7,3,1,18
4,7,4,1,18
4,7,5,1,18
4,7,6,1,18
4,8,0,1,18
4,8,1,1,18
4,8,2,1,18
4,8,3,1,18
4,8,4,1,18
4,8,5,1,18
4,8,6,1,18
4,9,0,1,18
4,9,1,1,18
4,9,2,1,18
4,9,3,1,18
4,9,4,1,18
4,9,5,1,18
4,9,6,1,18
4,10,0,1,18
4,10,1,1,18
4,10,2,1,18
4,10,3,1,18
4,10,4,1,18
4,10,5,1,18
4,10,6,1,18
4,11,0,1,18
4,11,1,1,18
4,11,2,1,18
4,11,3,1,18
4,11,4,1,18
4,11,5,1,18
4,11,6,1,18
4,12,0,1,18
4,12,1,1,18
4,12,2,1,18
4,12,3,1,18
4,12,4,1,18
4,12,5,1,18
4,12,6,1,18
4,13,0,1,18
4,13,1,1,18
4,13,2,1,18
4,13,3,1,18
4,13,4,1,18
4,13,5,1,18
4,13,6,1,18
4,14,0,1,18
4,14,1,1,18
4,14,2,1,18
4,14,3,1,18
4,14,4,1,18
4,14,5,1,18
4,14,6,1,18
4,15,0,1,18
4,15,1,1,18
4,15,2,1,18
4,15,3,1,18
4,15,4,1,18
4,15,5,1,18
4,15,6,1,18
4,16,0,1,18
4,16,1,1,18
4,16,2,1,18
4,16,3,1,18
4,16,4,1,18
4,16,5,1,18
4,16,6,1,18
4,17,0,1,18
4,17,1,1,18
4,17,2,1,18
4,17,3,1,18
4,17,4,1,18
4,17,5,1,18
4,17,6,1,18
4,18,0,1,18
4,18,1,1,18
4,18,2,1,18
4,18,3,1,18
4,18,4,1,18
4,18,5,1,18
4,18,6,1,18
4,19,0,1,18
4,19,1,1,18
4,19,2,1,18
4,19,3,1,18
4,19,4,1,18
4,19,5,1,18
4,19,6,1,18
4,20,0,1,18
4,20,1,1,18
4,20,2,1,18
4,20,3,1,18
4,20,4,1,18
4,20,5,1,18
4,20,6,1,18
4,21,0,1,18
4,21,1,1,18
4,21,2,1,18
4,21,3,1,18
4,21,4,1,18
4,21,5,1,18
4,21,6,1,18
4,0,0,2,18
4,0,1,2,18
4,0,2,2,18
4,0,3,2,18
4,0,4,2,18
4,0,5,2,18
4,0,6,2,18
4,1,0,2,18
4,1,1,2,18
4,1,2,2,18
4,1,3,2,18
4,1,4,2,18
4,1,5,2,18
4,1,6,2,18
4,2,0,2,18
4,2,1,2,18
4,2,2,2,18
4,2,3,2,18
4,2,4,2,18
4,2,5,2,18
4,2,6,2,18
4,3,0,2,18
4,3,1,2,18
4,3,2,2,18
4,3,3,2,18
4,3,4,2,18
4,3,5,2,18
4,3,6,2,18
4,4,0,2,18
4,4,1,2,18
4,4,2,2,18
4,4,3,2,18
4,4,4,2,18
4,4,5,2,18
4,4,6,2,18
4,5,0,2,18
4,5,1,2,18
4,5,2,2,18
4,5,3,2,18
4,5,4,2,18
4,5,5,2,18
4,5,6,2,18
4,6,0,2,18
4,6,1,2,18
4,6,2,2,18
4,6,3,2,18
4,6,4,2,18
4,6,5,2,18
4,6,6,2,18
4,7,0,2,18
4,7,1,2,18
4,7,2,2,18
4,7,3,2,18
4,7,4,2,18
4,7,5,2,18
4,7,6,2,18
4,8,0,2,18
4,8,1,2,18
4,8,2,2,18
4,8,3,2,18
4,8,4,2,18
4,8,5,2,18
4,8,6,2,18
4,9,0,2,18
4,9,1,2,18
4,9,2,2,18
4,9,3,2,18
4,9,4,2,18
4,9,5,2,18
4,9,6,2,18
4,10,0,2,18
4,10,1,2,18
4,10,2,2,18
4,10,3,2,18
4,10,4,2,18
4,10,5,2,18
4,10,6,2,18
4,11,0,2,18
4,11,1,2,18
4,11,2,2,18
4,11,3,2,18
4,11,4,2,18
4,11,5,2,18
4,11,6,2,18
4,12,0,2,18
4,12,1,2,18
4,12,2,2,18
4,12,3,2,18
4,12,4,2,18
4,12,5,2,18
4,12,6,2,18
4,13,0,2,18
4,13,1,2,18
4,13,2,2,18
4,13,3,2,18
4,13,4,2,18
4,13,5,2,18
4,13,6,2,18
4,14,0,2,18
4,14,1,2,18
4,14,2,2,18
4,14,3,2,18
4,14,4,2,18
4,14,5,2,18
4,14,6,2,18
4,15,0,2,18
4,15,1,2,18
4,15,2,2,18
4,15,3,2,18
4,15,4,2,18
4,15,5,2,18
4,15,6,2,18
4,16,0,2,18
4,16,1,2,18
4,16,2,2,18
4,16,3,2,18
4,16,4,2,18
4,16,5,2,18
4,16,6,2,18
4,17,0,2,18
4,17,1,2,18
4,17,2,2,18
4,17,3,2,18
4,17,4,2,18
4,17,5,2,18
4,17,6,2,18
4,18,0,2,18
4,18,1,2,18
4,18,2,2,18
4,18,3,2,18
4,18,4,2,18
4,18,5,2,18
4,18,6,2,18
4,0,0,3,18
4,0,1,3,18
4,0,2,3,18
4,0,3,3,18
4,0,4,3,18
4,0,5,3,18
4,0,6,3,18
4,1,0,3,18
4,1,1,3,18
4,1,2,3,18
4,1,3,3,18
4,1,4,3,18
4,1,5,3,18
4,1,6,3,18
4,2,0,3,18
4,2,1,3,18
4,2,2,3,18
4,2,3,3,18
4,2,4,3,18
4,2,5,3,18
4,2,6,3,18
4,3,0,3,18
4,3,1,3,18
4,3,2,3,18
4,3,3,3,18
4,3,4,3,18
4,3,5,3,18
4,3,6,3,18
4,4,0,3,18
4,4,1,3,18
4,4,2,3,18
4,4,3,3,18
4,4,4,3,18
4,4,5,3,18
4,4,6,3,18
4,5,0,3,18
4,5,1,3,18
4,5,2,3,18
4,5,3,3,18
4,5,4,3,18
4,5,5,3,18
4,5,6,3,18
4,6,0,3,18
4,6,1,3,18
4,6,2,3,18
4,6,3,3,18
4,6,4,3,18
4,6,5,3,18
4,6,6,3,18
4,7,0,3,18
4,7,1,3,18
4,7,2,3,18
4,7,3,3,18
4,7,4,3,18
4,7,5,3,18
4,7,6,3,18
4,8,0,3,18
4,8,1,3,18
4,8,2,3,18
4,8,3,3,18
4,8,4,3,18
4,8,5,3,18
4,8,6,3,18
4,9,0,3,18
4,9,1,3,18
4,9,2,3,18
4,9,3,3,18
4,9,4,3,18
4,9,5,3,18
4,9,6,3,18
4,10,0,3,18
4,10,1,3,18
4,10,2,3,18
4,10,3,3,18
4,10,4,3,18
4,10,5,3,18
4,10,6,3,18
4,11,0,3,18
4,11,1,3,18
4,11,2,3,18
4,11,3,3,18
4,11,4,3,18
4,11,5,3,18
4,11,6,3,18
4,12,0,3,18
4,12,1,3,18
4,12,2,3,18
4,12,3,3,18
4,12,4,3,18
4,12,5,3,18
4,12,6,3,18
4,13,0,3,18
4,13,1,3,18
4,13,2,3,18
4,13,3,3,18
4,13,4,3,18
4,13,5,3,18
4,13,6,3,18
4,14,0,3,18
4,14,1,3,18
4,14,2,3,18
4,14,3,3,18
4,14,4,3,18
4,14,5,3,18
4,14,6,3,18
4,15,0,3,18
4,15,1,3,18
4,15,2,3,18
4,15,3,3,18
4,15,4,3,18
4,15,5,3,18
4,15,6,3,18
4,0,0,4,18
4,0,1,4,18
4,0,2,4,18
4,0,3,4,18
4,0,4,4,18
4,0,5,4,18
4,0,6,4,18
4,1,0,4,18
4,1,1,4,18
4,1,2,4,18
4,1,3,4,18
4,1,4,4,18
4,1,5,4,18
4,1,6,4,18
4,2,0,4,18
4,2,1,4,18
4,2,2,4,18
4,2,3,4,18
4,2,4,4,18
4,2,5,4,18
4,2,6,4,18
4,3,0,4,18
4,3,1,4,18
4,3,2,4,18
4,3,3,4,18
4,3,4,4,18
4,3,5,4,18
4,3,6,4,18
4,4,0,4,18
4,4,1,4,18
4,4,2,4,18
4,4,3,4,18
4,4,4,4,18
4,4,5,4,18
4,4,6,4,18
4,5,0,4,18
4,5,1,4,18
4,5,2,4,18
4,5,3,4,18
4,5,4,4,18
4,5,5,4,18
4,5,6,4,18
4,6,0,4,18
4,6,1,4,18
4,6,2,4,18
4,6,3,4,18
4,6,4,4,18
4,6,5,4,18
4,6,6,4,18
4,7,0,4,18
4,7,1,4,18
4,7,2,4,18
4,7,3,4,18
4,7,4,4,18
4,7,5,4,18
4,7,6,4,18
4,8,0,4,18
4,8,1,4,18
4,8,2,4,18
4,8,3,4,18
4,8,4,4,18
4,8,5,4,18
4,8,6,4,18
4,9,0,4,18
4,9,1,4,18
4,9,2,4,18
4,9,3,4,18
4,9,4,4,18
4,9,5,4,18
4,9,6,4,18
4,10,0,4,18
4,10,1,4,18
4,10,2,4,18
4,10,3,4,18
4,10,4,4,18
4,10,5,4,18
4,10,6,4,18
4,11,0,4,18
4,11,1,4,18
4,11,2,4,18
4,11,3,4,18
4,11,4,4,18
4,11,5,4,18
4,11,6,4,18
4,12,0,4,18
4,12,1,4,18
4,12,2,4,18
4,12,3,4,18
4,12,4,4,18
4,12,5,4,18
4,12,6,4,18
4,0,0,5,18
4,0,1,5,18
4,0,2,5,18
4,0,3,5,18
4,0,4,5,18
4,0,5,5,18
4,0,6,5,18
4,1,0,5,18
4,1,1,5,18
4,1,2,5,18
4,1,3,5,18
4,1,4,5,18
4,1,5,5,18
4,1,6,5,18
4,2,0,5,18
4,2,1,5,18
4,2,2,5,18
4,2,3,5,18
4,2,4,5,18
4,2,5,5,18
4,2,6,5,18
4,3,0,5,18
4,3,1,5,18
4,3,2,5,18
4,3,3,5,18
4,3,4,5,18
4,3,5,5,18
4,3,6,5,18
4,4,0,5,18
4,4,1,5,18
4,4,2,5,18
4,4,3,5,18
4,4,4,5,18
4,4,5,5,18
4,4,6,5,18
4,5,0,5,18
4,5,1,5,18
4,5,2,5,18
4,5,3,5,18
4,5,4,5,18
4,5,5,5,18
4,5,6,5,18
4,6,0,5,18
4,6,1,5,18
4,6,2,5,18
4,6,3,5,18
4,6,4,5,18
4,6,5,5,18
4,6,6,5,18
4,7,0,5,18
4,7,1,5,18
4,7,2,5,18
4,7,3,5,18
4,7,4,5,18
4,7,5,5,18
4,7,6,5,18
4,8,0,5,18
4,8,1,5,18
4,8,2,5,18
4,8,3,5,18
4,8,4,5,18
4,8,5,5,18
4,8,6,5,18
4,9,0,5,18
4,9,1,5,18
4,9,2,5,18
4,9,3,5,18
4,9,4,5,18
4,9,5,5,18
4,9,6,5,18
4,0,0,6,18
4,0,1,6,18
4,0,2,6,18
4,0,3,6,18
4,0,4,6,18
4,0,5,6,18
4,0,6,6,18
4,1,0,6,18
4,1,1,6,18
4,1,2,6,18
4,1,3,6,18
4,1,4,6,18
4,1,5,6,18
4,1,6,6,18
4,2,0,6,18
4,2,1,6,18
4,2,2,6,18
4,2,3,6,18
4,2,4,6,18
4,2,5,6,18
4,2,6,6,18
4,3,0,6,18
4,3,1,6,18
4,3,2,6,18
4,3,3,6,18
4,3,4,6,18
4,3,5,6,18
4,3,6,6,18
4,4,0,6,18
4,4,1,6,18
4,4,2,6,18
4,4,3,6,18
4,4,4,6,18
4,4,5,6,18
4,4,6,6,18
4,5,0,6,18
4,5,1,6,18
4,5,2,6,18
4,5,3,6,18
4,5,4,6,18
4,5,5,6,18
4,5,6,6,18
4,6,0,6,18
4,6,1,6,18
4,6,2,6,18
4,6,3,6,18
4,6,4,6,18
4,6,5,6,18
4,6,6,6,18
4,0,0,7,18
4,0,1,7,18
4,0,2,7,18
4,0,3,7,18
4,0,4,7,18
4,0,5,7,18
4,0,6,7,18
4,1,0,7,18
4,1,1,7,18
4,1,2,7,18
4,1,3,7,18
4,1,4,7,18
4,1,5,7,18
4,1,6,7,18
4,2,0,7,18
4,2,1,7,18
4,2,2,7,18
4,2,3,7,18
4,2,4,7,18
4,2,5,7,18
4,2,6,7,18
4,3,0,7,18
4,3,1,7,18
4,3,2,7,18
4,3,3,7,18
4,3,4,7,18
4,3,5,7,18
4,3,6,7,18
4,0,0,8,18
4,0,1,8,18
4,0,2,8,18
4,0,3,8,18
4,0,4,8,18
4,0,5,8,18
4,0,6,8,18
4,0,0,1,19
4,0,1,1,19
4,0,2,1,19
4,0,3,1,19
4,0,4,1,19
4,0,5,1,19
4,1,0,1,19
4,1,1,1,19
4,1,2,1,19
4,1,3,1,19
4,1,4,1,19
4,1,5,1,19
4,2,0,1,19
4,2,1,1,19
4,2,2,1,19
4,2,3,1,19
4,2,4,1,19
4,2,5,1,19
4,3,0,1,19
4,3,1,1,19
4,3,2,1,19
4,3,3,1,19
4,3,4,1,19
4,3,5,1,19
4,4,0,1,19
4,4,1,1,19
4,4,2,1,19
4,4,3,1,19
4,4,4,1,19
4,4,5,1,19
4,5,0,1,19
4,5,1,1,19
4,5,2,1,19
4,5,3,1,19
4,5,4,1,19
4,5,5,1,19
4,6,0,1,19
4,6,1,1,19
4,6,2,1,19
4,6,3,1,19
4,6,4,1,19
4,6,5,1,19
4,7,0,1,19
4,7,1,1,19
4,7,2,1,19
4,7,3,1,19
4,7,4,1,19
4,7,5,1,19
4,8,0,1,19
4,8,1,1,19
4,8,2,1,19
4,8,3,1,19
4,8,4,1,19
4,8,5,1,19
4,9,0,1,19
4,9,1,1,19
4,9,2,1,19
4,9,3,1,19
4,9,4,1,19
4,9,5,1,19
4,10,0,1,19
4,10,1,1,19
4,10,2,1,19
4,10,3,1,19
4,10,4,1,19
4,10,5,1,19
4,11,0,1,19
4,11,1,1,19
4,11,2,1,19
4,11,3,1,19
4,11,4,1,19
4,11,5,1,19
4,12,0,1,19
4,12,1,1,19
4,12,2,1,19
4,12,3,1,19
4,12,4,1,19
4,12,5,1,19
4,13,0,1,19
4,13,1,1,19
4,13,2,1,19
4,13,3,1,19
4,13,4,1,19
4,13,5,1,19
4,14,0,1,19
4,14,1,1,19
4,14,2,1,19
4,14,3,1,19
4,14,4,1,19
4,14,5,1,19
4,15,0,1,19
4,15,1,1,19
4,15,2,1,19
4,15,3,1,19
4,15,4,1,19
4,15,5,1,19
4,16,0,1,19
4,16,1,1,19
4,16,2,1,19
4,16,3,1,19
4,16,4,1,19
4,16,5,1,19
4,17,0,1,19
4,17,1,1,19
4,17,2,1,19
4,17,3,1,19
4,17,4,1,19
4,17,5,1,19
4,18,0,1,19
4,18,1,1,19
4,18,2,1,19
4,18,3,1,19
4,18,4,1,19
4,18,5,1,19
4,19,0,1,19
4,19,1,1,19
4,19,2,1,19
4,19,3,1,19
4,19,4,1,19
4,19,5,1,19
4,20,0,1,19
4,20,1,1,19
4,20,2,1,19
4,20,3,1,19
4,20,4,1,19
4,20,5,1,19
4,21,0,1,19
4,21,1,1,19
4,21,2,1,19
4,21,3,1,19
4,21,4,1,19
4,21,5,1,19
4,0,0,2,19
4,0,1,2,19
4,0,2,2,19
4,0,3,2,19
4,0,4,2,19
4,0,5,2,19
4,1,0,2,19
4,1,1,2,19
4,1,2,2,19
4,1,3,2,19
4,1,4,2,19
4,1,5,2,19
4,2,0,2,19
4,2,1,2,19
4,2,2,2,19
4,2,3,2,19
4,2,4,2,19
4,2,5,2,19
4,3,0,2,19
4,3,1,2,19
4,3,2,2,19
4,3,3,2,19
4,3,4,2,19
4,3,5,2,19
4,4,0,2,19
4,4,1,2,19
4,4,2,2,19
4,4,3,2,19
4,4,4,2,19
4,4,5,2,19
4,5,0,2,19
4,5,1,2,19
4,5,2,2,19
4,5,3,2,19
4,5,4,2,19
4,5,5,2,19
4,6,0,2,19
4,6,1,2,19
4,6,2,2,19
4,6,3,2,19
4,6,4,2,19
4,6,5,2,19
4,7,0,2,19
4,7,1,2,19
4,7,2,2,19
4,7,3,2,19
4,7,4,2,19
4,7,5,2,19
4,8,0,2,19
4,8,1,2,19
4,8,2,2,19
4,8,3,2,19
4,8,4,2,19
4,8,5,2,19
4,9,0,2,19
4,9,1,2,19
4,9,2,2,19
4,9,3,2,19
4,9,4,2,19
4,9,5,2,19
4,10,0,2,19
4,10,1,2,19
4,10,2,2,19
4,10,3,2,19
4,10,4,2,19
4,10,5,2,19
4,11,0,2,19
4,11,1,2,19
4,11,2,2,19
4,11,3,2,19
4,11,4,2,19
4,11,5,2,19
4,12,0,2,19
4,12,1,2,19
4,12,2,2,19
4,12,3,2,19
4,12,4,2,19
4,12,5,2,19
4,13,0,2,19
4,13,1,2,19
4,13,2,2,19
4,13,3,2,19
4,13,4,2,19
4,13,5,2,19
4,14,0,2,19
4,14,1,2,19
4,14,2,2,19
4,14,3,2,19
4,14,4,2,19
4,14,5,2,19
4,15,0,2,19
4,15,1,2,19
4,15,2,2,19
4,15,3,2,19
4,15,4,2,19
4,15,5,2,19
4,16,0,2,19
4,16,1,2,19
4,16,2,2,19
4,16,3,2,19
4,16,4,2,19
4,16,5,2,19
4,17,0,2,19
4,17,1,2,19
4,17,2,2,19
4,17,3,2,19
4,17,4,2,19
4,17,5,2,19
4,18,0,2,19
4,18,1,2,19
4,18,2,2,19
4,18,3,2,19
4,18,4,2,19
4,18,5,2,19
4,0,0,3,19
4,0,1,3,19
4,0,2,3,19
4,0,3,3,19
4,0,4,3,19
4,0,5,3,19
4,1,0,3,19
4,1,1,3,19
4,1,2,3,19
4,1,3,3,19
4,1,4,3,19
4,1,5,3,19
4,2,0,3,19
4,2,1,3,19
4,2,2,3,19
4,2,3,3,19
4,2,4,3,19
4,2,5,3,19
4,3,0,3,19
4,3,1,3,19
4,3,2,3,19
4,3,3,3,19
4,3,4,3,19
4,3,5,3,19
4,4,0,3,19
4,4,1,3,19
4,4,2,3,19
4,4,3,3,19
4,4,4,3,19
4,4,5,3,19
4,5,0,3,19
4,5,1,3,19
4,5,2,3,19
4,5,3,3,19
4,5,4,3,19
4,5,5,3,19
4,6,0,3,19
4,6,1,3,19
4,6,2,3,19
4,6,3,3,19
4,6,4,3,19
4,6,5,3,19
4,7,0,3,19
4,7,1,3,19
4,7,2,3,19
4,7,3,3,19
4,7,4,3,19
4,7,5,3,19
4,8,0,3,19
4,8,1,3,19
4,8,2,3,19
4,8,3,3,19
4,8,4,3,19
4,8,5,3,19
4,9,0,3,19
4,9,1,3,19
4,9,2,3,19
4,9,3,3,19
4,9,4,3,19
4,9,5,3,19
4,10,0,3,19
4,10,1,3,19
4,10,2,3,19
4,10,3,3,19
4,10,4,3,19
4,10,5,3,19
4,11,0,3,19
4,11,1,3,19
4,11,2,3,19
4,11,3,3,19
4,11,4,3,19
4,11,5,3,19
4,12,0,3,19
4,12,1,3,19
4,12,2,3,19
4,12,3,3,19
4,12,4,3,19
4,12,5,3,19
4,13,0,3,19
4,13,1,3,19
4,13,2,3,19
4,13,3,3,19
4,13,4,3,19
4,13,5,3,19
4,14,0,3,19
4,14,1,3,19
4,14,2,3,19
4,14,3,3,19
4,14,4,3,19
4,14,5,3,19
4,15,0,3,19
4,15,1,3,19
4,15,2,3,19
4,15,3,3,19
4,15,4,3,19
4,15,5,3,19
4,0,0,4,19
4,0,1,4,19
4,0,2,4,19
4,0,3,4,19
4,0,4,4,19
4,0,5,4,19
4,1,0,4,19
4,1,1,4,19
4,1,2,4,19
4,1,3,4,19
4,1,4,4,19
4,1,5,4,19
4,2,0,4,19
4,2,1,4,19
4,2,2,4,19
4,2,3,4,19
4,2,4,4,19
4,2,5,4,19
4,3,0,4,19
4,3,1,4,19
4,3,2,4,19
4,3,3,4,19
4,3,4,4,19
4,3,5,4,19
4,4,0,4,19
4,4,1,4,19
4,4,2,4,19
4,4,3,4,19
4,4,4,4,19
4,4,5,4,19
4,5,0,4,19
4,5,1,4,19
4,5,2,4,19
4,5,3,4,19
4,5,4,4,19
4,5,5,4,19
4,6,0,4,19
4,6,1,4,19
4,6,2,4,19
4,6,3,4,19
4,6,4,4,19
4,6,5,4,19
4,7,0,4,19
4,7,1,4,19
4,7,2,4,19
4,7,3,4,19
4,7,4,4,19
4,7,5,4,19
4,8,0,4,19
4,8,1,4,19
4,8,2,4,19
4,8,3,4,19
4,8,4,4,19
4,8,5,4,19
4,9,0,4,19
4,9,1,4,19
4,9,2,4,19
4,9,3,4,19
4,9,4,4,19
4,9,5,4,19
4,10,0,4,19
4,10,1,4,19
4,10,2,4,19
4,10,3,4,19
4,10,4,4,19
4,10,5,4,19
4,11,0,4,19
4,11,1,4,19
4,11,2,4,19
4,11,3,4,19
4,11,4,4,19
4,11,5,4,19
4,12,0,4,19
4,12,1,4,19
4,12,2,4,19
4,12,3,4,19
4,12,4,4,19
4,12,5,4,19
4,0,0,5,19
4,0,1,5,19
4,0,2,5,19
4,0,3,5,19
4,0,4,5,19
4,0,5,5,19
4,1,0,5,19
4,1,1,5,19
4,1,2,5,19
4,1,3,5,19
4,1,4,5,19
4,1,5,5,19
4,2,0,5,19
4,2,1,5,19
4,2,2,5,19
4,2,3,5,19
4,2,4,5,19
4,2,5,5,19
4,3,0,5,19
4,3,1,5,19
4,3,2,5,19
4,3,3,5,19
4,3,4,5,19
4,3,5,5,19
4,4,0,5,19
4,4,1,5,19
4,4,2,5,19
4,4,3,5,19
4,4,4,5,19
4,4,5,5,19
4,5,0,5,19
4,5,1,5,19
4,5,2,5,19
4,5,3,5,19
4,5,4,5,19
4,5,5,5,19
4,6,0,5,19
4,6,1,5,19
4,6,2,5,19
4,6,3,5,19
4,6,4,5,19
4,6,5,5,19
4,7,0,5,19
4,7,1,5,19
4,7,2,5,19
4,7,3,5,19
4,7,4,5,19
4,7,5,5,19
4,8,0,5,19
4,8,1,5,19
4,8,2,5,19
4,8,3,5,19
4,8,4,5,19
4,8,5,5,19
4,9,0,5,19
4,9,1,5,19
4,9,2,5,19
4,9,3,5,19
4,9,4,5,19
4,9,5,5,19
4,0,0,6,19
4,0,1,6,19
4,0,2,6,19
4,0,3,6,19
4,0,4,6,19
4,0,5,6,19
4,1,0,6,19
4,1,1,6,19
4,1,2,6,19
4,1,3,6,19
4,1,4,6,19
4,1,5,6,19
4,2,0,6,19
4,2,1,6,19
4,2,2,6,19
4,2,3,6,19
4,2,4,6,19
4,2,5,6,19
4,3,0,6,19
4,3,1,6,19
4,3,2,6,19
4,3,3,6,19
4,3,4,6,19
4,3,5,6,19
4,4,0,6,19
4,4,1,6,19
4,4,2,6,19
4,4,3,6,19
4,4,4,6,19
4,4,5,6,19
4,5,0,6,19
4,5,1,6,19
4,5,2,6,19
4,5,3,6,19
4,5,4,6,19
4,5,5,6,19
4,6,0,6,19
4,6,1,6,19
4,6,2,6,19
4,6,3,6,19
4,6,4,6,19
4,6,5,6,19
4,0,0,7,19
4,0,1,7,19
4,0,2,7,19
4,0,3,7,19
4,0,4,7,19
4,0,5,7,19
4,1,0,7,19
4,1,1,7,19
4,1,2,7,19
4,1,3,7,19
4,1,4,7,19
4,1,5,7,19
4,2,0,7,19
4,2,1,7,19
4,2,2,7,19
4,2,3,7,19
4,2,4,7,19
4,2,5,7,19
4,3,0,7,19
4,3,1,7,19
4,3,2,7,19
4,3,3,7,19
4,3,4,7,19
4,3,5,7,19
4,0,0,8,19
4,0,1,8,19
4,0,2,8,19
4,0,3,8,19
4,0,4,8,19
4,0,5,8,19
4,0,0,1,20
4,0,1,1,20
4,0,2,1,20
4,0,3,1,20
4,0,4,1,20
4,1,0,1,20
4,1,1,1,20
4,1,2,1,20
4,1,3,1,20
4,1,4,1,20
4,2,0,1,20
4,2,1,1,20
4,2,2,1,20
4,2,3,1,20
4,2,4,1,20
4,3,0,1,20
4,3,1,1,20
4,3,2,1,20
4,3,3,1,20
4,3,4,1,20
4,4,0,1,20
4,4,1,1,20
4,4,2,1,20
4,4,3,1,20
4,4,4,1,20
4,5,0,1,20
4,5,1,1,20
4,5,2,1,20
4,5,3,1,20
4,5,4,1,20
4,6,0,1,20
4,6,1,1,20
4,6,2,1,20
4,6,3,1,20
4,6,4,1,20
4,7,0,1,20
4,7,1,1,20
4,7,2,1,20
4,7,3,1,20
4,7,4,1,20
4,8,0,1,20
4,8,1,1,20
4,8,2,1,20
4,8,3,1,20
4,8,4,1,20
4,9,0,1,20
4,9,1,1,20
4,9,2,1,20
4,9,3,1,20
4,9,4,1,20
4,10,0,1,20
4,10,1,1,20
4,10,2,1,20
4,10,3,1,20
4,10,4,1,20
4,11,0,1,20
4,11,1,1,20
4,11,2,1,20
4,11,3,1,20
4,11,4,1,20
4,12,0,1,20
4,12,1,1,20
4,12,2,1,20
4,12,3,1,20
4,12,4,1,20
4,13,0,1,20
4,13,1,1,20
4,13,2,1,20
4,13,3,1,20
4,13,4,1,20
4,14,0,1,20
4,14,1,1,20
4,14,2,1,20
4,14,3,1,20
4,14,4,1,20
4,15,0,1,20
4,15,1,1,20
4,15,2,1,20
4,15,3,1,20
4,15,4,1,20
4,16,0,1,20
4,16,1,1,20
4,16,2,1,20
4,16,3,1,20
4,16,4,1,20
4,17,0,1,20
4,17,1,1,20
4,17,2,1,20
4,17,3,1,20
4,17,4,1,20
4,18,0,1,20
4,18,1,1,20
4,18,2,1,20
4,18,3,1,20
4,18,4,1,20
4,19,0,1,20
4,19,1,1,20
4,19,2,1,20
4,19,3,1,20
4,19,4,1,20
4,20,0,1,20
4,20,1,1,20
4,20,2,1,20
4,20,3,1,20
4,20,4,1,20
4,21,0,1,20
4,21,1,1,20
4,21,2,1,20
4,21,3,1,20
4,21,4,1,20
4,0,0,2,20
4,0,1,2,20
4,0,2,2,20
4,0,3,2,20
4,0,4,2,20
4,1,0,2,20
4,1,1,2,20
4,1,2,2,20
4,1,3,2,20
4,1,4,2,20
4,2,0,2,20
4,2,1,2,20
4,2,2,2,20
4,2,3,2,20
4,2,4,2,20
4,3,0,2,20
4,3,1,2,20
4,3,2,2,20
4,3,3,2,20
4,3,4,2,20
4,4,0,2,20
4,4,1,2,20
4,4,2,2,20
4,4,3,2,20
4,4,4,2,20
4,5,0,2,20
4,5,1,2,20
4,5,2,2,20
4,5,3,2,20
4,5,4,2,20
4,6,0,2,20
4,6,1,2,20
4,6,2,2,20
4,6,3,2,20
4,6,4,2,20
4,7,0,2,20
4,7,1,2,20
4,7,2,2,20
4,7,3,2,20
4,7,4,2,20
4,8,0,2,20
4,8,1,2,20
4,8,2,2,20
4,8,3,2,20
4,8,4,2,20
4,9,0,2,20
4,9,1,2,20
4,9,2,2,20
4,9,3,2,20
4,9,4,2,20
4,10,0,2,20
4,10,1,2,20
4,10,2,2,20
4,10,3,2,20
4,10,4,2,20
4,11,0,2,20
4,11,1,2,20
4,11,2,2,20
4,11,3,2,20
4,11,4,2,20
4,12,0,2,20
4,12,1,2,20
4,12,2,2,20
4,12,3,2,20
4,12,4,2,20
4,13,0,2,20
4,13,1,2,20
4,13,2,2,20
4,13,3,2,20
4,13,4,2,20
4,14,0,2,20
4,14,1,2,20
4,14,2,2,20
4,14,3,2,20
4,14,4,2,20
4,15,0,2,20
4,15,1,2,20
4,15,2,2,20
4,15,3,2,20
4,15,4,2,20
4,16,0,2,20
4,16,1,2,20
4,16,2,2,20
4,16,3,2,20
4,16,4,2,20
4,17,0,2,20
4,17,1,2,20
4,17,2,2,20
4,17,3,2,20
4,17,4,2,20
4,18,0,2,20
4,18,1,2,20
4,18,2,2,20
4,18,3,2,20
4,18,4,2,20
4,0,0,3,20
4,0,1,3,20
4,0,2,3,20
4,0,3,3,20
4,0,4,3,20
4,1,0,3,20
4,1,1,3,20
4,1,2,3,20
4,1,3,3,20
4,1,4,3,20
4,2,0,3,20
4,2,1,3,20
4,2,2,3,20
4,2,3,3,20
4,2,4,3,20
4,3,0,3,20
4,3,1,3,20
4,3,2,3,20
4,3,3,3,20
4,3,4,3,20
4,4,0,3,20
4,4,1,3,20
4,4,2,3,20
4,4,3,3,20
4,4,4,3,20
4,5,0,3,20
4,5,1,3,20
4,5,2,3,20
4,5,3,3,20
4,5,4,3,20
4,6,0,3,20
4,6,1,3,20
4,6,2,3,20
4,6,3,3,20
4,6,4,3,20
4,7,0,3,20
4,7,1,3,20
4,7,2,3,20
4,7,3,3,20
4,7,4,3,20
4,8,0,3,20
4,8,1,3,20
4,8,2,3,20
4,8,3,3,20
4,8,4,3,20
4,9,0,3,20
4,9,1,3,20
4,9,2,3,20
4,9,3,3,20
4,9,4,3,20
4,10,0,3,20
4,10,1,3,20
4,10,2,3,20
4,10,3,3,20
4,10,4,3,20
4,11,0,3,20
4,11,1,3,20
4,11,2,3,20
4,11,3,3,20
4,11,4,3,20
4,12,0,3,20
4,12,1,3,20
4,12,2,3,20
4,12,3,3,20
4,12,4,3,20
4,13,0,3,20
4,13,1,3,20
4,13,2,3,20
4,13,3,3,20
4,13,4,3,20
4,14,0,3,20
4,14,1,3,20
4,14,2,3,20
4,14,3,3,20
4,14,4,3,20
4,15,0,3,20
4,15,1,3,20
4,15,2,3,20
4,15,3,3,20
4,15,4,3,20
4,0,0,4,20
4,0,1,4,20
4,0,2,4,20
4,0,3,4,20
4,0,4,4,20
4,1,0,4,20
4,1,1,4,20
4,1,2,4,20
4,1,3,4,20
4,1,4,4,20
4,2,0,4,20
4,2,1,4,20
4,2,2,4,20
4,2,3,4,20
4,2,4,4,20
4,3,0,4,20
4,3,1,4,20
4,3,2,4,20
4,3,3,4,20
4,3,4,4,20
4,4,0,4,20
4,4,1,4,20
4,4,2,4,20
4,4,3,4,20
4,4,4,4,20
4,5,0,4,20
4,5,1,4,20
4,5,2,4,20
4,5,3,4,20
4,5,4,4,20
4,6,0,4,20
4,6,1,4,20
4,6,2,4,20
4,6,3,4,20
4,6,4,4,20
4,7,0,4,20
4,7,1,4,20
4,7,2,4,20
4,7,3,4,20
4,7,4,4,20
4,8,0,4,20
4,8,1,4,20
4,8,2,4,20
4,8,3,4,20
4,8,4,4,20
4,9,0,4,20
4,9,1,4,20
4,9,2,4,20
4,9,3,4,20
4,9,4,4,20
4,10,0,4,20
4,10,1,4,20
4,10,2,4,20
4,10,3,4,20
4,10,4,4,20
4,11,0,4,20
4,11,1,4,20
4,11,2,4,20
4,11,3,4,20
4,11,4,4,20
4,12,0,4,20
4,12,1,4,20
4,12,2,4,20
4,12,3,4,20
4,12,4,4,20
4,0,0,5,20
4,0,1,5,20
4,0,2,5,20
4,0,3,5,20
4,0,4,5,20
4,1,0,5,20
4,1,1,5,20
4,1,2,5,20
4,1,3,5,20
4,1,4,5,20
4,2,0,5,20
4,2,1,5,20
4,2,2,5,20
4,2,3,5,20
4,2,4,5,20
4,3,0,5,20
4,3,1,5,20
4,3,2,5,20
4,3,3,5,20
4,3,4,5,20
4,4,0,5,20
4,4,1,5,20
4,4,2,5,20
4,4,3,5,20
4,4,4,5,20
4,5,0,5,20
4,5,1,5,20
4,5,2,5,20
4,5,3,5,20
4,5,4,5,20
4,6,0,5,20
4,6,1,5,20
4,6,2,5,20
4,6,3,5,20
4,6,4,5,20
4,7,0,5,20
4,7,1,5,20
4,7,2,5,20
4,7,3,5,20
4,7,4,5,20
4,8,0,5,20
4,8,1,5,20
4,8,2,5,20
4,8,3,5,20
4,8,4,5,20
4,9,0,5,20
4,9,1,5,20
4,9,2,5,20
4,9,3,5,20
4,9,4,5,20
4,0,0,6,20
4,0,1,6,20
4,0,2,6,20
4,0,3,6,20
4,0,4,6,20
4,1,0,6,20
4,1,1,6,20
4,1,2,6,20
4,1,3,6,20
4,1,4,6,20
4,2,0,6,20
4,2,1,6,20
4,2,2,6,20
4,2,3,6,20
4,2,4,6,20
4,3,0,6,20
4,3,1,6,20
4,3,2,6,20
4,3,3,6,20
4,3,4,6,20
4,4,0,6,20
4,4,1,6,20
4,4,2,6,20
4,4,3,6,20
4,4,4,6,20
4,5,0,6,20
4,5,1,6,20
4,5,2,6,20
4,5,3,6,20
4,5,4,6,20
4,6,0,6,20
4,6,1,6,20
4,6,2,6,20
4,6,3,6,20
4,6,4,6,20
4,0,0,7,20
4,0,1,7,20
4,0,2,7,20
4,0,3,7,20
4,0,4,7,20
4,1,0,7,20
4,1,1,7,20
4,1,2,7,20
4,1,3,7,20
4,1,4,7,20
4,2,0,7,20
4,2,1,7,20
4,2,2,7,20
4,2,3,7,20
4,2,4,7,20
4,3,0,7,20
4,3,1,7,20
4,3,2,7,20
4,3,3,7,20
4,3,4,7,20
4,0,0,8,20
4,0,1,8,20
4,0,2,8,20
4,0,3,8,20
4,0,4,8,20
4,0,0,1,21
4,0,1,1,21
4,0,2,1,21
4,0,3,1,21
4,1,0,1,21
4,1,1,1,21
4,1,2,1,21
4,1,3,1,21
4,2,0,1,21
4,2,1,1,21
4,2,2,1,21
4,2,3,1,21
4,3,0,1,21
4,3,1,1,21
4,3,2,1,21
4,3,3,1,21
4,4,0,1,21
4,4,1,1,21
4,4,2,1,21
4,4,3,1,21
4,5,0,1,21
4,5,1,1,21
4,5,2,1,21
4,5,3,1,21
4,6,0,1,21
4,6,1,1,21
4,6,2,1,21
4,6,3,1,21
4,7,0,1,21
4,7,1,1,21
4,7,2,1,21
4,7,3,1,21
4,8,0,1,21
4,8,1,1,21
4,8,2,1,21
4,8,3,1,21
4,9,0,1,21
4,9,1,1,21
4,9,2,1,21
4,9,3,1,21
4,10,0,1,21
4,10,1,1,21
4,10,2,1,21
4,10,3,1,21
4,11,0,1,21
4,11,1,1,21
4,11,2,1,21
4,11,3,1,21
4,12,0,1,21
4,12,1,1,21
4,12,2,1,21
4,12,3,1,21
4,13,0,1,21
4,13,1,1,21
4,13,2,1,21
4,13,3,1,21
4,14,0,1,21
4,14,1,1,21
4,14,2,1,21
4,14,3,1,21
4,15,0,1,21
4,15,1,1,21
4,15,2,1,21
4,15,3,1,21
4,16,0,1,21
4,16,1,1,21
4,16,2,1,21
4,16,3,1,21
4,17,0,1,21
4,17,1,1,21
4,17,2,1,21
4,17,3,1,21
4,18,0,1,21
4,18,1,1,21
4,18,2,1,21
4,18,3,1,21
4,19,0,1,21
4,19,1,1,21
4,19,2,1,21
4,19,3,1,21
4,20,0,1,21
4,20,1,1,21
4,20,2,1,21
4,20,3,1,21
4,21,0,1,21
4,21,1,1,21
4,21,2,1,21
4,21,3,1,21
4,0,0,2,21
4,0,1,2,21
4,0,2,2,21
4,0,3,2,21
4,1,0,2,21
4,1,1,2,21
4,1,2,2,21
4,1,3,2,21
4,2,0,2,21
4,2,1,2,21
4,2,2,2,21
4,2,3,2,21
4,3,0,2,21
4,3,1,2,21
4,3,2,2,21
4,3,3,2,21
4,4,0,2,21
4,4,1,2,21
4,4,2,2,21
4,4,3,2,21
4,5,0,2,21
4,5,1,2,21
4,5,2,2,21
4,5,3,2,21
4,6,0,2,21
4,6,1,2,21
4,6,2,2,21
4,6,3,2,21
4,7,0,2,21
4,7,1,2,21
4,7,2,2,21
4,7,3,2,21
4,8,0,2,21
4,8,1,2,21
4,8,2,2,21
4,8,3,2,21
4,9,0,2,21
4,9,1,2,21
4,9,2,2,21
4,9,3,2,21
4,10,0,2,21
4,10,1,2,21
4,10,2,2,21
4,10,3,2,21
4,11,0,2,21
4,11,1,2,21
4,11,2,2,21
4,11,3,2,21
4,12,0,2,21
4,12,1,2,21
4,12,2,2,21
4,12,3,2,21
4,13,0,2,21
4,13,1,2,21
4,13,2,2,21
4,13,3,2,21
4,14,0,2,21
4,14,1,2,21
4,14,2,2,21
4,14,3,2,21
4,15,0,2,21
4,15,1,2,21
4,15,2,2,21
4,15,3,2,21
4,16,0,2,21
4,16,1,2,21
4,16,2,2,21
4,16,3,2,21
4,17,0,2,21
4,17,1,2,21
4,17,2,2,21
4,17,3,2,21
4,18,0,2,21
4,18,1,2,21
4,18,2,2,21
4,18,3,2,21
4,0,0,3,21
4,0,1,3,21
4,0,2,3,21
4,0,3,3,21
4,1,0,3,21
4,1,1,3,21
4,1,2,3,21
4,1,3,3,21
4,2,0,3,21
4,2,1,3,21
4,2,2,3,21
4,2,3,3,21
4,3,0,3,21
4,3,1,3,21
4,3,2,3,21
4,3,3,3,21
4,4,0,3,21
4,4,1,3,21
4,4,2,3,21
4,4,3,3,21
4,5,0,3,21
4,5,1,3,21
4,5,2,3,21
4,5,3,3,21
4,6,0,3,21
4,6,1,3,21
4,6,2,3,21
4,6,3,3,21
4,7,0,3,21
4,7,1,3,21
4,7,2,3,21
4,7,3,3,21
4,8,0,3,21
4,8,1,3,21
4,8,2,3,21
4,8,3,3,21
4,9,0,3,21
4,9,1,3,21
4,9,2,3,21
4,9,3,3,21
4,10,0,3,21
4,10,1,3,21
4,10,2,3,21
4,10,3,3,21
4,11,0,3,21
4,11,1,3,21
4,11,2,3,21
4,11,3,3,21
4,12,0,3,21
4,12,1,3,21
4,12,2,3,21
4,12,3,3,21
4,13,0,3,21
4,13,1,3,21
4,13,2,3,21
4,13,3,3,21
4,14,0,3,21
4,14,1,3,21
4,14,2,3,21
4,14,3,3,21
4,15,0,3,21
4,15,1,3,21
4,15,2,3,21
4,15,3,3,21
4,0,0,4,21
4,0,1,4,21
4,0,2,4,21
4,0,3,4,21
4,1,0,4,21
4,1,1,4,21
4,1,2,4,21
4,1,3,4,21
4,2,0,4,21
4,2,1,4,21
4,2,2,4,21
4,2,3,4,21
4,3,0,4,21
4,3,1,4,21
4,3,2,4,21
4,3,3,4,21
4,4,0,4,21
4,4,1,4,21
4,4,2,4,21
4,4,3,4,21
4,5,0,4,21
4,5,1,4,21
4,5,2,4,21
4,5,3,4,21
4,6,0,4,21
4,6,1,4,21
4,6,2,4,21
4,6,3,4,21
4,7,0,4,21
4,7,1,4,21
4,7,2,4,21
4,7,3,4,21
4,8,0,4,21
4,8,1,4,21
4,8,2,4,21
4,8,3,4,21
4,9,0,4,21
4,9,1,4,21
4,9,2,4,21
4,9,3,4,21
4,10,0,4,21
4,10,1,4,21
4,10,2,4,21
4,10,3,4,21
4,11,0,4,21
4,11,1,4,21
4,11,2,4,21
4,11,3,4,21
4,12,0,4,21
4,12,1,4,21
4,12,2,4,21
4,12,3,4,21
4,0,0,5,21
4,0,1,5,21
4,0,2,5,21
4,0,3,5,21
4,1,0,5,21
4,1,1,5,21
4,1,2,5,21
4,1,3,5,21
4,2,0,5,21
4,2,1,5,21
4,2,2,5,21
4,2,3,5,21
4,3,0,5,21
4,3,1,5,21
4,3,2,5,21
4,3,3,5,21
4,4,0,5,21
4,4,1,5,21
4,4,2,5,21
4,4,3,5,21
4,5,0,5,21
4,5,1,5,21
4,5,2,5,21
4,5,3,5,21
4,6,0,5,21
4,6,1,5,21
4,6,2,5,21
4,6,3,5,21
4,7,0,5,21
4,7,1,5,21
4,7,2,5,21
4,7,3,5,21
4,8,0,5,21
4,8,1,5,21
4,8,2,5,21
4,8,3,5,21
4,9,0,5,21
4,9,1,5,21
4,9,2,5,21
4,9,3,5,21
4,0,0,6,21
4,0,1,6,21
4,0,2,6,21
4,0,3,6,21
4,1,0,6,21
4,1,1,6,21
4,1,2,6,21
4,1,3,6,21
4,2,0,6,21
4,2,1,6,21
4,2,2,6,21
4,2,3,6,21
4,3,0,6,21
4,3,1,6,21
4,3,2,6,21
4,3,3,6,21
4,4,0,6,21
4,4,1,6,21
4,4,2,6,21
4,4,3,6,21
4,5,0,6,21
4,5,1,6,21
4,5,2,6,21
4,5,3,6,21
4,6,0,6,21
4,6,1,6,21
4,6,2,6,21
4,6,3,6,21
4,0,0,7,21
4,0,1,7,21
4,0,2,7,21
4,0,3,7,21
4,1,0,7,21
4,1,1,7,21
4,1,2,7,21
4,1,3,7,21
4,2,0,7,21
4,2,1,7,21
4,2,2,7,21
4,2,3,7,21
4,3,0,7,21
4,3,1,7,21
4,3,2,7,21
4,3,3,7,21
4,0,0,8,21
4,0,1,8,21
4,0,2,8,21
4,0,3,8,21
4,0,0,1,22
4,0,1,1,22
4,0,2,1,22
4,1,0,1,22
4,1,1,1,22
4,1,2,1,22
4,2,0,1,22
4,2,1,1,22
4,2,2,1,22
4,3,0,1,22
4,3,1,1,22
4,3,2,1,22
4,4,0,1,22
4,4,1,1,22
4,4,2,1,22
4,5,0,1,22
4,5,1,1,22
4,5,2,1,22
4,6,0,1,22
4,6,1,1,22
4,6,2,1,22
4,7,0,1,22
4,7,1,1,22
4,7,2,1,22
4,8,0,1,22
4,8,1,1,22
4,8,2,1,22
4,9,0,1,22
4,9,1,1,22
4,9,2,1,22
4,10,0,1,22
4,10,1,1,22
4,10,2,1,22
4,11,0,1,22
4,11,1,1,22
4,11,2,1,22
4,12,0,1,22
4,12,1,1,22
4,12,2,1,22
4,13,0,1,22
4,13,1,1,22
4,13,2,1,22
4,14,0,1,22
4,14,1,1,22
4,14,2,1,22
4,15,0,1,22
4,15,1,1,22
4,15,2,1,22
4,16,0,1,22
4,16,1,1,22
4,16,2,1,22
4,17,0,1,22
4,17,1,1,22
4,17,2,1,22
4,18,0,1,22
4,18,1,1,22
4,18,2,1,22
4,19,0,1,22
4,19,1,1,22
4,19,2,1,22
4,20,0,1,22
4,20,1,1,22
4,20,2,1,22
4,21,0,1,22
4,21,1,1,22
4,21,2,1,22
4,0,0,2,22
4,0,1,2,22
4,0,2,2,22
4,1,0,2,22
4,1,1,2,22
4,1,2,2,22
4,2,0,2,22
4,2,1,2,22
4,2,2,2,22
4,3,0,2,22
4,3,1,2,22
4,3,2,2,22
4,4,0,2,22
4,4,1,2,22
4,4,2,2,22
4,5,0,2,22
4,5,1,2,22
4,5,2,2,22
4,6,0,2,22
4,6,1,2,22
4,6,2,2,22
4,7,0,2,22
4,7,1,2,22
4,7,2,2,22
4,8,0,2,22
4,8,1,2,22
4,8,2,2,22
4,9,0,2,22
4,9,1,2,22
4,9,2,2,22
4,10,0,2,22
4,10,1,2,22
4,10,2,2,22
4,11,0,2,22
4,11,1,2,22
4,11,2,2,22
4,12,0,2,22
4,12,1,2,22
4,12,2,2,22
4,13,0,2,22
4,13,1,2,22
4,13,2,2,22
4,14,0,2,22
4,14,1,2,22
4,14,2,2,22
4,15,0,2,22
4,15,1,2,22
4,15,2,2,22
4,16,0,2,22
4,16,1,2,22
4,16,2,2,22
4,17,0,2,22
4,17,1,2,22
4,17,2,2,22
4,18,0,2,22
4,18,1,2,22
4,18,2,2,22
4,0,0,3,22
4,0,1,3,22
4,0,2,3,22
4,1,0,3,22
4,1,1,3,22
4,1,2,3,22
4,2,0,3,22
4,2,1,3,22
4,2,2,3,22
4,3,0,3,22
4,3,1,3,22
4,3,2,3,22
4,4,0,3,22
4,4,1,3,22
4,4,2,3,22
4,5,0,3,22
4,5,1,3,22
4,5,2,3,22
4,6,0,3,22
4,6,1,3,22
4,6,2,3,22
4,7,0,3,22
4,7,1,3,22
4,7,2,3,22
4,8,0,3,22
4,8,1,3,22
4,8,2,3,22
4,9,0,3,22
4,9,1,3,22
4,9,2,3,22
4,10,0,3,22
4,10,1,3,22
4,10,2,3,22
4,11,0,3,22
4,11,1,3,22
4,11,2,3,22
4,12,0,3,22
4,12,1,3,22
4,12,2,3,22
4,13,0,3,22
4,13,1,3,22
4,13,2,3,22
4,14,0,3,22
4,14,1,3,22
4,14,2,3,22
4,15,0,3,22
4,15,1,3,22
4,15,2,3,22
4,0,0,4,22
4,0,1,4,22
4,0,2,4,22
4,1,0,4,22
4,1,1,4,22
4,1,2,4,22
4,2,0,4,22
4,2,1,4,22
4,2,2,4,22
4,3,0,4,22
4,3,1,4,22
4,3,2,4,22
4,4,0,4,22
4,4,1,4,22
4,4,2,4,22
4,5,0,4,22
4,5,1,4,22
4,5,2,4,22
4,6,0,4,22
4,6,1,4,22
4,6,2,4,22
4,7,0,4,22
4,7,1,4,22
4,7,2,4,22
4,8,0,4,22
4,8,1,4,22
4,8,2,4,22
4,9,0,4,22
4,9,1,4,22
4,9,2,4,22
4,10,0,4,22
4,10,1,4,22
4,10,2,4,22
4,11,0,4,22
4,11,1,4,22
4,11,2,4,22
4,12,0,4,22
4,12,1,4,22
4,12,2,4,22
4,0,0,5,22
4,0,1,5,22
4,0,2,5,22
4,1,0,5,22
4,1,1,5,22
4,1,2,5,22
4,2,0,5,22
4,2,1,5,22
4,2,2,5,22
4,3,0,5,22
4,3,1,5,22
4,3,2,5,22
4,4,0,5,22
4,4,1,5,22
4,4,2,5,22
4,5,0,5,22
4,5,1,5,22
4,5,2,5,22
4,6,0,5,22
4,6,1,5,22
4,6,2,5,22
4,7,0,5,22
4,7,1,5,22
4,7,2,5,22
4,8,0,5,22
4,8,1,5,22
4,8,2,5,22
4,9,0,5,22
4,9,1,5,22
4,9,2,5,22
4,0,0,6,22
4,0,1,6,22
4,0,2,6,22
4,1,0,6,22
4,1,1,6,22
4,1,2,6,22
4,2,0,6,22
4,2,1,6,22
4,2,2,6,22
4,3,0,6,22
4,3,1,6,22
4,3,2,6,22
4,4,0,6,22
4,4,1,6,22
4,4,2,6,22
4,5,0,6,22
4,5,1,6,22
4,5,2,6,22
4,6,0,6,22
4,6,1,6,22
4,6,2,6,22
4,0,0,7,22
4,0,1,7,22
4,0,2,7,22
4,1,0,7,22
4,1,1,7,22
4,1,2,7,22
4,2,0,7,22
4,2,1,7,22
4,2,2,7,22
4,3,0,7,22
4,3,1,7,22
4,3,2,7,22
4,0,0,8,22
4,0,1,8,22
4,0,2,8,22
4,0,0,1,23
4,0,1,1,23
4,1,0,1,23
4,1,1,1,23
4,2,0,1,23
4,2,1,1,23
4,3,0,1,23
4,3,1,1,23
4,4,0,1,23
4,4,1,1,23
4,5,0,1,23
4,5,1,1,23
4,6,0,1,23
4,6,1,1,23
4,7,0,1,23
4,7,1,1,23
4,8,0,1,23
4,8,1,1,23
4,9,0,1,23
4,9,1,1,23
4,10,0,1,23
4,10,1,1,23
4,11,0,1,23
4,11,1,1,23
4,12,0,1,23
4,12,1,1,23
4,13,0,1,23
4,13,1,1,23
4,14,0,1,23
4,14,1,1,23
4,15,0,1,23
4,15,1,1,23
4,16,0,1,23
4,16,1,1,23
4,17,0,1,23
4,17,1,1,23
4,18,0,1,23
4,18,1,1,23
4,19,0,1,23
4,19,1,1,23
4,20,0,1,23
4,20,1,1,23
4,21,0,1,23
4,21,1,1,23
4,0,0,2,23
4,0,1,2,23
4,1,0,2,23
4,1,1,2,23
4,2,0,2,23
4,2,1,2,23
4,3,0,2,23
4,3,1,2,23
4,4,0,2,23
4,4,1,2,23
4,5,0,2,23
4,5,1,2,23
4,6,0,2,23
4,6,1,2,23
4,7,0,2,23
4,7,1,2,23
4,8,0,2,23
4,8,1,2,23
4,9,0,2,23
4,9,1,2,23
4,10,0,2,23
4,10,1,2,23
4,11,0,2,23
4,11,1,2,23
4,12,0,2,23
4,12,1,2,23
4,13,0,2,23
4,13,1,2,23
4,14,0,2,23
4,14,1,2,23
4,15,0,2,23
4,15,1,2,23
4,16,0,2,23
4,16,1,2,23
4,17,0,2,23
4,17,1,2,23
4,18,0,2,23
4,18,1,2,23
4,0,0,3,23
4,0,1,3,23
4,1,0,3,23
4,1,1,3,23
4,2,0,3,23
4,2,1,3,23
4,3,0,3,23
4,3,1,3,23
4,4,0,3,23
4,4,1,3,23
4,5,0,3,23
4,5,1,3,23
4,6,0,3,23
4,6,1,3,23
4,7,0,3,23
4,7,1,3,23
4,8,0,3,23
4,8,1,3,23
4,9,0,3,23
4,9,1,3,23
4,10,0,3,23
4,10,1,3,23
4,11,0,3,23
4,11,1,3,23
4,12,0,3,23
4,12,1,3,23
4,13,0,3,23
4,13,1,3,23
4,14,0,3,23
4,14,1,3,23
4,15,0,3,23
4,15,1,3,23
4,0,0,4,23
4,0,1,4,23
4,1,0,4,23
4,1,1,4,23
4,2,0,4,23
4,2,1,4,23
4,3,0,4,23
4,3,1,4,23
4,4,0,4,23
4,4,1,4,23
4,5,0,4,23
4,5,1,4,23
4,6,0,4,23
4,6,1,4,23
4,7,0,4,23
4,7,1,4,23
4,8,0,4,23
4,8,1,4,23
4,9,0,4,23
4,9,1,4,23
4,10,0,4,23
4,10,1,4,23
4,11,0,4,23
4,11,1,4,23
4,12,0,4,23
4,12,1,4,23
4,0,0,5,23
4,0,1,5,23
4,1,0,5,23
4,1,1,5,23
4,2,0,5,23
4,2,1,5,23
4,3,0,5,23
4,3,1,5,23
4,4,0,5,23
4,4,1,5,23
4,5,0,5,23
4,5,1,5,23
4,6,0,5,23
4,6,1,5,23
4,7,0,5,23
4,7,1,5,23
4,8,0,5,23
4,8,1,5,23
4,9,0,5,23
4,9,1,5,23
4,0,0,6,23
4,0,1,6,23
4,1,0,6,23
4,1,1,6,23
4,2,0,6,23
4,2,1,6,23
4,3,0,6,23
4,3,1,6,23
4,4,0,6,23
4,4,1,6,23
4,5,0,6,23
4,5,1,6,23
4,6,0,6,23
4,6,1,6,23
4,0,0,7,23
4,0,1,7,23
4,1,0,7,23
4,1,1,7,23
4,2,0,7,23
4,2,1,7,23
4,3,0,7,23
4,3,1,7,23
4,0,0,8,23
4,0,1,8,23
4,0,0,1,24
4,1,0,1,24
4,2,0,1,24
4,3,0,1,24
4,4,0,1,24
4,5,0,1,24
4,6,0,1,24
4,7,0,1,24
4,8,0,1,24
4,9,0,1,24
4,10,0,1,24
4,11,0,1,24
4,12,0,1,24
4,13,0,1,24
4,14,0,1,24
4,15,0,1,24
4,16,0,1,24
4,17,0,1,24
4,18,0,1,24
4,19,0,1,24
4,20,0,1,24
4,21,0,1,24
4,0,0,2,24
4,1,0,2,24
4,2,0,2,24
4,3,0,2,24
4,4,0,2,24
4,5,0,2,24
4,6,0,2,24
4,7,0,2,24
4,8,0,2,24
4,9,0,2,24
4,10,0,2,24
4,11,0,2,24
4,12,0,2,24
4,13,0,2,24
4,14,0,2,24
4,15,0,2,24
4,16,0,2,24
4,17,0,2,24
4,18,0,2,24
4,0,0,3,24
4,1,0,3,24
4,2,0,3,24
4,3,0,3,24
4,4,0,3,24
4,5,0,3,24
4,6,0,3,24
4,7,0,3,24
4,8,0,3,24
4,9,0,3,24
4,10,0,3,24
4,11,0,3,24
4,12,0,3,24
4,13,0,3,24
4,14,0,3,24
4,15,0,3,24
4,0,0,4,24
4,1,0,4,24
4,2,0,4,24
4,3,0,4,24
4,4,0,4,24
4,5,0,4,24
4,6,0,4,24
4,7,0,4,24
4,8,0,4,24
4,9,0,4,24
4,10,0,4,24
4,11,0,4,24
4,12,0,4,24
4,0,0,5,24
4,1,0,5,24
4,2,0,5,24
4,3,0,5,24
4,4,0,5,24
4,5,0,5,24
4,6,0,5,24
4,7,0,5,24
4,8,0,5,24
4,9,0,5,24
4,0,0,6,24
4,1,0,6,24
4,2,0,6,24
4,3,0,6,24
4,4,0,6,24
4,5,0,6,24
4,6,0,6,24
4,0,0,7,24
4,1,0,7,24
4,2,0,7,24
4,3,0,7,24
4,0,0,8,24
5,0,0,1,1
5,0,1,1,1
5,0,2,1,1
5,0,3,1,1
5,0,4,1,1
5,0,5,1,1
5,0,6,1,1
5,0,7,1,1
5,0,8,1,1
5,0,9,1,1
5,0,10,1,1
5,0,11,1,1
5,0,12,1,1
5,0,13,1,1
5,0,14,1,1
5,0,15,1,1
5,0,16,1,1
5,0,17,1,1
5,0,18,1,1
5,0,19,1,1
5,0,20,1,1
5,0,21,1,1
5,0,22,1,1
5,1,0,1,1
5,1,1,1,1
5,1,2,1,1
5,1,3,1,1
5,1,4,1,1
5,1,5,1,1
5,1,6,1,1
5,1,7,1,1
5,1,8,1,1
5,1,9,1,1
5,1,10,1,1
5,1,11,1,1
5,1,12,1,1
5,1,13,1,1
5,1,14,1,1
5,1,15,1,1
5,1,16,1,1
5,1,17,1,1
5,1,18,1,1
5,1,19,1,1
5,1,20,1,1
5,1,21,1,1
5,1,22,1,1
5,2,0,1,1
5,2,1,1,1
5,2,2,1,1
5,2,3,1,1
5,2,4,1,1
5,2,5,1,1
5,2,6,1,1
5,2,7,1,1
5,2,8,1,1
5,2,9,1,1
5,2,10,1,1
5,2,11,1,1
5,2,12,1,1
5,2,13,1,1
5,2,14,1,1
5,2,15,1,1
5,2,16,1,1
5,2,17,1,1
5,2,18,1,1
5,2,19,1,1
5,2,20,1,1
5,2,21,1,1
5,2,22,1,1
5,3,0,1,1
5,3,1,1,1
5,3,2,1,1
5,3,3,1,1
5,3,4,1,1
5,3,5,1,1
5,3,6,1,1
5,3,7,1,1
5,3,8,1,1
5,3,9,1,1
5,3,10,1,1
5,3,11,1,1
5,3,12,1,1
5,3,13,1,1
5,3,14,1,1
5,3,15,1,1
5,3,16,1,1
5,3,17,1,1
5,3,18,1,1
5,3,19,1,1
5,3,20,1,1
5,3,21,1,1
5,3,22,1,1
5,4,0,1,1
5,4,1,1,1
5,4,2,1,1
5,4,3,1,1
5,4,4,1,1
5,4,5,1,1
5,4,6,1,1
5,4,7,1,1
5,4,8,1,1
5,4,9,1,1
5,4,10,1,1
5,4,11,1,1
5,4,12,1,1
5,4,13,1,1
5,4,14,1,1
5,4,15,1,1
5,4,16,1,1
5,4,17,1,1
5,4,18,1,1
5,4,19,1,1
5,4,20,1,1
5,4,21,1,1
5,4,22,1,1
5,5,0,1,1
5,5,1,1,1
5,5,2,1,1
5,5,3,1,1
5,5,4,1,1
5,5,5,1,1
5,5,6,1,1
5,5,7,1,1
5,5,8,1,1
5,5,9,1,1
5,5,10,1,1
5,5,11,1,1
5,5,12,1,1
5,5,13,1,1
5,5,14,1,1
5,5,15,1,1
5,5,16,1,1
5,5,17,1,1
5,5,18,1,1
5,5,19,1,1
5,5,20,1,1
5,5,21,1,1
5,5,22,1,1
5,6,0,1,1
5,6,1,1,1
5,6,2,1,1
5,6,3,1,1
5,6,4,1,1
5,6,5,1,1
5,6,6,1,1
5,6,7,1,1
5,6,8,1,1
5,6,9,1,1
5,6,10,1,1
5,6,11,1,1
5,6,12,1,1
5,6,13,1,1
5,6,14,1,1
5,6,15,1,1
5,6,16,1,1
5,6,17,1,1
5,6,18,1,1
5,6,19,1,1
5,6,20,1,1
5,6,21,1,1
5,6,22,1,1
5,7,0,1,1
5,7,1,1,1
5,7,2,1,1
5,7,3,1,1
5,7,4,1,1
5,7,5,1,1
5,7,6,1,1
5,7,7,1,1
5,7,8,1,1
5,7,9,1,1
5,7,10,1,1
5,7,11,1,1
5,7,12,1,1
5,7,13,1,1
5,7,14,1,1
5,7,15,1,1
5,7,16,1,1
5,7,17,1,1
5,7,18,1,1
5,7,19,1,1
5,7,20,1,1
5,7,21,1,1
5,7,22,1,1
5,8,0,1,1
5,8,1,1,1
5,8,2,1,1
5,8,3,1,1
5,8,4,1,1
5,8,5,1,1
5,8,6,1,1
5,8,7,1,1
5,8,8,1,1
5,8,9,1,1
5,8,10,1,1
5,8,11,1,1
5,8,12,1,1
5,8,13,1,1
5,8,14,1,1
5,8,15,1,1
5,8,16,1,1
5,8,17,1,1
5,8,18,1,1
5,8,19,1,1
5,8,20,1,1
5,8,21,1,1
5,8,22,1,1
5,9,0,1,1
5,9,1,1,1
5,9,2,1,1
5,9,3,1,1
5,9,4,1,1
5,9,5,1,1
5,9,6,1,1
5,9,7,1,1
5,9,8,1,1
5,9,9,1,1
5,9,10,1,1
5,9,11,1,1
5,9,12,1,1
5,9,13,1,1
5,9,14,1,1
5,9,15,1,1
5,9,16,1,1
5,9,17,1,1
5,9,18,1,1
5,9,19,1,1
5,9,20,1,1
5,9,21,1,1
5,9,22,1,1
5,10,0,1,1
5,10,1,1,1
5,10,2,1,1
5,10,3,1,1
5,10,4,1,1
5,10,5,1,1
5,10,6,1,1
5,10,7,1,1
5,10,8,1,1
5,10,9,1,1
5,10,10,1,1
5,10,11,1,1
5,10,12,1,1
5,10,13,1,1
5,10,14,1,1
5,10,15,1,1
5,10,16,1,1
5,10,17,1,1
5,10,18,1,1
5,10,19,1,1
5,10,20,1,1
5,10,21,1,1
5,10,22,1,1
5,11,0,1,1
5,11,1,1,1
5,11,2,1,1
5,11,3,1,1
5,11,4,1,1
5,11,5,1,1
5,11,6,1,1
5,11,7,1,1
5,11,8,1,1
5,11,9,1,1
5,11,10,1,1
5,11,11,1,1
5,11,12,1,1
5,11,13,1,1
5,11,14,1,1
5,11,15,1,1
5,11,16,1,1
5,11,17,1,1
5,11,18,1,1
5,11,19,1,1
5,11,20,1,1
5,11,21,1,1
5,11,22,1,1
5,12,0,1,1
5,12,1,1,1
5,12,2,1,1
5,12,3,1,1
5,12,4,1,1
5,12,5,1,1
5,12,6,1,1
5,12,7,1,1
5,12,8,1,1
5,12,9,1,1
5,12,10,1,1
5,12,11,1,1
5,12,12,1,1
5,12,13,1,1
5,12,14,1,1
5,12,15,1,1
5,12,16,1,1
5,12,17,1,1
5,12,18,1,1
5,12,19,1,1
5,12,20,1,1
5,12,21,1,1
5,12,22,1,1
5,13,0,1,1
5,13,1,1,1
5,13,2,1,1
5,13,3,1,1
5,13,4,1,1
5,13,5,1,1
5,13,6,1,1
5,13,7,1,1
5,13,8,1,1
5,13,9,1,1
5,13,10,1,1
5,13,11,1,1
5,13,12,1,1
5,13,13,1,1
5,13,14,1,1
5,13,15,1,1
5,13,16,1,1
5,13,17,1,1
5,13,18,1,1
5,13,19,1,1
5,13,20,1,1
5,13,21,1,1
5,13,22,1,1
5,14,0,1,1
5,14,1,1,1
5,14,2,1,1
5,14,3,1,1
5,14,4,1,1
5,14,5,1,1
5,14,6,1,1
5,14,7,1,1
5,14,8,1,1
5,14,9,1,1
5,14,10,1,1
5,14,11,1,1
5,14,12,1,1
5,14,13,1,1
5,14,14,1,1
5,14,15,1,1
5,14,16,1,1
5,14,17,1,1
5,14,18,1,1
5,14,19,1,1
5,14,20,1,1
5,14,21,1,1
5,14,22,1,1
5,15,0,1,1
5,15,1,1,1
5,15,2,1,1
5,15,3,1,1
5,15,4,1,1
5,15,5,1,1
5,15,6,1,1
5,15,7,1,1
5,15,8,1,1
5,15,9,1,1
5,15,10,1,1
5,15,11,1,1
5,15,12,1,1
5,15,13,1,1
5,15,14,1,1
5,15,15,1,1
5,15,16,1,1
5,15,17,1,1
5,15,18,1,1
5,15,19,1,1
5,15,20,1,1
5,15,21,1,1
5,15,22,1,1
5,16,0,1,1
5,16,1,1,1
5,16,2,1,1
5,16,3,1,1
5,16,4,1,1
5,16,5,1,1
5,16,6,1,1
5,16,7,1,1
5,16,8,1,1
5,16,9,1,1
5,16,10,1,1
5,16,11,1,1
5,16,12,1,1
5,16,13,1,1
5,16,14,1,1
5,16,15,1,1
5,16,16,1,1
5,16,17,1,1
5,16,18,1,1
5,16,19,1,1
5,16,20,1,1
5,16,21,1,1
5,16,22,1,1
5,17,0,1,1
5,17,1,1,1
5,17,2,1,1
5,17,3,1,1
5,17,4,1,1
5,17,5,1,1
5,17,6,1,1
5,17,7,1,1
5,17,8,1,1
5,17,9,1,1
5,17,10,1,1
5,17,11,1,1
5,17,12,1,1
5,17,13,1,1
5,17,14,1,1
5,17,15,1,1
5,17,16,1,1
5,17,17,1,1
5,17,18,1,1
5,17,19,1,1
5,17,20,1,1
5,17,21,1,1
5,17,22,1,1
5,18,0,1,1
5,18,1,1,1
5,18,2,1,1
5,18,3,1,1
5,18,4,1,1
5,18,5,1,1
5,18,6,1,1
5,18,7,1,1
5,18,8,1,1
5,18,9,1,1
5,18,10,1,1
5,18,11,1,1
5,18,12,1,1
5,18,13,1,1
5,18,14,1,1
5,18,15,1,1
5,18,16,1,1
5,18,17,1,1
5,18,18,1,1
5,18,19,1,1
5,18,20,1,1
5,18,21,1,1
5,18,22,1,1
5,19,0,1,1
5,19,1,1,1
5,19,2,1,1
5,19,3,1,1
5,19,4,1,1
5,19,5,1,1
5,19,6,1,1
5,19,7,1,1
5,19,8,1,1
5,19,9,1,1
5,19,10,1,1
5,19,11,1,1
5,19,12,1,1
5,19,13,1,1
5,19,14,1,1
5,19,15,1,1
5,19,16,1,1
5,19,17,1,1
5,19,18,1,1
5,19,19,1,1
5,19,20,1,1
5,19,21,1,1
5,19,22,1,1
5,20,0,1,1
5,20,1,1,1
5,20,2,1,1
5,20,3,1,1
5,20,4,1,1
5,20,5,1,1
5,20,6,1,1
5,20,7,1,1
5,20,8,1,1
5,20,9,1,1
5,20,10,1,1
5,20,11,1,1
5,20,12,1,1
5,20,13,1,1
5,20,14,1,1
5,20,15,1,1
5,20,16,1,1
5,20,17,1,1
5,20,18,1,1
5,20,19,1,1
5,20,20,1,1
5,20,21,1,1
5,20,22,1,1
5,21,0,1,1
5,21,1,1,1
5,21,2,1,1
5,21,3,1,1
5,21,4,1,1
5,21,5,1,1
5,21,6,1,1
5,21,7,1,1
5,21,8,1,1
5,21,9,1,1
5,21,10,1,1
5,21,11,1,1
5,21,12,1,1
5,21,13,1,1
5,21,14,1,1
5,21,15,1,1
5,21,16,1,1
5,21,17,1,1
5,21,18,1,1
5,21,19,1,1
5,21,20,1,1
5,21,21,1,1
5,21,22,1,1
5,22,0,1,1
5,22,1,1,1
5,22,2,1,1
5,22,3,1,1
5,22,4,1,1
5,22,5,1,1
5,22,6,1,1
5,22,7,1,1
5,22,8,1,1
5,22,9,1,1
5,22,10,1,1
5,22,11,1,1
5,22,12,1,1
5,22,13,1,1
5,22,14,1,1
5,22,15,1,1
5,22,16,1,1
5,22,17,1,1
5,22,18,1,1
5,22,19,1,1
5,22,20,1,1
5,22,21,1,1
5,22,22,1,1
5,0,0,2,1
5,0,1,2,1
5,0,2,2,1
5,0,3,2,1
5,0,4,2,1
5,0,5,2,1
5,0,6,2,1
5,0,7,2,1
5,0,8,2,1
5,0,9,2,1
5,0,10,2,1
5,0,11,2,1
5,0,12,2,1
5,0,13,2,1
5,0,14,2,1
5,0,15,2,1
5,0,16,2,1
5,0,17,2,1
5,0,18,2,1
5,0,19,2,1
5,0,20,2,1
5,0,21,2,1
5,0,22,2,1
5,1,0,2,1
5,1,1,2,1
5,1,2,2,1
5,1,3,2,1
5,1,4,2,1
5,1,5,2,1
5,1,6,2,1
5,1,7,2,1
5,1,8,2,1
5,1,9,2,1
5,1,10,2,1
5,1,11,2,1
5,1,12,2,1
5,1,13,2,1
5,1,14,2,1
5,1,15,2,1
5,1,16,2,1
5,1,17,2,1
5,1,18,2,1
5,1,19,2,1
5,1,20,2,1
5,1,21,2,1
5,1,22,2,1
5,2,0,2,1
5,2,1,2,1
5,2,2,2,1
5,2,3,2,1
5,2,4,2,1
5,2,5,2,1
5,2,6,2,1
5,2,7,2,1
5,2,8,2,1
5,2,9,2,1
5,2,10,2,1
5,2,11,2,1
5,2,12,2,1
5,2,13,2,1
5,2,14,2,1
5,2,15,2,1
5,2,16,2,1
5,2,17,2,1
5,2,18,2,1
5,2,19,2,1
5,2,20,2,1
5,2,21,2,1
5,2,22,2,1
5,3,0,2,1
5,3,1,2,1
5,3,2,2,1
5,3,3,2,1
5,3,4,2,1
5,3,5,2,1
5,3,6,2,1
5,3,7,2,1
5,3,8,2,1
5,3,9,2,1
5,3,10,2,1
5,3,11,2,1
5,3,12,2,1
5,3,13,2,1
5,3,14,2,1
5,3,15,2,1
5,3,16,2,1
5,3,17,2,1
5,3,18,2,1
5,3,19,2,1
5,3,20,2,1
5,3,21,2,1
5,3,22,2,1
5,4,0,2,1
5,4,1,2,1
5,4,2,2,1
5,4,3,2,1
5,4,4,2,1
5,4,5,2,1
5,4,6,2,1
5,4,7,2,1
5,4,8,2,1
5,4,9,2,1
5,4,10,2,1
5,4,11,2,1
5,4,12,2,1
5,4,13,2,1
5,4,14,2,1
5,4,15,2,1
5,4,16,2,1
5,4,17,2,1
5,4,18,2,1
5,4,19,2,1
5,4,20,2,1
5,4,21,2,1
5,4,22,2,1
5,5,0,2,1
5,5,1,2,1
5,5,2,2,1
5,5,3,2,1
5,5,4,2,1
5,5,5,2,1
5,5,6,2,1
5,5,7,2,1
5,5,8,2,1
5,5,9,2,1
5,5,10,2,1
5,5,11,2,1
5,5,12,2,1
5,5,13,2,1
5,5,14,2,1
5,5,15,2,1
5,5,16,2,1
5,5,17,2,1
5,5,18,2,1
5,5,19,2,1
5,5,20,2,1
5,5,21,2,1
5,5,22,2,1
5,6,0,2,1
5,6,1,2,1
5,6,2,2,1
5,6,3,2,1
5,6,4,2,1
5,6,5,2,1
5,6,6,2,1
5,6,7,2,1
5,6,8,2,1
5,6,9,2,1
5,6,10,2,1
5,6,11,2,1
5,6,12,2,1
5,6,13,2,1
5,6,14,2,1
5,6,15,2,1
5,6,16,2,1
5,6,17,2,1
5,6,18,2,1
5,6,19,2,1
5,6,20,2,1
5,6,21,2,1
5,6,22,2,1
5,7,0,2,1
5,7,1,2,1
5,7,2,2,1
5,7,3,2,1
5,7,4,2,1
5,7,5,2,1
5,7,6,2,1
5,7,7,2,1
5,7,8,2,1
5,7,9,2,1
5,7,10,2,1
5,7,11,2,1
5,7,12,2,1
5,7,13,2,1
5,7,14,2,1
5,7,15,2,1
5,7,16,2,1
5,7,17,2,1
5,7,18,2,1
5,7,19,2,1
5,7,20,2,1
5,7,21,2,1
5,7,22,2,1
5,8,0,2,1
5,8,1,2,1
5,8,2,2,1
5,8,3,2,1
5,8,4,2,1
5,8,5,2,1
5,8,6,2,1
5,8,7,2,1
5,8,8,2,1
5,8,9,2,1
5,8,10,2,1
5,8,11,2,1
5,8,12,2,1
5,8,13,2,1
5,8,14,2,1
5,8,15,2,1
5,8,16,2,1
5,8,17,2,1
5,8,18,2,1
5,8,19,2,1
5,8,20,2,1
5,8,21,2,1
5,8,22,2,1
5,9,0,2,1
5,9,1,2,1
5,9,2,2,1
5,9,3,2,1
5,9,4,2,1
5,9,5,2,1
5,9,6,2,1
5,9,7,2,1
5,9,8,2,1
5,9,9,2,1
5,9,10,2,1
5,9,11,2,1
5,9,12,2,1
5,9,13,2,1
5,9,14,2,1
5,9,15,2,1
5,9,16,2,1
5,9,17,2,1
5,9,18,2,1
5,9,19,2,1
5,9,20,2,1
5,9,21,2,1
5,9,22,2,1
5,10,0,2,1
5,10,1,2,1
5,10,2,2,1
5,10,3,2,1
5,10,4,2,1
5,10,5,2,1
5,10,6,2,1
5,10,7,2,1
5,10,8,2,1
5,10,9,2,1
5,10,10,2,1
5,10,11,2,1
5,10,12,2,1
5,10,13,2,1
5,10,14,2,1
5,10,15,2,1
5,10,16,2,1
5,10,17,2,1
5,10,18,2,1
5,10,19,2,1
5,10,20,2,1
5,10,21,2,1
5,10,22,2,1
5,11,0,2,1
5,11,1,2,1
5,11,2,2,1
5,11,3,2,1
5,11,4,2,1
5,11,5,2,1
5,11,6,2,1
5,11,7,2,1
5,11,8,2,1
5,11,9,2,1
5,11,10,2,1
5,11,11,2,1
5,11,12,2,1
5,11,13,2,1
5,11,14,2,1
5,11,15,2,1
5,11,16,2,1
5,11,17,2,1
5,11,18,2,1
5,11,19,2,1
5,11,20,2,1
5,11,21,2,1
5,11,22,2,1
5,12,0,2,1
5,12,1,2,1
5,12,2,2,1
5,12,3,2,1
5,12,4,2,1
5,12,5,2,1
5,12,6,2,1
5,12,7,2,1
5,12,8,2,1
5,12,9,2,1
5,12,10,2,1
5,12,11,2,1
5,12,12,2,1
5,12,13,2,1
5,12,14,2,1
5,12,15,2,1
5,12,16,2,1
5,12,17,2,1
5,12,18,2,1
5,12,19,2,1
5,12,20,2,1
5,12,21,2,1
5,12,22,2,1
5,13,0,2,1
5,13,1,2,1
5,13,2,2,1
5,13,3,2,1
5,13,4,2,1
5,13,5,2,1
5,13,6,2,1
5,13,7,2,1
5,13,8,2,1
5,13,9,2,1
5,13,10,2,1
5,13,11,2,1
5,13,12,2,1
5,13,13,2,1
5,13,14,2,1
5,13,15,2,1
5,13,16,2,1
5,13,17,2,1
5,13,18,2,1
5,13,19,2,1
5,13,20,2,1
5,13,21,2,1
5,13,22,2,1
5,14,0,2,1
5,14,1,2,1
5,14,2,2,1
5,14,3,2,1
5,14,4,2,1
5,14,5,2,1
5,14,6,2,1
5,14,7,2,1
5,14,8,2,1
5,14,9,2,1
5,14,10,2,1
5,14,11,2,1
5,14,12,2,1
5,14,13,2,1
5,14,14,2,1
5,14,15,2,1
5,14,16,2,1
5,14,17,2,1
5,14,18,2,1
5,14,19,2,1
5,14,20,2,1
5,14,21,2,1
5,14,22,2,1
5,15,0,2,1
5,15,1,2,1
5,15,2,2,1
5,15,3,2,1
5,15,4,2,1
5,15,5,2,1
5,15,6,2,1
5,15,7,2,1
5,15,8,2,1
5,15,9,2,1
5,15,10,2,1
5,15,11,2,1
5,15,12,2,1
5,15,13,2,1
5,15,14,2,1
5,15,15,2,1
5,15,16,2,1
5,15,17,2,1
5,15,18,2,1
5,15,19,2,1
5,15,20,2,1
5,15,21,2,1
5,15,22,2,1
5,16,0,2,1
5,16,1,2,1
5,16,2,2,1
5,16,3,2,1
5,16,4,2,1
5,16,5,2,1
5,16,6,2,1
5,16,7,2,1
5,16,8,2,1
5,16,9,2,1
5,16,10,2,1
5,16,11,2,1
5,16,12,2,1
5,16,13,2,1
5,16,14,2,1
5,16,15,2,1
5,16,16,2,1
5,16,17,2,1
5,16,18,2,1
5,16,19,2,1
5,16,20,2,1
5,16,21,2,1
5,16,22,2,1
5,17,0,2,1
5,17,1,2,1
5,17,2,2,1
5,17,3,2,1
5,17,4,2,1
5,17,5,2,1
5,17,6,2,1
5,17,7,2,1
5,17,8,2,1
5,17,9,2,1
5,17,10,2,1
5,17,11,2,1
5,17,12,2,1
5,17,13,2,1
5,17,14,2,1
5,17,15,2,1
5,17,16,2,1
5,17,17,2,1
5,17,18,2,1
5,17,19,2,1
5,17,20,2,1
5,17,21,2,1
5,17,22,2,1
5,18,0,2,1
5,18,1,2,1
5,18,2,2,1
5,18,3,2,1
5,18,4,2,1
5,18,5,2,1
5,18,6,2,1
5,18,7,2,1
5,18,8,2,1
5,18,9,2,1
5,18,10,2,1
5,18,11,2,1
5,18,12,2,1
5,18,13,2,1
5,18,14,2,1
5,18,15,2,1
5,18,16,2,1
5,18,17,2,1
5,18,18,2,1
5,18,19,2,1
5,18,20,2,1
5,18,21,2,1
5,18,22,2,1
5,19,0,2,1
5,19,1,2,1
5,19,2,2,1
5,19,3,2,1
5,19,4,2,1
5,19,5,2,1
5,19,6,2,1
5,19,7,2,1
5,19,8,2,1
5,19,9,2,1
5,19,10,2,1
5,19,11,2,1
5,19,12,2,1
5,19,13,2,1
5,19,14,2,1
5,19,15,2,1
5,19,16,2,1
5,19,17,2,1
5,19,18,2,1
5,19,19,2,1
5,19,20,2,1
5,19,21,2,1
5,19,22,2,1
5,20,0,2,1
5,20,1,2,1
5,20,2,2,1
5,20,3,2,1
5,20,4,2,1
5,20,5,2,1
5,20,6,2,1
5,20,7,2,1
5,20,8,2,1
5,20,9,2,1
5,20,10,2,1
5,20,11,2,1
5,20,12,2,1
5,20,13,2,1
5,20,14,2,1
5,20,15,2,1
5,20,16,2,1
5,20,17,2,1
5,20,18,2,1
5,20,19,2,1
5,20,20,2,1
5,20,21,2,1
5,20,22,2,1
5,0,0,3,1
5,0,1,3,1
5,0,2,3,1
5,0,3,3,1
5,0,4,3,1
5,0,5,3,1
5,0,6,3,1
5,0,7,3,1
5,0,8,3,1
5,0,9,3,1
5,0,10,3,1
5,0,11,3,1
5,0,12,3,1
5,0,13,3,1
5,0,14,3,1
5,0,15,3,1
5,0,16,3,1
5,0,17,3,1
5,0,18,3,1
5,0,19,3,1
5,0,20,3,1
5,0,21,3,1
5,0,22,3,1
5,1,0,3,1
5,1,1,3,1
5,1,2,3,1
5,1,3,3,1
5,1,4,3,1
5,1,5,3,1
5,1,6,3,1
5,1,7,3,1
5,1,8,3,1
5,1,9,3,1
5,1,10,3,1
5,1,11,3,1
5,1,12,3,1
5,1,13,3,1
5,1,14,3,1
5,1,15,3,1
5,1,16,3,1
5,1,17,3,1
5,1,18,3,1
5,1,19,3,1
5,1,20,3,1
5,1,21,3,1
5,1,22,3,1
5,2,0,3,1
5,2,1,3,1
5,2,2,3,1
5,2,3,3,1
5,2,4,3,1
5,2,5,3,1
5,2,6,3,1
5,2,7,3,1
5,2,8,3,1
5,2,9,3,1
5,2,10,3,1
5,2,11,3,1
5,2,12,3,1
5,2,13,3,1
5,2,14,3,1
5,2,15,3,1
5,2,16,3,1
5,2,17,3,1
5,2,18,3,1
5,2,19,3,1
5,2,20,3,1
5,2,21,3,1
5,2,22,3,1
5,3,0,3,1
5,3,1,3,1
5,3,2,3,1
5,3,3,3,1
5,3,4,3,1
5,3,5,3,1
5,3,6,3,1
5,3,7,3,1
5,3,8,3,1
5,3,9,3,1
5,3,10,3,1
5,3,11,3,1
5,3,12,3,1
5,3,13,3,1
5,3,14,3,1
5,3,15,3,1
5,3,16,3,1
5,3,17,3,1
5,3,18,3,1
5,3,19,3,1
5,3,20,3,1
5,3,21,3,1
5,3,22,3,1
5,4,0,3,1
5,4,1,3,1
5,4,2,3,1
5,4,3,3,1
5,4,4,3,1
5,4,5,3,1
5,4,6,3,1
5,4,7,3,1
5,4,8,3,1
5,4,9,3,1
5,4,10,3,1
5,4,11,3,1
5,4,12,3,1
5,4,13,3,1
5,4,14,3,1
5,4,15,3,1
5,4,16,3,1
5,4,17,3,1
5,4,18,3,1
5,4,19,3,1
5,4,20,3,1
5,4,21,3,1
5,4,22,3,1
5,5,0,3,1
5,5,1,3,1
5,5,2,3,1
5,5,3,3,1
5,5,4,3,1
5,5,5,3,1
5,5,6,3,1
5,5,7,3,1
5,5,8,3,1
5,5,9,3,1
5,5,10,3,1
5,5,11,3,1
5,5,12,3,1
5,5,13,3,1
5,5,14,3,1
5,5,15,3,1
5,5,16,3,1
5,5,17,3,1
5,5,18,3,1
5,5,19,3,1
5,5,20,3,1
5,5,21,3,1
5,5,22,3,1
5,6,0,3,1
5,6,1,3,1
5,6,2,3,1
5,6,3,3,1
5,6,4,3,1
5,6,5,3,1
5,6,6,3,1
5,6,7,3,1
5,6,8,3,1
5,6,9,3,1
5,6,10,3,1
5,6,11,3,1
5,6,12,3,1
5,6,13,3,1
5,6,14,3,1
5,6,15,3,1
5,6,16,3,1
5,6,17,3,1
5,6,18,3,1
5,6,19,3,1
5,6,20,3,1
5,6,21,3,1
5,6,22,3,1
5,7,0,3,1
5,7,1,3,1
5,7,2,3,1
5,7,3,3,1
5,7,4,3,1
5,7,5,3,1
5,7,6,3,1
5,7,7,3,1
5,7,8,3,1
5,7,9,3,1
5,7,10,3,1
5,7,11,3,1
5,7,12,3,1
5,7,13,3,1
5,7,14,3,1
5,7,15,3,1
5,7,16,3,1
5,7,17,3,1
5,7,18,3,1
5,7,19,3,1
5,7,20,3,1
5,7,21,3,1
5,7,22,3,1
5,8,0,3,1
5,8,1,3,1
5,8,2,3,1
5,8,3,3,1
5,8,4,3,1
5,8,5,3,1
5,8,6,3,1
5,8,7,3,1
5,8,8,3,1
5,8,9,3,1
5,8,10,3,1
5,8,11,3,1
5,8,12,3,1
5,8,13,3,1
5,8,14,3,1
5,8,15,3,1
5,8,16,3,1
5,8,17,3,1
5,8,18,3,1
5,8,19,3,1
5,8,20,3,1
5,8,21,3,1
5,8,22,3,1
5,9,0,3,1
5,9,1,3,1
5,9,2,3,1
5,9,3,3,1
5,9,4,3,1
5,9,5,3,1
5,9,6,3,1
5,9,7,3,1
5,9,8,3,1
5,9,9,3,1
5,9,10,3,1
5,9,11,3,1
5,9,12,3,1
5,9,13,3,1
5,9,14,3,1
5,9,15,3,1
5,9,16,3,1
5,9,17,3,1
5,9,18,3,1
5,9,19,3,1
5,9,20,3,1
5,9,21,3,1
5,9,22,3,1
5,10,0,3,1
5,10,1,3,1
5,10,2,3,1
5,10,3,3,1
5,10,4,3,1
5,10,5,3,1
5,10,6,3,1
5,10,7,3,1
5,10,8,3,1
5,10,9,3,1
5,10,10,3,1
5,10,11,3,1
5,10,12,3,1
5,10,13,3,1
5,10,14,3,1
5,10,15,3,1
5,10,16,3,1
5,10,17,3,1
5,10,18,3,1
5,10,19,3,1
5,10,20,3,1
5,10,21,3,1
5,10,22,3,1
5,11,0,3,1
5,11,1,3,1
5,11,2,3,1
5,11,3,3,1
5,11,4,3,1
5,11,5,3,1
5,11,6,3,1
5,11,7,3,1
5,11,8,3,1
5,11,9,3,1
5,11,10,3,1
5,11,11,3,1
5,11,12,3,1
5,11,13,3,1
5,11,14,3,1
5,11,15,3,1
5,11,16,3,1
5,11,17,3,1
5,11,18,3,1
5,11,19,3,1
5,11,20,3,1
5,11,21,3,1
5,11,22,3,1
5,12,0,3,1
5,12,1,3,1
5,12,2,3,1
5,12,3,3,1
5,12,4,3,1
5,12,5,3,1
5,12,6,3,1
5,12,7,3,1
5,12,8,3,1
5,12,9,3,1
5,12,10,3,1
5,12,11,3,1
5,12,12,3,1
5,12,13,3,1
5,12,14,3,1
5,12,15,3,1
5,12,16,3,1
5,12,17,3,1
5,12,18,3,1
5,12,19,3,1
5,12,20,3,1
5,12,21,3,1
5,12,22,3,1
5,13,0,3,1
5,13,1,3,1
5,13,2,3,1
5,13,3,3,1
5,13,4,3,1
5,13,5,3,1
5,13,6,3,1
5,13,7,3,1
5,13,8,3,1
5,13,9,3,1
5,13,10,3,1
5,13,11,3,1
5,13,12,3,1
5,13,13,3,1
5,13,14,3,1
5,13,15,3,1
5,13,16,3,1
5,13,17,3,1
5,13,18,3,1
5,13,19,3,1
5,13,20,3,1
5,13,21,3,1
5,13,22,3,1
5,14,0,3,1
5,14,1,3,1
5,14,2,3,1
5,14,3,3,1
5,14,4,3,1
5,14,5,3,1
5,14,6,3,1
5,14,7,3,1
5,14,8,3,1
5,14,9,3,1
5,14,10,3,1
5,14,11,3,1
5,14,12,3,1
5,14,13,3,1
5,14,14,3,1
5,14,15,3,1
5,14,16,3,1
5,14,17,3,1
5,14,18,3,1
5,14,19,3,1
5,14,20,3,1
5,14,21,3,1
5,14,22,3,1
5,15,0,3,1
5,15,1,3,1
5,15,2,3,1
5,15,3,3,1
5,15,4,3,1
5,15,5,3,1
5,15,6,3,1
5,15,7,3,1
5,15,8,3,1
5,15,9,3,1
5,15,10,3,1
5,15,11,3,1
5,15,12,3,1
5,15,13,3,1
5,15,14,3,1
5,15,15,3,1
5,15,16,3,1
5,15,17,3,1
5,15,18,3,1
5,15,19,3,1
5,15,20,3,1
5,15,21,3,1
5,15,22,3,1
5,16,0,3,1
5,16,1,3,1
5,16,2,3,1
5,16,3,3,1
5,16,4,3,1
5,16,5,3,1
5,16,6,3,1
5,16,7,3,1
5,16,8,3,1
5,16,9,3,1
5,16,10,3,1
5,16,11,3,1
5,16,12,3,1
5,16,13,3,1
5,16,14,3,1
5,16,15,3,1
5,16,16,3,1
5,16,17,3,1
5,16,18,3,1
5,16,19,3,1
5,16,20,3,1
5,16,21,3,1
5,16,22,3,1
5,17,0,3,1
5,17,1,3,1
5,17,2,3,1
5,17,3,3,1
5,17,4,3,1
5,17,5,3,1
5,17,6,3,1
5,17,7,3,1
5,17,8,3,1
5,17,9,3,1
5,17,10,3,1
5,17,11,3,1
5,17,12,3,1
5,17,13,3,1
5,17,14,3,1
5,17,15,3,1
5,17,16,3,1
5,17,17,3,1
5,17,18,3,1
5,17,19,3,1
5,17,20,3,1
5,17,21,3,1
5,17,22,3,1
5,18,0,3,1
5,18,1,3,1
5,18,2,3,1
5,18,3,3,1
5,18,4,3,1
5,18,5,3,1
5,18,6,3,1
5,18,7,3,1
5,18,8,3,1
5,18,9,3,1
5,18,10,3,1
5,18,11,3,1
5,18,12,3,1
5,18,13,3,1
5,18,14,3,1
5,18,15,3,1
5,18,16,3,1
5,18,17,3,1
5,18,18,3,1
5,18,19,3,1
5,18,20,3,1
5,18,21,3,1
5,18,22,3,1
5,0,0,4,1
5,0,1,4,1
5,0,2,4,1
5,0,3,4,1
5,0,4,4,1
5,0,5,4,1
5,0,6,4,1
5,0,7,4,1
5,0,8,4,1
5,0,9,4,1
5,0,10,4,1
5,0,11,4,1
5,0,12,4,1
5,0,13,4,1
5,0,14,4,1
5,0,15,4,1
5,0,16,4,1
5,0,17,4,1
5,0,18,4,1
5,0,19,4,1
5,0,20,4,1
5,0,21,4,1
5,0,22,4,1
5,1,0,4,1
5,1,1,4,1
5,1,2,4,1
5,1,3,4,1
5,1,4,4,1
5,1,5,4,1
5,1,6,4,1
5,1,7,4,1
5,1,8,4,1
5,1,9,4,1
5,1,10,4,1
5,1,11,4,1
5,1,12,4,1
5,1,13,4,1
5,1,14,4,1
5,1,15,4,1
5,1,16,4,1
5,1,17,4,1
5,1,18,4,1
5,1,19,4,1
5,1,20,4,1
5,1,21,4,1
5,1,22,4,1
5,2,0,4,1
5,2,1,4,1
5,2,2,4,1
5,2,3,4,1
5,2,4,4,1
5,2,5,4,1
5,2,6,4,1
5,2,7,4,1
5,2,8,4,1
5,2,9,4,1
5,2,10,4,1
5,2,11,4,1
5,2,12,4,1
5,2,13,4,1
5,2,14,4,1
5,2,15,4,1
5,2,16,4,1
5,2,17,4,1
5,2,18,4,1
5,2,19,4,1
5,2,20,4,1
5,2,21,4,1
5,2,22,4,1
5,3,0,4,1
5,3,1,4,1
5,3,2,4,1
5,3,3,4,1
5,3,4,4,1
5,3,5,4,1
5,3,6,4,1
5,3,7,4,1
5,3,8,4,1
5,3,9,4,1
5,3,10,4,1
5,3,11,4,1
5,3,12,4,1
5,3,13,4,1
5,3,14,4,1
5,3,15,4,1
5,3,16,4,1
5,3,17,4,1
5,3,18,4,1
5,3,19,4,1
5,3,20,4,1
5,3,21,4,1
5,3,22,4,1
5,4,0,4,1
5,4,1,4,1
5,4,2,4,1
5,4,3,4,1
5,4,4,4,1
5,4,5,4,1
5,4,6,4,1
5,4,7,4,1
5,4,8,4,1
5,4,9,4,1
5,4,10,4,1
5,4,11,4,1
5,4,12,4,1
5,4,13,4,1
5,4,14,4,1
5,4,15,4,1
5,4,16,4,1
5,4,17,4,1
5,4,18,4,1
5,4,19,4,1
5,4,20,4,1
5,4,21,4,1
5,4,22,4,1
5,5,0,4,1
5,5,1,4,1
5,5,2,4,1
5,5,3,4,1
5,5,4,4,1
5,5,5,4,1
5,5,6,4,1
5,5,7,4,1
5,5,8,4,1
5,5,9,4,1
5,5,10,4,1
5,5,11,4,1
5,5,12,4,1
5,5,13,4,1
5,5,14,4,1
5,5,15,4,1
5,5,16,4,1
5,5,17,4,1
5,5,18,4,1
5,5,19,4,1
5,5,20,4,1
5,5,21,4,1
5,5,22,4,1
5,6,0,4,1
5,6,1,4,1
5,6,2,4,1
5,6,3,4,1
5,6,4,4,1
5,6,5,4,1
5,6,6,4,1
5,6,7,4,1
5,6,8,4,1
5,6,9,4,1
5,6,10,4,1
5,6,11,4,1
5,6,12,4,1
5,6,13,4,1
5,6,14,4,1
5,6,15,4,1
5,6,16,4,1
5,6,17,4,1
5,6,18,4,1
5,6,19,4,1
5,6,20,4,1
5,6,21,4,1
5,6,22,4,1
5,7,0,4,1
5,7,1,4,1
5,7,2,4,1
5,7,3,4,1
5,7,4,4,1
5,7,5,4,1
5,7,6,4,1
5,7,7,4,1
5,7,8,4,1
5,7,9,4,1
5,7,10,4,1
5,7,11,4,1
5,7,12,4,1
5,7,13,4,1
5,7,14,4,1
5,7,15,4,1
5,7,16,4,1
5,7,17,4,1
5,7,18,4,1
5,7,19,4,1
5,7,20,4,1
5,7,21,4,1
5,7,22,4,1
5,8,0,4,1
5,8,1,4,1
5,8,2,4,1
5,8,3,4,1
5,8,4,4,1
5,8,5,4,1
5,8,6,4,1
5,8,7,4,1
5,8,8,4,1
5,8,9,4,1
5,8,10,4,1
5,8,11,4,1
5,8,12,4,1
5,8,13,4,1
5,8,14,4,1
5,8,15,4,1
5,8,16,4,1
5,8,17,4,1
5,8,18,4,1
5,8,19,4,1
5,8,20,4,1
5,8,21,4,1
5,8,22,4,1
5,9,0,4,1
5,9,1,4,1
5,9,2,4,1
5,9,3,4,1
5,9,4,4,1
5,9,5,4,1
5,9,6,4,1
5,9,7,4,1
5,9,8,4,1
5,9,9,4,1
5,9,10,4,1
5,9,11,4,1
5,9,12,4,1
5,9,13,4,1
5,9,14,4,1
5,9,15,4,1
5,9,16,4,1
5,9,17,4,1
5,9,18,4,1
5,9,19,4,1
5,9,20,4,1
5,9,21,4,1
5,9,22,4,1
5,10,0,4,1
5,10,1,4,1
5,10,2,4,1
5,10,3,4,1
5,10,4,4,1
5,10,5,4,1
5,10,6,4,1
5,10,7,4,1
5,10,8,4,1
5,10,9,4,1
5,10,10,4,1
5,10,11,4,1
5,10,12,4,1
5,10,13,4,1
5,10,14,4,1
5,10,15,4,1
5,10,16,4,1
5,10,17,4,1
5,10,18,4,1
5,10,19,4,1
5,10,20,4,1
5,10,21,4,1
5,10,22,4,1
5,11,0,4,1
5,11,1,4,1
5,11,2,4,1
5,11,3,4,1
5,11,4,4,1
5,11,5,4,1
5,11,6,4,1
5,11,7,4,1
5,11,8,4,1
5,11,9,4,1
5,11,10,4,1
5,11,11,4,1
5,11,12,4,1
5,11,13,4,1
5,11,14,4,1
5,11,15,4,1
5,11,16,4,1
5,11,17,4,1
5,11,18,4,1
5,11,19,4,1
5,11,20,4,1
5,11,21,4,1
5,11,22,4,1
5,12,0,4,1
5,12,1,4,1
5,12,2,4,1
5,12,3,4,1
5,12,4,4,1
5,12,5,4,1
5,12,6,4,1
5,12,7,4,1
5,12,8,4,1
5,12,9,4,1
5,12,10,4,1
5,12,11,4,1
5,12,12,4,1
5,12,13,4,1
5,12,14,4,1
5,12,15,4,1
5,12,16,4,1
5,12,17,4,1
5,12,18,4,1
5,12,19,4,1
5,12,20,4,1
5,12,21,4,1
5,12,22,4,1
5,13,0,4,1
5,13,1,4,1
5,13,2,4,1
5,13,3,4,1
5,13,4,4,1
5,13,5,4,1
5,13,6,4,1
5,13,7,4,1
5,13,8,4,1
5,13,9,4,1
5,13,10,4,1
5,13,11,4,1
5,13,12,4,1
5,13,13,4,1
5,13,14,4,1
5,13,15,4,1
5,13,16,4,1
5,13,17,4,1
5,13,18,4,1
5,13,19,4,1
5,13,20,4,1
5,13,21,4,1
5,13,22,4,1
5,14,0,4,1
5,14,1,4,1
5,14,2,4,1
5,14,3,4,1
5,14,4,4,1
5,14,5,4,1
5,14,6,4,1
5,14,7,4,1
5,14,8,4,1
5,14,9,4,1
5,14,10,4,1
5,14,11,4,1
5,14,12,4,1
5,14,13,4,1
5,14,14,4,1
5,14,15,4,1
5,14,16,4,1
5,14,17,4,1
5,14,18,4,1
5,14,19,4,1
5,14,20,4,1
5,14,21,4,1
5,14,22,4,1
5,15,0,4,1
5,15,1,4,1
5,15,2,4,1
5,15,3,4,1
5,15,4,4,1
5,15,5,4,1
5,15,6,4,1
5,15,7,4,1
5,15,8,4,1
5,15,9,4,1
5,15,10,4,1
5,15,11,4,1
5,15,12,4,1
5,15,13,4,1
5,15,14,4,1
5,15,15,4,1
5,15,16,4,1
5,15,17,4,1
5,15,18,4,1
5,15,19,4,1
5,15,20,4,1
5,15,21,4,1
5,15,22,4,1
5,16,0,4,1
5,16,1,4,1
5,16,2,4,1
5,16,3,4,1
5,16,4,4,1
5,16,5,4,1
5,16,6,4,1
5,16,7,4,1
5,16,8,4,1
5,16,9,4,1
5,16,10,4,1
5,16,11,4,1
5,16,12,4,1
5,16,13,4,1
5,16,14,4,1
5,16,15,4,1
5,16,16,4,1
5,16,17,4,1
5,16,18,4,1
5,16,19,4,1
5,16,20,4,1
5,16,21,4,1
5,16,22,4,1
5,0,0,5,1
5,0,1,5,1
5,0,2,5,1
5,0,3,5,1
5,0,4,5,1
5,0,5,5,1
5,0,6,5,1
5,0,7,5,1
5,0,8,5,1
5,0,9,5,1
5,0,10,5,1
5,0,11,5,1
5,0,12,5,1
5,0,13,5,1
5,0,14,5,1
5,0,15,5,1
5,0,16,5,1
5,0,17,5,1
5,0,18,5,1
5,0,19,5,1
5,0,20,5,1
5,0,21,5,1
5,0,22,5,1
5,1,0,5,1
5,1,1,5,1
5,1,2,5,1
5,1,3,5,1
5,1,4,5,1
5,1,5,5,1
5,1,6,5,1
5,1,7,5,1
5,1,8,5,1
5,1,9,5,1
5,1,10,5,1
5,1,11,5,1
5,1,12,5,1
5,1,13,5,1
5,1,14,5,1
5,1,15,5,1
5,1,16,5,1
5,1,17,5,1
5,1,18,5,1
5,1,19,5,1
5,1,20,5,1
5,1,21,5,1
5,1,22,5,1
5,2,0,5,1
5,2,1,5,1
5,2,2,5,1
5,2,3,5,1
5,2,4,5,1
5,2,5,5,1
5,2,6,5,1
5,2,7,5,1
5,2,8,5,1
5,2,9,5,1
5,2,10,5,1
5,2,11,5,1
5,2,12,5,1
5,2,13,5,1
5,2,14,5,1
5,2,15,5,1
5,2,16,5,1
5,2,17,5,1
5,2,18,5,1
5,2,19,5,1
5,2,20,5,1
5,2,21,5,1
5,2,22,5,1
5,3,0,5,1
5,3,1,5,1
5,3,2,5,1
5,3,3,5,1
5,3,4,5,1
5,3,5,5,1
5,3,6,5,1
5,3,7,5,1
5,3,8,5,1
5,3,9,5,1
5,3,10,5,1
5,3,11,5,1
5,3,12,5,1
5,3,13,5,1
5,3,14,5,1
5,3,15,5,1
5,3,16,5,1
5,3,17,5,1
5,3,18,5,1
5,3,19,5,1
5,3,20,5,1
5,3,21,5,1
5,3,22,5,1
5,4,0,5,1
5,4,1,5,1
5,4,2,5,1
5,4,3,5,1
5,4,4,5,1
5,4,5,5,1
5,4,6,5,1
5,4,7,5,1
5,4,8,5,1
5,4,9,5,1
5,4,10,5,1
5,4,11,5,1
5,4,12,5,1
5,4,13,5,1
5,4,14,5,1
5,4,15,5,1
5,4,16,5,1
5,4,17,5,1
5,4,18,5,1
5,4,19,5,1
5,4,20,5,1
5,4,21,5,1
5,4,22,5,1
5,5,0,5,1
5,5,1,5,1
5,5,2,5,1
5,5,3,5,1
5,5,4,5,1
5,5,5,5,1
5,5,6,5,1
5,5,7,5,1
5,5,8,5,1
5,5,9,5,1
5,5,10,5,1
5,5,11,5,1
5,5,12,5,1
5,5,13,5,1
5,5,14,5,1
5,5,15,5,1
5,5,16,5,1
5,5,17,5,1
5,5,18,5,1
5,5,19,5,1
5,5,20,5,1
5,5,21,5,1
5,5,22,5,1
5,6,0,5,1
5,6,1,5,1
5,6,2,5,1
5,6,3,5,1
5,6,4,5,1
5,6,5,5,1
5,6,6,5,1
5,6,7,5,1
5,6,8,5,1
5,6,9,5,1
5,6,10,5,1
5,6,11,5,1
5,6,12,5,1
5,6,13,5,1
5,6,14,5,1
5,6,15,5,1
5,6,16,5,1
5,6,17,5,1
5,6,18,5,1
5,6,19,5,1
5,6,20,5,1
5,6,21,5,1
5,6,22,5,1
5,7,0,5,1
5,7,1,5,1
5,7,2,5,1
5,7,3,5,1
5,7,4,5,1
5,7,5,5,1
5,7,6,5,1
5,7,7,5,1
5,7,8,5,1
5,7,9,5,1
5,7,10,5,1
5,7,11,5,1
5,7,12,5,1
5,7,13,5,1
5,7,14,5,1
5,7,15,5,1
5,7,16,5,1
5,7,17,5,1
5,7,18,5,1
5,7,19,5,1
5,7,20,5,1
5,7,21,5,1
5,7,22,5,1
5,8,0,5,1
5,8,1,5,1
5,8,2,5,1
5,8,3,5,1
5,8,4,5,1
5,8,5,5,1
5,8,6,5,1
5,8,7,5,1
5,8,8,5,1
5,8,9,5,1
5,8,10,5,1
5,8,11,5,1
5,8,12,5,1
5,8,13,5,1
5,8,14,5,1
5,8,15,5,1
5,8,16,5,1
5,8,17,5,1
5,8,18,5,1
5,8,19,5,1
5,8,20,5,1
5,8,21,5,1
5,8,22,5,1
5,9,0,5,1
5,9,1,5,1
5,9,2,5,1
5,9,3,5,1
5,9,4,5,1
5,9,5,5,1
5,9,6,5,1
5,9,7,5,1
5,9,8,5,1
5,9,9,5,1
5,9,10,5,1
5,9,11,5,1
5,9,12,5,1
5,9,13,5,1
5,9,14,5,1
5,9,15,5,1
5,9,16,5,1
5,9,17,5,1
5,9,18,5,1
5,9,19,5,1
5,9,20,5,1
5,9,21,5,1
5,9,22,5,1
5,10,0,5,1
5,10,1,5,1
5,10,2,5,1
5,10,3,5,1
5,10,4,5,1
5,10,5,5,1
5,10,6,5,1
5,10,7,5,1
5,10,8,5,1
5,10,9,5,1
5,10,10,5,1
5,10,11,5,1
5,10,12,5,1
5,10,13,5,1
5,10,14,5,1
5,10,15,5,1
5,10,16,5,1
5,10,17,5,1
5,10,18,5,1
5,10,19,5,1
5,10,20,5,1
5,10,21,5,1
5,10,22,5,1
5,11,0,5,1
5,11,1,5,1
5,11,2,5,1
5,11,3,5,1
5,11,4,5,1
5,11,5,5,1
5,11,6,5,1
5,11,7,5,1
5,11,8,5,1
5,11,9,5,1
5,11,10,5,1
5,11,11,5,1
5,11,12,5,1
5,11,13,5,1
5,11,14,5,1
5,11,15,5,1
5,11,16,5,1
5,11,17,5,1
5,11,18,5,1
5,11,19,5,1
5,11,20,5,1
5,11,21,5,1
5,11,22,5,1
5,12,0,5,1
5,12,1,5,1
5,12,2,5,1
5,12,3,5,1
5,12,4,5,1
5,12,5,5,1
5,12,6,5,1
5,12,7,5,1
5,12,8,5,1
5,12,9,5,1
5,12,10,5,1
5,12,11,5,1
5,12,12,5,1
5,12,13,5,1
5,12,14,5,1
5,12,15,5,1
5,12,16,5,1
5,12,17,5,1
5,12,18,5,1
5,12,19,5,1
5,12,20,5,1
5,12,21,5,1
5,12,22,5,1
5,13,0,5,1
5,13,1,5,1
5,13,2,5,1
5,13,3,5,1
5,13,4,5,1
5,13,5,5,1
5,13,6,5,1
5,13,7,5,1
5,13,8,5,1
5,13,9,5,1
5,13,10,5,1
5,13,11,5,1
5,13,12,5,1
5,13,13,5,1
5,13,14,5,1
5,13,15,5,1
5,13,16,5,1
5,13,17,5,1
5,13,18,5,1
5,13,19,5,1
5,13,20,5,1
5,13,21,5,1
5,13,22,5,1
5,14,0,5,1
5,14,1,5,1
5,14,2,5,1
5,14,3,5,1
5,14,4,5,1
5,14,5,5,1
5,14,6,5,1
5,14,7,5,1
5,14,8,5,1
5,14,9,5,1
5,14,10,5,1
5,14,11,5,1
5,14,12,5,1
5,14,13,5,1
5,14,14,5,1
5,14,15,5,1
5,14,16,5,1
5,14,17,5,1
5,14,18,5,1
5,14,19,5,1
5,14,20,5,1
5,14,21,5,1
5,14,22,5,1
5,0,0,6,1
5,0,1,6,1
5,0,2,6,1
5,0,3,6,1
5,0,4,6,1
5,0,5,6,1
5,0,6,6,1
5,0,7,6,1
5,0,8,6,1
5,0,9,6,1
5,0,10,6,1
5,0,11,6,1
5,0,12,6,1
5,0,13,6,1
5,0,14,6,1
5,0,15,6,1
5,0,16,6,1
5,0,17,6,1
5,0,18,6,1
5,0,19,6,1
5,0,20,6,1
5,0,21,6,1
5,0,22,6,1
5,1,0,6,1
5,1,1,6,1
5,1,2,6,1
5,1,3,6,1
5,1,4,6,1
5,1,5,6,1
5,1,6,6,1
5,1,7,6,1
5,1,8,6,1
5,1,9,6,1
5,1,10,6,1
5,1,11,6,1
5,1,12,6,1
5,1,13,6,1
5,1,14,6,1
5,1,15,6,1
5,1,16,6,1
5,1,17,6,1
5,1,18,6,1
5,1,19,6,1
5,1,20,6,1
5,1,21,6,1
5,1,22,6,1
5,2,0,6,1
5,2,1,6,1
5,2,2,6,1
5,2,3,6,1
5,2,4,6,1
5,2,5,6,1
5,2,6,6,1
5,2,7,6,1
5,2,8,6,1
5,2,9,6,1
5,2,10,6,1
5,2,11,6,1
5,2,12,6,1
5,2,13,6,1
5,2,14,6,1
5,2,15,6,1
5,2,16,6,1
5,2,17,6,1
5,2,18,6,1
5,2,19,6,1
5,2,20,6,1
5,2,21,6,1
5,2,22,6,1
5,3,0,6,1
5,3,1,6,1
5,3,2,6,1
5,3,3,6,1
5,3,4,6,1
5,3,5,6,1
5,3,6,6,1
5,3,7,6,1
5,3,8,6,1
5,3,9,6,1
5,3,10,6,1
5,3,11,6,1
5,3,12,6,1
5,3,13,6,1
5,3,14,6,1
5,3,15,6,1
5,3,16,6,1
5,3,17,6,1
5,3,18,6,1
5,3,19,6,1
5,3,20,6,1
5,3,21,6,1
5,3,22,6,1
5,4,0,6,1
5,4,1,6,1
5,4,2,6,1
5,4,3,6,1
5,4,4,6,1
5,4,5,6,1
5,4,6,6,1
5,4,7,6,1
5,4,8,6,1
5,4,9,6,1
5,4,10,6,1
5,4,11,6,1
5,4,12,6,1
5,4,13,6,1
5,4,14,6,1
5,4,15,6,1
5,4,16,6,1
5,4,17,6,1
5,4,18,6,1
5,4,19,6,1
5,4,20,6,1
5,4,21,6,1
5,4,22,6,1
5,5,0,6,1
5,5,1,6,1
5,5,2,6,1
5,5,3,6,1
5,5,4,6,1
5,5,5,6,1
5,5,6,6,1
5,5,7,6,1
5,5,8,6,1
5,5,9,6,1
5,5,10,6,1
5,5,11,6,1
5,5,12,6,1
5,5,13,6,1
5,5,14,6,1
5,5,15,6,1
5,5,16,6,1
5,5,17,6,1
5,5,18,6,1
5,5,19,6,1
5,5,20,6,1
5,5,21,6,1
5,5,22,6,1
5,6,0,6,1
5,6,1,6,1
5,6,2,6,1
5,6,3,6,1
5,6,4,6,1
5,6,5,6,1
5,6,6,6,1
5,6,7,6,1
5,6,8,6,1
5,6,9,6,1
5,6,10,6,1
5,6,11,6,1
5,6,12,6,1
5,6,13,6,1
5,6,14,6,1
5,6,15,6,1
5,6,16,6,1
5,6,17,6,1
5,6,18,6,1
5,6,19,6,1
5,6,20,6,1
5,6,21,6,1
5,6,22,6,1
5,7,0,6,1
5,7,1,6,1
5,7,2,6,1
5,7,3,6,1
5,7,4,6,1
5,7,5,6,1
5,7,6,6,1
5,7,7,6,1
5,7,8,6,1
5,7,9,6,1
5,7,10,6,1
5,7,11,6,1
5,7,12,6,1
5,7,13,6,1
5,7,14,6,1
5,7,15,6,1
5,7,16,6,1
5,7,17,6,1
5,7,18,6,1
5,7,19,6,1
5,7,20,6,1
5,7,21,6,1
5,7,22,6,1
5,8,0,6,1
5,8,1,6,1
5,8,2,6,1
5,8,3,6,1
5,8,4,6,1
5,8,5,6,1
5,8,6,6,1
5,8,7,6,1
5,8,8,6,1
5,8,9,6,1
5,8,10,6,1
5,8,11,6,1
5,8,12,6,1
5,8,13,6,1
5,8,14,6,1
5,8,15,6,1
5,8,16,6,1
5,8,17,6,1
5,8,18,6,1
5,8,19,6,1
5,8,20,6,1
5,8,21,6,1
5,8,22,6,1
5,9,0,6,1
5,9,1,6,1
5,9,2,6,1
5,9,3,6,1
5,9,4,6,1
5,9,5,6,1
5,9,6,6,1
5,9,7,6,1
5,9,8,6,1
5,9,9,6,1
5,9,10,6,1
5,9,11,6,1
5,9,12,6,1
5,9,13,6,1
5,9,14,6,1
5,9,15,6,1
5,9,16,6,1
5,9,17,6,1
5,9,18,6,1
5,9,19,6,1
5,9,20,6,1
5,9,21,6,1
5,9,22,6,1
5,10,0,6,1
5,10,1,6,1
5,10,2,6,1
5,10,3,6,1
5,10,4,6,1
5,10,5,6,1
5,10,6,6,1
5,10,7,6,1
5,10,8,6,1
5,10,9,6,1
5,10,10,6,1
5,10,11,6,1
5,10,12,6,1
5,10,13,6,1
5,10,14,6,1
5,10,15,6,1
5,10,16,6,1
5,10,17,6,1
5,10,18,6,1
5,10,19,6,1
5,10,20,6,1
5,10,21,6,1
5,10,22,6,1
5,11,0,6,1
5,11,1,6,1
5,11,2,6,1
5,11,3,6,1
5,11,4,6,1
5,11,5,6,1
5,11,6,6,1
5,11,7,6,1
5,11,8,6,1
5,11,9,6,1
5,11,10,6,1
5,11,11,6,1
5,11,12,6,1
5,11,13,6,1
5,11,14,6,1
5,11,15,6,1
5,11,16,6,1
5,11,17,6,1
5,11,18,6,1
5,11,19,6,1
5,11,20,6,1
5,11,21,6,1
5,11,22,6,1
5,12,0,6,1
5,12,1,6,1
5,12,2,6,1
5,12,3,6,1
5,12,4,6,1
5,12,5,6,1
5,12,6,6,1
5,12,7,6,1
5,12,8,6,1
5,12,9,6,1
5,12,10,6,1
5,12,11,6,1
5,12,12,6,1
5,12,13,6,1
5,12,14,6,1
5,12,15,6,1
5,12,16,6,1
5,12,17,6,1
5,12,18,6,1
5,12,19,6,1
5,12,20,6,1
5,12,21,6,1
5,12,22,6,1
5,0,0,7,1
5,0,1,7,1
5,0,2,7,1
5,0,3,7,1
5,0,4,7,1
5,0,5,7,1
5,0,6,7,1
5,0,7,7,1
5,0,8,7,1
5,0,9,7,1
5,0,10,7,1
5,0,11,7,1
5,0,12,7,1
5,0,13,7,1
5,0,14,7,1
5,0,15,7,1
5,0,16,7,1
5,0,17,7,1
5,0,18,7,1
5,0,19,7,1
5,0,20,7,1
5,0,21,7,1
5,0,22,7,1
5,1,0,7,1
5,1,1,7,1
5,1,2,7,1
5,1,3,7,1
5,1,4,7,1
5,1,5,7,1
5,1,6,7,1
5,1,7,7,1
5,1,8,7,1
5,1,9,7,1
5,1,10,7,1
5,1,11,7,1
5,1,12,7,1
5,1,13,7,1
5,1,14,7,1
5,1,15,7,1
5,1,16,7,1
5,1,17,7,1
5,1,18,7,1
5,1,19,7,1
5,1,20,7,1
5,1,21,7,1
5,1,22,7,1
5,2,0,7,1
5,2,1,7,1
5,2,2,7,1
5,2,3,7,1
5,2,4,7,1
5,2,5,7,1
5,2,6,7,1
5,2,7,7,1
5,2,8,7,1
5,2,9,7,1
5,2,10,7,1
5,2,11,7,1
5,2,12,7,1
5,2,13,7,1
5,2,14,7,1
5,2,15,7,1
5,2,16,7,1
5,2,17,7,1
5,2,18,7,1
5,2,19,7,1
5,2,20,7,1
5,2,21,7,1
5,2,22,7,1
5,3,0,7,1
5,3,1,7,1
5,3,2,7,1
5,3,3,7,1
5,3,4,7,1
5,3,5,7,1
5,3,6,7,1
5,3,7,7,1
5,3,8,7,1
5,3,9,7,1
5,3,10,7,1
5,3,11,7,1
5,3,12,7,1
5,3,13,7,1
5,3,14,7,1
5,3,15,7,1
5,3,16,7,1
5,3,17,7,1
5,3,18,7,1
5,3,19,7,1
5,3,20,7,1
5,3,21,7,1
5,3,22,7,1
5,4,0,7,1
5,4,1,7,1
5,4,2,7,1
5,4,3,7,1
5,4,4,7,1
5,4,5,7,1
5,4,6,7,1
5,4,7,7,1
5,4,8,7,1
5,4,9,7,1
5,4,10,7,1
5,4,11,7,1
5,4,12,7,1
5,4,13,7,1
5,4,14,7,1
5,4,15,7,1
5,4,16,7,1
5,4,17,7,1
5,4,18,7,1
5,4,19,7,1
5,4,20,7,1
5,4,21,7,1
5,4,22,7,1
5,5,0,7,1
5,5,1,7,1
5,5,2,7,1
5,5,3,7,1
5,5,4,7,1
5,5,5,7,1
5,5,6,7,1
5,5,7,7,1
5,5,8,7,1
5,5,9,7,1
5,5,10,7,1
5,5,11,7,1
5,5,12,7,1
5,5,13,7,1
5,5,14,7,1
5,5,15,7,1
5,5,16,7,1
5,5,17,7,1
5,5,18,7,1
5,5,19,7,1
5,5,20,7,1
5,5,21,7,1
5,5,22,7,1
5,6,0,7,1
5,6,1,7,1
5,6,2,7,1
5,6,3,7,1
5,6,4,7,1
5,6,5,7,1
5,6,6,7,1
5,6,7,7,1
5,6,8,7,1
5,6,9,7,1
5,6,10,7,1
5,6,11,7,1
5,6,12,7,1
5,6,13,7,1
5,6,14,7,1
5,6,15,7,1
5,6,16,7,1
5,6,17,7,1
5,6,18,7,1
5,6,19,7,1
5,6,20,7,1
5,6,21,7,1
5,6,22,7,1
5,7,0,7,1
5,7,1,7,1
5,7,2,7,1
5,7,3,7,1
5,7,4,7,1
5,7,5,7,1
5,7,6,7,1
5,7,7,7,1
5,7,8,7,1
5,7,9,7,1
5,7,10,7,1
5,7,11,7,1
5,7,12,7,1
5,7,13,7,1
5,7,14,7,1
5,7,15,7,1
5,7,16,7,1
5,7,17,7,1
5,7,18,7,1
5,7,19,7,1
5,7,20,7,1
5,7,21,7,1
5,7,22,7,1
5,8,0,7,1
5,8,1,7,1
5,8,2,7,1
5,8,3,7,1
5,8,4,7,1
5,8,5,7,1
5,8,6,7,1
5,8,7,7,1
5,8,8,7,1
5,8,9,7,1
5,8,10,7,1
5,8,11,7,1
5,8,12,7,1
5,8,13,7,1
5,8,14,7,1
5,8,15,7,1
5,8,16,7,1
5,8,17,7,1
5,8,18,7,1
5,8,19,7,1
5,8,20,7,1
5,8,21,7,1
5,8,22,7,1
5,9,0,7,1
5,9,1,7,1
5,9,2,7,1
5,9,3,7,1
5,9,4,7,1
5,9,5,7,1
5,9,6,7,1
5,9,7,7,1
5,9,8,7,1
5,9,9,7,1
5,9,10,7,1
5,9,11,7,1
5,9,12,7,1
5,9,13,7,1
5,9,14,7,1
5,9,15,7,1
5,9,16,7,1
5,9,17,7,1
5,9,18,7,1
5,9,19,7,1
5,9,20,7,1
5,9,21,7,1
5,9,22,7,1
5,10,0,7,1
5,10,1,7,1
5,10,2,7,1
5,10,3,7,1
5,10,4,7,1
5,10,5,7,1
5,10,6,7,1
5,10,7,7,1
5,10,8,7,1
5,10,9,7,1
5,10,10,7,1
5,10,11,7,1
5,10,12,7,1
5,10,13,7,1
5,10,14,7,1
5,10,15,7,1
5,10,16,7,1
5,10,17,7,1
5,10,18,7,1
5,10,19,7,1
5,10,20,7,1
5,10,21,7,1
5,10,22,7,1
5,0,0,8,1
5,0,1,8,1
5,0,2,8,1
5,0,3,8,1
5,0,4,8,1
5,0,5,8,1
5,0,6,8,1
5,0,7,8,1
5,0,8,8,1
5,0,9,8,1
5,0,10,8,1
5,0,11,8,1
5,0,12,8,1
5,0,13,8,1
5,0,14,8,1
5,0,15,8,1
5,0,16,8,1
5,0,17,8,1
5,0,18,8,1
5,0,19,8,1
5,0,20,8,1
5,0,21,8,1
5,0,22,8,1
5,1,0,8,1
5,1,1,8,1
5,1,2,8,1
5,1,3,8,1
5,1,4,8,1
5,1,5,8,1
5,1,6,8,1
5,1,7,8,1
5,1,8,8,1
5,1,9,8,1
5,1,10,8,1
5,1,11,8,1
5,1,12,8,1
5,1,13,8,1
5,1,14,8,1
5,1,15,8,1
5,1,16,8,1
5,1,17,8,1
5,1,18,8,1
5,1,19,8,1
5,1,20,8,1
5,1,21,8,1
5,1,22,8,1
5,2,0,8,1
5,2,1,8,1
5,2,2,8,1
5,2,3,8,1
5,2,4,8,1
5,2,5,8,1
5,2,6,8,1
5,2,7,8,1
5,2,8,8,1
5,2,9,8,1
5,2,10,8,1
5,2,11,8,1
5,2,12,8,1
5,2,13,8,1
5,2,14,8,1
5,2,15,8,1
5,2,16,8,1
5,2,17,8,1
5,2,18,8,1
5,2,19,8,1
5,2,20,8,1
5,2,21,8,1
5,2,22,8,1
5,3,0,8,1
5,3,1,8,1
5,3,2,8,1
5,3,3,8,1
5,3,4,8,1
5,3,5,8,1
5,3,6,8,1
5,3,7,8,1
5,3,8,8,1
5,3,9,8,1
5,3,10,8,1
5,3,11,8,1
5,3,12,8,1
5,3,13,8,1
5,3,14,8,1
5,3,15,8,1
5,3,16,8,1
5,3,17,8,1
5,3,18,8,1
5,3,19,8,1
5,3,20,8,1
5,3,21,8,1
5,3,22,8,1
5,4,0,8,1
5,4,1,8,1
5,4,2,8,1
5,4,3,8,1
5,4,4,8,1
5,4,5,8,1
5,4,6,8,1
5,4,7,8,1
5,4,8,8,1
5,4,9,8,1
5,4,10,8,1
5,4,11,8,1
5,4,12,8,1
5,4,13,8,1
5,4,14,8,1
5,4,15,8,1
5,4,16,8,1
5,4,17,8,1
5,4,18,8,1
5,4,19,8,1
5,4,20,8,1
5,4,21,8,1
5,4,22,8,1
5,5,0,8,1
5,5,1,8,1
5,5,2,8,1
5,5,3,8,1
5,5,4,8,1
5,5,5,8,1
5,5,6,8,1
5,5,7,8,1
5,5,8,8,1
5,5,9,8,1
5,5,10,8,1
5,5,11,8,1
5,5,12,8,1
5,5,13,8,1
5,5,14,8,1
5,5,15,8,1
5,5,16,8,1
5,5,17,8,1
5,5,18,8,1
5,5,19,8,1
5,5,20,8,1
5,5,21,8,1
5,5,22,8,1
5,6,0,8,1
5,6,1,8,1
5,6,2,8,1
5,6,3,8,1
5,6,4,8,1
5,6,5,8,1
5,6,6,8,1
5,6,7,8,1
5,6,8,8,1
5,6,9,8,1
5,6,10,8,1
5,6,11,8,1
5,6,12,8,1
5,6,13,8,1
5,6,14,8,1
5,6,15,8,1
5,6,16,8,1
5,6,17,8,1
5,6,18,8,1
5,6,19,8,1
5,6,20,8,1
5,6,21,8,1
5,6,22,8,1
5,7,0,8,1
5,7,1,8,1
5,7,2,8,1
5,7,3,8,1
5,7,4,8,1
5,7,5,8,1
5,7,6,8,1
5,7,7,8,1
5,7,8,8,1
5,7,9,8,1
5,7,10,8,1
5,7,11,8,1
5,7,12,8,1
5,7,13,8,1
5,7,14,8,1
5,7,15,8,1
5,7,16,8,1
5,7,17,8,1
5,7,18,8,1
5,7,19,8,1
5,7,20,8,1
5,7,21,8,1
5,7,22,8,1
5,8,0,8,1
5,8,1,8,1
5,8,2,8,1
5,8,3,8,1
5,8,4,8,1
5,8,5,8,1
5,8,6,8,1
5,8,7,8,1
5,8,8,8,1
5,8,9,8,1
5,8,10,8,1
5,8,11,8,1
5,8,12,8,1
5,8,13,8,1
5,8,14,8,1
5,8,15,8,1
5,8,16,8,1
5,8,17,8,1
5,8,18,8,1
5,8,19,8,1
5,8,20,8,1
5,8,21,8,1
5,8,22,8,1
5,0,0,9,1
5,0,1,9,1
5,0,2,9,1
5,0,3,9,1
5,0,4,9,1
5,0,5,9,1
5,0,6,9,1
5,0,7,9,1
5,0,8,9,1
5,0,9,9,1
5,0,10,9,1
5,0,11,9,1
5,0,12,9,1
5,0,13,9,1
5,0,14,9,1
5,0,15,9,1
5,0,16,9,1
5,0,17,9,1
5,0,18,9,1
5,0,19,9,1
5,0,20,9,1
5,0,21,9,1
5,0,22,9,1
5,1,0,9,1
5,1,1,9,1
5,1,2,9,1
5,1,3,9,1
5,1,4,9,1
5,1,5,9,1
5,1,6,9,1
5,1,7,9,1
5,1,8,9,1
5,1,9,9,1
5,1,10,9,1
5,1,11,9,1
5,1,12,9,1
5,1,13,9,1
5,1,14,9,1
5,1,15,9,1
5,1,16,9,1
5,1,17,9,1
5,1,18,9,1
5,1,19,9,1
5,1,20,9,1
5,1,21,9,1
5,1,22,9,1
5,2,0,9,1
5,2,1,9,1
5,2,2,9,1
5,2,3,9,1
5,2,4,9,1
5,2,5,9,1
5,2,6,9,1
5,2,7,9,1
5,2,8,9,1
5,2,9,9,1
5,2,10,9,1
5,2,11,9,1
5,2,12,9,1
5,2,13,9,1
5,2,14,9,1
5,2,15,9,1
5,2,16,9,1
5,2,17,9,1
5,2,18,9,1
5,2,19,9,1
5,2,20,9,1
5,2,21,9,1
5,2,22,9,1
5,3,0,9,1
5,3,1,9,1
5,3,2,9,1
5,3,3,9,1
5,3,4,9,1
5,3,5,9,1
5,3,6,9,1
5,3,7,9,1
5,3,8,9,1
5,3,9,9,1
5,3,10,9,1
5,3,11,9,1
5,3,12,9,1
5,3,13,9,1
5,3,14,9,1
5,3,15,9,1
5,3,16,9,1
5,3,17,9,1
5,3,18,9,1
5,3,19,9,1
5,3,20,9,1
5,3,21,9,1
5,3,22,9,1
5,4,0,9,1
5,4,1,9,1
5,4,2,9,1
5,4,3,9,1
5,4,4,9,1
5,4,5,9,1
5,4,6,9,1
5,4,7,9,1
5,4,8,9,1
5,4,9,9,1
5,4,10,9,1
5,4,11,9,1
5,4,12,9,1
5,4,13,9,1
5,4,14,9,1
5,4,15,9,1
5,4,16,9,1
5,4,17,9,1
5,4,18,9,1
5,4,19,9,1
5,4,20,9,1
5,4,21,9,1
5,4,22,9,1
5,5,0,9,1
5,5,1,9,1
5,5,2,9,1
5,5,3,9,1
5,5,4,9,1
5,5,5,9,1
5,5,6,9,1
5,5,7,9,1
5,5,8,9,1
5,5,9,9,1
5,5,10,9,1
5,5,11,9,1
5,5,12,9,1
5,5,13,9,1
5,5,14,9,1
5,5,15,9,1
5,5,16,9,1
5,5,17,9,1
5,5,18,9,1
5,5,19,9,1
5,5,20,9,1
5,5,21,9,1
5,5,22,9,1
5,6,0,9,1
5,6,1,9,1
5,6,2,9,1
5,6,3,9,1
5,6,4,9,1
5,6,5,9,1
5,6,6,9,1
5,6,7,9,1
5,6,8,9,1
5,6,9,9,1
5,6,10,9,1
5,6,11,9,1
5,6,12,9,1
5,6,13,9,1
5,6,14,9,1
5,6,15,9,1
5,6,16,9,1
5,6,17,9,1
5,6,18,9,1
5,6,19,9,1
5,6,20,9,1
5,6,21,9,1
5,6,22,9,1
5,0,0,10,1
5,0,1,10,1
5,0,2,10,1
5,0,3,10,1
5,0,4,10,1
5,0,5,10,1
5,0,6,10,1
5,0,7,10,1
5,0,8,10,1
5,0,9,10,1
5,0,10,10,1
5,0,11,10,1
5,0,12,10,1
5,0,13,10,1
5,0,14,10,1
5,0,15,10,1
5,0,16,10,1
5,0,17,10,1
5,0,18,10,1
5,0,19,10,1
5,0,20,10,1
5,0,21,10,1
5,0,22,10,1
5,1,0,10,1
5,1,1,10,1
5,1,2,10,1
5,1,3,10,1
5,1,4,10,1
5,1,5,10,1
5,1,6,10,1
5,1,7,10,1
5,1,8,10,1
5,1,9,10,1
5,1,10,10,1
5,1,11,10,1
5,1,12,10,1
5,1,13,10,1
5,1,14,10,1
5,1,15,10,1
5,1,16,10,1
5,1,17,10,1
5,1,18,10,1
5,1,19,10,1
5,1,20,10,1
5,1,21,10,1
5,1,22,10,1
5,2,0,10,1
5,2,1,10,1
5,2,2,10,1
5,2,3,10,1
5,2,4,10,1
5,2,5,10,1
5,2,6,10,1
5,2,7,10,1
5,2,8,10,1
5,2,9,10,1
5,2,10,10,1
5,2,11,10,1
5,2,12,10,1
5,2,13,10,1
5,2,14,10,1
5,2,15,10,1
5,2,16,10,1
5,2,17,10,1
5,2,18,10,1
5,2,19,10,1
5,2,20,10,1
5,2,21,10,1
5,2,22,10,1
5,3,0,10,1
5,3,1,10,1
5,3,2,10,1
5,3,3,10,1
5,3,4,10,1
5,3,5,10,1
5,3,6,10,1
5,3,7,10,1
5,3,8,10,1
5,3,9,10,1
5,3,10,10,1
5,3,11,10,1
5,3,12,10,1
5,3,13,10,1
5,3,14,10,1
5,3,15,10,1
5,3,16,10,1
5,3,17,10,1
5,3,18,10,1
5,3,19,10,1
5,3,20,10,1
5,3,21,10,1
5,3,22,10,1
5,4,0,10,1
5,4,1,10,1
5,4,2,10,1
5,4,3,10,1
5,4,4,10,1
5,4,5,10,1
5,4,6,10,1
5,4,7,10,1
5,4,8,10,1
5,4,9,10,1
5,4,10,10,1
5,4,11,10,1
5,4,12,10,1
5,4,13,10,1
5,4,14,10,1
5,4,15,10,1
5,4,16,10,1
5,4,17,10,1
5,4,18,10,1
5,4,19,10,1
5,4,20,10,1
5,4,21,10,1
5,4,22,10,1
5,0,0,11,1
5,0,1,11,1
5,0,2,11,1
5,0,3,11,1
5,0,4,11,1
5,0,5,11,1
5,0,6,11,1
5,0,7,11,1
5,0,8,11,1
5,0,9,11,1
5,0,10,11,1
5,0,11,11,1
5,0,12,11,1
5,0,13,11,1
5,0,14,11,1
5,0,15,11,1
5,0,16,11,1
5,0,17,11,1
5,0,18,11,1
5,0,19,11,1
5,0,20,11,1
5,0,21,11,1
5,0,22,11,1
5,1,0,11,1
5,1,1,11,1
5,1,2,11,1
5,1,3,11,1
5,1,4,11,1
5,1,5,11,1
5,1,6,11,1
5,1,7,11,1
5,1,8,11,1
5,1,9,11,1
5,1,10,11,1
5,1,11,11,1
5,1,12,11,1
5,1,13,11,1
5,1,14,11,1
5,1,15,11,1
5,1,16,11,1
5,1,17,11,1
5,1,18,11,1
5,1,19,11,1
5,1,20,11,1
5,1,21,11,1
5,1,22,11,1
5,2,0,11,1
5,2,1,11,1
5,2,2,11,1
5,2,3,11,1
5,2,4,11,1
5,2,5,11,1
5,2,6,11,1
5,2,7,11,1
5,2,8,11,1
5,2,9,11,1
5,2,10,11,1
5,2,11,11,1
5,2,12,11,1
5,2,13,11,1
5,2,14,11,1
5,2,15,11,1
5,2,16,11,1
5,2,17,11,1
5,2,18,11,1
5,2,19,11,1
5,2,20,11,1
5,2,21,11,1
5,2,22,11,1
5,0,0,12,1
5,0,1,12,1
5,0,2,12,1
5,0,3,12,1
5,0,4,12,1
5,0,5,12,1
5,0,6,12,1
5,0,7,12,1
5,0,8,12,1
5,0,9,12,1
5,0,10,12,1
5,0,11,12,1
5,0,12,12,1
5,0,13,12,1
5,0,14,12,1
5,0,15,12,1
5,0,16,12,1
5,0,17,12,1
5,0,18,12,1
5,0,19,12,1
5,0,20,12,1
5,0,21,12,1
5,0,22,12,1
5,0,0,1,2
5,0,1,1,2
5,0,2,1,2
5,0,3,1,2
5,0,4,1,2
5,0,5,1,2
5,0,6,1,2
5,0,7,1,2
5,0,8,1,2
5,0,9,1,2
5,0,10,1,2
5,0,11,1,2
5,0,12,1,2
5,0,13,1,2
5,0,14,1,2
5,0,15,1,2
5,0,16,1,2
5,0,17,1,2
5,0,18,1,2
5,0,19,1,2
5,0,20,1,2
5,1,0,1,2
5,1,1,1,2
5,1,2,1,2
5,1,3,1,2
5,1,4,1,2
5,1,5,1,2
5,1,6,1,2
5,1,7,1,2
5,1,8,1,2
5,1,9,1,2
5,1,10,1,2
5,1,11,1,2
5,1,12,1,2
5,1,13,1,2
5,1,14,1,2
5,1,15,1,2
5,1,16,1,2
5,1,17,1,2
5,1,18,1,2
5,1,19,1,2
5,1,20,1,2
5,2,0,1,2
5,2,1,1,2
5,2,2,1,2
5,2,3,1,2
5,2,4,1,2
5,2,5,1,2
5,2,6,1,2
5,2,7,1,2
5,2,8,1,2
5,2,9,1,2
5,2,10,1,2
5,2,11,1,2
5,2,12,1,2
5,2,13,1,2
5,2,14,1,2
5,2,15,1,2
5,2,16,1,2
5,2,17,1,2
5,2,18,1,2
5,2,19,1,2
5,2,20,1,2
5,3,0,1,2
5,3,1,1,2
5,3,2,1,2
5,3,3,1,2
5,3,4,1,2
5,3,5,1,2
5,3,6,1,2
5,3,7,1,2
5,3,8,1,2
5,3,9,1,2
5,3,10,1,2
5,3,11,1,2
5,3,12,1,2
5,3,13,1,2
5,3,14,1,2
5,3,15,1,2
5,3,16,1,2
5,3,17,1,2
5,3,18,1,2
5,3,19,1,2
5,3,20,1,2
5,4,0,1,2
5,4,1,1,2
5,4,2,1,2
5,4,3,1,2
5,4,4,1,2
5,4,5,1,2
5,4,6,1,2
5,4,7,1,2
5,4,8,1,2
5,4,9,1,2
5,4,10,1,2
5,4,11,1,2
5,4,12,1,2
5,4,13,1,2
5,4,14,1,2
5,4,15,1,2
5,4,16,1,2
5,4,17,1,2
5,4,18,1,2
5,4,19,1,2
5,4,20,1,2
5,5,0,1,2
5,5,1,1,2
5,5,2,1,2
5,5,3,1,2
5,5,4,1,2
5,5,5,1,2
5,5,6,1,2
5,5,7,1,2
5,5,8,1,2
5,5,9,1,2
5,5,10,1,2
5,5,11,1,2
5,5,12,1,2
5,5,13,1,2
5,5,14,1,2
5,5,15,1,2
5,5,16,1,2
5,5,17,1,2
5,5,18,1,2
5,5,19,1,2
5,5,20,1,2
5,6,0,1,2
5,6,1,1,2
5,6,2,1,2
5,6,3,1,2
5,6,4,1,2
5,6,5,1,2
5,6,6,1,2
5,6,7,1,2
5,6,8,1,2
5,6,9,1,2
5,6,10,1,2
5,6,11,1,2
5,6,12,1,2
5,6,13,1,2
5,6,14,1,2
5,6,15,1,2
5,6,16,1,2
5,6,17,1,2
5,6,18,1,2
5,6,19,1,2
5,6,20,1,2
5,7,0,1,2
5,7,1,1,2
5,7,2,1,2
5,7,3,1,2
5,7,4,1,2
5,7,5,1,2
5,7,6,1,2
5,7,7,1,2
5,7,8,1,2
5,7,9,1,2
5,7,10,1,2
5,7,11,1,2
5,7,12,1,2
5,7,13,1,2
5,7,14,1,2
5,7,15,1,2
5,7,16,1,2
5,7,17,1,2
5,7,18,1,2
5,7,19,1,2
5,7,20,1,2
5,8,0,1,2
5,8,1,1,2
5,8,2,1,2
5,8,3,1,2
5,8,4,1,2
5,8,5,1,2
5,8,6,1,2
5,8,7,1,2
5,8,8,1,2
5,8,9,1,2
5,8,10,1,2
5,8,11,1,2
5,8,12,1,2
5,8,13,1,2
5,8,14,1,2
5,8,15,1,2
5,8,16,1,2
5,8,17,1,2
5,8,18,1,2
5,8,19,1,2
5,8,20,1,2
5,9,0,1,2
5,9,1,1,2
5,9,2,1,2
5,9,3,1,2
5,9,4,1,2
5,9,5,1,2
5,9,6,1,2
5,9,7,1,2
5,9,8,1,2
5,9,9,1,2
5,9,10,1,2
5,9,11,1,2
5,9,12,1,2
5,9,13,1,2
5,9,14,1,2
5,9,15,1,2
5,9,16,1,2
5,9,17,1,2
5,9,18,1,2
5,9,19,1,2
5,9,20,1,2
5,10,0,1,2
5,10,1,1,2
5,10,2,1,2
5,10,3,1,2
5,10,4,1,2
5,10,5,1,2
5,10,6,1,2
5,10,7,1,2
5,10,8,1,2
5,10,9,1,2
5,10,10,1,2
5,10,11,1,2
5,10,12,1,2
5,10,13,1,2
5,10,14,1,2
5,10,15,1,2
5,10,16,1,2
5,10,17,1,2
5,10,18,1,2
5,10,19,1,2
5,10,20,1,2
5,11,0,1,2
5,11,1,1,2
5,11,2,1,2
5,11,3,1,2
5,11,4,1,2
5,11,5,1,2
5,11,6,1,2
5,11,7,1,2
5,11,8,1,2
5,11,9,1,2
5,11,10,1,2
5,11,11,1,2
5,11,12,1,2
5,11,13,1,2
5,11,14,1,2
5,11,15,1,2
5,11,16,1,2
5,11,17,1,2
5,11,18,1,2
5,11,19,1,2
5,11,20,1,2
5,12,0,1,2
5,12,1,1,2
5,12,2,1,2
5,12,3,1,2
5,12,4,1,2
5,12,5,1,2
5,12,6,1,2
5,12,7,1,2
5,12,8,1,2
5,12,9,1,2
5,12,10,1,2
5,12,11,1,2
5,12,12,1,2
5,12,13,1,2
5,12,14,1,2
5,12,15,1,2
5,12,16,1,2
5,12,17,1,2
5,12,18,1,2
5,12,19,1,2
5,12,20,1,2
5,13,0,1,2
5,13,1,1,2
5,13,2,1,2
5,13,3,1,2
5,13,4,1,2
5,13,5,1,2
5,13,6,1,2
5,13,7,1,2
5,13,8,1,2
5,13,9,1,2
5,13,10,1,2
5,13,11,1,2
5,13,12,1,2
5,13,13,1,2
5,13,14,1,2
5,13,15,1,2
5,13,16,1,2
5,13,17,1,2
5,13,18,1,2
5,13,19,1,2
5,13,20,1,2
5,14,0,1,2
5,14,1,1,2
5,14,2,1,2
5,14,3,1,2
5,14,4,1,2
5,14,5,1,2
5,14,6,1,2
5,14,7,1,2
5,14,8,1,2
5,14,9,1,2
5,14,10,1,2
5,14,11,1,2
5,14,12,1,2
5,14,13,1,2
5,14,14,1,2
5,14,15,1,2
5,14,16,1,2
5,14,17,1,2
5,14,18,1,2
5,14,19,1,2
5,14,20,1,2
5,15,0,1,2
5,15,1,1,2
5,15,2,1,2
5,15,3,1,2
5,15,4,1,2
5,15,5,1,2
5,15,6,1,2
5,15,7,1,2
5,15,8,1,2
5,15,9,1,2
5,15,10,1,2
5,15,11,1,2
5,15,12,1,2
5,15,13,1,2
5,15,14,1,2
5,15,15,1,2
5,15,16,1,2
5,15,17,1,2
5,15,18,1,2
5,15,19,1,2
5,15,20,1,2
5,16,0,1,2
5,16,1,1,2
5,16,2,1,2
5,16,3,1,2
5,16,4,1,2
5,16,5,1,2
5,16,6,1,2
5,16,7,1,2
5,16,8,1,2
5,16,9,1,2
5,16,10,1,2
5,16,11,1,2
5,16,12,1,2
5,16,13,1,2
5,16,14,1,2
5,16,15,1,2
5,16,16,1,2
5,16,17,1,2
5,16,18,1,2
5,16,19,1,2
5,16,20,1,2
5,17,0,1,2
5,17,1,1,2
5,17,2,1,2
5,17,3,1,2
5,17,4,1,2
5,17,5,1,2
5,17,6,1,2
5,17,7,1,2
5,17,8,1,2
5,17,9,1,2
5,17,10,1,2
5,17,11,1,2
5,17,12,1,2
5,17,13,1,2
5,17,14,1,2
5,17,15,1,2
5,17,16,1,2
5,17,17,1,2
5,17,18,1,2
5,17,19,1,2
5,17,20,1,2
5,18,0,1,2
5,18,1,1,2
5,18,2,1,2
5,18,3,1,2
5,18,4,1,2
5,18,5,1,2
5,18,6,1,2
5,18,7,1,2
5,18,8,1,2
5,18,9,1,2
5,18,10,1,2
5,18,11,1,2
5,18,12,1,2
5,18,13,1,2
5,18,14,1,2
5,18,15,1,2
5,18,16,1,2
5,18,17,1,2
5,18,18,1,2
5,18,19,1,2
5,18,20,1,2
5,19,0,1,2
5,19,1,1,2
5,19,2,1,2
5,19,3,1,2
5,19,4,1,2
5,19,5,1,2
5,19,6,1,2
5,19,7,1,2
5,19,8,1,2
5,19,9,1,2
5,19,10,1,2
5,19,11,1,2
5,19,12,1,2
5,19,13,1,2
5,19,14,1,2
5,19,15,1,2
5,19,16,1,2
5,19,17,1,2
5,19,18,1,2
5,19,19,1,2
5,19,20,1,2
5,20,0,1,2
5,20,1,1,2
5,20,2,1,2
5,20,3,1,2
5,20,4,1,2
5,20,5,1,2
5,20,6,1,2
5,20,7,1,2
5,20,8,1,2
5,20,9,1,2
5,20,10,1,2
5,20,11,1,2
5,20,12,1,2
5,20,13,1,2
5,20,14,1,2
5,20,15,1,2
5,20,16,1,2
5,20,17,1,2
5,20,18,1,2
5,20,19,1,2
5,20,20,1,2
5,21,0,1,2
5,21,1,1,2
5,21,2,1,2
5,21,3,1,2
5,21,4,1,2
5,21,5,1,2
5,21,6,1,2
5,21,7,1,2
5,21,8,1,2
5,21,9,1,2
5,21,10,1,2
5,21,11,1,2
5,21,12,1,2
5,21,13,1,2
5,21,14,1,2
5,21,15,1,2
5,21,16,1,2
5,21,17,1,2
5,21,18,1,2
5,21,19,1,2
5,21,20,1,2
5,22,0,1,2
5,22,1,1,2
5,22,2,1,2
5,22,3,1,2
5,22,4,1,2
5,22,5,1,2
5,22,6,1,2
5,22,7,1,2
5,22,8,1,2
5,22,9,1,2
5,22,10,1,2
5,22,11,1,2
5,22,12,1,2
5,22,13,1,2
5,22,14,1,2
5,22,15,1,2
5,22,16,1,2
5,22,17,1,2
5,22,18,1,2
5,22,19,1,2
5,22,20,1,2
5,0,0,2,2
5,0,1,2,2
5,0,2,2,2
5,0,3,2,2
5,0,4,2,2
5,0,5,2,2
5,0,6,2,2
5,0,7,2,2
5,0,8,2,2
5,0,9,2,2
5,0,10,2,2
5,0,11,2,2
5,0,12,2,2
5,0,13,2,2
5,0,14,2,2
5,0,15,2,2
5,0,16,2,2
5,0,17,2,2
5,0,18,2,2
5,0,19,2,2
5,0,20,2,2
5,1,0,2,2
5,1,1,2,2
5,1,2,2,2
5,1,3,2,2
5,1,4,2,2
5,1,5,2,2
5,1,6,2,2
5,1,7,2,2
5,1,8,2,2
5,1,9,2,2
5,1,10,2,2
5,1,11,2,2
5,1,12,2,2
5,1,13,2,2
5,1,14,2,2
5,1,15,2,2
5,1,16,2,2
5,1,17,2,2
5,1,18,2,2
5,1,19,2,2
5,1,20,2,2
5,2,0,2,2
5,2,1,2,2
5,2,2,2,2
5,2,3,2,2
5,2,4,2,2
5,2,5,2,2
5,2,6,2,2
5,2,7,2,2
5,2,8,2,2
5,2,9,2,2
5,2,10,2,2
5,2,11,2,2
5,2,12,2,2
5,2,13,2,2
5,2,14,2,2
5,2,15,2,2
5,2,16,2,2
5,2,17,2,2
5,2,18,2,2
5,2,19,2,2
5,2,20,2,2
5,3,0,2,2
5,3,1,2,2
5,3,2,2,2
5,3,3,2,2
5,3,4,2,2
5,3,5,2,2
5,3,6,2,2
5,3,7,2,2
5,3,8,2,2
5,3,9,2,2
5,3,10,2,2
5,3,11,2,2
5,3,12,2,2
5,3,13,2,2
5,3,14,2,2
5,3,15,2,2
5,3,16,2,2
5,3,17,2,2
5,3,18,2,2
5,3,19,2,2
5,3,20,2,2
5,4,0,2,2
5,4,1,2,2
5,4,2,2,2
5,4,3,2,2
5,4,4,2,2
5,4,5,2,2
5,4,6,2,2
5,4,7,2,2
5,4,8,2,2
5,4,9,2,2
5,4,10,2,2
5,4,11,2,2
5,4,12,2,2
5,4,13,2,2
5,4,14,2,2
5,4,15,2,2
5,4,16,2,2
5,4,17,2,2
5,4,18,2,2
5,4,19,2,2
5,4,20,2,2
5,5,0,2,2
5,5,1,2,2
5,5,2,2,2
5,5,3,2,2
5,5,4,2,2
5,5,5,2,2
5,5,6,2,2
5,5,7,2,2
5,5,8,2,2
5,5,9,2,2
5,5,10,2,2
5,5,11,2,2
5,5,12,2,2
5,5,13,2,2
5,5,14,2,2
5,5,15,2,2
5,5,16,2,2
5,5,17,2,2
5,5,18,2,2
5,5,19,2,2
5,5,20,2,2
5,6,0,2,2
5,6,1,2,2
5,6,2,2,2
5,6,3,2,2
5,6,4,2,2
5,6,5,2,2
5,6,6,2,2
5,6,7,2,2
5,6,8,2,2
5,6,9,2,2
5,6,10,2,2
5,6,11,2,2
5,6,12,2,2
5,6,13,2,2
5,6,14,2,2
5,6,15,2,2
5,6,16,2,2
5,6,17,2,2
5,6,18,2,2
5,6,19,2,2
5,6,20,2,2
5,7,0,2,2
5,7,1,2,2
5,7,2,2,2
5,7,3,2,2
5,7,4,2,2
5,7,5,2,2
5,7,6,2,2
5,7,7,2,2
5,7,8,2,2
5,7,9,2,2
5,7,10,2,2
5,7,11,2,2
5,7,12,2,2
5,7,13,2,2
5,7,14,2,2
5,7,15,2,2
5,7,16,2,2
5,7,17,2,2
5,7,18,2,2
5,7,19,2,2
5,7,20,2,2
5,8,0,2,2
5,8,1,2,2
5,8,2,2,2
5,8,3,2,2
5,8,4,2,2
5,8,5,2,2
5,8,6,2,2
5,8,7,2,2
5,8,8,2,2
5,8,9,2,2
5,8,10,2,2
5,8,11,2,2
5,8,12,2,2
5,8,13,2,2
5,8,14,2,2
5,8,15,2,2
5,8,16,2,2
5,8,17,2,2
5,8,18,2,2
5,8,19,2,2
5,8,20,2,2
5,9,0,2,2
5,9,1,2,2
5,9,2,2,2
5,9,3,2,2
5,9,4,2,2
5,9,5,2,2
5,9,6,2,2
5,9,7,2,2
5,9,8,2,2
5,9,9,2,2
5,9,10,2,2
5,9,11,2,2
5,9,12,2,2
5,9,13,2,2
5,9,14,2,2
5,9,15,2,2
5,9,16,2,2
5,9,17,2,2
5,9,18,2,2
5,9,19,2,2
5,9,20,2,2
5,10,0,2,2
5,10,1,2,2
5,10,2,2,2
5,10,3,2,2
5,10,4,2,2
5,10,5,2,2
5,10,6,2,2
5,10,7,2,2
5,10,8,2,2
5,10,9,2,2
5,10,10,2,2
5,10,11,2,2
5,10,12,2,2
5,10,13,2,2
5,10,14,2,2
5,10,15,2,2
5,10,16,2,2
5,10,17,2,2
5,10,18,2,2
5,10,19,2,2
5,10,20,2,2
5,11,0,2,2
5,11,1,2,2
5,11,2,2,2
5,11,3,2,2
5,11,4,2,2
5,11,5,2,2
5,11,6,2,2
5,11,7,2,2
5,11,8,2,2
5,11,9,2,2
5,11,10,2,2
5,11,11,2,2
5,11,12,2,2
5,11,13,2,2
5,11,14,2,2
5,11,15,2,2
5,11,16,2,2
5,11,17,2,2
5,11,18,2,2
5,11,19,2,2
5,11,20,2,2
5,12,0,2,2
5,12,1,2,2
5,12,2,2,2
5,12,3,2,2
5,12,4,2,2
5,12,5,2,2
5,12,6,2,2
5,12,7,2,2
5,12,8,2,2
5,12,9,2,2
5,12,10,2,2
5,12,11,2,2
5,12,12,2,2
5,12,13,2,2
5,12,14,2,2
5,12,15,2,2
5,12,16,2,2
5,12,17,2,2
5,12,18,2,2
5,12,19,2,2
5,12,20,2,2
5,13,0,2,2
5,13,1,2,2
5,13,2,2,2
5,13,3,2,2
5,13,4,2,2
5,13,5,2,2
5,13,6,2,2
5,13,7,2,2
5,13,8,2,2
5,13,9,2,2
5,13,10,2,2
5,13,11,2,2
5,13,12,2,2
5,13,13,2,2
5,13,14,2,2
5,13,15,2,2
5,13,16,2,2
5,13,17,2,2
5,13,18,2,2
5,13,19,2,2
5,13,20,2,2
5,14,0,2,2
5,14,1,2,2
5,14,2,2,2
5,14,3,2,2
5,14,4,2,2
5,14,5,2,2
5,14,6,2,2
5,14,7,2,2
5,14,8,2,2
5,14,9,2,2
5,14,10,2,2
5,14,11,2,2
5,14,12,2,2
5,14,13,2,2
5,14,14,2,2
5,14,15,2,2
5,14,16,2,2
5,14,17,2,2
5,14,18,2,2
5,14,19,2,2
5,14,20,2,2
5,15,0,2,2
5,15,1,2,2
5,15,2,2,2
5,15,3,2,2
5,15,4,2,2
5,15,5,2,2
5,15,6,2,2
5,15,7,2,2
5,15,8,2,2
5,15,9,2,2
5,15,10,2,2
5,15,11,2,2
5,15,12,2,2
5,15,13,2,2
5,15,14,2,2
5,15,15,2,2
5,15,16,2,2
5,15,17,2,2
5,15,18,2,2
5,15,19,2,2
5,15,20,2,2
5,16,0,2,2
5,16,1,2,2
5,16,2,2,2
5,16,3,2,2
5,16,4,2,2
5,16,5,2,2
5,16,6,2,2
5,16,7,2,2
5,16,8,2,2
5,16,9,2,2
5,16,10,2,2
5,16,11,2,2
5,16,12,2,2
5,16,13,2,2
5,16,14,2,2
5,16,15,2,2
5,16,16,2,2
5,16,17,2,2
5,16,18,2,2
5,16,19,2,2
5,16,20,2,2
5,17,0,2,2
5,17,1,2,2
5,17,2,2,2
5,17,3,2,2
5,17,4,2,2
5,17,5,2,2
5,17,6,2,2
5,17,7,2,2
5,17,8,2,2
5,17,9,2,2
5,17,10,2,2
5,17,11,2,2
5,17,12,2,2
5,17,13,2,2
5,17,14,2,2
5,17,15,2,2
5,17,16,2,2
5,17,17,2,2
5,17,18,2,2
5,17,19,2,2
5,17,20,2,2
5,18,0,2,2
5,18,1,2,2
5,18,2,2,2
5,18,3,2,2
5,18,4,2,2
5,18,5,2,2
5,18,6,2,2
5,18,7,2,2
5,18,8,2,2
5,18,9,2,2
5,18,10,2,2
5,18,11,2,2
5,18,12,2,2
5,18,13,2,2
5,18,14,2,2
5,18,15,2,2
5,18,16,2,2
5,18,17,2,2
5,18,18,2,2
5,18,19,2,2
5,18,20,2,2
5,19,0,2,2
5,19,1,2,2
5,19,2,2,2
5,19,3,2,2
5,19,4,2,2
5,19,5,2,2
5,19,6,2,2
5,19,7,2,2
5,19,8,2,2
5,19,9,2,2
5,19,10,2,2
5,19,11,2,2
5,19,12,2,2
5,19,13,2,2
5,19,14,2,2
5,19,15,2,2
5,19,16,2,2
5,19,17,2,2
5,19,18,2,2
5,19,19,2,2
5,19,20,2,2
5,20,0,2,2
5,20,1,2,2
5,20,2,2,2
5,20,3,2,2
5,20,4,2,2
5,20,5,2,2
5,20,6,2,2
5,20,7,2,2
5,20,8,2,2
5,20,9,2,2
5,20,10,2,2
5,20,11,2,2
5,20,12,2,2
5,20,13,2,2
5,20,14,2,2
5,20,15,2,2
5,20,16,2,2
5,20,17,2,2
5,20,18,2,2
5,20,19,2,2
5,20,20,2,2
5,0,0,3,2
5,0,1,3,2
5,0,2,3,2
5,0,3,3,2
5,0,4,3,2
5,0,5,3,2
5,0,6,3,2
5,0,7,3,2
5,0,8,3,2
5,0,9,3,2
5,0,10,3,2
5,0,11,3,2
5,0,12,3,2
5,0,13,3,2
5,0,14,3,2
5,0,15,3,2
5,0,16,3,2
5,0,17,3,2
5,0,18,3,2
5,0,19,3,2
5,0,20,3,2
5,1,0,3,2
5,1,1,3,2
5,1,2,3,2
5,1,3,3,2
5,1,4,3,2
5,1,5,3,2
5,1,6,3,2
5,1,7,3,2
5,1,8,3,2
5,1,9,3,2
5,1,10,3,2
5,1,11,3,2
5,1,12,3,2
5,1,13,3,2
5,1,14,3,2
5,1,15,3,2
5,1,16,3,2
5,1,17,3,2
5,1,18,3,2
5,1,19,3,2
5,1,20,3,2
5,2,0,3,2
5,2,1,3,2
5,2,2,3,2
5,2,3,3,2
5,2,4,3,2
5,2,5,3,2
5,2,6,3,2
5,2,7,3,2
5,2,8,3,2
5,2,9,3,2
5,2,10,3,2
5,2,11,3,2
5,2,12,3,2
5,2,13,3,2
5,2,14,3,2
5,2,15,3,2
5,2,16,3,2
5,2,17,3,2
5,2,18,3,2
5,2,19,3,2
5,2,20,3,2
5,3,0,3,2
5,3,1,3,2
5,3,2,3,2
5,3,3,3,2
5,3,4,3,2
5,3,5,3,2
5,3,6,3,2
5,3,7,3,2
5,3,8,3,2
5,3,9,3,2
5,3,10,3,2
5,3,11,3,2
5,3,12,3,2
5,3,13,3,2
5,3,14,3,2
5,3,15,3,2
5,3,16,3,2
5,3,17,3,2
5,3,18,3,2
5,3,19,3,2
5,3,20,3,2
5,4,0,3,2
5,4,1,3,2
5,4,2,3,2
5,4,3,3,2
5,4,4,3,2
5,4,5,3,2
5,4,6,3,2
5,4,7,3,2
5,4,8,3,2
5,4,9,3,2
5,4,10,3,2
5,4,11,3,2
5,4,12,3,2
5,4,13,3,2
5,4,14,3,2
5,4,15,3,2
5,4,16,3,2
5,4,17,3,2
5,4,18,3,2
5,4,19,3,2
5,4,20,3,2
5,5,0,3,2
5,5,1,3,2
5,5,2,3,2
5,5,3,3,2
5,5,4,3,2
5,5,5,3,2
5,5,6,3,2
5,5,7,3,2
5,5,8,3,2
5,5,9,3,2
5,5,10,3,2
5,5,11,3,2
5,5,12,3,2
5,5,13,3,2
5,5,14,3,2
5,5,15,3,2
5,5,16,3,2
5,5,17,3,2
5,5,18,3,2
5,5,19,3,2
5,5,20,3,2
5,6,0,3,2
5,6,1,3,2
5,6,2,3,2
5,6,3,3,2
5,6,4,3,2
5,6,5,3,2
5,6,6,3,2
5,6,7,3,2
5,6,8,3,2
5,6,9,3,2
5,6,10,3,2
5,6,11,3,2
5,6,12,3,2
5,6,13,3,2
5,6,14,3,2
5,6,15,3,2
5,6,16,3,2
5,6,17,3,2
5,6,18,3,2
5,6,19,3,2
5,6,20,3,2
5,7,0,3,2
5,7,1,3,2
5,7,2,3,2
5,7,3,3,2
5,7,4,3,2
5,7,5,3,2
5,7,6,3,2
5,7,7,3,2
5,7,8,3,2
5,7,9,3,2
5,7,10,3,2
5,7,11,3,2
5,7,12,3,2
5,7,13,3,2
5,7,14,3,2
5,7,15,3,2
5,7,16,3,2
5,7,17,3,2
5,7,18,3,2
5,7,19,3,2
5,7,20,3,2
5,8,0,3,2
5,8,1,3,2
5,8,2,3,2
5,8,3,3,2
5,8,4,3,2
5,8,5,3,2
5,8,6,3,2
5,8,7,3,2
5,8,8,3,2
5,8,9,3,2
5,8,10,3,2
5,8,11,3,2
5,8,12,3,2
5,8,13,3,2
5,8,14,3,2
5,8,15,3,2
5,8,16,3,2
5,8,17,3,2
5,8,18,3,2
5,8,19,3,2
5,8,20,3,2
5,9,0,3,2
5,9,1,3,2
5,9,2,3,2
5,9,3,3,2
5,9,4,3,2
5,9,5,3,2
5,9,6,3,2
5,9,7,3,2
5,9,8,3,2
5,9,9,3,2
5,9,10,3,2
5,9,11,3,2
5,9,12,3,2
5,9,13,3,2
5,9,14,3,2
5,9,15,3,2
5,9,16,3,2
5,9,17,3,2
5,9,18,3,2
5,9,19,3,2
5,9,20,3,2
5,10,0,3,2
5,10,1,3,2
5,10,2,3,2
5,10,3,3,2
5,10,4,3,2
5,10,5,3,2
5,10,6,3,2
5,10,7,3,2
5,10,8,3,2
5,10,9,3,2
5,10,10,3,2
5,10,11,3,2
5,10,12,3,2
5,10,13,3,2
5,10,14,3,2
5,10,15,3,2
5,10,16,3,2
5,10,17,3,2
5,10,18,3,2
5,10,19,3,2
5,10,20,3,2
5,11,0,3,2
5,11,1,3,2
5,11,2,3,2
5,11,3,3,2
5,11,4,3,2
5,11,5,3,2
5,11,6,3,2
5,11,7,3,2
5,11,8,3,2
5,11,9,3,2
5,11,10,3,2
5,11,11,3,2
5,11,12,3,2
5,11,13,3,2
5,11,14,3,2
5,11,15,3,2
5,11,16,3,2
5,11,17,3,2
5,11,18,3,2
5,11,19,3,2
5,11,20,3,2
5,12,0,3,2
5,12,1,3,2
5,12,2,3,2
5,12,3,3,2
5,12,4,3,2
5,12,5,3,2
5,12,6,3,2
5,12,7,3,2
5,12,8,3,2
5,12,9,3,2
5,12,10,3,2
5,12,11,3,2
5,12,12,3,2
5,12,13,3,2
5,12,14,3,2
5,12,15,3,2
5,12,16,3,2
5,12,17,3,2
5,12,18,3,2
5,12,19,3,2
5,12,20,3,2
5,13,0,3,2
5,13,1,3,2
5,13,2,3,2
5,13,3,3,2
5,13,4,3,2
5,13,5,3,2
5,13,6,3,2
5,13,7,3,2
5,13,8,3,2
5,13,9,3,2
5,13,10,3,2
5,13,11,3,2
5,13,12,3,2
5,13,13,3,2
5,13,14,3,2
5,13,15,3,2
5,13,16,3,2
5,13,17,3,2
5,13,18,3,2
5,13,19,3,2
5,13,20,3,2
5,14,0,3,2
5,14,1,3,2
5,14,2,3,2
5,14,3,3,2
5,14,4,3,2
5,14,5,3,2
5,14,6,3,2
5,14,7,3,2
5,14,8,3,2
5,14,9,3,2
5,14,10,3,2
5,14,11,3,2
5,14,12,3,2
5,14,13,3,2
5,14,14,3,2
5,14,15,3,2
5,14,16,3,2
5,14,17,3,2
5,14,18,3,2
5,14,19,3,2
5,14,20,3,2
5,15,0,3,2
5,15,1,3,2
5,15,2,3,2
5,15,3,3,2
5,15,4,3,2
5,15,5,3,2
5,15,6,3,2
5,15,7,3,2
5,15,8,3,2
5,15,9,3,2
5,15,10,3,2
5,15,11,3,2
5,15,12,3,2
5,15,13,3,2
5,15,14,3,2
5,15,15,3,2
5,15,16,3,2
5,15,17,3,2
5,15,18,3,2
5,15,19,3,2
5,15,20,3,2
5,16,0,3,2
5,16,1,3,2
5,16,2,3,2
5,16,3,3,2
5,16,4,3,2
5,16,5,3,2
5,16,6,3,2
5,16,7,3,2
5,16,8,3,2
5,16,9,3,2
5,16,10,3,2
5,16,11,3,2
5,16,12,3,2
5,16,13,3,2
5,16,14,3,2
5,16,15,3,2
5,16,16,3,2
5,16,17,3,2
5,16,18,3,2
5,16,19,3,2
5,16,20,3,2
5,17,0,3,2
5,17,1,3,2
5,17,2,3,2
5,17,3,3,2
5,17,4,3,2
5,17,5,3,2
5,17,6,3,2
5,17,7,3,2
5,17,8,3,2
5,17,9,3,2
5,17,10,3,2
5,17,11,3,2
5,17,12,3,2
5,17,13,3,2
5,17,14,3,2
5,17,15,3,2
5,17,16,3,2
5,17,17,3,2
5,17,18,3,2
5,17,19,3,2
5,17,20,3,2
5,18,0,3,2
5,18,1,3,2
5,18,2,3,2
5,18,3,3,2
5,18,4,3,2
5,18,5,3,2
5,18,6,3,2
5,18,7,3,2
5,18,8,3,2
5,18,9,3,2
5,18,10,3,2
5,18,11,3,2
5,18,12,3,2
5,18,13,3,2
5,18,14,3,2
5,18,15,3,2
5,18,16,3,2
5,18,17,3,2
5,18,18,3,2
5,18,19,3,2
5,18,20,3,2
5,0,0,4,2
5,0,1,4,2
5,0,2,4,2
5,0,3,4,2
5,0,4,4,2
5,0,5,4,2
5,0,6,4,2
5,0,7,4,2
5,0,8,4,2
5,0,9,4,2
5,0,10,4,2
5,0,11,4,2
5,0,12,4,2
5,0,13,4,2
5,0,14,4,2
5,0,15,4,2
5,0,16,4,2
5,0,17,4,2
5,0,18,4,2
5,0,19,4,2
5,0,20,4,2
5,1,0,4,2
5,1,1,4,2
5,1,2,4,2
5,1,3,4,2
5,1,4,4,2
5,1,5,4,2
5,1,6,4,2
5,1,7,4,2
5,1,8,4,2
5,1,9,4,2
5,1,10,4,2
5,1,11,4,2
5,1,12,4,2
5,1,13,4,2
5,1,14,4,2
5,1,15,4,2
5,1,16,4,2
5,1,17,4,2
5,1,18,4,2
5,1,19,4,2
5,1,20,4,2
5,2,0,4,2
5,2,1,4,2
5,2,2,4,2
5,2,3,4,2
5,2,4,4,2
5,2,5,4,2
5,2,6,4,2
5,2,7,4,2
5,2,8,4,2
5,2,9,4,2
5,2,10,4,2
5,2,11,4,2
5,2,12,4,2
5,2,13,4,2
5,2,14,4,2
5,2,15,4,2
5,2,16,4,2
5,2,17,4,2
5,2,18,4,2
5,2,19,4,2
5,2,20,4,2
5,3,0,4,2
5,3,1,4,2
5,3,2,4,2
5,3,3,4,2
5,3,4,4,2
5,3,5,4,2
5,3,6,4,2
5,3,7,4,2
5,3,8,4,2
5,3,9,4,2
5,3,10,4,2
5,3,11,4,2
5,3,12,4,2
5,3,13,4,2
5,3,14,4,2
5,3,15,4,2
5,3,16,4,2
5,3,17,4,2
5,3,18,4,2
5,3,19,4,2
5,3,20,4,2
5,4,0,4,2
5,4,1,4,2
5,4,2,4,2
5,4,3,4,2
5,4,4,4,2
5,4,5,4,2
5,4,6,4,2
5,4,7,4,2
5,4,8,4,2
5,4,9,4,2
5,4,10,4,2
5,4,11,4,2
5,4,12,4,2
5,4,13,4,2
5,4,14,4,2
5,4,15,4,2
5,4,16,4,2
5,4,17,4,2
5,4,18,4,2
5,4,19,4,2
5,4,20,4,2
5,5,0,4,2
5,5,1,4,2
5,5,2,4,2
5,5,3,4,2
5,5,4,4,2
5,5,5,4,2
5,5,6,4,2
5,5,7,4,2
5,5,8,4,2
5,5,9,4,2
5,5,10,4,2
5,5,11,4,2
5,5,12,4,2
5,5,13,4,2
5,5,14,4,2
5,5,15,4,2
5,5,16,4,2
5,5,17,4,2
5,5,18,4,2
5,5,19,4,2
5,5,20,4,2
5,6,0,4,2
5,6,1,4,2
5,6,2,4,2
5,6,3,4,2
5,6,4,4,2
5,6,5,4,2
5,6,6,4,2
5,6,7,4,2
5,6,8,4,2
5,6,9,4,2
5,6,10,4,2
5,6,11,4,2
5,6,12,4,2
5,6,13,4,2
5,6,14,4,2
5,6,15,4,2
5,6,16,4,2
5,6,17,4,2
5,6,18,4,2
5,6,19,4,2
5,6,20,4,2
5,7,0,4,2
5,7,1,4,2
5,7,2,4,2
5,7,3,4,2
5,7,4,4,2
5,7,5,4,2
5,7,6,4,2
5,7,7,4,2
5,7,8,4,2
5,7,9,4,2
5,7,10,4,2
5,7,11,4,2
5,7,12,4,2
5,7,13,4,2
5,7,14,4,2
5,7,15,4,2
5,7,16,4,2
5,7,17,4,2
5,7,18,4,2
5,7,19,4,2
5,7,20,4,2
5,8,0,4,2
5,8,1,4,2
5,8,2,4,2
5,8,3,4,2
5,8,4,4,2
5,8,5,4,2
5,8,6,4,2
5,8,7,4,2
5,8,8,4,2
5,8,9,4,2
5,8,10,4,2
5,8,11,4,2
5,8,12,4,2
5,8,13,4,2
5,8,14,4,2
5,8,15,4,2
5,8,16,4,2
5,8,17,4,2
5,8,18,4,2
5,8,19,4,2
5,8,20,4,2
5,9,0,4,2
5,9,1,4,2
5,9,2,4,2
5,9,3,4,2
5,9,4,4,2
5,9,5,4,2
5,9,6,4,2
5,9,7,4,2
5,9,8,4,2
5,9,9,4,2
5,9,10,4,2
5,9,11,4,2
5,9,12,4,2
5,9,13,4,2
5,9,14,4,2
5,9,15,4,2
5,9,16,4,2
5,9,17,4,2
5,9,18,4,2
5,9,19,4,2
5,9,20,4,2
5,10,0,4,2
5,10,1,4,2
5,10,2,4,2
5,10,3,4,2
5,10,4,4,2
5,10,5,4,2
5,10,6,4,2
5,10,7,4,2
5,10,8,4,2
5,10,9,4,2
5,10,10,4,2
5,10,11,4,2
5,10,12,4,2
5,10,13,4,2
5,10,14,4,2
5,10,15,4,2
5,10,16,4,2
5,10,17,4,2
5,10,18,4,2
5,10,19,4,2
5,10,20,4,2
5,11,0,4,2
5,11,1,4,2
5,11,2,4,2
5,11,3,4,2
5,11,4,4,2
5,11,5,4,2
5,11,6,4,2
5,11,7,4,2
5,11,8,4,2
5,11,9,4,2
5,11,10,4,2
5,11,11,4,2
5,11,12,4,2
5,11,13,4,2
5,11,14,4,2
5,11,15,4,2
5,11,16,4,2
5,11,17,4,2
5,11,18,4,2
5,11,19,4,2
5,11,20,4,2
5,12,0,4,2
5,12,1,4,2
5,12,2,4,2
5,12,3,4,2
5,12,4,4,2
5,12,5,4,2
5,12,6,4,2
5,12,7,4,2
5,12,8,4,2
5,12,9,4,2
5,12,10,4,2
5,12,11,4,2
5,12,12,4,2
5,12,13,4,2
5,12,14,4,2
5,12,15,4,2
5,12,16,4,2
5,12,17,4,2
5,12,18,4,2
5,12,19,4,2
5,12,20,4,2
5,13,0,4,2
5,13,1,4,2
5,13,2,4,2
5,13,3,4,2
5,13,4,4,2
5,13,5,4,2
5,13,6,4,2
5,13,7,4,2
5,13,8,4,2
5,13,9,4,2
5,13,10,4,2
5,13,11,4,2
5,13,12,4,2
5,13,13,4,2
5,13,14,4,2
5,13,15,4,2
5,13,16,4,2
5,13,17,4,2
5,13,18,4,2
5,13,19,4,2
5,13,20,4,2
5,14,0,4,2
5,14,1,4,2
5,14,2,4,2
5,14,3,4,2
5,14,4,4,2
5,14,5,4,2
5,14,6,4,2
5,14,7,4,2
5,14,8,4,2
5,14,9,4,2
5,14,10,4,2
5,14,11,4,2
5,14,12,4,2
5,14,13,4,2
5,14,14,4,2
5,14,15,4,2
5,14,16,4,2
5,14,17,4,2
5,14,18,4,2
5,14,19,4,2
5,14,20,4,2
5,15,0,4,2
5,15,1,4,2
5,15,2,4,2
5,15,3,4,2
5,15,4,4,2
5,15,5,4,2
5,15,6,4,2
5,15,7,4,2
5,15,8,4,2
5,15,9,4,2
5,15,10,4,2
5,15,11,4,2
5,15,12,4,2
5,15,13,4,2
5,15,14,4,2
5,15,15,4,2
5,15,16,4,2
5,15,17,4,2
5,15,18,4,2
5,15,19,4,2
5,15,20,4,2
5,16,0,4,2
5,16,1,4,2
5,16,2,4,2
5,16,3,4,2
5,16,4,4,2
5,16,5,4,2
5,16,6,4,2
5,16,7,4,2
5,16,8,4,2
5,16,9,4,2
5,16,10,4,2
5,16,11,4,2
5,16,12,4,2
5,16,13,4,2
5,16,14,4,2
5,16,15,4,2
5,16,16,4,2
5,16,17,4,2
5,16,18,4,2
5,16,19,4,2
5,16,20,4,2
5,0,0,5,2
5,0,1,5,2
5,0,2,5,2
5,0,3,5,2
5,0,4,5,2
5,0,5,5,2
5,0,6,5,2
5,0,7,5,2
5,0,8,5,2
5,0,9,5,2
5,0,10,5,2
5,0,11,5,2
5,0,12,5,2
5,0,13,5,2
5,0,14,5,2
5,0,15,5,2
5,0,16,5,2
5,0,17,5,2
5,0,18,5,2
5,0,19,5,2
5,0,20,5,2
5,1,0,5,2
5,1,1,5,2
5,1,2,5,2
5,1,3,5,2
5,1,4,5,2
5,1,5,5,2
5,1,6,5,2
5,1,7,5,2
5,1,8,5,2
5,1,9,5,2
5,1,10,5,2
5,1,11,5,2
5,1,12,5,2
5,1,13,5,2
5,1,14,5,2
5,1,15,5,2
5,1,16,5,2
5,1,17,5,2
5,1,18,5,2
5,1,19,5,2
5,1,20,5,2
5,2,0,5,2
5,2,1,5,2
5,2,2,5,2
5,2,3,5,2
5,2,4,5,2
5,2,5,5,2
5,2,6,5,2
5,2,7,5,2
5,2,8,5,2
5,2,9,5,2
5,2,10,5,2
5,2,11,5,2
5,2,12,5,2
5,2,13,5,2
5,2,14,5,2
5,2,15,5,2
5,2,16,5,2
5,2,17,5,2
5,2,18,5,2
5,2,19,5,2
5,2,20,5,2
5,3,0,5,2
5,3,1,5,2
5,3,2,5,2
5,3,3,5,2
5,3,4,5,2
5,3,5,5,2
5,3,6,5,2
5,3,7,5,2
5,3,8,5,2
5,3,9,5,2
5,3,10,5,2
5,3,11,5,2
5,3,12,5,2
5,3,13,5,2
5,3,14,5,2
5,3,15,5,2
5,3,16,5,2
5,3,17,5,2
5,3,18,5,2
5,3,19,5,2
5,3,20,5,2
5,4,0,5,2
5,4,1,5,2
5,4,2,5,2
5,4,3,5,2
5,4,4,5,2
5,4,5,5,2
5,4,6,5,2
5,4,7,5,2
5,4,8,5,2
5,4,9,5,2
5,4,10,5,2
5,4,11,5,2
5,4,12,5,2
5,4,13,5,2
5,4,14,5,2
5,4,15,5,2
5,4,16,5,2
5,4,17,5,2
5,4,18,5,2
5,4,19,5,2
5,4,20,5,2
5,5,0,5,2
5,5,1,5,2
5,5,2,5,2
5,5,3,5,2
5,5,4,5,2
5,5,5,5,2
5,5,6,5,2
5,5,7,5,2
5,5,8,5,2
5,5,9,5,2
5,5,10,5,2
5,5,11,5,2
5,5,12,5,2
5,5,13,5,2
5,5,14,5,2
5,5,15,5,2
5,5,16,5,2
5,5,17,5,2
5,5,18,5,2
5,5,19,5,2
5,5,20,5,2
5,6,0,5,2
5,6,1,5,2
5,6,2,5,2
5,6,3,5,2
5,6,4,5,2
5,6,5,5,2
5,6,6,5,2
5,6,7,5,2
5,6,8,5,2
5,6,9,5,2
5,6,10,5,2
5,6,11,5,2
5,6,12,5,2
5,6,13,5,2
5,6,14,5,2
5,6,15,5,2
5,6,16,5,2
5,6,17,5,2
5,6,18,5,2
5,6,19,5,2
5,6,20,5,2
5,7,0,5,2
5,7,1,5,2
5,7,2,5,2
5,7,3,5,2
5,7,4,5,2
5,7,5,5,2
5,7,6,5,2
5,7,7,5,2
5,7,8,5,2
5,7,9,5,2
5,7,10,5,2
5,7,11,5,2
5,7,12,5,2
5,7,13,5,2
5,7,14,5,2
5,7,15,5,2
5,7,16,5,2
5,7,17,5,2
5,7,18,5,2
5,7,19,5,2
5,7,20,5,2
5,8,0,5,2
5,8,1,5,2
5,8,2,5,2
5,8,3,5,2
5,8,4,5,2
5,8,5,5,2
5,8,6,5,2
5,8,7,5,2
5,8,8,5,2
5,8,9,5,2
5,8,10,5,2
5,8,11,5,2
5,8,12,5,2
5,8,13,5,2
5,8,14,5,2
5,8,15,5,2
5,8,16,5,2
5,8,17,5,2
5,8,18,5,2
5,8,19,5,2
5,8,20,5,2
5,9,0,5,2
5,9,1,5,2
5,9,2,5,2
5,9,3,5,2
5,9,4,5,2
5,9,5,5,2
5,9,6,5,2
5,9,7,5,2
5,9,8,5,2
5,9,9,5,2
5,9,10,5,2
5,9,11,5,2
5,9,12,5,2
5,9,13,5,2
5,9,14,5,2
5,9,15,5,2
5,9,16,5,2
5,9,17,5,2
5,9,18,5,2
5,9,19,5,2
5,9,20,5,2
5,10,0,5,2
5,10,1,5,2
5,10,2,5,2
5,10,3,5,2
5,10,4,5,2
5,10,5,5,2
5,10,6,5,2
5,10,7,5,2
5,10,8,5,2
5,10,9,5,2
5,10,10,5,2
5,10,11,5,2
5,10,12,5,2
5,10,13,5,2
5,10,14,5,2
5,10,15,5,2
5,10,16,5,2
5,10,17,5,2
5,10,18,5,2
5,10,19,5,2
5,10,20,5,2
5,11,0,5,2
5,11,1,5,2
5,11,2,5,2
5,11,3,5,2
5,11,4,5,2
5,11,5,5,2
5,11,6,5,2
5,11,7,5,2
5,11,8,5,2
5,11,9,5,2
5,11,10,5,2
5,11,11,5,2
5,11,12,5,2
5,11,13,5,2
5,11,14,5,2
5,11,15,5,2
5,11,16,5,2
5,11,17,5,2
5,11,18,5,2
5,11,19,5,2
5,11,20,5,2
5,12,0,5,2
5,12,1,5,2
5,12,2,5,2
5,12,3,5,2
5,12,4,5,2
5,12,5,5,2
5,12,6,5,2
5,12,7,5,2
5,12,8,5,2
5,12,9,5,2
5,12,10,5,2
5,12,11,5,2
5,12,12,5,2
5,12,13,5,2
5,12,14,5,2
5,12,15,5,2
5,12,16,5,2
5,12,17,5,2
5,12,18,5,2
5,12,19,5,2
5,12,20,5,2
5,13,0,5,2
5,13,1,5,2
5,13,2,5,2
5,13,3,5,2
5,13,4,5,2
5,13,5,5,2
5,13,6,5,2
5,13,7,5,2
5,13,8,5,2
5,13,9,5,2
5,13,10,5,2
5,13,11,5,2
5,13,12,5,2
5,13,13,5,2
5,13,14,5,2
5,13,15,5,2
5,13,16,5,2
5,13,17,5,2
5,13,18,5,2
5,13,19,5,2
5,13,20,5,2
5,14,0,5,2
5,14,1,5,2
5,14,2,5,2
5,14,3,5,2
5,14,4,5,2
5,14,5,5,2
5,14,6,5,2
5,14,7,5,2
5,14,8,5,2
5,14,9,5,2
5,14,10,5,2
5,14,11,5,2
5,14,12,5,2
5,14,13,5,2
5,14,14,5,2
5,14,15,5,2
5,14,16,5,2
5,14,17,5,2
5,14,18,5,2
5,14,19,5,2
5,14,20,5,2
5,0,0,6,2
5,0,1,6,2
5,0,2,6,2
5,0,3,6,2
5,0,4,6,2
5,0,5,6,2
5,0,6,6,2
5,0,7,6,2
5,0,8,6,2
5,0,9,6,2
5,0,10,6,2
5,0,11,6,2
5,0,12,6,2
5,0,13,6,2
5,0,14,6,2
5,0,15,6,2
5,0,16,6,2
5,0,17,6,2
5,0,18,6,2
5,0,19,6,2
5,0,20,6,2
5,1,0,6,2
5,1,1,6,2
5,1,2,6,2
5,1,3,6,2
5,1,4,6,2
5,1,5,6,2
5,1,6,6,2
5,1,7,6,2
5,1,8,6,2
5,1,9,6,2
5,1,10,6,2
5,1,11,6,2
5,1,12,6,2
5,1,13,6,2
5,1,14,6,2
5,1,15,6,2
5,1,16,6,2
5,1,17,6,2
5,1,18,6,2
5,1,19,6,2
5,1,20,6,2
5,2,0,6,2
5,2,1,6,2
5,2,2,6,2
5,2,3,6,2
5,2,4,6,2
5,2,5,6,2
5,2,6,6,2
5,2,7,6,2
5,2,8,6,2
5,2,9,6,2
5,2,10,6,2
5,2,11,6,2
5,2,12,6,2
5,2,13,6,2
5,2,14,6,2
5,2,15,6,2
5,2,16,6,2
5,2,17,6,2
5,2,18,6,2
5,2,19,6,2
5,2,20,6,2
5,3,0,6,2
5,3,1,6,2
5,3,2,6,2
5,3,3,6,2
5,3,4,6,2
5,3,5,6,2
5,3,6,6,2
5,3,7,6,2
5,3,8,6,2
5,3,9,6,2
5,3,10,6,2
5,3,11,6,2
5,3,12,6,2
5,3,13,6,2
5,3,14,6,2
5,3,15,6,2
5,3,16,6,2
5,3,17,6,2
5,3,18,6,2
5,3,19,6,2
5,3,20,6,2
5,4,0,6,2
5,4,1,6,2
5,4,2,6,2
5,4,3,6,2
5,4,4,6,2
5,4,5,6,2
5,4,6,6,2
5,4,7,6,2
5,4,8,6,2
5,4,9,6,2
5,4,10,6,2
5,4,11,6,2
5,4,12,6,2
5,4,13,6,2
5,4,14,6,2
5,4,15,6,2
5,4,16,6,2
5,4,17,6,2
5,4,18,6,2
5,4,19,6,2
5,4,20,6,2
5,5,0,6,2
5,5,1,6,2
5,5,2,6,2
5,5,3,6,2
5,5,4,6,2
5,5,5,6,2
5,5,6,6,2
5,5,7,6,2
5,5,8,6,2
5,5,9,6,2
5,5,10,6,2
5,5,11,6,2
5,5,12,6,2
5,5,13,6,2
5,5,14,6,2
5,5,15,6,2
5,5,16,6,2
5,5,17,6,2
5,5,18,6,2
5,5,19,6,2
5,5,20,6,2
5,6,0,6,2
5,6,1,6,2
5,6,2,6,2
5,6,3,6,2
5,6,4,6,2
5,6,5,6,2
5,6,6,6,2
5,6,7,6,2
5,6,8,6,2
5,6,9,6,2
5,6,10,6,2
5,6,11,6,2
5,6,12,6,2
5,6,13,6,2
5,6,14,6,2
5,6,15,6,2
5,6,16,6,2
5,6,17,6,2
5,6,18,6,2
5,6,19,6,2
5,6,20,6,2
5,7,0,6,2
5,7,1,6,2
5,7,2,6,2
5,7,3,6,2
5,7,4,6,2
5,7,5,6,2
5,7,6,6,2
5,7,7,6,2
5,7,8,6,2
5,7,9,6,2
5,7,10,6,2
5,7,11,6,2
5,7,12,6,2
5,7,13,6,2
5,7,14,6,2
5,7,15,6,2
5,7,16,6,2
5,7,17,6,2
5,7,18,6,2
5,7,19,6,2
5,7,20,6,2
5,8,0,6,2
5,8,1,6,2
5,8,2,6,2
5,8,3,6,2
5,8,4,6,2
5,8,5,6,2
5,8,6,6,2
5,8,7,6,2
5,8,8,6,2
5,8,9,6,2
5,8,10,6,2
5,8,11,6,2
5,8,12,6,2
5,8,13,6,2
5,8,14,6,2
5,8,15,6,2
5,8,16,6,2
5,8,17,6,2
5,8,18,6,2
5,8,19,6,2
5,8,20,6,2
5,9,0,6,2
5,9,1,6,2
5,9,2,6,2
5,9,3,6,2
5,9,4,6,2
5,9,5,6,2
5,9,6,6,2
5,9,7,6,2
5,9,8,6,2
5,9,9,6,2
5,9,10,6,2
5,9,11,6,2
5,9,12,6,2
5,9,13,6,2
5,9,14,6,2
5,9,15,6,2
5,9,16,6,2
5,9,17,6,2
5,9,18,6,2
5,9,19,6,2
5,9,20,6,2
5,10,0,6,2
5,10,1,6,2
5,10,2,6,2
5,10,3,6,2
5,10,4,6,2
5,10,5,6,2
5,10,6,6,2
5,10,7,6,2
5,10,8,6,2
5,10,9,6,2
5,10,10,6,2
5,10,11,6,2
5,10,12,6,2
5,10,13,6,2
5,10,14,6,2
5,10,15,6,2
5,10,16,6,2
5,10,17,6,2
5,10,18,6,2
5,10,19,6,2
5,10,20,6,2
5,11,0,6,2
5,11,1,6,2
5,11,2,6,2
5,11,3,6,2
5,11,4,6,2
5,11,5,6,2
5,11,6,6,2
5,11,7,6,2
5,11,8,6,2
5,11,9,6,2
5,11,10,6,2
5,11,11,6,2
5,11,12,6,2
5,11,13,6,2
5,11,14,6,2
5,11,15,6,2
5,11,16,6,2
5,11,17,6,2
5,11,18,6,2
5,11,19,6,2
5,11,20,6,2
5,12,0,6,2
5,12,1,6,2
5,12,2,6,2
5,12,3,6,2
5,12,4,6,2
5,12,5,6,2
5,12,6,6,2
5,12,7,6,2
5,12,8,6,2
5,12,9,6,2
5,12,10,6,2
5,12,11,6,2
5,12,12,6,2
5,12,13,6,2
5,12,14,6,2
5,12,15,6,2
5,12,16,6,2
5,12,17,6,2
5,12,18,6,2
5,12,19,6,2
5,12,20,6,2
5,0,0,7,2
5,0,1,7,2
5,0,2,7,2
5,0,3,7,2
5,0,4,7,2
5,0,5,7,2
5,0,6,7,2
5,0,7,7,2
5,0,8,7,2
5,0,9,7,2
5,0,10,7,2
5,0,11,7,2
5,0,12,7,2
5,0,13,7,2
5,0,14,7,2
5,0,15,7,2
5,0,16,7,2
5,0,17,7,2
5,0,18,7,2
5,0,19,7,2
5,0,20,7,2
5,1,0,7,2
5,1,1,7,2
5,1,2,7,2
5,1,3,7,2
5,1,4,7,2
5,1,5,7,2
5,1,6,7,2
5,1,7,7,2
5,1,8,7,2
5,1,9,7,2
5,1,10,7,2
5,1,11,7,2
5,1,12,7,2
5,1,13,7,2
5,1,14,7,2
5,1,15,7,2
5,1,16,7,2
5,1,17,7,2
5,1,18,7,2
5,1,19,7,2
5,1,20,7,2
5,2,0,7,2
5,2,1,7,2
5,2,2,7,2
5,2,3,7,2
5,2,4,7,2
5,2,5,7,2
5,2,6,7,2
5,2,7,7,2
5,2,8,7,2
5,2,9,7,2
5,2,10,7,2
5,2,11,7,2
5,2,12,7,2
5,2,13,7,2
5,2,14,7,2
5,2,15,7,2
5,2,16,7,2
5,2,17,7,2
5,2,18,7,2
5,2,19,7,2
5,2,20,7,2
5,3,0,7,2
5,3,1,7,2
5,3,2,7,2
5,3,3,7,2
5,3,4,7,2
5,3,5,7,2
5,3,6,7,2
5,3,7,7,2
5,3,8,7,2
5,3,9,7,2
5,3,10,7,2
5,3,11,7,2
5,3,12,7,2
5,3,13,7,2
5,3,14,7,2
5,3,15,7,2
5,3,16,7,2
5,3,17,7,2
5,3,18,7,2
5,3,19,7,2
5,3,20,7,2
5,4,0,7,2
5,4,1,7,2
5,4,2,7,2
5,4,3,7,2
5,4,4,7,2
5,4,5,7,2
5,4,6,7,2
5,4,7,7,2
5,4,8,7,2
5,4,9,7,2
5,4,10,7,2
5,4,11,7,2
5,4,12,7,2
5,4,13,7,2
5,4,14,7,2
5,4,15,7,2
5,4,16,7,2
5,4,17,7,2
5,4,18,7,2
5,4,19,7,2
5,4,20,7,2
5,5,0,7,2
5,5,1,7,2
5,5,2,7,2
5,5,3,7,2
5,5,4,7,2
5,5,5,7,2
5,5,6,7,2
5,5,7,7,2
5,5,8,7,2
5,5,9,7,2
5,5,10,7,2
5,5,11,7,2
5,5,12,7,2
5,5,13,7,2
5,5,14,7,2
5,5,15,7,2
5,5,16,7,2
5,5,17,7,2
5,5,18,7,2
5,5,19,7,2
5,5,20,7,2
5,6,0,7,2
5,6,1,7,2
5,6,2,7,2
5,6,3,7,2
5,6,4,7,2
5,6,5,7,2
5,6,6,7,2
5,6,7,7,2
5,6,8,7,2
5,6,9,7,2
5,6,10,7,2
5,6,11,7,2
5,6,12,7,2
5,6,13,7,2
5,6,14,7,2
5,6,15,7,2
5,6,16,7,2
5,6,17,7,2
5,6,18,7,2
5,6,19,7,2
5,6,20,7,2
5,7,0,7,2
5,7,1,7,2
5,7,2,7,2
5,7,3,7,2
5,7,4,7,2
5,7,5,7,2
5,7,6,7,2
5,7,7,7,2
5,7,8,7,2
5,7,9,7,2
5,7,10,7,2
5,7,11,7,2
5,7,12,7,2
5,7,13,7,2
5,7,14,7,2
5,7,15,7,2
5,7,16,7,2
5,7,17,7,2
5,7,18,7,2
5,7,19,7,2
5,7,20,7,2
5,8,0,7,2
5,8,1,7,2
5,8,2,7,2
5,8,3,7,2
5,8,4,7,2
5,8,5,7,2
5,8,6,7,2
5,8,7,7,2
5,8,8,7,2
5,8,9,7,2
5,8,10,7,2
5,8,11,7,2
5,8,12,7,2
5,8,13,7,2
5,8,14,7,2
5,8,15,7,2
5,8,16,7,2
5,8,17,7,2
5,8,18,7,2
5,8,19,7,2
5,8,20,7,2
5,9,0,7,2
5,9,1,7,2
5,9,2,7,2
5,9,3,7,2
5,9,4,7,2
5,9,5,7,2
5,9,6,7,2
5,9,7,7,2
5,9,8,7,2
5,9,9,7,2
5,9,10,7,2
5,9,11,7,2
5,9,12,7,2
5,9,13,7,2
5,9,14,7,2
5,9,15,7,2
5,9,16,7,2
5,9,17,7,2
5,9,18,7,2
5,9,19,7,2
5,9,20,7,2
5,10,0,7,2
5,10,1,7,2
5,10,2,7,2
5,10,3,7,2
5,10,4,7,2
5,10,5,7,2
5,10,6,7,2
5,10,7,7,2
5,10,8,7,2
5,10,9,7,2
5,10,10,7,2
5,10,11,7,2
5,10,12,7,2
5,10,13,7,2
5,10,14,7,2
5,10,15,7,2
5,10,16,7,2
5,10,17,7,2
5,10,18,7,2
5,10,19,7,2
5,10,20,7,2
5,0,0,8,2
5,0,1,8,2
5,0,2,8,2
5,0,3,8,2
5,0,4,8,2
5,0,5,8,2
5,0,6,8,2
5,0,7,8,2
5,0,8,8,2
5,0,9,8,2
5,0,10,8,2
5,0,11,8,2
5,0,12,8,2
5,0,13,8,2
5,0,14,8,2
5,0,15,8,2
5,0,16,8,2
5,0,17,8,2
5,0,18,8,2
5,0,19,8,2
5,0,20,8,2
5,1,0,8,2
5,1,1,8,2
5,1,2,8,2
5,1,3,8,2
5,1,4,8,2
5,1,5,8,2
5,1,6,8,2
5,1,7,8,2
5,1,8,8,2
5,1,9,8,2
5,1,10,8,2
5,1,11,8,2
5,1,12,8,2
5,1,13,8,2
5,1,14,8,2
5,1,15,8,2
5,1,16,8,2
5,1,17,8,2
5,1,18,8,2
5,1,19,8,2
5,1,20,8,2
5,2,0,8,2
5,2,1,8,2
5,2,2,8,2
5,2,3,8,2
5,2,4,8,2
5,2,5,8,2
5,2,6,8,2
5,2,7,8,2
5,2,8,8,2
5,2,9,8,2
5,2,10,8,2
5,2,11,8,2
5,2,12,8,2
5,2,13,8,2
5,2,14,8,2
5,2,15,8,2
5,2,16,8,2
5,2,17,8,2
5,2,18,8,2
5,2,19,8,2
5,2,20,8,2
5,3,0,8,2
5,3,1,8,2
5,3,2,8,2
5,3,3,8,2
5,3,4,8,2
5,3,5,8,2
5,3,6,8,2
5,3,7,8,2
5,3,8,8,2
5,3,9,8,2
5,3,10,8,2
5,3,11,8,2
5,3,12,8,2
5,3,13,8,2
5,3,14,8,2
5,3,15,8,2
5,3,16,8,2
5,3,17,8,2
5,3,18,8,2
5,3,19,8,2
5,3,20,8,2
5,4,0,8,2
5,4,1,8,2
5,4,2,8,2
5,4,3,8,2
5,4,4,8,2
5,4,5,8,2
5,4,6,8,2
5,4,7,8,2
5,4,8,8,2
5,4,9,8,2
5,4,10,8,2
5,4,11,8,2
5,4,12,8,2
5,4,13,8,2
5,4,14,8,2
5,4,15,8,2
5,4,16,8,2
5,4,17,8,2
5,4,18,8,2
5,4,19,8,2
5,4,20,8,2
5,5,0,8,2
5,5,1,8,2
5,5,2,8,2
5,5,3,8,2
5,5,4,8,2
5,5,5,8,2
5,5,6,8,2
5,5,7,8,2
5,5,8,8,2
5,5,9,8,2
5,5,10,8,2
5,5,11,8,2
5,5,12,8,2
5,5,13,8,2
5,5,14,8,2
5,5,15,8,2
5,5,16,8,2
5,5,17,8,2
5,5,18,8,2
5,5,19,8,2
5,5,20,8,2
5,6,0,8,2
5,6,1,8,2
5,6,2,8,2
5,6,3,8,2
5,6,4,8,2
5,6,5,8,2
5,6,6,8,2
5,6,7,8,2
5,6,8,8,2
5,6,9,8,2
5,6,10,8,2
5,6,11,8,2
5,6,12,8,2
5,6,13,8,2
5,6,14,8,2
5,6,15,8,2
5,6,16,8,2
5,6,17,8,2
5,6,18,8,2
5,6,19,8,2
5,6,20,8,2
5,7,0,8,2
5,7,1,8,2
5,7,2,8,2
5,7,3,8,2
5,7,4,8,2
5,7,5,8,2
5,7,6,8,2
5,7,7,8,2
5,7,8,8,2
5,7,9,8,2
5,7,10,8,2
5,7,11,8,2
5,7,12,8,2
5,7,13,8,2
5,7,14,8,2
5,7,15,8,2
5,7,16,8,2
5,7,17,8,2
5,7,18,8,2
5,7,19,8,2
5,7,20,8,2
5,8,0,8,2
5,8,1,8,2
5,8,2,8,2
5,8,3,8,2
5,8,4,8,2
5,8,5,8,2
5,8,6,8,2
5,8,7,8,2
5,8,8,8,2
5,8,9,8,2
5,8,10,8,2
5,8,11,8,2
5,8,12,8,2
5,8,13,8,2
5,8,14,8,2
5,8,15,8,2
5,8,16,8,2
5,8,17,8,2
5,8,18,8,2
5,8,19,8,2
5,8,20,8,2
5,0,0,9,2
5,0,1,9,2
5,0,2,9,2
5,0,3,9,2
5,0,4,9,2
5,0,5,9,2
5,0,6,9,2
5,0,7,9,2
5,0,8,9,2
5,0,9,9,2
5,0,10,9,2
5,0,11,9,2
5,0,12,9,2
5,0,13,9,2
5,0,14,9,2
5,0,15,9,2
5,0,16,9,2
5,0,17,9,2
5,0,18,9,2
5,0,19,9,2
5,0,20,9,2
5,1,0,9,2
5,1,1,9,2
5,1,2,9,2
5,1,3,9,2
5,1,4,9,2
5,1,5,9,2
5,1,6,9,2
5,1,7,9,2
5,1,8,9,2
5,1,9,9,2
5,1,10,9,2
5,1,11,9,2
5,1,12,9,2
5,1,13,9,2
5,1,14,9,2
5,1,15,9,2
5,1,16,9,2
5,1,17,9,2
5,1,18,9,2
5,1,19,9,2
5,1,20,9,2
5,2,0,9,2
5,2,1,9,2
5,2,2,9,2
5,2,3,9,2
5,2,4,9,2
5,2,5,9,2
5,2,6,9,2
5,2,7,9,2
5,2,8,9,2
5,2,9,9,2
5,2,10,9,2
5,2,11,9,2
5,2,12,9,2
5,2,13,9,2
5,2,14,9,2
5,2,15,9,2
5,2,16,9,2
5,2,17,9,2
5,2,18,9,2
5,2,19,9,2
5,2,20,9,2
5,3,0,9,2
5,3,1,9,2
5,3,2,9,2
5,3,3,9,2
5,3,4,9,2
5,3,5,9,2
5,3,6,9,2
5,3,7,9,2
5,3,8,9,2
5,3,9,9,2
5,3,10,9,2
5,3,11,9,2
5,3,12,9,2
5,3,13,9,2
5,3,14,9,2
5,3,15,9,2
5,3,16,9,2
5,3,17,9,2
5,3,18,9,2
5,3,19,9,2
5,3,20,9,2
5,4,0,9,2
5,4,1,9,2
5,4,2,9,2
5,4,3,9,2
5,4,4,9,2
5,4,5,9,2
5,4,6,9,2
5,4,7,9,2
5,4,8,9,2
5,4,9,9,2
5,4,10,9,2
5,4,11,9,2
5,4,12,9,2
5,4,13,9,2
5,4,14,9,2
5,4,15,9,2
5,4,16,9,2
5,4,17,9,2
5,4,18,9,2
5,4,19,9,2
5,4,20,9,2
5,5,0,9,2
5,5,1,9,2
5,5,2,9,2
5,5,3,9,2
5,5,4,9,2
5,5,5,9,2
5,5,6,9,2
5,5,7,9,2
5,5,8,9,2
5,5,9,9,2
5,5,10,9,2
5,5,11,9,2
5,5,12,9,2
5,5,13,9,2
5,5,14,9,2
5,5,15,9,2
5,5,16,9,2
5,5,17,9,2
5,5,18,9,2
5,5,19,9,2
5,5,20,9,2
5,6,0,9,2
5,6,1,9,2
5,6,2,9,2
5,6,3,9,2
5,6,4,9,2
5,6,5,9,2
5,6,6,9,2
5,6,7,9,2
5,6,8,9,2
5,6,9,9,2
5,6,10,9,2
5,6,11,9,2
5,6,12,9,2
5,6,13,9,2
5,6,14,9,2
5,6,15,9,2
5,6,16,9,2
5,6,17,9,2
5,6,18,9,2
5,6,19,9,2
5,6,20,9,2
5,0,0,10,2
5,0,1,10,2
5,0,2,10,2
5,0,3,10,2
5,0,4,10,2
5,0,5,10,2
5,0,6,10,2
5,0,7,10,2
5,0,8,10,2
5,0,9,10,2
5,0,10,10,2
5,0,11,10,2
5,0,12,10,2
5,0,13,10,2
5,0,14,10,2
5,0,15,10,2
5,0,16,10,2
5,0,17,10,2
5,0,18,10,2
5,0,19,10,2
5,0,20,10,2
5,1,0,10,2
5,1,1,10,2
5,1,2,10,2
5,1,3,10,2
5,1,4,10,2
5,1,5,10,2
5,1,6,10,2
5,1,7,10,2
5,1,8,10,2
5,1,9,10,2
5,1,10,10,2
5,1,11,10,2
5,1,12,10,2
5,1,13,10,2
5,1,14,10,2
5,1,15,10,2
5,1,16,10,2
5,1,17,10,2
5,1,18,10,2
5,1,19,10,2
5,1,20,10,2
5,2,0,10,2
5,2,1,10,2
5,2,2,10,2
5,2,3,10,2
5,2,4,10,2
5,2,5,10,2
5,2,6,10,2
5,2,7,10,2
5,2,8,10,2
5,2,9,10,2
5,2,10,10,2
5,2,11,10,2
5,2,12,10,2
5,2,13,10,2
5,2,14,10,2
5,2,15,10,2
5,2,16,10,2
5,2,17,10,2
5,2,18,10,2
5,2,19,10,2
5,2,20,10,2
5,3,0,10,2
5,3,1,10,2
5,3,2,10,2
5,3,3,10,2
5,3,4,10,2
5,3,5,10,2
5,3,6,10,2
5,3,7,10,2
5,3,8,10,2
5,3,9,10,2
5,3,10,10,2
5,3,11,10,2
5,3,12,10,2
5,3,13,10,2
5,3,14,10,2
5,3,15,10,2
5,3,16,10,2
5,3,17,10,2
5,3,18,10,2
5,3,19,10,2
5,3,20,10,2
5,4,0,10,2
5,4,1,10,2
5,4,2,10,2
5,4,3,10,2
5,4,4,10,2
5,4,5,10,2
5,4,6,10,2
5,4,7,10,2
5,4,8,10,2
5,4,9,10,2
5,4,10,10,2
5,4,11,10,2
5,4,12,10,2
5,4,13,10,2
5,4,14,10,2
5,4,15,10,2
5,4,16,10,2
5,4,17,10,2
5,4,18,10,2
5,4,19,10,2
5,4,20,10,2
5,0,0,11,2
5,0,1,11,2
5,0,2,11,2
5,0,3,11,2
5,0,4,11,2
5,0,5,11,2
5,0,6,11,2
5,0,7,11,2
5,0,8,11,2
5,0,9,11,2
5,0,10,11,2
5,0,11,11,2
5,0,12,11,2
5,0,13,11,2
5,0,14,11,2
5,0,15,11,2
5,0,16,11,2
5,0,17,11,2
5,0,18,11,2
5,0,19,11,2
5,0,20,11,2
5,1,0,11,2
5,1,1,11,2
5,1,2,11,2
5,1,3,11,2
5,1,4,11,2
5,1,5,11,2
5,1,6,11,2
5,1,7,11,2
5,1,8,11,2
5,1,9,11,2
5,1,10,11,2
5,1,11,11,2
5,1,12,11,2
5,1,13,11,2
5,1,14,11,2
5,1,15,11,2
5,1,16,11,2
5,1,17,11,2
5,1,18,11,2
5,1,19,11,2
5,1,20,11,2
5,2,0,11,2
5,2,1,11,2
5,2,2,11,2
5,2,3,11,2
5,2,4,11,2
5,2,5,11,2
5,2,6,11,2
5,2,7,11,2
5,2,8,11,2
5,2,9,11,2
5,2,10,11,2
5,2,11,11,2
5,2,12,11,2
5,2,13,11,2
5,2,14,11,2
5,2,15,11,2
5,2,16,11,2
5,2,17,11,2
5,2,18,11,2
5,2,19,11,2
5,2,20,11,2
5,0,0,12,2
5,0,1,12,2
5,0,2,12,2
5,0,3,12,2
5,0,4,12,2
5,0,5,12,2
5,0,6,12,2
5,0,7,12,2
5,0,8,12,2
5,0,9,12,2
5,0,10,12,2
5,0,11,12,2
5,0,12,12,2
5,0,13,12,2
5,0,14,12,2
5,0,15,12,2
5,0,16,12,2
5,0,17,12,2
5,0,18,12,2
5,0,19,12,2
5,0,20,12,2
5,0,0,1,3
5,0,1,1,3
5,0,2,1,3
5,0,3,1,3
5,0,4,1,3
5,0,5,1,3
5,0,6,1,3
5,0,7,1,3
5,0,8,1,3
5,0,9,1,3
5,0,10,1,3
5,0,11,1,3
5,0,12,1,3
5,0,13,1,3
5,0,14,1,3
5,0,15,1,3
5,0,16,1,3
5,0,17,1,3
5,0,18,1,3
5,1,0,1,3
5,1,1,1,3
5,1,2,1,3
5,1,3,1,3
5,1,4,1,3
5,1,5,1,3
5,1,6,1,3
5,1,7,1,3
5,1,8,1,3
5,1,9,1,3
5,1,10,1,3
5,1,11,1,3
5,1,12,1,3
5,1,13,1,3
5,1,14,1,3
5,1,15,1,3
5,1,16,1,3
5,1,17,1,3
5,1,18,1,3
5,2,0,1,3
5,2,1,1,3
5,2,2,1,3
5,2,3,1,3
5,2,4,1,3
5,2,5,1,3
5,2,6,1,3
5,2,7,1,3
5,2,8,1,3
5,2,9,1,3
5,2,10,1,3
5,2,11,1,3
5,2,12,1,3
5,2,13,1,3
5,2,14,1,3
5,2,15,1,3
5,2,16,1,3
5,2,17,1,3
5,2,18,1,3
5,3,0,1,3
5,3,1,1,3
5,3,2,1,3
5,3,3,1,3
5,3,4,1,3
5,3,5,1,3
5,3,6,1,3
5,3,7,1,3
5,3,8,1,3
5,3,9,1,3
5,3,10,1,3
5,3,11,1,3
5,3,12,1,3
5,3,13,1,3
5,3,14,1,3
5,3,15,1,3
5,3,16,1,3
5,3,17,1,3
5,3,18,1,3
5,4,0,1,3
5,4,1,1,3
5,4,2,1,3
5,4,3,1,3
5,4,4,1,3
5,4,5,1,3
5,4,6,1,3
5,4,7,1,3
5,4,8,1,3
5,4,9,1,3
5,4,10,1,3
5,4,11,1,3
5,4,12,1,3
5,4,13,1,3
5,4,14,1,3
5,4,15,1,3
5,4,16,1,3
5,4,17,1,3
5,4,18,1,3
5,5,0,1,3
5,5,1,1,3
5,5,2,1,3
5,5,3,1,3
5,5,4,1,3
5,5,5,1,3
5,5,6,1,3
5,5,7,1,3
5,5,8,1,3
5,5,9,1,3
5,5,10,1,3
5,5,11,1,3
5,5,12,1,3
5,5,13,1,3
5,5,14,1,3
5,5,15,1,3
5,5,16,1,3
5,5,17,1,3
5,5,18,1,3
5,6,0,1,3
5,6,1,1,3
5,6,2,1,3
5,6,3,1,3
5,6,4,1,3
5,6,5,1,3
5,6,6,1,3
5,6,7,1,3
5,6,8,1,3
5,6,9,1,3
5,6,10,1,3
5,6,11,1,3
5,6,12,1,3
5,6,13,1,3
5,6,14,1,3
5,6,15,1,3
5,6,16,1,3
5,6,17,1,3
5,6,18,1,3
5,7,0,1,3
5,7,1,1,3
5,7,2,1,3
5,7,3,1,3
5,7,4,1,3
5,7,5,1,3
5,7,6,1,3
5,7,7,1,3
5,7,8,1,3
5,7,9,1,3
5,7,10,1,3
5,7,11,1,3
5,7,12,1,3
5,7,13,1,3
5,7,14,1,3
5,7,15,1,3
5,7,16,1,3
5,7,17,1,3
5,7,18,1,3
5,8,0,1,3
5,8,1,1,3
5,8,2,1,3
5,8,3,1,3
5,8,4,1,3
5,8,5,1,3
5,8,6,1,3
5,8,7,1,3
5,8,8,1,3
5,8,9,1,3
5,8,10,1,3
5,8,11,1,3
5,8,12,1,3
5,8,13,1,3
5,8,14,1,3
5,8,15,1,3
5,8,16,1,3
5,8,17,1,3
5,8,18,1,3
5,9,0,1,3
5,9,1,1,3
5,9,2,1,3
5,9,3,1,3
5,9,4,1,3
5,9,5,1,3
5,9,6,1,3
5,9,7,1,3
5,9,8,1,3
5,9,9,1,3
5,9,10,1,3
5,9,11,1,3
5,9,12,1,3
5,9,13,1,3
5,9,14,1,3
5,9,15,1,3
5,9,16,1,3
5,9,17,1,3
5,9,18,1,3
5,10,0,1,3
5,10,1,1,3
5,10,2,1,3
5,10,3,1,3
5,10,4,1,3
5,10,5,1,3
5,10,6,1,3
5,10,7,1,3
5,10,8,1,3
5,10,9,1,3
5,10,10,1,3
5,10,11,1,3
5,10,12,1,3
5,10,13,1,3
5,10,14,1,3
5,10,15,1,3
5,10,16,1,3
5,10,17,1,3
5,10,18,1,3
5,11,0,1,3
5,11,1,1,3
5,11,2,1,3
5,11,3,1,3
5,11,4,1,3
5,11,5,1,3
5,11,6,1,3
5,11,7,1,3
5,11,8,1,3
5,11,9,1,3
5,11,10,1,3
5,11,11,1,3
5,11,12,1,3
5,11,13,1,3
5,11,14,1,3
5,11,15,1,3
5,11,16,1,3
5,11,17,1,3
5,11,18,1,3
5,12,0,1,3
5,12,1,1,3
5,12,2,1,3
5,12,3,1,3
5,12,4,1,3
5,12,5,1,3
5,12,6,1,3
5,12,7,1,3
5,12,8,1,3
5,12,9,1,3
5,12,10,1,3
5,12,11,1,3
5,12,12,1,3
5,12,13,1,3
5,12,14,1,3
5,12,15,1,3
5,12,16,1,3
5,12,17,1,3
5,12,18,1,3
5,13,0,1,3
5,13,1,1,3
5,13,2,1,3
5,13,3,1,3
5,13,4,1,3
5,13,5,1,3
5,13,6,1,3
5,13,7,1,3
5,13,8,1,3
5,13,9,1,3
5,13,10,1,3
5,13,11,1,3
5,13,12,1,3
5,13,13,1,3
5,13,14,1,3
5,13,15,1,3
5,13,16,1,3
5,13,17,1,3
5,13,18,1,3
5,14,0,1,3
5,14,1,1,3
5,14,2,1,3
5,14,3,1,3
5,14,4,1,3
5,14,5,1,3
5,14,6,1,3
5,14,7,1,3
5,14,8,1,3
5,14,9,1,3
5,14,10,1,3
5,14,11,1,3
5,14,12,1,3
5,14,13,1,3
5,14,14,1,3
5,14,15,1,3
5,14,16,1,3
5,14,17,1,3
5,14,18,1,3
5,15,0,1,3
5,15,1,1,3
5,15,2,1,3
5,15,3,1,3
5,15,4,1,3
5,15,5,1,3
5,15,6,1,3
5,15,7,1,3
5,15,8,1,3
5,15,9,1,3
5,15,10,1,3
5,15,11,1,3
5,15,12,1,3
5,15,13,1,3
5,15,14,1,3
5,15,15,1,3
5,15,16,1,3
5,15,17,1,3
5,15,18,1,3
5,16,0,1,3
5,16,1,1,3
5,16,2,1,3
5,16,3,1,3
5,16,4,1,3
5,16,5,1,3
5,16,6,1,3
5,16,7,1,3
5,16,8,1,3
5,16,9,1,3
5,16,10,1,3
5,16,11,1,3
5,16,12,1,3
5,16,13,1,3
5,16,14,1,3
5,16,15,1,3
5,16,16,1,3
5,16,17,1,3
5,16,18,1,3
5,17,0,1,3
5,17,1,1,3
5,17,2,1,3
5,17,3,1,3
5,17,4,1,3
5,17,5,1,3
5,17,6,1,3
5,17,7,1,3
5,17,8,1,3
5,17,9,1,3
5,17,10,1,3
5,17,11,1,3
5,17,12,1,3
5,17,13,1,3
5,17,14,1,3
5,17,15,1,3
5,17,16,1,3
5,17,17,1,3
5,17,18,1,3
5,18,0,1,3
5,18,1,1,3
5,18,2,1,3
5,18,3,1,3
5,18,4,1,3
5,18,5,1,3
5,18,6,1,3
5,18,7,1,3
5,18,8,1,3
5,18,9,1,3
5,18,10,1,3
5,18,11,1,3
5,18,12,1,3
5,18,13,1,3
5,18,14,1,3
5,18,15,1,3
5,18,16,1,3
5,18,17,1,3
5,18,18,1,3
5,19,0,1,3
5,19,1,1,3
5,19,2,1,3
5,19,3,1,3
5,19,4,1,3
5,19,5,1,3
5,19,6,1,3
5,19,7,1,3
5,19,8,1,3
5,19,9,1,3
5,19,10,1,3
5,19,11,1,3
5,19,12,1,3
5,19,13,1,3
5,19,14,1,3
5,19,15,1,3
5,19,16,1,3
5,19,17,1,3
5,19,18,1,3
5,20,0,1,3
5,20,1,1,3
5,20,2,1,3
5,20,3,1,3
5,20,4,1,3
5,20,5,1,3
5,20,6,1,3
5,20,7,1,3
5,20,8,1,3
5,20,9,1,3
5,20,10,1,3
5,20,11,1,3
5,20,12,1,3
5,20,13,1,3
5,20,14,1,3
5,20,15,1,3
5,20,16,1,3
5,20,17,1,3
5,20,18,1,3
5,21,0,1,3
5,21,1,1,3
5,21,2,1,3
5,21,3,1,3
5,21,4,1,3
5,21,5,1,3
5,21,6,1,3
5,21,7,1,3
5,21,8,1,3
5,21,9,1,3
5,21,10,1,3
5,21,11,1,3
5,21,12,1,3
5,21,13,1,3
5,21,14,1,3
5,21,15,1,3
5,21,16,1,3
5,21,17,1,3
5,21,18,1,3
5,22,0,1,3
5,22,1,1,3
5,22,2,1,3
5,22,3,1,3
5,22,4,1,3
5,22,5,1,3
5,22,6,1,3
5,22,7,1,3
5,22,8,1,3
5,22,9,1,3
5,22,10,1,3
5,22,11,1,3
5,22,12,1,3
5,22,13,1,3
5,22,14,1,3
5,22,15,1,3
5,22,16,1,3
5,22,17,1,3
5,22,18,1,3
5,0,0,2,3
5,0,1,2,3
5,0,2,2,3
5,0,3,2,3
5,0,4,2,3
5,0,5,2,3
5,0,6,2,3
5,0,7,2,3
5,0,8,2,3
5,0,9,2,3
5,0,10,2,3
5,0,11,2,3
5,0,12,2,3
5,0,13,2,3
5,0,14,2,3
5,0,15,2,3
5,0,16,2,3
5,0,17,2,3
5,0,18,2,3
5,1,0,2,3
5,1,1,2,3
5,1,2,2,3
5,1,3,2,3
5,1,4,2,3
5,1,5,2,3
5,1,6,2,3
5,1,7,2,3
5,1,8,2,3
5,1,9,2,3
5,1,10,2,3
5,1,11,2,3
5,1,12,2,3
5,1,13,2,3
5,1,14,2,3
5,1,15,2,3
5,1,16,2,3
5,1,17,2,3
5,1,18,2,3
5,2,0,2,3
5,2,1,2,3
5,2,2,2,3
5,2,3,2,3
5,2,4,2,3
5,2,5,2,3
5,2,6,2,3
5,2,7,2,3
5,2,8,2,3
5,2,9,2,3
5,2,10,2,3
5,2,11,2,3
5,2,12,2,3
5,2,13,2,3
5,2,14,2,3
5,2,15,2,3
5,2,16,2,3
5,2,17,2,3
5,2,18,2,3
5,3,0,2,3
5,3,1,2,3
5,3,2,2,3
5,3,3,2,3
5,3,4,2,3
5,3,5,2,3
5,3,6,2,3
5,3,7,2,3
5,3,8,2,3
5,3,9,2,3
5,3,10,2,3
5,3,11,2,3
5,3,12,2,3
5,3,13,2,3
5,3,14,2,3
5,3,15,2,3
5,3,16,2,3
5,3,17,2,3
5,3,18,2,3
5,4,0,2,3
5,4,1,2,3
5,4,2,2,3
5,4,3,2,3
5,4,4,2,3
5,4,5,2,3
5,4,6,2,3
5,4,7,2,3
5,4,8,2,3
5,4,9,2,3
5,4,10,2,3
5,4,11,2,3
5,4,12,2,3
5,4,13,2,3
5,4,14,2,3
5,4,15,2,3
5,4,16,2,3
5,4,17,2,3
5,4,18,2,3
5,5,0,2,3
5,5,1,2,3
5,5,2,2,3
5,5,3,2,3
5,5,4,2,3
5,5,5,2,3
5,5,6,2,3
5,5,7,2,3
5,5,8,2,3
5,5,9,2,3
5,5,10,2,3
5,5,11,2,3
5,5,12,2,3
5,5,13,2,3
5,5,14,2,3
5,5,15,2,3
5,5,16,2,3
5,5,17,2,3
5,5,18,2,3
5,6,0,2,3
5,6,1,2,3
5,6,2,2,3
5,6,3,2,3
5,6,4,2,3
5,6,5,2,3
5,6,6,2,3
5,6,7,2,3
5,6,8,2,3
5,6,9,2,3
5,6,10,2,3
5,6,11,2,3
5,6,12,2,3
5,6,13,2,3
5,6,14,2,3
5,6,15,2,3
5,6,16,2,3
5,6,17,2,3
5,6,18,2,3
5,7,0,2,3
5,7,1,2,3
5,7,2,2,3
5,7,3,2,3
5,7,4,2,3
5,7,5,2,3
5,7,6,2,3
5,7,7,2,3
5,7,8,2,3
5,7,9,2,3
5,7,10,2,3
5,7,11,2,3
5,7,12,2,3
5,7,13,2,3
5,7,14,2,3
5,7,15,2,3
5,7,16,2,3
5,7,17,2,3
5,7,18,2,3
5,8,0,2,3
5,8,1,2,3
5,8,2,2,3
5,8,3,2,3
5,8,4,2,3
5,8,5,2,3
5,8,6,2,3
5,8,7,2,3
5,8,8,2,3
5,8,9,2,3
5,8,10,2,3
5,8,11,2,3
5,8,12,2,3
5,8,13,2,3
5,8,14,2,3
5,8,15,2,3
5,8,16,2,3
5,8,17,2,3
5,8,18,2,3
5,9,0,2,3
5,9,1,2,3
5,9,2,2,3
5,9,3,2,3
5,9,4,2,3
5,9,5,2,3
5,9,6,2,3
5,9,7,2,3
5,9,8,2,3
5,9,9,2,3
5,9,10,2,3
5,9,11,2,3
5,9,12,2,3
5,9,13,2,3
5,9,14,2,3
5,9,15,2,3
5,9,16,2,3
5,9,17,2,3
5,9,18,2,3
5,10,0,2,3
5,10,1,2,3
5,10,2,2,3
5,10,3,2,3
5,10,4,2,3
5,10,5,2,3
5,10,6,2,3
5,10,7,2,3
5,10,8,2,3
5,10,9,2,3
5,10,10,2,3
5,10,11,2,3
5,10,12,2,3
5,10,13,2,3
5,10,14,2,3
5,10,15,2,3
5,10,16,2,3
5,10,17,2,3
5,10,18,2,3
5,11,0,2,3
5,11,1,2,3
5,11,2,2,3
5,11,3,2,3
5,11,4,2,3
5,11,5,2,3
5,11,6,2,3
5,11,7,2,3
5,11,8,2,3
5,11,9,2,3
5,11,10,2,3
5,11,11,2,3
5,11,12,2,3
5,11,13,2,3
5,11,14,2,3
5,11,15,2,3
5,11,16,2,3
5,11,17,2,3
5,11,18,2,3
5,12,0,2,3
5,12,1,2,3
5,12,2,2,3
5,12,3,2,3
5,12,4,2,3
5,12,5,2,3
5,12,6,2,3
5,12,7,2,3
5,12,8,2,3
5,12,9,2,3
5,12,10,2,3
5,12,11,2,3
5,12,12,2,3
5,12,13,2,3
5,12,14,2,3
5,12,15,2,3
5,12,16,2,3
5,12,17,2,3
5,12,18,2,3
5,13,0,2,3
5,13,1,2,3
5,13,2,2,3
5,13,3,2,3
5,13,4,2,3
5,13,5,2,3
5,13,6,2,3
5,13,7,2,3
5,13,8,2,3
5,13,9,2,3
5,13,10,2,3
5,13,11,2,3
5,13,12,2,3
5,13,13,2,3
5,13,14,2,3
5,13,15,2,3
5,13,16,2,3
5,13,17,2,3
5,13,18,2,3
5,14,0,2,3
5,14,1,2,3
5,14,2,2,3
5,14,3,2,3
5,14,4,2,3
5,14,5,2,3
5,14,6,2,3
5,14,7,2,3
5,14,8,2,3
5,14,9,2,3
5,14,10,2,3
5,14,11,2,3
5,14,12,2,3
5,14,13,2,3
5,14,14,2,3
5,14,15,2,3
5,14,16,2,3
5,14,17,2,3
5,14,18,2,3
5,15,0,2,3
5,15,1,2,3
5,15,2,2,3
5,15,3,2,3
5,15,4,2,3
5,15,5,2,3
5,15,6,2,3
5,15,7,2,3
5,15,8,2,3
5,15,9,2,3
5,15,10,2,3
5,15,11,2,3
5,15,12,2,3
5,15,13,2,3
5,15,14,2,3
5,15,15,2,3
5,15,16,2,3
5,15,17,2,3
5,15,18,2,3
5,16,0,2,3
5,16,1,2,3
5,16,2,2,3
5,16,3,2,3
5,16,4,2,3
5,16,5,2,3
5,16,6,2,3
5,16,7,2,3
5,16,8,2,3
5,16,9,2,3
5,16,10,2,3
5,16,11,2,3
5,16,12,2,3
5,16,13,2,3
5,16,14,2,3
5,16,15,2,3
5,16,16,2,3
5,16,17,2,3
5,16,18,2,3
5,17,0,2,3
5,17,1,2,3
5,17,2,2,3
5,17,3,2,3
5,17,4,2,3
5,17,5,2,3
5,17,6,2,3
5,17,7,2,3
5,17,8,2,3
5,17,9,2,3
5,17,10,2,3
5,17,11,2,3
5,17,12,2,3
5,17,13,2,3
5,17,14,2,3
5,17,15,2,3
5,17,16,2,3
5,17,17,2,3
5,17,18,2,3
5,18,0,2,3
5,18,1,2,3
5,18,2,2,3
5,18,3,2,3
5,18,4,2,3
5,18,5,2,3
5,18,6,2,3
5,18,7,2,3
5,18,8,2,3
5,18,9,2,3
5,18,10,2,3
5,18,11,2,3
5,18,12,2,3
5,18,13,2,3
5,18,14,2,3
5,18,15,2,3
5,18,16,2,3
5,18,17,2,3
5,18,18,2,3
5,19,0,2,3
5,19,1,2,3
5,19,2,2,3
5,19,3,2,3
5,19,4,2,3
5,19,5,2,3
5,19,6,2,3
5,19,7,2,3
5,19,8,2,3
5,19,9,2,3
5,19,10,2,3
5,19,11,2,3
5,19,12,2,3
5,19,13,2,3
5,19,14,2,3
5,19,15,2,3
5,19,16,2,3
5,19,17,2,3
5,19,18,2,3
5,20,0,2,3
5,20,1,2,3
5,20,2,2,3
5,20,3,2,3
5,20,4,2,3
5,20,5,2,3
5,20,6,2,3
5,20,7,2,3
5,20,8,2,3
5,20,9,2,3
5,20,10,2,3
5,20,11,2,3
5,20,12,2,3
5,20,13,2,3
5,20,14,2,3
5,20,15,2,3
5,20,16,2,3
5,20,17,2,3
5,20,18,2,3
5,0,0,3,3
5,0,1,3,3
5,0,2,3,3
5,0,3,3,3
5,0,4,3,3
5,0,5,3,3
5,0,6,3,3
5,0,7,3,3
5,0,8,3,3
5,0,9,3,3
5,0,10,3,3
5,0,11,3,3
5,0,12,3,3
5,0,13,3,3
5,0,14,3,3
5,0,15,3,3
5,0,16,3,3
5,0,17,3,3
5,0,18,3,3
5,1,0,3,3
5,1,1,3,3
5,1,2,3,3
5,1,3,3,3
5,1,4,3,3
5,1,5,3,3
5,1,6,3,3
5,1,7,3,3
5,1,8,3,3
5,1,9,3,3
5,1,10,3,3
5,1,11,3,3
5,1,12,3,3
5,1,13,3,3
5,1,14,3,3
5,1,15,3,3
5,1,16,3,3
5,1,17,3,3
5,1,18,3,3
5,2,0,3,3
5,2,1,3,3
5,2,2,3,3
5,2,3,3,3
5,2,4,3,3
5,2,5,3,3
5,2,6,3,3
5,2,7,3,3
5,2,8,3,3
5,2,9,3,3
5,2,10,3,3
5,2,11,3,3
5,2,12,3,3
5,2,13,3,3
5,2,14,3,3
5,2,15,3,3
5,2,16,3,3
5,2,17,3,3
5,2,18,3,3
5,3,0,3,3
5,3,1,3,3
5,3,2,3,3
5,3,3,3,3
5,3,4,3,3
5,3,5,3,3
5,3,6,3,3
5,3,7,3,3
5,3,8,3,3
5,3,9,3,3
5,3,10,3,3
5,3,11,3,3
5,3,12,3,3
5,3,13,3,3
5,3,14,3,3
5,3,15,3,3
5,3,16,3,3
5,3,17,3,3
5,3,18,3,3
5,4,0,3,3
5,4,1,3,3
5,4,2,3,3
5,4,3,3,3
5,4,4,3,3
5,4,5,3,3
5,4,6,3,3
5,4,7,3,3
5,4,8,3,3
5,4,9,3,3
5,4,10,3,3
5,4,11,3,3
5,4,12,3,3
5,4,13,3,3
5,4,14,3,3
5,4,15,3,3
5,4,16,3,3
5,4,17,3,3
5,4,18,3,3
5,5,0,3,3
5,5,1,3,3
5,5,2,3,3
5,5,3,3,3
5,5,4,3,3
5,5,5,3,3
5,5,6,3,3
5,5,7,3,3
5,5,8,3,3
5,5,9,3,3
5,5,10,3,3
5,5,11,3,3
5,5,12,3,3
5,5,13,3,3
5,5,14,3,3
5,5,15,3,3
5,5,16,3,3
5,5,17,3,3
5,5,18,3,3
5,6,0,3,3
5,6,1,3,3
5,6,2,3,3
5,6,3,3,3
5,6,4,3,3
5,6,5,3,3
5,6,6,3,3
5,6,7,3,3
5,6,8,3,3
5,6,9,3,3
5,6,10,3,3
5,6,11,3,3
5,6,12,3,3
5,6,13,3,3
5,6,14,3,3
5,6,15,3,3
5,6,16,3,3
5,6,17,3,3
5,6,18,3,3
5,7,0,3,3
5,7,1,3,3
5,7,2,3,3
5,7,3,3,3
5,7,4,3,3
5,7,5,3,3
5,7,6,3,3
5,7,7,3,3
5,7,8,3,3
5,7,9,3,3
5,7,10,3,3
5,7,11,3,3
5,7,12,3,3
5,7,13,3,3
5,7,14,3,3
5,7,15,3,3
5,7,16,3,3
5,7,17,3,3
5,7,18,3,3
5,8,0,3,3
5,8,1,3,3
5,8,2,3,3
5,8,3,3,3
5,8,4,3,3
5,8,5,3,3
5,8,6,3,3
5,8,7,3,3
5,8,8,3,3
5,8,9,3,3
5,8,10,3,3
5,8,11,3,3
5,8,12,3,3
5,8,13,3,3
5,8,14,3,3
5,8,15,3,3
5,8,16,3,3
5,8,17,3,3
5,8,18,3,3
5,9,0,3,3
5,9,1,3,3
5,9,2,3,3
5,9,3,3,3
5,9,4,3,3
5,9,5,3,3
5,9,6,3,3
5,9,7,3,3
5,9,8,3,3
5,9,9,3,3
5,9,10,3,3
5,9,11,3,3
5,9,12,3,3
5,9,13,3,3
5,9,14,3,3
5,9,15,3,3
5,9,16,3,3
5,9,17,3,3
5,9,18,3,3
5,10,0,3,3
5,10,1,3,3
5,10,2,3,3
5,10,3,3,3
5,10,4,3,3
5,10,5,3,3
5,10,6,3,3
5,10,7,3,3
5,10,8,3,3
5,10,9,3,3
5,10,10,3,3
5,10,11,3,3
5,10,12,3,3
5,10,13,3,3
5,10,14,3,3
5,10,15,3,3
5,10,16,3,3
5,10,17,3,3
5,10,18,3,3
5,11,0,3,3
5,11,1,3,3
5,11,2,3,3
5,11,3,3,3
5,11,4,3,3
5,11,5,3,3
5,11,6,3,3
5,11,7,3,3
5,11,8,3,3
5,11,9,3,3
5,11,10,3,3
5,11,11,3,3
5,11,12,3,3
5,11,13,3,3
5,11,14,3,3
5,11,15,3,3
5,11,16,3,3
5,11,17,3,3
5,11,18,3,3
5,12,0,3,3
5,12,1,3,3
5,12,2,3,3
5,12,3,3,3
5,12,4,3,3
5,12,5,3,3
5,12,6,3,3
5,12,7,3,3
5,12,8,3,3
5,12,9,3,3
5,12,10,3,3
5,12,11,3,3
5,12,12,3,3
5,12,13,3,3
5,12,14,3,3
5,12,15,3,3
5,12,16,3,3
5,12,17,3,3
5,12,18,3,3
5,13,0,3,3
5,13,1,3,3
5,13,2,3,3
5,13,3,3,3
5,13,4,3,3
5,13,5,3,3
5,13,6,3,3
5,13,7,3,3
5,13,8,3,3
5,13,9,3,3
5,13,10,3,3
5,13,11,3,3
5,13,12,3,3
5,13,13,3,3
5,13,14,3,3
5,13,15,3,3
5,13,16,3,3
5,13,17,3,3
5,13,18,3,3
5,14,0,3,3
5,14,1,3,3
5,14,2,3,3
5,14,3,3,3
5,14,4,3,3
5,14,5,3,3
5,14,6,3,3
5,14,7,3,3
5,14,8,3,3
5,14,9,3,3
5,14,10,3,3
5,14,11,3,3
5,14,12,3,3
5,14,13,3,3
5,14,14,3,3
5,14,15,3,3
5,14,16,3,3
5,14,17,3,3
5,14,18,3,3
5,15,0,3,3
5,15,1,3,3
5,15,2,3,3
5,15,3,3,3
5,15,4,3,3
5,15,5,3,3
5,15,6,3,3
5,15,7,3,3
5,15,8,3,3
5,15,9,3,3
5,15,10,3,3
5,15,11,3,3
5,15,12,3,3
5,15,13,3,3
5,15,14,3,3
5,15,15,3,3
5,15,16,3,3
5,15,17,3,3
5,15,18,3,3
5,16,0,3,3
5,16,1,3,3
5,16,2,3,3
5,16,3,3,3
5,16,4,3,3
5,16,5,3,3
5,16,6,3,3
5,16,7,3,3
5,16,8,3,3
5,16,9,3,3
5,16,10,3,3
5,16,11,3,3
5,16,12,3,3
5,16,13,3,3
5,16,14,3,3
5,16,15,3,3
5,16,16,3,3
5,16,17,3,3
5,16,18,3,3
5,17,0,3,3
5,17,1,3,3
5,17,2,3,3
5,17,3,3,3
5,17,4,3,3
5,17,5,3,3
5,17,6,3,3
5,17,7,3,3
5,17,8,3,3
5,17,9,3,3
5,17,10,3,3
5,17,11,3,3
5,17,12,3,3
5,17,13,3,3
5,17,14,3,3
5,17,15,3,3
5,17,16,3,3
5,17,17,3,3
5,17,18,3,3
5,18,0,3,3
5,18,1,3,3
5,18,2,3,3
5,18,3,3,3
5,18,4,3,3
5,18,5,3,3
5,18,6,3,3
5,18,7,3,3
5,18,8,3,3
5,18,9,3,3
5,18,10,3,3
5,18,11,3,3
5,18,12,3,3
5,18,13,3,3
5,18,14,3,3
5,18,15,3,3
5,18,16,3,3
5,18,17,3,3
5,18,18,3,3
5,0,0,4,3
5,0,1,4,3
5,0,2,4,3
5,0,3,4,3
5,0,4,4,3
5,0,5,4,3
5,0,6,4,3
5,0,7,4,3
5,0,8,4,3
5,0,9,4,3
5,0,10,4,3
5,0,11,4,3
5,0,12,4,3
5,0,13,4,3
5,0,14,4,3
5,0,15,4,3
5,0,16,4,3
5,0,17,4,3
5,0,18,4,3
5,1,0,4,3
5,1,1,4,3
5,1,2,4,3
5,1,3,4,3
5,1,4,4,3
5,1,5,4,3
5,1,6,4,3
5,1,7,4,3
5,1,8,4,3
5,1,9,4,3
5,1,10,4,3
5,1,11,4,3
5,1,12,4,3
5,1,13,4,3
5,1,14,4,3
5,1,15,4,3
5,1,16,4,3
5,1,17,4,3
5,1,18,4,3
5,2,0,4,3
5,2,1,4,3
5,2,2,4,3
5,2,3,4,3
5,2,4,4,3
5,2,5,4,3
5,2,6,4,3
5,2,7,4,3
5,2,8,4,3
5,2,9,4,3
5,2,10,4,3
5,2,11,4,3
5,2,12,4,3
5,2,13,4,3
5,2,14,4,3
5,2,15,4,3
5,2,16,4,3
5,2,17,4,3
5,2,18,4,3
5,3,0,4,3
5,3,1,4,3
5,3,2,4,3
5,3,3,4,3
5,3,4,4,3
5,3,5,4,3
5,3,6,4,3
5,3,7,4,3
5,3,8,4,3
5,3,9,4,3
5,3,10,4,3
5,3,11,4,3
5,3,12,4,3
5,3,13,4,3
5,3,14,4,3
5,3,15,4,3
5,3,16,4,3
5,3,17,4,3
5,3,18,4,3
5,4,0,4,3
5,4,1,4,3
5,4,2,4,3
5,4,3,4,3
5,4,4,4,3
5,4,5,4,3
5,4,6,4,3
5,4,7,4,3
5,4,8,4,3
5,4,9,4,3
5,4,10,4,3
5,4,11,4,3
5,4,12,4,3
5,4,13,4,3
5,4,14,4,3
5,4,15,4,3
5,4,16,4,3
5,4,17,4,3
5,4,18,4,3
5,5,0,4,3
5,5,1,4,3
5,5,2,4,3
5,5,3,4,3
5,5,4,4,3
5,5,5,4,3
5,5,6,4,3
5,5,7,4,3
5,5,8,4,3
5,5,9,4,3
5,5,10,4,3
5,5,11,4,3
5,5,12,4,3
5,5,13,4,3
5,5,14,4,3
5,5,15,4,3
5,5,16,4,3
5,5,17,4,3
5,5,18,4,3
5,6,0,4,3
5,6,1,4,3
5,6,2,4,3
5,6,3,4,3
5,6,4,4,3
5,6,5,4,3
5,6,6,4,3
5,6,7,4,3
5,6,8,4,3
5,6,9,4,3
5,6,10,4,3
5,6,11,4,3
5,6,12,4,3
5,6,13,4,3
5,6,14,4,3
5,6,15,4,3
5,6,16,4,3
5,6,17,4,3
5,6,18,4,3
5,7,0,4,3
5,7,1,4,3
5,7,2,4,3
5,7,3,4,3
5,7,4,4,3
5,7,5,4,3
5,7,6,4,3
5,7,7,4,3
5,7,8,4,3
5,7,9,4,3
5,7,10,4,3
5,7,11,4,3
5,7,12,4,3
5,7,13,4,3
5,7,14,4,3
5,7,15,4,3
5,7,16,4,3
5,7,17,4,3
5,7,18,4,3
5,8,0,4,3
5,8,1,4,3
5,8,2,4,3
5,8,3,4,3
5,8,4,4,3
5,8,5,4,3
5,8,6,4,3
5,8,7,4,3
5,8,8,4,3
5,8,9,4,3
5,8,10,4,3
5,8,11,4,3
5,8,12,4,3
5,8,13,4,3
5,8,14,4,3
5,8,15,4,3
5,8,16,4,3
5,8,17,4,3
5,8,18,4,3
5,9,0,4,3
5,9,1,4,3
5,9,2,4,3
5,9,3,4,3
5,9,4,4,3
5,9,5,4,3
5,9,6,4,3
5,9,7,4,3
5,9,8,4,3
5,9,9,4,3
5,9,10,4,3
5,9,11,4,3
5,9,12,4,3
5,9,13,4,3
5,9,14,4,3
5,9,15,4,3
5,9,16,4,3
5,9,17,4,3
5,9,18,4,3
5,10,0,4,3
5,10,1,4,3
5,10,2,4,3
5,10,3,4,3
5,10,4,4,3
5,10,5,4,3
5,10,6,4,3
5,10,7,4,3
5,10,8,4,3
5,10,9,4,3
5,10,10,4,3
5,10,11,4,3
5,10,12,4,3
5,10,13,4,3
5,10,14,4,3
5,10,15,4,3
5,10,16,4,3
5,10,17,4,3
5,10,18,4,3
5,11,0,4,3
5,11,1,4,3
5,11,2,4,3
5,11,3,4,3
5,11,4,4,3
5,11,5,4,3
5,11,6,4,3
5,11,7,4,3
5,11,8,4,3
5,11,9,4,3
5,11,10,4,3
5,11,11,4,3
5,11,12,4,3
5,11,13,4,3
5,11,14,4,3
5,11,15,4,3
5,11,16,4,3
5,11,17,4,3
5,11,18,4,3
5,12,0,4,3
5,12,1,4,3
5,12,2,4,3
5,12,3,4,3
5,12,4,4,3
5,12,5,4,3
5,12,6,4,3
5,12,7,4,3
5,12,8,4,3
5,12,9,4,3
5,12,10,4,3
5,12,11,4,3
5,12,12,4,3
5,12,13,4,3
5,12,14,4,3
5,12,15,4,3
5,12,16,4,3
5,12,17,4,3
5,12,18,4,3
5,13,0,4,3
5,13,1,4,3
5,13,2,4,3
5,13,3,4,3
5,13,4,4,3
5,13,5,4,3
5,13,6,4,3
5,13,7,4,3
5,13,8,4,3
5,13,9,4,3
5,13,10,4,3
5,13,11,4,3
5,13,12,4,3
5,13,13,4,3
5,13,14,4,3
5,13,15,4,3
5,13,16,4,3
5,13,17,4,3
5,13,18,4,3
5,14,0,4,3
5,14,1,4,3
5,14,2,4,3
5,14,3,4,3
5,14,4,4,3
5,14,5,4,3
5,14,6,4,3
5,14,7,4,3
5,14,8,4,3
5,14,9,4,3
5,14,10,4,3
5,14,11,4,3
5,14,12,4,3
5,14,13,4,3
5,14,14,4,3
5,14,15,4,3
5,14,16,4,3
5,14,17,4,3
5,14,18,4,3
5,15,0,4,3
5,15,1,4,3
5,15,2,4,3
5,15,3,4,3
5,15,4,4,3
5,15,5,4,3
5,15,6,4,3
5,15,7,4,3
5,15,8,4,3
5,15,9,4,3
5,15,10,4,3
5,15,11,4,3
5,15,12,4,3
5,15,13,4,3
5,15,14,4,3
5,15,15,4,3
5,15,16,4,3
5,15,17,4,3
5,15,18,4,3
5,16,0,4,3
5,16,1,4,3
5,16,2,4,3
5,16,3,4,3
5,16,4,4,3
5,16,5,4,3
5,16,6,4,3
5,16,7,4,3
5,16,8,4,3
5,16,9,4,3
5,16,10,4,3
5,16,11,4,3
5,16,12,4,3
5,16,13,4,3
5,16,14,4,3
5,16,15,4,3
5,16,16,4,3
5,16,17,4,3
5,16,18,4,3
5,0,0,5,3
5,0,1,5,3
5,0,2,5,3
5,0,3,5,3
5,0,4,5,3
5,0,5,5,3
5,0,6,5,3
5,0,7,5,3
5,0,8,5,3
5,0,9,5,3
5,0,10,5,3
5,0,11,5,3
5,0,12,5,3
5,0,13,5,3
5,0,14,5,3
5,0,15,5,3
5,0,16,5,3
5,0,17,5,3
5,0,18,5,3
5,1,0,5,3
5,1,1,5,3
5,1,2,5,3
5,1,3,5,3
5,1,4,5,3
5,1,5,5,3
5,1,6,5,3
5,1,7,5,3
5,1,8,5,3
5,1,9,5,3
5,1,10,5,3
5,1,11,5,3
5,1,12,5,3
5,1,13,5,3
5,1,14,5,3
5,1,15,5,3
5,1,16,5,3
5,1,17,5,3
5,1,18,5,3
5,2,0,5,3
5,2,1,5,3
5,2,2,5,3
5,2,3,5,3
5,2,4,5,3
5,2,5,5,3
5,2,6,5,3
5,2,7,5,3
5,2,8,5,3
5,2,9,5,3
5,2,10,5,3
5,2,11,5,3
5,2,12,5,3
5,2,13,5,3
5,2,14,5,3
5,2,15,5,3
5,2,16,5,3
5,2,17,5,3
5,2,18,5,3
5,3,0,5,3
5,3,1,5,3
5,3,2,5,3
5,3,3,5,3
5,3,4,5,3
5,3,5,5,3
5,3,6,5,3
5,3,7,5,3
5,3,8,5,3
5,3,9,5,3
5,3,10,5,3
5,3,11,5,3
5,3,12,5,3
5,3,13,5,3
5,3,14,5,3
5,3,15,5,3
5,3,16,5,3
5,3,17,5,3
5,3,18,5,3
5,4,0,5,3
5,4,1,5,3
5,4,2,5,3
5,4,3,5,3
5,4,4,5,3
5,4,5,5,3
5,4,6,5,3
5,4,7,5,3
5,4,8,5,3
5,4,9,5,3
5,4,10,5,3
5,4,11,5,3
5,4,12,5,3
5,4,13,5,3
5,4,14,5,3
5,4,15,5,3
5,4,16,5,3
5,4,17,5,3
5,4,18,5,3
5,5,0,5,3
5,5,1,5,3
5,5,2,5,3
5,5,3,5,3
5,5,4,5,3
5,5,5,5,3
5,5,6,5,3
5,5,7,5,3
5,5,8,5,3
5,5,9,5,3
5,5,10,5,3
5,5,11,5,3
5,5,12,5,3
5,5,13,5,3
5,5,14,5,3
5,5,15,5,3
5,5,16,5,3
5,5,17,5,3
5,5,18,5,3
5,6,0,5,3
5,6,1,5,3
5,6,2,5,3
5,6,3,5,3
5,6,4,5,3
5,6,5,5,3
5,6,6,5,3
5,6,7,5,3
5,6,8,5,3
5,6,9,5,3
5,6,10,5,3
5,6,11,5,3
5,6,12,5,3
5,6,13,5,3
5,6,14,5,3
5,6,15,5,3
5,6,16,5,3
5,6,17,5,3
5,6,18,5,3
5,7,0,5,3
5,7,1,5,3
5,7,2,5,3
5,7,3,5,3
5,7,4,5,3
5,7,5,5,3
5,7,6,5,3
5,7,7,5,3
5,7,8,5,3
5,7,9,5,3
5,7,10,5,3
5,7,11,5,3
5,7,12,5,3
5,7,13,5,3
5,7,14,5,3
5,7,15,5,3
5,7,16,5,3
5,7,17,5,3
5,7,18,5,3
5,8,0,5,3
5,8,1,5,3
5,8,2,5,3
5,8,3,5,3
5,8,4,5,3
5,8,5,5,3
5,8,6,5,3
5,8,7,5,3
5,8,8,5,3
5,8,9,5,3
5,8,10,5,3
5,8,11,5,3
5,8,12,5,3
5,8,13,5,3
5,8,14,5,3
5,8,15,5,3
5,8,16,5,3
5,8,17,5,3
5,8,18,5,3
5,9,0,5,3
5,9,1,5,3
5,9,2,5,3
5,9,3,5,3
5,9,4,5,3
5,9,5,5,3
5,9,6,5,3
5,9,7,5,3
5,9,8,5,3
5,9,9,5,3
5,9,10,5,3
5,9,11,5,3
5,9,12,5,3
5,9,13,5,3
5,9,14,5,3
5,9,15,5,3
5,9,16,5,3
5,9,17,5,3
5,9,18,5,3
5,10,0,5,3
5,10,1,5,3
5,10,2,5,3
5,10,3,5,3
5,10,4,5,3
5,10,5,5,3
5,10,6,5,3
5,10,7,5,3
5,10,8,5,3
5,10,9,5,3
5,10,10,5,3
5,10,11,5,3
5,10,12,5,3
5,10,13,5,3
5,10,14,5,3
5,10,15,5,3
5,10,16,5,3
5,10,17,5,3
5,10,18,5,3
5,11,0,5,3
5,11,1,5,3
5,11,2,5,3
5,11,3,5,3
5,11,4,5,3
5,11,5,5,3
5,11,6,5,3
5,11,7,5,3
5,11,8,5,3
5,11,9,5,3
5,11,10,5,3
5,11,11,5,3
5,11,12,5,3
5,11,13,5,3
5,11,14,5,3
5,11,15,5,3
5,11,16,5,3
5,11,17,5,3
5,11,18,5,3
5,12,0,5,3
5,12,1,5,3
5,12,2,5,3
5,12,3,5,3
5,12,4,5,3
5,12,5,5,3
5,12,6,5,3
5,12,7,5,3
5,12,8,5,3
5,12,9,5,3
5,12,10,5,3
5,12,11,5,3
5,12,12,5,3
5,12,13,5,3
5,12,14,5,3
5,12,15,5,3
5,12,16,5,3
5,12,17,5,3
5,12,18,5,3
5,13,0,5,3
5,13,1,5,3
5,13,2,5,3
5,13,3,5,3
5,13,4,5,3
5,13,5,5,3
5,13,6,5,3
5,13,7,5,3
5,13,8,5,3
5,13,9,5,3
5,13,10,5,3
5,13,11,5,3
5,13,12,5,3
5,13,13,5,3
5,13,14,5,3
5,13,15,5,3
5,13,16,5,3
5,13,17,5,3
5,13,18,5,3
5,14,0,5,3
5,14,1,5,3
5,14,2,5,3
5,14,3,5,3
5,14,4,5,3
5,14,5,5,3
5,14,6,5,3
5,14,7,5,3
5,14,8,5,3
5,14,9,5,3
5,14,10,5,3
5,14,11,5,3
5,14,12,5,3
5,14,13,5,3
5,14,14,5,3
5,14,15,5,3
5,14,16,5,3
5,14,17,5,3
5,14,18,5,3
5,0,0,6,3
5,0,1,6,3
5,0,2,6,3
5,0,3,6,3
5,0,4,6,3
5,0,5,6,3
5,0,6,6,3
5,0,7,6,3
5,0,8,6,3
5,0,9,6,3
5,0,10,6,3
5,0,11,6,3
5,0,12,6,3
5,0,13,6,3
5,0,14,6,3
5,0,15,6,3
5,0,16,6,3
5,0,17,6,3
5,0,18,6,3
5,1,0,6,3
5,1,1,6,3
5,1,2,6,3
5,1,3,6,3
5,1,4,6,3
5,1,5,6,3
5,1,6,6,3
5,1,7,6,3
5,1,8,6,3
5,1,9,6,3
5,1,10,6,3
5,1,11,6,3
5,1,12,6,3
5,1,13,6,3
5,1,14,6,3
5,1,15,6,3
5,1,16,6,3
5,1,17,6,3
5,1,18,6,3
5,2,0,6,3
5,2,1,6,3
5,2,2,6,3
5,2,3,6,3
5,2,4,6,3
5,2,5,6,3
5,2,6,6,3
5,2,7,6,3
5,2,8,6,3
5,2,9,6,3
5,2,10,6,3
5,2,11,6,3
5,2,12,6,3
5,2,13,6,3
5,2,14,6,3
5,2,15,6,3
5,2,16,6,3
5,2,17,6,3
5,2,18,6,3
5,3,0,6,3
5,3,1,6,3
5,3,2,6,3
5,3,3,6,3
5,3,4,6,3
5,3,5,6,3
5,3,6,6,3
5,3,7,6,3
5,3,8,6,3
5,3,9,6,3
5,3,10,6,3
5,3,11,6,3
5,3,12,6,3
5,3,13,6,3
5,3,14,6,3
5,3,15,6,3
5,3,16,6,3
5,3,17,6,3
5,3,18,6,3
5,4,0,6,3
5,4,1,6,3
5,4,2,6,3
5,4,3,6,3
5,4,4,6,3
5,4,5,6,3
5,4,6,6,3
5,4,7,6,3
5,4,8,6,3
5,4,9,6,3
5,4,10,6,3
5,4,11,6,3
5,4,12,6,3
5,4,13,6,3
5,4,14,6,3
5,4,15,6,3
5,4,16,6,3
5,4,17,6,3
5,4,18,6,3
5,5,0,6,3
5,5,1,6,3
5,5,2,6,3
5,5,3,6,3
5,5,4,6,3
5,5,5,6,3
5,5,6,6,3
5,5,7,6,3
5,5,8,6,3
5,5,9,6,3
5,5,10,6,3
5,5,11,6,3
5,5,12,6,3
5,5,13,6,3
5,5,14,6,3
5,5,15,6,3
5,5,16,6,3
5,5,17,6,3
5,5,18,6,3
5,6,0,6,3
5,6,1,6,3
5,6,2,6,3
5,6,3,6,3
5,6,4,6,3
5,6,5,6,3
5,6,6,6,3
5,6,7,6,3
5,6,8,6,3
5,6,9,6,3
5,6,10,6,3
5,6,11,6,3
5,6,12,6,3
5,6,13,6,3
5,6,14,6,3
5,6,15,6,3
5,6,16,6,3
5,6,17,6,3
5,6,18,6,3
5,7,0,6,3
5,7,1,6,3
5,7,2,6,3
5,7,3,6,3
5,7,4,6,3
5,7,5,6,3
5,7,6,6,3
5,7,7,6,3
5,7,8,6,3
5,7,9,6,3
5,7,10,6,3
5,7,11,6,3
5,7,12,6,3
5,7,13,6,3
5,7,14,6,3
5,7,15,6,3
5,7,16,6,3
5,7,17,6,3
5,7,18,6,3
5,8,0,6,3
5,8,1,6,3
5,8,2,6,3
5,8,3,6,3
5,8,4,6,3
5,8,5,6,3
5,8,6,6,3
5,8,7,6,3
5,8,8,6,3
5,8,9,6,3
5,8,10,6,3
5,8,11,6,3
5,8,12,6,3
5,8,13,6,3
5,8,14,6,3
5,8,15,6,3
5,8,16,6,3
5,8,17,6,3
5,8,18,6,3
5,9,0,6,3
5,9,1,6,3
5,9,2,6,3
5,9,3,6,3
5,9,4,6,3
5,9,5,6,3
5,9,6,6,3
5,9,7,6,3
5,9,8,6,3
5,9,9,6,3
5,9,10,6,3
5,9,11,6,3
5,9,12,6,3
5,9,13,6,3
5,9,14,6,3
5,9,15,6,3
5,9,16,6,3
5,9,17,6,3
5,9,18,6,3
5,10,0,6,3
5,10,1,6,3
5,10,2,6,3
5,10,3,6,3
5,10,4,6,3
5,10,5,6,3
5,10,6,6,3
5,10,7,6,3
5,10,8,6,3
5,10,9,6,3
5,10,10,6,3
5,10,11,6,3
5,10,12,6,3
5,10,13,6,3
5,10,14,6,3
5,10,15,6,3
5,10,16,6,3
5,10,17,6,3
5,10,18,6,3
5,11,0,6,3
5,11,1,6,3
5,11,2,6,3
5,11,3,6,3
5,11,4,6,3
5,11,5,6,3
5,11,6,6,3
5,11,7,6,3
5,11,8,6,3
5,11,9,6,3
5,11,10,6,3
5,11,11,6,3
5,11,12,6,3
5,11,13,6,3
5,11,14,6,3
5,11,15,6,3
5,11,16,6,3
5,11,17,6,3
5,11,18,6,3
5,12,0,6,3
5,12,1,6,3
5,12,2,6,3
5,12,3,6,3
5,12,4,6,3
5,12,5,6,3
5,12,6,6,3
5,12,7,6,3
5,12,8,6,3
5,12,9,6,3
5,12,10,6,3
5,12,11,6,3
5,12,12,6,3
5,12,13,6,3
5,12,14,6,3
5,12,15,6,3
5,12,16,6,3
5,12,17,6,3
5,12,18,6,3
5,0,0,7,3
5,0,1,7,3
5,0,2,7,3
5,0,3,7,3
5,0,4,7,3
5,0,5,7,3
5,0,6,7,3
5,0,7,7,3
5,0,8,7,3
5,0,9,7,3
5,0,10,7,3
5,0,11,7,3
5,0,12,7,3
5,0,13,7,3
5,0,14,7,3
5,0,15,7,3
5,0,16,7,3
5,0,17,7,3
5,0,18,7,3
5,1,0,7,3
5,1,1,7,3
5,1,2,7,3
5,1,3,7,3
5,1,4,7,3
5,1,5,7,3
5,1,6,7,3
5,1,7,7,3
5,1,8,7,3
5,1,9,7,3
5,1,10,7,3
5,1,11,7,3
5,1,12,7,3
5,1,13,7,3
5,1,14,7,3
5,1,15,7,3
5,1,16,7,3
5,1,17,7,3
5,1,18,7,3
5,2,0,7,3
5,2,1,7,3
5,2,2,7,3
5,2,3,7,3
5,2,4,7,3
5,2,5,7,3
5,2,6,7,3
5,2,7,7,3
5,2,8,7,3
5,2,9,7,3
5,2,10,7,3
5,2,11,7,3
5,2,12,7,3
5,2,13,7,3
5,2,14,7,3
5,2,15,7,3
5,2,16,7,3
5,2,17,7,3
5,2,18,7,3
5,3,0,7,3
5,3,1,7,3
5,3,2,7,3
5,3,3,7,3
5,3,4,7,3
5,3,5,7,3
5,3,6,7,3
5,3,7,7,3
5,3,8,7,3
5,3,9,7,3
5,3,10,7,3
5,3,11,7,3
5,3,12,7,3
5,3,13,7,3
5,3,14,7,3
5,3,15,7,3
5,3,16,7,3
5,3,17,7,3
5,3,18,7,3
5,4,0,7,3
5,4,1,7,3
5,4,2,7,3
5,4,3,7,3
5,4,4,7,3
5,4,5,7,3
5,4,6,7,3
5,4,7,7,3
5,4,8,7,3
5,4,9,7,3
5,4,10,7,3
5,4,11,7,3
5,4,12,7,3
5,4,13,7,3
5,4,14,7,3
5,4,15,7,3
5,4,16,7,3
5,4,17,7,3
5,4,18,7,3
5,5,0,7,3
5,5,1,7,3
5,5,2,7,3
5,5,3,7,3
5,5,4,7,3
5,5,5,7,3
5,5,6,7,3
5,5,7,7,3
5,5,8,7,3
5,5,9,7,3
5,5,10,7,3
5,5,11,7,3
5,5,12,7,3
5,5,13,7,3
5,5,14,7,3
5,5,15,7,3
5,5,16,7,3
5,5,17,7,3
5,5,18,7,3
5,6,0,7,3
5,6,1,7,3
5,6,2,7,3
5,6,3,7,3
5,6,4,7,3
5,6,5,7,3
5,6,6,7,3
5,6,7,7,3
5,6,8,7,3
5,6,9,7,3
5,6,10,7,3
5,6,11,7,3
5,6,12,7,3
5,6,13,7,3
5,6,14,7,3
5,6,15,7,3
5,6,16,7,3
5,6,17,7,3
5,6,18,7,3
5,7,0,7,3
5,7,1,7,3
5,7,2,7,3
5,7,3,7,3
5,7,4,7,3
5,7,5,7,3
5,7,6,7,3
5,7,7,7,3
5,7,8,7,3
5,7,9,7,3
5,7,10,7,3
5,7,11,7,3
5,7,12,7,3
5,7,13,7,3
5,7,14,7,3
5,7,15,7,3
5,7,16,7,3
5,7,17,7,3
5,7,18,7,3
5,8,0,7,3
5,8,1,7,3
5,8,2,7,3
5,8,3,7,3
5,8,4,7,3
5,8,5,7,3
5,8,6,7,3
5,8,7,7,3
5,8,8,7,3
5,8,9,7,3
5,8,10,7,3
5,8,11,7,3
5,8,12,7,3
5,8,13,7,3
5,8,14,7,3
5,8,15,7,3
5,8,16,7,3
5,8,17,7,3
5,8,18,7,3
5,9,0,7,3
5,9,1,7,3
5,9,2,7,3
5,9,3,7,3
5,9,4,7,3
5,9,5,7,3
5,9,6,7,3
5,9,7,7,3
5,9,8,7,3
5,9,9,7,3
5,9,10,7,3
5,9,11,7,3
5,9,12,7,3
5,9,13,7,3
5,9,14,7,3
5,9,15,7,3
5,9,16,7,3
5,9,17,7,3
5,9,18,7,3
5,10,0,7,3
5,10,1,7,3
5,10,2,7,3
5,10,3,7,3
5,10,4,7,3
5,10,5,7,3
5,10,6,7,3
5,10,7,7,3
5,10,8,7,3
5,10,9,7,3
5,10,10,7,3
5,10,11,7,3
5,10,12,7,3
5,10,13,7,3
5,10,14,7,3
5,10,15,7,3
5,10,16,7,3
5,10,17,7,3
5,10,18,7,3
5,0,0,8,3
5,0,1,8,3
5,0,2,8,3
5,0,3,8,3
5,0,4,8,3
5,0,5,8,3
5,0,6,8,3
5,0,7,8,3
5,0,8,8,3
5,0,9,8,3
5,0,10,8,3
5,0,11,8,3
5,0,12,8,3
5,0,13,8,3
5,0,14,8,3
5,0,15,8,3
5,0,16,8,3
5,0,17,8,3
5,0,18,8,3
5,1,0,8,3
5,1,1,8,3
5,1,2,8,3
5,1,3,8,3
5,1,4,8,3
5,1,5,8,3
5,1,6,8,3
5,1,7,8,3
5,1,8,8,3
5,1,9,8,3
5,1,10,8,3
5,1,11,8,3
5,1,12,8,3
5,1,13,8,3
5,1,14,8,3
5,1,15,8,3
5,1,16,8,3
5,1,17,8,3
5,1,18,8,3
5,2,0,8,3
5,2,1,8,3
5,2,2,8,3
5,2,3,8,3
5,2,4,8,3
5,2,5,8,3
5,2,6,8,3
5,2,7,8,3
5,2,8,8,3
5,2,9,8,3
5,2,10,8,3
5,2,11,8,3
5,2,12,8,3
5,2,13,8,3
5,2,14,8,3
5,2,15,8,3
5,2,16,8,3
5,2,17,8,3
5,2,18,8,3
5,3,0,8,3
5,3,1,8,3
5,3,2,8,3
5,3,3,8,3
5,3,4,8,3
5,3,5,8,3
5,3,6,8,3
5,3,7,8,3
5,3,8,8,3
5,3,9,8,3
5,3,10,8,3
5,3,11,8,3
5,3,12,8,3
5,3,13,8,3
5,3,14,8,3
5,3,15,8,3
5,3,16,8,3
5,3,17,8,3
5,3,18,8,3
5,4,0,8,3
5,4,1,8,3
5,4,2,8,3
5,4,3,8,3
5,4,4,8,3
5,4,5,8,3
5,4,6,8,3
5,4,7,8,3
5,4,8,8,3
5,4,9,8,3
5,4,10,8,3
5,4,11,8,3
5,4,12,8,3
5,4,13,8,3
5,4,14,8,3
5,4,15,8,3
5,4,16,8,3
5,4,17,8,3
5,4,18,8,3
5,5,0,8,3
5,5,1,8,3
5,5,2,8,3
5,5,3,8,3
5,5,4,8,3
5,5,5,8,3
5,5,6,8,3
5,5,7,8,3
5,5,8,8,3
5,5,9,8,3
5,5,10,8,3
5,5,11,8,3
5,5,12,8,3
5,5,13,8,3
5,5,14,8,3
5,5,15,8,3
5,5,16,8,3
5,5,17,8,3
5,5,18,8,3
5,6,0,8,3
5,6,1,8,3
5,6,2,8,3
5,6,3,8,3
5,6,4,8,3
5,6,5,8,3
5,6,6,8,3
5,6,7,8,3
5,6,8,8,3
5,6,9,8,3
5,6,10,8,3
5,6,11,8,3
5,6,12,8,3
5,6,13,8,3
5,6,14,8,3
5,6,15,8,3
5,6,16,8,3
5,6,17,8,3
5,6,18,8,3
5,7,0,8,3
5,7,1,8,3
5,7,2,8,3
5,7,3,8,3
5,7,4,8,3
5,7,5,8,3
5,7,6,8,3
5,7,7,8,3
5,7,8,8,3
5,7,9,8,3
5,7,10,8,3
5,7,11,8,3
5,7,12,8,3
5,7,13,8,3
5,7,14,8,3
5,7,15,8,3
5,7,16,8,3
5,7,17,8,3
5,7,18,8,3
5,8,0,8,3
5,8,1,8,3
5,8,2,8,3
5,8,3,8,3
5,8,4,8,3
5,8,5,8,3
5,8,6,8,3
5,8,7,8,3
5,8,8,8,3
5,8,9,8,3
5,8,10,8,3
5,8,11,8,3
5,8,12,8,3
5,8,13,8,3
5,8,14,8,3
5,8,15,8,3
5,8,16,8,3
5,8,17,8,3
5,8,18,8,3
5,0,0,9,3
5,0,1,9,3
5,0,2,9,3
5,0,3,9,3
5,0,4,9,3
5,0,5,9,3
5,0,6,9,3
5,0,7,9,3
5,0,8,9,3
5,0,9,9,3
5,0,10,9,3
5,0,11,9,3
5,0,12,9,3
5,0,13,9,3
5,0,14,9,3
5,0,15,9,3
5,0,16,9,3
5,0,17,9,3
5,0,18,9,3
5,1,0,9,3
5,1,1,9,3
5,1,2,9,3
5,1,3,9,3
5,1,4,9,3
5,1,5,9,3
5,1,6,9,3
5,1,7,9,3
5,1,8,9,3
5,1,9,9,3
5,1,10,9,3
5,1,11,9,3
5,1,12,9,3
5,1,13,9,3
5,1,14,9,3
5,1,15,9,3
5,1,16,9,3
5,1,17,9,3
5,1,18,9,3
5,2,0,9,3
5,2,1,9,3
5,2,2,9,3
5,2,3,9,3
5,2,4,9,3
5,2,5,9,3
5,2,6,9,3
5,2,7,9,3
5,2,8,9,3
5,2,9,9,3
5,2,10,9,3
5,2,11,9,3
5,2,12,9,3
5,2,13,9,3
5,2,14,9,3
5,2,15,9,3
5,2,16,9,3
5,2,17,9,3
5,2,18,9,3
5,3,0,9,3
5,3,1,9,3
5,3,2,9,3
5,3,3,9,3
5,3,4,9,3
5,3,5,9,3
5,3,6,9,3
5,3,7,9,3
5,3,8,9,3
5,3,9,9,3
5,3,10,9,3
5,3,11,9,3
5,3,12,9,3
5,3,13,9,3
5,3,14,9,3
5,3,15,9,3
5,3,16,9,3
5,3,17,9,3
5,3,18,9,3
5,4,0,9,3
5,4,1,9,3
5,4,2,9,3
5,4,3,9,3
5,4,4,9,3
5,4,5,9,3
5,4,6,9,3
5,4,7,9,3
5,4,8,9,3
5,4,9,9,3
5,4,10,9,3
5,4,11,9,3
5,4,12,9,3
5,4,13,9,3
5,4,14,9,3
5,4,15,9,3
5,4,16,9,3
5,4,17,9,3
5,4,18,9,3
5,5,0,9,3
5,5,1,9,3
5,5,2,9,3
5,5,3,9,3
5,5,4,9,3
5,5,5,9,3
5,5,6,9,3
5,5,7,9,3
5,5,8,9,3
5,5,9,9,3
5,5,10,9,3
5,5,11,9,3
5,5,12,9,3
5,5,13,9,3
5,5,14,9,3
5,5,15,9,3
5,5,16,9,3
5,5,17,9,3
5,5,18,9,3
5,6,0,9,3
5,6,1,9,3
5,6,2,9,3
5,6,3,9,3
5,6,4,9,3
5,6,5,9,3
5,6,6,9,3
5,6,7,9,3
5,6,8,9,3
5,6,9,9,3
5,6,10,9,3
5,6,11,9,3
5,6,12,9,3
5,6,13,9,3
5,6,14,9,3
5,6,15,9,3
5,6,16,9,3
5,6,17,9,3
5,6,18,9,3
5,0,0,10,3
5,0,1,10,3
5,0,2,10,3
5,0,3,10,3
5,0,4,10,3
5,0,5,10,3
5,0,6,10,3
5,0,7,10,3
5,0,8,10,3
5,0,9,10,3
5,0,10,10,3
5,0,11,10,3
5,0,12,10,3
5,0,13,10,3
5,0,14,10,3
5,0,15,10,3
5,0,16,10,3
5,0,17,10,3
5,0,18,10,3
5,1,0,10,3
5,1,1,10,3
5,1,2,10,3
5,1,3,10,3
5,1,4,10,3
5,1,5,10,3
5,1,6,10,3
5,1,7,10,3
5,1,8,10,3
5,1,9,10,3
5,1,10,10,3
5,1,11,10,3
5,1,12,10,3
5,1,13,10,3
5,1,14,10,3
5,1,15,10,3
5,1,16,10,3
5,1,17,10,3
5,1,18,10,3
5,2,0,10,3
5,2,1,10,3
5,2,2,10,3
5,2,3,10,3
5,2,4,10,3
5,2,5,10,3
5,2,6,10,3
5,2,7,10,3
5,2,8,10,3
5,2,9,10,3
5,2,10,10,3
5,2,11,10,3
5,2,12,10,3
5,2,13,10,3
5,2,14,10,3
5,2,15,10,3
5,2,16,10,3
5,2,17,10,3
5,2,18,10,3
5,3,0,10,3
5,3,1,10,3
5,3,2,10,3
5,3,3,10,3
5,3,4,10,3
5,3,5,10,3
5,3,6,10,3
5,3,7,10,3
5,3,8,10,3
5,3,9,10,3
5,3,10,10,3
5,3,11,10,3
5,3,12,10,3
5,3,13,10,3
5,3,14,10,3
5,3,15,10,3
5,3,16,10,3
5,3,17,10,3
5,3,18,10,3
5,4,0,10,3
5,4,1,10,3
5,4,2,10,3
5,4,3,10,3
5,4,4,10,3
5,4,5,10,3
5,4,6,10,3
5,4,7,10,3
5,4,8,10,3
5,4,9,10,3
5,4,10,10,3
5,4,11,10,3
5,4,12,10,3
5,4,13,10,3
5,4,14,10,3
5,4,15,10,3
5,4,16,10,3
5,4,17,10,3
5,4,18,10,3
5,0,0,11,3
5,0,1,11,3
5,0,2,11,3
5,0,3,11,3
5,0,4,11,3
5,0,5,11,3
5,0,6,11,3
5,0,7,11,3
5,0,8,11,3
5,0,9,11,3
5,0,10,11,3
5,0,11,11,3
5,0,12,11,3
5,0,13,11,3
5,0,14,11,3
5,0,15,11,3
5,0,16,11,3
5,0,17,11,3
5,0,18,11,3
5,1,0,11,3
5,1,1,11,3
5,1,2,11,3
5,1,3,11,3
5,1,4,11,3
5,1,5,11,3
5,1,6,11,3
5,1,7,11,3
5,1,8,11,3
5,1,9,11,3
5,1,10,11,3
5,1,11,11,3
5,1,12,11,3
5,1,13,11,3
5,1,14,11,3
5,1,15,11,3
5,1,16,11,3
5,1,17,11,3
5,1,18,11,3
5,2,0,11,3
5,2,1,11,3
5,2,2,11,3
5,2,3,11,3
5,2,4,11,3
5,2,5,11,3
5,2,6,11,3
5,2,7,11,3
5,2,8,11,3
5,2,9,11,3
5,2,10,11,3
5,2,11,11,3
5,2,12,11,3
5,2,13,11,3
5,2,14,11,3
5,2,15,11,3
5,2,16,11,3
5,2,17,11,3
5,2,18,11,3
5,0,0,12,3
5,0,1,12,3
5,0,2,12,3
5,0,3,12,3
5,0,4,12,3
5,0,5,12,3
5,0,6,12,3
5,0,7,12,3
5,0,8,12,3
5,0,9,12,3
5,0,10,12,3
5,0,11,12,3
5,0,12,12,3
5,0,13,12,3
5,0,14,12,3
5,0,15,12,3
5,0,16,12,3
5,0,17,12,3
5,0,18,12,3
5,0,0,1,4
5,0,1,1,4
5,0,2,1,4
5,0,3,1,4
5,0,4,1,4
5,0,5,1,4
5,0,6,1,4
5,0,7,1,4
5,0,8,1,4
5,0,9,1,4
5,0,10,1,4
5,0,11,1,4
5,0,12,1,4
5,0,13,1,4
5,0,14,1,4
5,0,15,1,4
5,0,16,1,4
5,1,0,1,4
5,1,1,1,4
5,1,2,1,4
5,1,3,1,4
5,1,4,1,4
5,1,5,1,4
5,1,6,1,4
5,1,7,1,4
5,1,8,1,4
5,1,9,1,4
5,1,10,1,4
5,1,11,1,4
5,1,12,1,4
5,1,13,1,4
5,1,14,1,4
5,1,15,1,4
5,1,16,1,4
5,2,0,1,4
5,2,1,1,4
5,2,2,1,4
5,2,3,1,4
5,2,4,1,4
5,2,5,1,4
5,2,6,1,4
5,2,7,1,4
5,2,8,1,4
5,2,9,1,4
5,2,10,1,4
5,2,11,1,4
5,2,12,1,4
5,2,13,1,4
5,2,14,1,4
5,2,15,1,4
5,2,16,1,4
5,3,0,1,4
5,3,1,1,4
5,3,2,1,4
5,3,3,1,4
5,3,4,1,4
5,3,5,1,4
5,3,6,1,4
5,3,7,1,4
5,3,8,1,4
5,3,9,1,4
5,3,10,1,4
5,3,11,1,4
5,3,12,1,4
5,3,13,1,4
5,3,14,1,4
5,3,15,1,4
5,3,16,1,4
5,4,0,1,4
5,4,1,1,4
5,4,2,1,4
5,4,3,1,4
5,4,4,1,4
5,4,5,1,4
5,4,6,1,4
5,4,7,1,4
5,4,8,1,4
5,4,9,1,4
5,4,10,1,4
5,4,11,1,4
5,4,12,1,4
5,4,13,1,4
5,4,14,1,4
5,4,15,1,4
5,4,16,1,4
5,5,0,1,4
5,5,1,1,4
5,5,2,1,4
5,5,3,1,4
5,5,4,1,4
5,5,5,1,4
5,5,6,1,4
5,5,7,1,4
5,5,8,1,4
5,5,9,1,4
5,5,10,1,4
5,5,11,1,4
5,5,12,1,4
5,5,13,1,4
5,5,14,1,4
5,5,15,1,4
5,5,16,1,4
5,6,0,1,4
5,6,1,1,4
5,6,2,1,4
5,6,3,1,4
5,6,4,1,4
5,6,5,1,4
5,6,6,1,4
5,6,7,1,4
5,6,8,1,4
5,6,9,1,4
5,6,10,1,4
5,6,11,1,4
5,6,12,1,4
5,6,13,1,4
5,6,14,1,4
5,6,15,1,4
5,6,16,1,4
5,7,0,1,4
5,7,1,1,4
5,7,2,1,4
5,7,3,1,4
5,7,4,1,4
5,7,5,1,4
5,7,6,1,4
5,7,7,1,4
5,7,8,1,4
5,7,9,1,4
5,7,10,1,4
5,7,11,1,4
5,7,12,1,4
5,7,13,1,4
5,7,14,1,4
5,7,15,1,4
5,7,16,1,4
5,8,0,1,4
5,8,1,1,4
5,8,2,1,4
5,8,3,1,4
5,8,4,1,4
5,8,5,1,4
5,8,6,1,4
5,8,7,1,4
5,8,8,1,4
5,8,9,1,4
5,8,10,1,4
5,8,11,1,4
5,8,12,1,4
5,8,13,1,4
5,8,14,1,4
5,8,15,1,4
5,8,16,1,4
5,9,0,1,4
5,9,1,1,4
5,9,2,1,4
5,9,3,1,4
5,9,4,1,4
5,9,5,1,4
5,9,6,1,4
5,9,7,1,4
5,9,8,1,4
5,9,9,1,4
5,9,10,1,4
5,9,11,1,4
5,9,12,1,4
5,9,13,1,4
5,9,14,1,4
5,9,15,1,4
5,9,16,1,4
5,10,0,1,4
5,10,1,1,4
5,10,2,1,4
5,10,3,1,4
5,10,4,1,4
5,10,5,1,4
5,10,6,1,4
5,10,7,1,4
5,10,8,1,4
5,10,9,1,4
5,10,10,1,4
5,10,11,1,4
5,10,12,1,4
5,10,13,1,4
5,10,14,1,4
5,10,15,1,4
5,10,16,1,4
5,11,0,1,4
5,11,1,1,4
5,11,2,1,4
5,11,3,1,4
5,11,4,1,4
5,11,5,1,4
5,11,6,1,4
5,11,7,1,4
5,11,8,1,4
5,11,9,1,4
5,11,10,1,4
5,11,11,1,4
5,11,12,1,4
5,11,13,1,4
5,11,14,1,4
5,11,15,1,4
5,11,16,1,4
5,12,0,1,4
5,12,1,1,4
5,12,2,1,4
5,12,3,1,4
5,12,4,1,4
5,12,5,1,4
5,12,6,1,4
5,12,7,1,4
5,12,8,1,4
5,12,9,1,4
5,12,10,1,4
5,12,11,1,4
5,12,12,1,4
5,12,13,1,4
5,12,14,1,4
5,12,15,1,4
5,12,16,1,4
5,13,0,1,4
5,13,1,1,4
5,13,2,1,4
5,13,3,1,4
5,13,4,1,4
5,13,5,1,4
5,13,6,1,4
5,13,7,1,4
5,13,8,1,4
5,13,9,1,4
5,13,10,1,4
5,13,11,1,4
5,13,12,1,4
5,13,13,1,4
5,13,14,1,4
5,13,15,1,4
5,13,16,1,4
5,14,0,1,4
5,14,1,1,4
5,14,2,1,4
5,14,3,1,4
5,14,4,1,4
5,14,5,1,4
5,14,6,1,4
5,14,7,1,4
5,14,8,1,4
5,14,9,1,4
5,14,10,1,4
5,14,11,1,4
5,14,12,1,4
5,14,13,1,4
5,14,14,1,4
5,14,15,1,4
5,14,16,1,4
5,15,0,1,4
5,15,1,1,4
5,15,2,1,4
5,15,3,1,4
5,15,4,1,4
5,15,5,1,4
5,15,6,1,4
5,15,7,1,4
5,15,8,1,4
5,15,9,1,4
5,15,10,1,4
5,15,11,1,4
5,15,12,1,4
5,15,13,1,4
5,15,14,1,4
5,15,15,1,4
5,15,16,1,4
5,16,0,1,4
5,16,1,1,4
5,16,2,1,4
5,16,3,1,4
5,16,4,1,4
5,16,5,1,4
5,16,6,1,4
5,16,7,1,4
5,16,8,1,4
5,16,9,1,4
5,16,10,1,4
5,16,11,1,4
5,16,12,1,4
5,16,13,1,4
5,16,14,1,4
5,16,15,1,4
5,16,16,1,4
5,17,0,1,4
5,17,1,1,4
5,17,2,1,4
5,17,3,1,4
5,17,4,1,4
5,17,5,1,4
5,17,6,1,4
5,17,7,1,4
5,17,8,1,4
5,17,9,1,4
5,17,10,1,4
5,17,11,1,4
5,17,12,1,4
5,17,13,1,4
5,17,14,1,4
5,17,15,1,4
5,17,16,1,4
5,18,0,1,4
5,18,1,1,4
5,18,2,1,4
5,18,3,1,4
5,18,4,1,4
5,18,5,1,4
5,18,6,1,4
5,18,7,1,4
5,18,8,1,4
5,18,9,1,4
5,18,10,1,4
5,18,11,1,4
5,18,12,1,4
5,18,13,1,4
5,18,14,1,4
5,18,15,1,4
5,18,16,1,4
5,19,0,1,4
5,19,1,1,4
5,19,2,1,4
5,19,3,1,4
5,19,4,1,4
5,19,5,1,4
5,19,6,1,4
5,19,7,1,4
5,19,8,1,4
5,19,9,1,4
5,19,10,1,4
5,19,11,1,4
5,19,12,1,4
5,19,13,1,4
5,19,14,1,4
5,19,15,1,4
5,19,16,1,4
5,20,0,1,4
5,20,1,1,4
5,20,2,1,4
5,20,3,1,4
5,20,4,1,4
5,20,5,1,4
5,20,6,1,4
5,20,7,1,4
5,20,8,1,4
5,20,9,1,4
5,20,10,1,4
5,20,11,1,4
5,20,12,1,4
5,20,13,1,4
5,20,14,1,4
5,20,15,1,4
5,20,16,1,4
5,21,0,1,4
5,21,1,1,4
5,21,2,1,4
5,21,3,1,4
5,21,4,1,4
5,21,5,1,4
5,21,6,1,4
5,21,7,1,4
5,21,8,1,4
5,21,9,1,4
5,21,10,1,4
5,21,11,1,4
5,21,12,1,4
5,21,13,1,4
5,21,14,1,4
5,21,15,1,4
5,21,16,1,4
5,22,0,1,4
5,22,1,1,4
5,22,2,1,4
5,22,3,1,4
5,22,4,1,4
5,22,5,1,4
5,22,6,1,4
5,22,7,1,4
5,22,8,1,4
5,22,9,1,4
5,22,10,1,4
5,22,11,1,4
5,22,12,1,4
5,22,13,1,4
5,22,14,1,4
5,22,15,1,4
5,22,16,1,4
5,0,0,2,4
5,0,1,2,4
5,0,2,2,4
5,0,3,2,4
5,0,4,2,4
5,0,5,2,4
5,0,6,2,4
5,0,7,2,4
5,0,8,2,4
5,0,9,2,4
5,0,10,2,4
5,0,11,2,4
5,0,12,2,4
5,0,13,2,4
5,0,14,2,4
5,0,15,2,4
5,0,16,2,4
5,1,0,2,4
5,1,1,2,4
5,1,2,2,4
5,1,3,2,4
5,1,4,2,4
5,1,5,2,4
5,1,6,2,4
5,1,7,2,4
5,1,8,2,4
5,1,9,2,4
5,1,10,2,4
5,1,11,2,4
5,1,12,2,4
5,1,13,2,4
5,1,14,2,4
5,1,15,2,4
5,1,16,2,4
5,2,0,2,4
5,2,1,2,4
5,2,2,2,4
5,2,3,2,4
5,2,4,2,4
5,2,5,2,4
5,2,6,2,4
5,2,7,2,4
5,2,8,2,4
5,2,9,2,4
5,2,10,2,4
5,2,11,2,4
5,2,12,2,4
5,2,13,2,4
5,2,14,2,4
5,2,15,2,4
5,2,16,2,4
5,3,0,2,4
5,3,1,2,4
5,3,2,2,4
5,3,3,2,4
5,3,4,2,4
5,3,5,2,4
5,3,6,2,4
5,3,7,2,4
5,3,8,2,4
5,3,9,2,4
5,3,10,2,4
5,3,11,2,4
5,3,12,2,4
5,3,13,2,4
5,3,14,2,4
5,3,15,2,4
5,3,16,2,4
5,4,0,2,4
5,4,1,2,4
5,4,2,2,4
5,4,3,2,4
5,4,4,2,4
5,4,5,2,4
5,4,6,2,4
5,4,7,2,4
5,4,8,2,4
5,4,9,2,4
5,4,10,2,4
5,4,11,2,4
5,4,12,2,4
5,4,13,2,4
5,4,14,2,4
5,4,15,2,4
5,4,16,2,4
5,5,0,2,4
5,5,1,2,4
5,5,2,2,4
5,5,3,2,4
5,5,4,2,4
5,5,5,2,4
5,5,6,2,4
5,5,7,2,4
5,5,8,2,4
5,5,9,2,4
5,5,10,2,4
5,5,11,2,4
5,5,12,2,4
5,5,13,2,4
5,5,14,2,4
5,5,15,2,4
5,5,16,2,4
5,6,0,2,4
5,6,1,2,4
5,6,2,2,4
5,6,3,2,4
5,6,4,2,4
5,6,5,2,4
5,6,6,2,4
5,6,7,2,4
5,6,8,2,4
5,6,9,2,4
5,6,10,2,4
5,6,11,2,4
5,6,12,2,4
5,6,13,2,4
5,6,14,2,4
5,6,15,2,4
5,6,16,2,4
5,7,0,2,4
5,7,1,2,4
5,7,2,2,4
5,7,3,2,4
5,7,4,2,4
5,7,5,2,4
5,7,6,2,4
5,7,7,2,4
5,7,8,2,4
5,7,9,2,4
5,7,10,2,4
5,7,11,2,4
5,7,12,2,4
5,7,13,2,4
5,7,14,2,4
5,7,15,2,4
5,7,16,2,4
5,8,0,2,4
5,8,1,2,4
5,8,2,2,4
5,8,3,2,4
5,8,4,2,4
5,8,5,2,4
5,8,6,2,4
5,8,7,2,4
5,8,8,2,4
5,8,9,2,4
5,8,10,2,4
5,8,11,2,4
5,8,12,2,4
5,8,13,2,4
5,8,14,2,4
5,8,15,2,4
5,8,16,2,4
5,9,0,2,4
5,9,1,2,4
5,9,2,2,4
5,9,3,2,4
5,9,4,2,4
5,9,5,2,4
5,9,6,2,4
5,9,7,2,4
5,9,8,2,4
5,9,9,2,4
5,9,10,2,4
5,9,11,2,4
5,9,12,2,4
5,9,13,2,4
5,9,14,2,4
5,9,15,2,4
5,9,16,2,4
5,10,0,2,4
5,10,1,2,4
5,10,2,2,4
5,10,3,2,4
5,10,4,2,4
5,10,5,2,4
5,10,6,2,4
5,10,7,2,4
5,10,8,2,4
5,10,9,2,4
5,10,10,2,4
5,10,11,2,4
5,10,12,2,4
5,10,13,2,4
5,10,14,2,4
5,10,15,2,4
5,10,16,2,4
5,11,0,2,4
5,11,1,2,4
5,11,2,2,4
5,11,3,2,4
5,11,4,2,4
5,11,5,2,4
5,11,6,2,4
5,11,7,2,4
5,11,8,2,4
5,11,9,2,4
5,11,10,2,4
5,11,11,2,4
5,11,12,2,4
5,11,13,2,4
5,11,14,2,4
5,11,15,2,4
5,11,16,2,4
5,12,0,2,4
5,12,1,2,4
5,12,2,2,4
5,12,3,2,4
5,12,4,2,4
5,12,5,2,4
5,12,6,2,4
5,12,7,2,4
5,12,8,2,4
5,12,9,2,4
5,12,10,2,4
5,12,11,2,4
5,12,12,2,4
5,12,13,2,4
5,12,14,2,4
5,12,15,2,4
5,12,16,2,4
5,13,0,2,4
5,13,1,2,4
5,13,2,2,4
5,13,3,2,4
5,13,4,2,4
5,13,5,2,4
5,13,6,2,4
5,13,7,2,4
5,13,8,2,4
5,13,9,2,4
5,13,10,2,4
5,13,11,2,4
5,13,12,2,4
5,13,13,2,4
5,13,14,2,4
5,13,15,2,4
5,13,16,2,4
5,14,0,2,4
5,14,1,2,4
5,14,2,2,4
5,14,3,2,4
5,14,4,2,4
5,14,5,2,4
5,14,6,2,4
5,14,7,2,4
5,14,8,2,4
5,14,9,2,4
5,14,10,2,4
5,14,11,2,4
5,14,12,2,4
5,14,13,2,4
5,14,14,2,4
5,14,15,2,4
5,14,16,2,4
5,15,0,2,4
5,15,1,2,4
5,15,2,2,4
5,15,3,2,4
5,15,4,2,4
5,15,5,2,4
5,15,6,2,4
5,15,7,2,4
5,15,8,2,4
5,15,9,2,4
5,15,10,2,4
5,15,11,2,4
5,15,12,2,4
5,15,13,2,4
5,15,14,2,4
5,15,15,2,4
5,15,16,2,4
5,16,0,2,4
5,16,1,2,4
5,16,2,2,4
5,16,3,2,4
5,16,4,2,4
5,16,5,2,4
5,16,6,2,4
5,16,7,2,4
5,16,8,2,4
5,16,9,2,4
5,16,10,2,4
5,16,11,2,4
5,16,12,2,4
5,16,13,2,4
5,16,14,2,4
5,16,15,2,4
5,16,16,2,4
5,17,0,2,4
5,17,1,2,4
5,17,2,2,4
5,17,3,2,4
5,17,4,2,4
5,17,5,2,4
5,17,6,2,4
5,17,7,2,4
5,17,8,2,4
5,17,9,2,4
5,17,10,2,4
5,17,11,2,4
5,17,12,2,4
5,17,13,2,4
5,17,14,2,4
5,17,15,2,4
5,17,16,2,4
5,18,0,2,4
5,18,1,2,4
5,18,2,2,4
5,18,3,2,4
5,18,4,2,4
5,18,5,2,4
5,18,6,2,4
5,18,7,2,4
5,18,8,2,4
5,18,9,2,4
5,18,10,2,4
5,18,11,2,4
5,18,12,2,4
5,18,13,2,4
5,18,14,2,4
5,18,15,2,4
5,18,16,2,4
5,19,0,2,4
5,19,1,2,4
5,19,2,2,4
5,19,3,2,4
5,19,4,2,4
5,19,5,2,4
5,19,6,2,4
5,19,7,2,4
5,19,8,2,4
5,19,9,2,4
5,19,10,2,4
5,19,11,2,4
5,19,12,2,4
5,19,13,2,4
5,19,14,2,4
5,19,15,2,4
5,19,16,2,4
5,20,0,2,4
5,20,1,2,4
5,20,2,2,4
5,20,3,2,4
5,20,4,2,4
5,20,5,2,4
5,20,6,2,4
5,20,7,2,4
5,20,8,2,4
5,20,9,2,4
5,20,10,2,4
5,20,11,2,4
5,20,12,2,4
5,20,13,2,4
5,20,14,2,4
5,20,15,2,4
5,20,16,2,4
5,0,0,3,4
5,0,1,3,4
5,0,2,3,4
5,0,3,3,4
5,0,4,3,4
5,0,5,3,4
5,0,6,3,4
5,0,7,3,4
5,0,8,3,4
5,0,9,3,4
5,0,10,3,4
5,0,11,3,4
5,0,12,3,4
5,0,13,3,4
5,0,14,3,4
5,0,15,3,4
5,0,16,3,4
5,1,0,3,4
5,1,1,3,4
5,1,2,3,4
5,1,3,3,4
5,1,4,3,4
5,1,5,3,4
5,1,6,3,4
5,1,7,3,4
5,1,8,3,4
5,1,9,3,4
5,1,10,3,4
5,1,11,3,4
5,1,12,3,4
5,1,13,3,4
5,1,14,3,4
5,1,15,3,4
5,1,16,3,4
5,2,0,3,4
5,2,1,3,4
5,2,2,3,4
5,2,3,3,4
5,2,4,3,4
5,2,5,3,4
5,2,6,3,4
5,2,7,3,4
5,2,8,3,4
5,2,9,3,4
5,2,10,3,4
5,2,11,3,4
5,2,12,3,4
5,2,13,3,4
5,2,14,3,4
5,2,15,3,4
5,2,16,3,4
5,3,0,3,4
5,3,1,3,4
5,3,2,3,4
5,3,3,3,4
5,3,4,3,4
5,3,5,3,4
5,3,6,3,4
5,3,7,3,4
5,3,8,3,4
5,3,9,3,4
5,3,10,3,4
5,3,11,3,4
5,3,12,3,4
5,3,13,3,4
5,3,14,3,4
5,3,15,3,4
5,3,16,3,4
5,4,0,3,4
5,4,1,3,4
5,4,2,3,4
5,4,3,3,4
5,4,4,3,4
5,4,5,3,4
5,4,6,3,4
5,4,7,3,4
5,4,8,3,4
5,4,9,3,4
5,4,10,3,4
5,4,11,3,4
5,4,12,3,4
5,4,13,3,4
5,4,14,3,4
5,4,15,3,4
5,4,16,3,4
5,5,0,3,4
5,5,1,3,4
5,5,2,3,4
5,5,3,3,4
5,5,4,3,4
5,5,5,3,4
5,5,6,3,4
5,5,7,3,4
5,5,8,3,4
5,5,9,3,4
5,5,10,3,4
5,5,11,3,4
5,5,12,3,4
5,5,13,3,4
5,5,14,3,4
5,5,15,3,4
5,5,16,3,4
5,6,0,3,4
5,6,1,3,4
5,6,2,3,4
5,6,3,3,4
5,6,4,3,4
5,6,5,3,4
5,6,6,3,4
5,6,7,3,4
5,6,8,3,4
5,6,9,3,4
5,6,10,3,4
5,6,11,3,4
5,6,12,3,4
5,6,13,3,4
5,6,14,3,4
5,6,15,3,4
5,6,16,3,4
5,7,0,3,4
5,7,1,3,4
5,7,2,3,4
5,7,3,3,4
5,7,4,3,4
5,7,5,3,4
5,7,6,3,4
5,7,7,3,4
5,7,8,3,4
5,7,9,3,4
5,7,10,3,4
5,7,11,3,4
5,7,12,3,4
5,7,13,3,4
5,7,14,3,4
5,7,15,3,4
5,7,16,3,4
5,8,0,3,4
5,8,1,3,4
5,8,2,3,4
5,8,3,3,4
5,8,4,3,4
5,8,5,3,4
5,8,6,3,4
5,8,7,3,4
5,8,8,3,4
5,8,9,3,4
5,8,10,3,4
5,8,11,3,4
5,8,12,3,4
5,8,13,3,4
5,8,14,3,4
5,8,15,3,4
5,8,16,3,4
5,9,0,3,4
5,9,1,3,4
5,9,2,3,4
5,9,3,3,4
5,9,4,3,4
5,9,5,3,4
5,9,6,3,4
5,9,7,3,4
5,9,8,3,4
5,9,9,3,4
5,9,10,3,4
5,9,11,3,4
5,9,12,3,4
5,9,13,3,4
5,9,14,3,4
5,9,15,3,4
5,9,16,3,4
5,10,0,3,4
5,10,1,3,4
5,10,2,3,4
5,10,3,3,4
5,10,4,3,4
5,10,5,3,4
5,10,6,3,4
5,10,7,3,4
5,10,8,3,4
5,10,9,3,4
5,10,10,3,4
5,10,11,3,4
5,10,12,3,4
5,10,13,3,4
5,10,14,3,4
5,10,15,3,4
5,10,16,3,4
5,11,0,3,4
5,11,1,3,4
5,11,2,3,4
5,11,3,3,4
5,11,4,3,4
5,11,5,3,4
5,11,6,3,4
5,11,7,3,4
5,11,8,3,4
5,11,9,3,4
5,11,10,3,4
5,11,11,3,4
5,11,12,3,4
5,11,13,3,4
5,11,14,3,4
5,11,15,3,4
5,11,16,3,4
5,12,0,3,4
5,12,1,3,4
5,12,2,3,4
5,12,3,3,4
5,12,4,3,4
5,12,5,3,4
5,12,6,3,4
5,12,7,3,4
5,12,8,3,4
5,12,9,3,4
5,12,10,3,4
5,12,11,3,4
5,12,12,3,4
5,12,13,3,4
5,12,14,3,4
5,12,15,3,4
5,12,16,3,4
5,13,0,3,4
5,13,1,3,4
5,13,2,3,4
5,13,3,3,4
5,13,4,3,4
5,13,5,3,4
5,13,6,3,4
5,13,7,3,4
5,13,8,3,4
5,13,9,3,4
5,13,10,3,4
5,13,11,3,4
5,13,12,3,4
5,13,13,3,4
5,13,14,3,4
5,13,15,3,4
5,13,16,3,4
5,14,0,3,4
5,14,1,3,4
5,14,2,3,4
5,14,3,3,4
5,14,4,3,4
5,14,5,3,4
5,14,6,3,4
5,14,7,3,4
5,14,8,3,4
5,14,9,3,4
5,14,10,3,4
5,14,11,3,4
5,14,12,3,4
5,14,13,3,4
5,14,14,3,4
5,14,15,3,4
5,14,16,3,4
5,15,0,3,4
5,15,1,3,4
5,15,2,3,4
5,15,3,3,4
5,15,4,3,4
5,15,5,3,4
5,15,6,3,4
5,15,7,3,4
5,15,8,3,4
5,15,9,3,4
5,15,10,3,4
5,15,11,3,4
5,15,12,3,4
5,15,13,3,4
5,15,14,3,4
5,15,15,3,4
5,15,16,3,4
5,16,0,3,4
5,16,1,3,4
5,16,2,3,4
5,16,3,3,4
5,16,4,3,4
5,16,5,3,4
5,16,6,3,4
5,16,7,3,4
5,16,8,3,4
5,16,9,3,4
5,16,10,3,4
5,16,11,3,4
5,16,12,3,4
5,16,13,3,4
5,16,14,3,4
5,16,15,3,4
5,16,16,3,4
5,17,0,3,4
5,17,1,3,4
5,17,2,3,4
5,17,3,3,4
5,17,4,3,4
5,17,5,3,4
5,17,6,3,4
5,17,7,3,4
5,17,8,3,4
5,17,9,3,4
5,17,10,3,4
5,17,11,3,4
5,17,12,3,4
5,17,13,3,4
5,17,14,3,4
5,17,15,3,4
5,17,16,3,4
5,18,0,3,4
5,18,1,3,4
5,18,2,3,4
5,18,3,3,4
5,18,4,3,4
5,18,5,3,4
5,18,6,3,4
5,18,7,3,4
5,18,8,3,4
5,18,9,3,4
5,18,10,3,4
5,18,11,3,4
5,18,12,3,4
5,18,13,3,4
5,18,14,3,4
5,18,15,3,4
5,18,16,3,4
5,0,0,4,4
5,0,1,4,4
5,0,2,4,4
5,0,3,4,4
5,0,4,4,4
5,0,5,4,4
5,0,6,4,4
5,0,7,4,4
5,0,8,4,4
5,0,9,4,4
5,0,10,4,4
5,0,11,4,4
5,0,12,4,4
5,0,13,4,4
5,0,14,4,4
5,0,15,4,4
5,0,16,4,4
5,1,0,4,4
5,1,1,4,4
5,1,2,4,4
5,1,3,4,4
5,1,4,4,4
5,1,5,4,4
5,1,6,4,4
5,1,7,4,4
5,1,8,4,4
5,1,9,4,4
5,1,10,4,4
5,1,11,4,4
5,1,12,4,4
5,1,13,4,4
5,1,14,4,4
5,1,15,4,4
5,1,16,4,4
5,2,0,4,4
5,2,1,4,4
5,2,2,4,4
5,2,3,4,4
5,2,4,4,4
5,2,5,4,4
5,2,6,4,4
5,2,7,4,4
5,2,8,4,4
5,2,9,4,4
5,2,10,4,4
5,2,11,4,4
5,2,12,4,4
5,2,13,4,4
5,2,14,4,4
5,2,15,4,4
5,2,16,4,4
5,3,0,4,4
5,3,1,4,4
5,3,2,4,4
5,3,3,4,4
5,3,4,4,4
5,3,5,4,4
5,3,6,4,4
5,3,7,4,4
5,3,8,4,4
5,3,9,4,4
5,3,10,4,4
5,3,11,4,4
5,3,12,4,4
5,3,13,4,4
5,3,14,4,4
5,3,15,4,4
5,3,16,4,4
5,4,0,4,4
5,4,1,4,4
5,4,2,4,4
5,4,3,4,4
5,4,4,4,4
5,4,5,4,4
5,4,6,4,4
5,4,7,4,4
5,4,8,4,4
5,4,9,4,4
5,4,10,4,4
5,4,11,4,4
5,4,12,4,4
5,4,13,4,4
5,4,14,4,4
5,4,15,4,4
5,4,16,4,4
5,5,0,4,4
5,5,1,4,4
5,5,2,4,4
5,5,3,4,4
5,5,4,4,4
5,5,5,4,4
5,5,6,4,4
5,5,7,4,4
5,5,8,4,4
5,5,9,4,4
5,5,10,4,4
5,5,11,4,4
5,5,12,4,4
5,5,13,4,4
5,5,14,4,4
5,5,15,4,4
5,5,16,4,4
5,6,0,4,4
5,6,1,4,4
5,6,2,4,4
5,6,3,4,4
5,6,4,4,4
5,6,5,4,4
5,6,6,4,4
5,6,7,4,4
5,6,8,4,4
5,6,9,4,4
5,6,10,4,4
5,6,11,4,4
5,6,12,4,4
5,6,13,4,4
5,6,14,4,4
5,6,15,4,4
5,6,16,4,4
5,7,0,4,4
5,7,1,4,4
5,7,2,4,4
5,7,3,4,4
5,7,4,4,4
5,7,5,4,4
5,7,6,4,4
5,7,7,4,4
5,7,8,4,4
5,7,9,4,4
5,7,10,4,4
5,7,11,4,4
5,7,12,4,4
5,7,13,4,4
5,7,14,4,4
5,7,15,4,4
5,7,16,4,4
5,8,0,4,4
5,8,1,4,4
5,8,2,4,4
5,8,3,4,4
5,8,4,4,4
5,8,5,4,4
5,8,6,4,4
5,8,7,4,4
5,8,8,4,4
5,8,9,4,4
5,8,10,4,4
5,8,11,4,4
5,8,12,4,4
5,8,13,4,4
5,8,14,4,4
5,8,15,4,4
5,8,16,4,4
5,9,0,4,4
5,9,1,4,4
5,9,2,4,4
5,9,3,4,4
5,9,4,4,4
5,9,5,4,4
5,9,6,4,4
5,9,7,4,4
5,9,8,4,4
5,9,9,4,4
5,9,10,4,4
5,9,11,4,4
5,9,12,4,4
5,9,13,4,4
5,9,14,4,4
5,9,15,4,4
5,9,16,4,4
5,10,0,4,4
5,10,1,4,4
5,10,2,4,4
5,10,3,4,4
5,10,4,4,4
5,10,5,4,4
5,10,6,4,4
5,10,7,4,4
5,10,8,4,4
5,10,9,4,4
5,10,10,4,4
5,10,11,4,4
5,10,12,4,4
5,10,13,4,4
5,10,14,4,4
5,10,15,4,4
5,10,16,4,4
5,11,0,4,4
5,11,1,4,4
5,11,2,4,4
5,11,3,4,4
5,11,4,4,4
5,11,5,4,4
5,11,6,4,4
5,11,7,4,4
5,11,8,4,4
5,11,9,4,4
5,11,10,4,4
5,11,11,4,4
5,11,12,4,4
5,11,13,4,4
5,11,14,4,4
5,11,15,4,4
5,11,16,4,4
5,12,0,4,4
5,12,1,4,4
5,12,2,4,4
5,12,3,4,4
5,12,4,4,4
5,12,5,4,4
5,12,6,4,4
5,12,7,4,4
5,12,8,4,4
5,12,9,4,4
5,12,10,4,4
5,12,11,4,4
5,12,12,4,4
5,12,13,4,4
5,12,14,4,4
5,12,15,4,4
5,12,16,4,4
5,13,0,4,4
5,13,1,4,4
5,13,2,4,4
5,13,3,4,4
5,13,4,4,4
5,13,5,4,4
5,13,6,4,4
5,13,7,4,4
5,13,8,4,4
5,13,9,4,4
5,13,10,4,4
5,13,11,4,4
5,13,12,4,4
5,13,13,4,4
5,13,14,4,4
5,13,15,4,4
5,13,16,4,4
5,14,0,4,4
5,14,1,4,4
5,14,2,4,4
5,14,3,4,4
5,14,4,4,4
5,14,5,4,4
5,14,6,4,4
5,14,7,4,4
5,14,8,4,4
5,14,9,4,4
5,14,10,4,4
5,14,11,4,4
5,14,12,4,4
5,14,13,4,4
5,14,14,4,4
5,14,15,4,4
5,14,16,4,4
5,15,0,4,4
5,15,1,4,4
5,15,2,4,4
5,15,3,4,4
5,15,4,4,4
5,15,5,4,4
5,15,6,4,4
5,15,7,4,4
5,15,8,4,4
5,15,9,4,4
5,15,10,4,4
5,15,11,4,4
5,15,12,4,4
5,15,13,4,4
5,15,14,4,4
5,15,15,4,4
5,15,16,4,4
5,16,0,4,4
5,16,1,4,4
5,16,2,4,4
5,16,3,4,4
5,16,4,4,4
5,16,5,4,4
5,16,6,4,4
5,16,7,4,4
5,16,8,4,4
5,16,9,4,4
5,16,10,4,4
5,16,11,4,4
5,16,12,4,4
5,16,13,4,4
5,16,14,4,4
5,16,15,4,4
5,16,16,4,4
5,0,0,5,4
5,0,1,5,4
5,0,2,5,4
5,0,3,5,4
5,0,4,5,4
5,0,5,5,4
5,0,6,5,4
5,0,7,5,4
5,0,8,5,4
5,0,9,5,4
5,0,10,5,4
5,0,11,5,4
5,0,12,5,4
5,0,13,5,4
5,0,14,5,4
5,0,15,5,4
5,0,16,5,4
5,1,0,5,4
5,1,1,5,4
5,1,2,5,4
5,1,3,5,4
5,1,4,5,4
5,1,5,5,4
5,1,6,5,4
5,1,7,5,4
5,1,8,5,4
5,1,9,5,4
5,1,10,5,4
5,1,11,5,4
5,1,12,5,4
5,1,13,5,4
5,1,14,5,4
5,1,15,5,4
5,1,16,5,4
5,2,0,5,4
5,2,1,5,4
5,2,2,5,4
5,2,3,5,4
5,2,4,5,4
5,2,5,5,4
5,2,6,5,4
5,2,7,5,4
5,2,8,5,4
5,2,9,5,4
5,2,10,5,4
5,2,11,5,4
5,2,12,5,4
5,2,13,5,4
5,2,14,5,4
5,2,15,5,4
5,2,16,5,4
5,3,0,5,4
5,3,1,5,4
5,3,2,5,4
5,3,3,5,4
5,3,4,5,4
5,3,5,5,4
5,3,6,5,4
5,3,7,5,4
5,3,8,5,4
5,3,9,5,4
5,3,10,5,4
5,3,11,5,4
5,3,12,5,4
5,3,13,5,4
5,3,14,5,4
5,3,15,5,4
5,3,16,5,4
5,4,0,5,4
5,4,1,5,4
5,4,2,5,4
5,4,3,5,4
5,4,4,5,4
5,4,5,5,4
5,4,6,5,4
5,4,7,5,4
5,4,8,5,4
5,4,9,5,4
5,4,10,5,4
5,4,11,5,4
5,4,12,5,4
5,4,13,5,4
5,4,14,5,4
5,4,15,5,4
5,4,16,5,4
5,5,0,5,4
5,5,1,5,4
5,5,2,5,4
5,5,3,5,4
5,5,4,5,4
5,5,5,5,4
5,5,6,5,4
5,5,7,5,4
5,5,8,5,4
5,5,9,5,4
5,5,10,5,4
5,5,11,5,4
5,5,12,5,4
5,5,13,5,4
5,5,14,5,4
5,5,15,5,4
5,5,16,5,4
5,6,0,5,4
5,6,1,5,4
5,6,2,5,4
5,6,3,5,4
5,6,4,5,4
5,6,5,5,4
5,6,6,5,4
5,6,7,5,4
5,6,8,5,4
5,6,9,5,4
5,6,10,5,4
5,6,11,5,4
5,6,12,5,4
5,6,13,5,4
5,6,14,5,4
5,6,15,5,4
5,6,16,5,4
5,7,0,5,4
5,7,1,5,4
5,7,2,5,4
5,7,3,5,4
5,7,4,5,4
5,7,5,5,4
5,7,6,5,4
5,7,7,5,4
5,7,8,5,4
5,7,9,5,4
5,7,10,5,4
5,7,11,5,4
5,7,12,5,4
5,7,13,5,4
5,7,14,5,4
5,7,15,5,4
5,7,16,5,4
5,8,0,5,4
5,8,1,5,4
5,8,2,5,4
5,8,3,5,4
5,8,4,5,4
5,8,5,5,4
5,8,6,5,4
5,8,7,5,4
5,8,8,5,4
5,8,9,5,4
5,8,10,5,4
5,8,11,5,4
5,8,12,5,4
5,8,13,5,4
5,8,14,5,4
5,8,15,5,4
5,8,16,5,4
5,9,0,5,4
5,9,1,5,4
5,9,2,5,4
5,9,3,5,4
5,9,4,5,4
5,9,5,5,4
5,9,6,5,4
5,9,7,5,4
5,9,8,5,4
5,9,9,5,4
5,9,10,5,4
5,9,11,5,4
5,9,12,5,4
5,9,13,5,4
5,9,14,5,4
5,9,15,5,4
5,9,16,5,4
5,10,0,5,4
5,10,1,5,4
5,10,2,5,4
5,10,3,5,4
5,10,4,5,4
5,10,5,5,4
5,10,6,5,4
5,10,7,5,4
5,10,8,5,4
5,10,9,5,4
5,10,10,5,4
5,10,11,5,4
5,10,12,5,4
5,10,13,5,4
5,10,14,5,4
5,10,15,5,4
5,10,16,5,4
5,11,0,5,4
5,11,1,5,4
5,11,2,5,4
5,11,3,5,4
5,11,4,5,4
5,11,5,5,4
5,11,6,5,4
5,11,7,5,4
5,11,8,5,4
5,11,9,5,4
5,11,10,5,4
5,11,11,5,4
5,11,12,5,4
5,11,13,5,4
5,11,14,5,4
5,11,15,5,4
5,11,16,5,4
5,12,0,5,4
5,12,1,5,4
5,12,2,5,4
5,12,3,5,4
5,12,4,5,4
5,12,5,5,4
5,12,6,5,4
5,12,7,5,4
5,12,8,5,4
5,12,9,5,4
5,12,10,5,4
5,12,11,5,4
5,12,12,5,4
5,12,13,5,4
5,12,14,5,4
5,12,15,5,4
5,12,16,5,4
5,13,0,5,4
5,13,1,5,4
5,13,2,5,4
5,13,3,5,4
5,13,4,5,4
5,13,5,5,4
5,13,6,5,4
5,13,7,5,4
5,13,8,5,4
5,13,9,5,4
5,13,10,5,4
5,13,11,5,4
5,13,12,5,4
5,13,13,5,4
5,13,14,5,4
5,13,15,5,4
5,13,16,5,4
5,14,0,5,4
5,14,1,5,4
5,14,2,5,4
5,14,3,5,4
5,14,4,5,4
5,14,5,5,4
5,14,6,5,4
5,14,7,5,4
5,14,8,5,4
5,14,9,5,4
5,14,10,5,4
5,14,11,5,4
5,14,12,5,4
5,14,13,5,4
5,14,14,5,4
5,14,15,5,4
5,14,16,5,4
5,0,0,6,4
5,0,1,6,4
5,0,2,6,4
5,0,3,6,4
5,0,4,6,4
5,0,5,6,4
5,0,6,6,4
5,0,7,6,4
5,0,8,6,4
5,0,9,6,4
5,0,10,6,4
5,0,11,6,4
5,0,12,6,4
5,0,13,6,4
5,0,14,6,4
5,0,15,6,4
5,0,16,6,4
5,1,0,6,4
5,1,1,6,4
5,1,2,6,4
5,1,3,6,4
5,1,4,6,4
5,1,5,6,4
5,1,6,6,4
5,1,7,6,4
5,1,8,6,4
5,1,9,6,4
5,1,10,6,4
5,1,11,6,4
5,1,12,6,4
5,1,13,6,4
5,1,14,6,4
5,1,15,6,4
5,1,16,6,4
5,2,0,6,4
5,2,1,6,4
5,2,2,6,4
5,2,3,6,4
5,2,4,6,4
5,2,5,6,4
5,2,6,6,4
5,2,7,6,4
5,2,8,6,4
5,2,9,6,4
5,2,10,6,4
5,2,11,6,4
5,2,12,6,4
5,2,13,6,4
5,2,14,6,4
5,2,15,6,4
5,2,16,6,4
5,3,0,6,4
5,3,1,6,4
5,3,2,6,4
5,3,3,6,4
5,3,4,6,4
5,3,5,6,4
5,3,6,6,4
5,3,7,6,4
5,3,8,6,4
5,3,9,6,4
5,3,10,6,4
5,3,11,6,4
5,3,12,6,4
5,3,13,6,4
5,3,14,6,4
5,3,15,6,4
5,3,16,6,4
5,4,0,6,4
5,4,1,6,4
5,4,2,6,4
5,4,3,6,4
5,4,4,6,4
5,4,5,6,4
5,4,6,6,4
5,4,7,6,4
5,4,8,6,4
5,4,9,6,4
5,4,10,6,4
5,4,11,6,4
5,4,12,6,4
5,4,13,6,4
5,4,14,6,4
5,4,15,6,4
5,4,16,6,4
5,5,0,6,4
5,5,1,6,4
5,5,2,6,4
5,5,3,6,4
5,5,4,6,4
5,5,5,6,4
5,5,6,6,4
5,5,7,6,4
5,5,8,6,4
5,5,9,6,4
5,5,10,6,4
5,5,11,6,4
5,5,12,6,4
5,5,13,6,4
5,5,14,6,4
5,5,15,6,4
5,5,16,6,4
5,6,0,6,4
5,6,1,6,4
5,6,2,6,4
5,6,3,6,4
5,6,4,6,4
5,6,5,6,4
5,6,6,6,4
5,6,7,6,4
5,6,8,6,4
5,6,9,6,4
5,6,10,6,4
5,6,11,6,4
5,6,12,6,4
5,6,13,6,4
5,6,14,6,4
5,6,15,6,4
5,6,16,6,4
5,7,0,6,4
5,7,1,6,4
5,7,2,6,4
5,7,3,6,4
5,7,4,6,4
5,7,5,6,4
5,7,6,6,4
5,7,7,6,4
5,7,8,6,4
5,7,9,6,4
5,7,10,6,4
5,7,11,6,4
5,7,12,6,4
5,7,13,6,4
5,7,14,6,4
5,7,15,6,4
5,7,16,6,4
5,8,0,6,4
5,8,1,6,4
5,8,2,6,4
5,8,3,6,4
5,8,4,6,4
5,8,5,6,4
5,8,6,6,4
5,8,7,6,4
5,8,8,6,4
5,8,9,6,4
5,8,10,6,4
5,8,11,6,4
5,8,12,6,4
5,8,13,6,4
5,8,14,6,4
5,8,15,6,4
5,8,16,6,4
5,9,0,6,4
5,9,1,6,4
5,9,2,6,4
5,9,3,6,4
5,9,4,6,4
5,9,5,6,4
5,9,6,6,4
5,9,7,6,4
5,9,8,6,4
5,9,9,6,4
5,9,10,6,4
5,9,11,6,4
5,9,12,6,4
5,9,13,6,4
5,9,14,6,4
5,9,15,6,4
5,9,16,6,4
5,10,0,6,4
5,10,1,6,4
5,10,2,6,4
5,10,3,6,4
5,10,4,6,4
5,10,5,6,4
5,10,6,6,4
5,10,7,6,4
5,10,8,6,4
5,10,9,6,4
5,10,10,6,4
5,10,11,6,4
5,10,12,6,4
5,10,13,6,4
5,10,14,6,4
5,10,15,6,4
5,10,16,6,4
5,11,0,6,4
5,11,1,6,4
5,11,2,6,4
5,11,3,6,4
5,11,4,6,4
5,11,5,6,4
5,11,6,6,4
5,11,7,6,4
5,11,8,6,4
5,11,9,6,4
5,11,10,6,4
5,11,11,6,4
5,11,12,6,4
5,11,13,6,4
5,11,14,6,4
5,11,15,6,4
5,11,16,6,4
5,12,0,6,4
5,12,1,6,4
5,12,2,6,4
5,12,3,6,4
5,12,4,6,4
5,12,5,6,4
5,12,6,6,4
5,12,7,6,4
5,12,8,6,4
5,12,9,6,4
5,12,10,6,4
5,12,11,6,4
5,12,12,6,4
5,12,13,6,4
5,12,14,6,4
5,12,15,6,4
5,12,16,6,4
5,0,0,7,4
5,0,1,7,4
5,0,2,7,4
5,0,3,7,4
5,0,4,7,4
5,0,5,7,4
5,0,6,7,4
5,0,7,7,4
5,0,8,7,4
5,0,9,7,4
5,0,10,7,4
5,0,11,7,4
5,0,12,7,4
5,0,13,7,4
5,0,14,7,4
5,0,15,7,4
5,0,16,7,4
5,1,0,7,4
5,1,1,7,4
5,1,2,7,4
5,1,3,7,4
5,1,4,7,4
5,1,5,7,4
5,1,6,7,4
5,1,7,7,4
5,1,8,7,4
5,1,9,7,4
5,1,10,7,4
5,1,11,7,4
5,1,12,7,4
5,1,13,7,4
5,1,14,7,4
5,1,15,7,4
5,1,16,7,4
5,2,0,7,4
5,2,1,7,4
5,2,2,7,4
5,2,3,7,4
5,2,4,7,4
5,2,5,7,4
5,2,6,7,4
5,2,7,7,4
5,2,8,7,4
5,2,9,7,4
5,2,10,7,4
5,2,11,7,4
5,2,12,7,4
5,2,13,7,4
5,2,14,7,4
5,2,15,7,4
5,2,16,7,4
5,3,0,7,4
5,3,1,7,4
5,3,2,7,4
5,3,3,7,4
5,3,4,7,4
5,3,5,7,4
5,3,6,7,4
5,3,7,7,4
5,3,8,7,4
5,3,9,7,4
5,3,10,7,4
5,3,11,7,4
5,3,12,7,4
5,3,13,7,4
5,3,14,7,4
5,3,15,7,4
5,3,16,7,4
5,4,0,7,4
5,4,1,7,4
5,4,2,7,4
5,4,3,7,4
5,4,4,7,4
5,4,5,7,4
5,4,6,7,4
5,4,7,7,4
5,4,8,7,4
5,4,9,7,4
5,4,10,7,4
5,4,11,7,4
5,4,12,7,4
5,4,13,7,4
5,4,14,7,4
5,4,15,7,4
5,4,16,7,4
5,5,0,7,4
5,5,1,7,4
5,5,2,7,4
5,5,3,7,4
5,5,4,7,4
5,5,5,7,4
5,5,6,7,4
5,5,7,7,4
5,5,8,7,4
5,5,9,7,4
5,5,10,7,4
5,5,11,7,4
5,5,12,7,4
5,5,13,7,4
5,5,14,7,4
5,5,15,7,4
5,5,16,7,4
5,6,0,7,4
5,6,1,7,4
5,6,2,7,4
5,6,3,7,4
5,6,4,7,4
5,6,5,7,4
5,6,6,7,4
5,6,7,7,4
5,6,8,7,4
5,6,9,7,4
5,6,10,7,4
5,6,11,7,4
5,6,12,7,4
5,6,13,7,4
5,6,14,7,4
5,6,15,7,4
5,6,16,7,4
5,7,0,7,4
5,7,1,7,4
5,7,2,7,4
5,7,3,7,4
5,7,4,7,4
5,7,5,7,4
5,7,6,7,4
5,7,7,7,4
5,7,8,7,4
5,7,9,7,4
5,7,10,7,4
5,7,11,7,4
5,7,12,7,4
5,7,13,7,4
5,7,14,7,4
5,7,15,7,4
5,7,16,7,4
5,8,0,7,4
5,8,1,7,4
5,8,2,7,4
5,8,3,7,4
5,8,4,7,4
5,8,5,7,4
5,8,6,7,4
5,8,7,7,4
5,8,8,7,4
5,8,9,7,4
5,8,10,7,4
5,8,11,7,4
5,8,12,7,4
5,8,13,7,4
5,8,14,7,4
5,8,15,7,4
5,8,16,7,4
5,9,0,7,4
5,9,1,7,4
5,9,2,7,4
5,9,3,7,4
5,9,4,7,4
5,9,5,7,4
5,9,6,7,4
5,9,7,7,4
5,9,8,7,4
5,9,9,7,4
5,9,10,7,4
5,9,11,7,4
5,9,12,7,4
5,9,13,7,4
5,9,14,7,4
5,9,15,7,4
5,9,16,7,4
5,10,0,7,4
5,10,1,7,4
5,10,2,7,4
5,10,3,7,4
5,10,4,7,4
5,10,5,7,4
5,10,6,7,4
5,10,7,7,4
5,10,8,7,4
5,10,9,7,4
5,10,10,7,4
5,10,11,7,4
5,10,12,7,4
5,10,13,7,4
5,10,14,7,4
5,10,15,7,4
5,10,16,7,4
5,0,0,8,4
5,0,1,8,4
5,0,2,8,4
5,0,3,8,4
5,0,4,8,4
5,0,5,8,4
5,0,6,8,4
5,0,7,8,4
5,0,8,8,4
5,0,9,8,4
5,0,10,8,4
5,0,11,8,4
5,0,12,8,4
5,0,13,8,4
5,0,14,8,4
5,0,15,8,4
5,0,16,8,4
5,1,0,8,4
5,1,1,8,4
5,1,2,8,4
5,1,3,8,4
5,1,4,8,4
5,1,5,8,4
5,1,6,8,4
5,1,7,8,4
5,1,8,8,4
5,1,9,8,4
5,1,10,8,4
5,1,11,8,4
5,1,12,8,4
5,1,13,8,4
5,1,14,8,4
5,1,15,8,4
5,1,16,8,4
5,2,0,8,4
5,2,1,8,4
5,2,2,8,4
5,2,3,8,4
5,2,4,8,4
5,2,5,8,4
5,2,6,8,4
5,2,7,8,4
5,2,8,8,4
5,2,9,8,4
5,2,10,8,4
5,2,11,8,4
5,2,12,8,4
5,2,13,8,4
5,2,14,8,4
5,2,15,8,4
5,2,16,8,4
5,3,0,8,4
5,3,1,8,4
5,3,2,8,4
5,3,3,8,4
5,3,4,8,4
5,3,5,8,4
5,3,6,8,4
5,3,7,8,4
5,3,8,8,4
5,3,9,8,4
5,3,10,8,4
5,3,11,8,4
5,3,12,8,4
5,3,13,8,4
5,3,14,8,4
5,3,15,8,4
5,3,16,8,4
5,4,0,8,4
5,4,1,8,4
5,4,2,8,4
5,4,3,8,4
5,4,4,8,4
5,4,5,8,4
5,4,6,8,4
5,4,7,8,4
5,4,8,8,4
5,4,9,8,4
5,4,10,8,4
5,4,11,8,4
5,4,12,8,4
5,4,13,8,4
5,4,14,8,4
5,4,15,8,4
5,4,16,8,4
5,5,0,8,4
5,5,1,8,4
5,5,2,8,4
5,5,3,8,4
5,5,4,8,4
5,5,5,8,4
5,5,6,8,4
5,5,7,8,4
5,5,8,8,4
5,5,9,8,4
5,5,10,8,4
5,5,11,8,4
5,5,12,8,4
5,5,13,8,4
5,5,14,8,4
5,5,15,8,4
5,5,16,8,4
5,6,0,8,4
5,6,1,8,4
5,6,2,8,4
5,6,3,8,4
5,6,4,8,4
5,6,5,8,4
5,6,6,8,4
5,6,7,8,4
5,6,8,8,4
5,6,9,8,4
5,6,10,8,4
5,6,11,8,4
5,6,12,8,4
5,6,13,8,4
5,6,14,8,4
5,6,15,8,4
5,6,16,8,4
5,7,0,8,4
5,7,1,8,4
5,7,2,8,4
5,7,3,8,4
5,7,4,8,4
5,7,5,8,4
5,7,6,8,4
5,7,7,8,4
5,7,8,8,4
5,7,9,8,4
5,7,10,8,4
5,7,11,8,4
5,7,12,8,4
5,7,13,8,4
5,7,14,8,4
5,7,15,8,4
5,7,16,8,4
5,8,0,8,4
5,8,1,8,4
5,8,2,8,4
5,8,3,8,4
5,8,4,8,4
5,8,5,8,4
5,8,6,8,4
5,8,7,8,4
5,8,8,8,4
5,8,9,8,4
5,8,10,8,4
5,8,11,8,4
5,8,12,8,4
5,8,13,8,4
5,8,14,8,4
5,8,15,8,4
5,8,16,8,4
5,0,0,9,4
5,0,1,9,4
5,0,2,9,4
5,0,3,9,4
5,0,4,9,4
5,0,5,9,4
5,0,6,9,4
5,0,7,9,4
5,0,8,9,4
5,0,9,9,4
5,0,10,9,4
5,0,11,9,4
5,0,12,9,4
5,0,13,9,4
5,0,14,9,4
5,0,15,9,4
5,0,16,9,4
5,1,0,9,4
5,1,1,9,4
5,1,2,9,4
5,1,3,9,4
5,1,4,9,4
5,1,5,9,4
5,1,6,9,4
5,1,7,9,4
5,1,8,9,4
5,1,9,9,4
5,1,10,9,4
5,1,11,9,4
5,1,12,9,4
5,1,13,9,4
5,1,14,9,4
5,1,15,9,4
5,1,16,9,4
5,2,0,9,4
5,2,1,9,4
5,2,2,9,4
5,2,3,9,4
5,2,4,9,4
5,2,5,9,4
5,2,6,9,4
5,2,7,9,4
5,2,8,9,4
5,2,9,9,4
5,2,10,9,4
5,2,11,9,4
5,2,12,9,4
5,2,13,9,4
5,2,14,9,4
5,2,15,9,4
5,2,16,9,4
5,3,0,9,4
5,3,1,9,4
5,3,2,9,4
5,3,3,9,4
5,3,4,9,4
5,3,5,9,4
5,3,6,9,4
5,3,7,9,4
5,3,8,9,4
5,3,9,9,4
5,3,10,9,4
5,3,11,9,4
5,3,12,9,4
5,3,13,9,4
5,3,14,9,4
5,3,15,9,4
5,3,16,9,4
5,4,0,9,4
5,4,1,9,4
5,4,2,9,4
5,4,3,9,4
5,4,4,9,4
5,4,5,9,4
5,4,6,9,4
5,4,7,9,4
5,4,8,9,4
5,4,9,9,4
5,4,10,9,4
5,4,11,9,4
5,4,12,9,4
5,4,13,9,4
5,4,14,9,4
5,4,15,9,4
5,4,16,9,4
5,5,0,9,4
5,5,1,9,4
5,5,2,9,4
5,5,3,9,4
5,5,4,9,4
5,5,5,9,4
5,5,6,9,4
5,5,7,9,4
5,5,8,9,4
5,5,9,9,4
5,5,10,9,4
5,5,11,9,4
5,5,12,9,4
5,5,13,9,4
5,5,14,9,4
5,5,15,9,4
5,5,16,9,4
5,6,0,9,4
5,6,1,9,4
5,6,2,9,4
5,6,3,9,4
5,6,4,9,4
5,6,5,9,4
5,6,6,9,4
5,6,7,9,4
5,6,8,9,4
5,6,9,9,4
5,6,10,9,4
5,6,11,9,4
5,6,12,9,4
5,6,13,9,4
5,6,14,9,4
5,6,15,9,4
5,6,16,9,4
5,0,0,10,4
5,0,1,10,4
5,0,2,10,4
5,0,3,10,4
5,0,4,10,4
5,0,5,10,4
5,0,6,10,4
5,0,7,10,4
5,0,8,10,4
5,0,9,10,4
5,0,10,10,4
5,0,11,10,4
5,0,12,10,4
5,0,13,10,4
5,0,14,10,4
5,0,15,10,4
5,0,16,10,4
5,1,0,10,4
5,1,1,10,4
5,1,2,10,4
5,1,3,10,4
5,1,4,10,4
5,1,5,10,4
5,1,6,10,4
5,1,7,10,4
5,1,8,10,4
5,1,9,10,4
5,1,10,10,4
5,1,11,10,4
5,1,12,10,4
5,1,13,10,4
5,1,14,10,4
5,1,15,10,4
5,1,16,10,4
5,2,0,10,4
5,2,1,10,4
5,2,2,10,4
5,2,3,10,4
5,2,4,10,4
5,2,5,10,4
5,2,6,10,4
5,2,7,10,4
5,2,8,10,4
5,2,9,10,4
5,2,10,10,4
5,2,11,10,4
5,2,12,10,4
5,2,13,10,4
5,2,14,10,4
5,2,15,10,4
5,2,16,10,4
5,3,0,10,4
5,3,1,10,4
5,3,2,10,4
5,3,3,10,4
5,3,4,10,4
5,3,5,10,4
5,3,6,10,4
5,3,7,10,4
5,3,8,10,4
5,3,9,10,4
5,3,10,10,4
5,3,11,10,4
5,3,12,10,4
5,3,13,10,4
5,3,14,10,4
5,3,15,10,4
5,3,16,10,4
5,4,0,10,4
5,4,1,10,4
5,4,2,10,4
5,4,3,10,4
5,4,4,10,4
5,4,5,10,4
5,4,6,10,4
5,4,7,10,4
5,4,8,10,4
5,4,9,10,4
5,4,10,10,4
5,4,11,10,4
5,4,12,10,4
5,4,13,10,4
5,4,14,10,4
5,4,15,10,4
5,4,16,10,4
5,0,0,11,4
5,0,1,11,4
5,0,2,11,4
5,0,3,11,4
5,0,4,11,4
5,0,5,11,4
5,0,6,11,4
5,0,7,11,4
5,0,8,11,4
5,0,9,11,4
5,0,10,11,4
5,0,11,11,4
5,0,12,11,4
5,0,13,11,4
5,0,14,11,4
5,0,15,11,4
5,0,16,11,4
5,1,0,11,4
5,1,1,11,4
5,1,2,11,4
5,1,3,11,4
5,1,4,11,4
5,1,5,11,4
5,1,6,11,4
5,1,7,11,4
5,1,8,11,4
5,1,9,11,4
5,1,10,11,4
5,1,11,11,4
5,1,12,11,4
5,1,13,11,4
5,1,14,11,4
5,1,15,11,4
5,1,16,11,4
5,2,0,11,4
5,2,1,11,4
5,2,2,11,4
5,2,3,11,4
5,2,4,11,4
5,2,5,11,4
5,2,6,11,4
5,2,7,11,4
5,2,8,11,4
5,2,9,11,4
5,2,10,11,4
5,2,11,11,4
5,2,12,11,4
5,2,13,11,4
5,2,14,11,4
5,2,15,11,4
5,2,16,11,4
5,0,0,12,4
5,0,1,12,4
5,0,2,12,4
5,0,3,12,4
5,0,4,12,4
5,0,5,12,4
5,0,6,12,4
5,0,7,12,4
5,0,8,12,4
5,0,9,12,4
5,0,10,12,4
5,0,11,12,4
5,0,12,12,4
5,0,13,12,4
5,0,14,12,4
5,0,15,12,4
5,0,16,12,4
5,0,0,1,5
5,0,1,1,5
5,0,2,1,5
5,0,3,1,5
5,0,4,1,5
5,0,5,1,5
5,0,6,1,5
5,0,7,1,5
5,0,8,1,5
5,0,9,1,5
5,0,10,1,5
5,0,11,1,5
5,0,12,1,5
5,0,13,1,5
5,0,14,1,5
5,1,0,1,5
5,1,1,1,5
5,1,2,1,5
5,1,3,1,5
5,1,4,1,5
5,1,5,1,5
5,1,6,1,5
5,1,7,1,5
5,1,8,1,5
5,1,9,1,5
5,1,10,1,5
5,1,11,1,5
5,1,12,1,5
5,1,13,1,5
5,1,14,1,5
5,2,0,1,5
5,2,1,1,5
5,2,2,1,5
5,2,3,1,5
5,2,4,1,5
5,2,5,1,5
5,2,6,1,5
5,2,7,1,5
5,2,8,1,5
5,2,9,1,5
5,2,10,1,5
5,2,11,1,5
5,2,12,1,5
5,2,13,1,5
5,2,14,1,5
5,3,0,1,5
5,3,1,1,5
5,3,2,1,5
5,3,3,1,5
5,3,4,1,5
5,3,5,1,5
5,3,6,1,5
5,3,7,1,5
5,3,8,1,5
5,3,9,1,5
5,3,10,1,5
5,3,11,1,5
5,3,12,1,5
5,3,13,1,5
5,3,14,1,5
5,4,0,1,5
5,4,1,1,5
5,4,2,1,5
5,4,3,1,5
5,4,4,1,5
5,4,5,1,5
5,4,6,1,5
5,4,7,1,5
5,4,8,1,5
5,4,9,1,5
5,4,10,1,5
5,4,11,1,5
5,4,12,1,5
5,4,13,1,5
5,4,14,1,5
5,5,0,1,5
5,5,1,1,5
5,5,2,1,5
5,5,3,1,5
5,5,4,1,5
5,5,5,1,5
5,5,6,1,5
5,5,7,1,5
5,5,8,1,5
5,5,9,1,5
5,5,10,1,5
5,5,11,1,5
5,5,12,1,5
5,5,13,1,5
5,5,14,1,5
5,6,0,1,5
5,6,1,1,5
5,6,2,1,5
5,6,3,1,5
5,6,4,1,5
5,6,5,1,5
5,6,6,1,5
5,6,7,1,5
5,6,8,1,5
5,6,9,1,5
5,6,10,1,5
5,6,11,1,5
5,6,12,1,5
5,6,13,1,5
5,6,14,1,5
5,7,0,1,5
5,7,1,1,5
5,7,2,1,5
5,7,3,1,5
5,7,4,1,5
5,7,5,1,5
5,7,6,1,5
5,7,7,1,5
5,7,8,1,5
5,7,9,1,5
5,7,10,1,5
5,7,11,1,5
5,7,12,1,5
5,7,13,1,5
5,7,14,1,5
5,8,0,1,5
5,8,1,1,5
5,8,2,1,5
5,8,3,1,5
5,8,4,1,5
5,8,5,1,5
5,8,6,1,5
5,8,7,1,5
5,8,8,1,5
5,8,9,1,5
5,8,10,1,5
5,8,11,1,5
5,8,12,1,5
5,8,13,1,5
5,8,14,1,5
5,9,0,1,5
5,9,1,1,5
5,9,2,1,5
5,9,3,1,5
5,9,4,1,5
5,9,5,1,5
5,9,6,1,5
5,9,7,1,5
5,9,8,1,5
5,9,9,1,5
5,9,10,1,5
5,9,11,1,5
5,9,12,1,5
5,9,13,1,5
5,9,14,1,5
5,10,0,1,5
5,10,1,1,5
5,10,2,1,5
5,10,3,1,5
5,10,4,1,5
5,10,5,1,5
5,10,6,1,5
5,10,7,1,5
5,10,8,1,5
5,10,9,1,5
5,10,10,1,5
5,10,11,1,5
5,10,12,1,5
5,10,13,1,5
5,10,14,1,5
5,11,0,1,5
5,11,1,1,5
5,11,2,1,5
5,11,3,1,5
5,11,4,1,5
5,11,5,1,5
5,11,6,1,5
5,11,7,1,5
5,11,8,1,5
5,11,9,1,5
5,11,10,1,5
5,11,11,1,5
5,11,12,1,5
5,11,13,1,5
5,11,14,1,5
5,12,0,1,5
5,12,1,1,5
5,12,2,1,5
5,12,3,1,5
5,12,4,1,5
5,12,5,1,5
5,12,6,1,5
5,12,7,1,5
5,12,8,1,5
5,12,9,1,5
5,12,10,1,5
5,12,11,1,5
5,12,12,1,5
5,12,13,1,5
5,12,14,1,5
5,13,0,1,5
5,13,1,1,5
5,13,2,1,5
5,13,3,1,5
5,13,4,1,5
5,13,5,1,5
5,13,6,1,5
5,13,7,1,5
5,13,8,1,5
5,13,9,1,5
5,13,10,1,5
5,13,11,1,5
5,13,12,1,5
5,13,13,1,5
5,13,14,1,5
5,14,0,1,5
5,14,1,1,5
5,14,2,1,5
5,14,3,1,5
5,14,4,1,5
5,14,5,1,5
5,14,6,1,5
5,14,7,1,5
5,14,8,1,5
5,14,9,1,5
5,14,10,1,5
5,14,11,1,5
5,14,12,1,5
5,14,13,1,5
5,14,14,1,5
5,15,0,1,5
5,15,1,1,5
5,15,2,1,5
5,15,3,1,5
5,15,4,1,5
5,15,5,1,5
5,15,6,1,5
5,15,7,1,5
5,15,8,1,5
5,15,9,1,5
5,15,10,1,5
5,15,11,1,5
5,15,12,1,5
5,15,13,1,5
5,15,14,1,5
5,16,0,1,5
5,16,1,1,5
5,16,2,1,5
5,16,3,1,5
5,16,4,1,5
5,16,5,1,5
5,16,6,1,5
5,16,7,1,5
5,16,8,1,5
5,16,9,1,5
5,16,10,1,5
5,16,11,1,5
5,16,12,1,5
5,16,13,1,5
5,16,14,1,5
5,17,0,1,5
5,17,1,1,5
5,17,2,1,5
5,17,3,1,5
5,17,4,1,5
5,17,5,1,5
5,17,6,1,5
5,17,7,1,5
5,17,8,1,5
5,17,9,1,5
5,17,10,1,5
5,17,11,1,5
5,17,12,1,5
5,17,13,1,5
5,17,14,1,5
5,18,0,1,5
5,18,1,1,5
5,18,2,1,5
5,18,3,1,5
5,18,4,1,5
5,18,5,1,5
5,18,6,1,5
5,18,7,1,5
5,18,8,1,5
5,18,9,1,5
5,18,10,1,5
5,18,11,1,5
5,18,12,1,5
5,18,13,1,5
5,18,14,1,5
5,19,0,1,5
5,19,1,1,5
5,19,2,1,5
5,19,3,1,5
5,19,4,1,5
5,19,5,1,5
5,19,6,1,5
5,19,7,1,5
5,19,8,1,5
5,19,9,1,5
5,19,10,1,5
5,19,11,1,5
5,19,12,1,5
5,19,13,1,5
5,19,14,1,5
5,20,0,1,5
5,20,1,1,5
5,20,2,1,5
5,20,3,1,5
5,20,4,1,5
5,20,5,1,5
5,20,6,1,5
5,20,7,1,5
5,20,8,1,5
5,20,9,1,5
5,20,10,1,5
5,20,11,1,5
5,20,12,1,5
5,20,13,1,5
5,20,14,1,5
5,21,0,1,5
5,21,1,1,5
5,21,2,1,5
5,21,3,1,5
5,21,4,1,5
5,21,5,1,5
5,21,6,1,5
5,21,7,1,5
5,21,8,1,5
5,21,9,1,5
5,21,10,1,5
5,21,11,1,5
5,21,12,1,5
5,21,13,1,5
5,21,14,1,5
5,22,0,1,5
5,22,1,1,5
5,22,2,1,5
5,22,3,1,5
5,22,4,1,5
5,22,5,1,5
5,22,6,1,5
5,22,7,1,5
5,22,8,1,5
5,22,9,1,5
5,22,10,1,5
5,22,11,1,5
5,22,12,1,5
5,22,13,1,5
5,22,14,1,5
5,0,0,2,5
5,0,1,2,5
5,0,2,2,5
5,0,3,2,5
5,0,4,2,5
5,0,5,2,5
5,0,6,2,5
5,0,7,2,5
5,0,8,2,5
5,0,9,2,5
5,0,10,2,5
5,0,11,2,5
5,0,12,2,5
5,0,13,2,5
5,0,14,2,5
5,1,0,2,5
5,1,1,2,5
5,1,2,2,5
5,1,3,2,5
5,1,4,2,5
5,1,5,2,5
5,1,6,2,5
5,1,7,2,5
5,1,8,2,5
5,1,9,2,5
5,1,10,2,5
5,1,11,2,5
5,1,12,2,5
5,1,13,2,5
5,1,14,2,5
5,2,0,2,5
5,2,1,2,5
5,2,2,2,5
5,2,3,2,5
5,2,4,2,5
5,2,5,2,5
5,2,6,2,5
5,2,7,2,5
5,2,8,2,5
5,2,9,2,5
5,2,10,2,5
5,2,11,2,5
5,2,12,2,5
5,2,13,2,5
5,2,14,2,5
5,3,0,2,5
5,3,1,2,5
5,3,2,2,5
5,3,3,2,5
5,3,4,2,5
5,3,5,2,5
5,3,6,2,5
5,3,7,2,5
5,3,8,2,5
5,3,9,2,5
5,3,10,2,5
5,3,11,2,5
5,3,12,2,5
5,3,13,2,5
5,3,14,2,5
5,4,0,2,5
5,4,1,2,5
5,4,2,2,5
5,4,3,2,5
5,4,4,2,5
5,4,5,2,5
5,4,6,2,5
5,4,7,2,5
5,4,8,2,5
5,4,9,2,5
5,4,10,2,5
5,4,11,2,5
5,4,12,2,5
5,4,13,2,5
5,4,14,2,5
5,5,0,2,5
5,5,1,2,5
5,5,2,2,5
5,5,3,2,5
5,5,4,2,5
5,5,5,2,5
5,5,6,2,5
5,5,7,2,5
5,5,8,2,5
5,5,9,2,5
5,5,10,2,5
5,5,11,2,5
5,5,12,2,5
5,5,13,2,5
5,5,14,2,5
5,6,0,2,5
5,6,1,2,5
5,6,2,2,5
5,6,3,2,5
5,6,4,2,5
5,6,5,2,5
5,6,6,2,5
5,6,7,2,5
5,6,8,2,5
5,6,9,2,5
5,6,10,2,5
5,6,11,2,5
5,6,12,2,5
5,6,13,2,5
5,6,14,2,5
5,7,0,2,5
5,7,1,2,5
5,7,2,2,5
5,7,3,2,5
5,7,4,2,5
5,7,5,2,5
5,7,6,2,5
5,7,7,2,5
5,7,8,2,5
5,7,9,2,5
5,7,10,2,5
5,7,11,2,5
5,7,12,2,5
5,7,13,2,5
5,7,14,2,5
5,8,0,2,5
5,8,1,2,5
5,8,2,2,5
5,8,3,2,5
5,8,4,2,5
5,8,5,2,5
5,8,6,2,5
5,8,7,2,5
5,8,8,2,5
5,8,9,2,5
5,8,10,2,5
5,8,11,2,5
5,8,12,2,5
5,8,13,2,5
5,8,14,2,5
5,9,0,2,5
5,9,1,2,5
5,9,2,2,5
5,9,3,2,5
5,9,4,2,5
5,9,5,2,5
5,9,6,2,5
5,9,7,2,5
5,9,8,2,5
5,9,9,2,5
5,9,10,2,5
5,9,11,2,5
5,9,12,2,5
5,9,13,2,5
5,9,14,2,5
5,10,0,2,5
5,10,1,2,5
5,10,2,2,5
5,10,3,2,5
5,10,4,2,5
5,10,5,2,5
5,10,6,2,5
5,10,7,2,5
5,10,8,2,5
5,10,9,2,5
5,10,10,2,5
5,10,11,2,5
5,10,12,2,5
5,10,13,2,5
5,10,14,2,5
5,11,0,2,5
5,11,1,2,5
5,11,2,2,5
5,11,3,2,5
5,11,4,2,5
5,11,5,2,5
5,11,6,2,5
5,11,7,2,5
5,11,8,2,5
5,11,9,2,5
5,11,10,2,5
5,11,11,2,5
5,11,12,2,5
5,11,13,2,5
5,11,14,2,5
5,12,0,2,5
5,12,1,2,5
5,12,2,2,5
5,12,3,2,5
5,12,4,2,5
5,12,5,2,5
5,12,6,2,5
5,12,7,2,5
5,12,8,2,5
5,12,9,2,5
5,12,10,2,5
5,12,11,2,5
5,12,12,2,5
5,12,13,2,5
5,12,14,2,5
5,13,0,2,5
5,13,1,2,5
5,13,2,2,5
5,13,3,2,5
5,13,4,2,5
5,13,5,2,5
5,13,6,2,5
5,13,7,2,5
5,13,8,2,5
5,13,9,2,5
5,13,10,2,5
5,13,11,2,5
5,13,12,2,5
5,13,13,2,5
5,13,14,2,5
5,14,0,2,5
5,14,1,2,5
5,14,2,2,5
5,14,3,2,5
5,14,4,2,5
5,14,5,2,5
5,14,6,2,5
5,14,7,2,5
5,14,8,2,5
5,14,9,2,5
5,14,10,2,5
5,14,11,2,5
5,14,12,2,5
5,14,13,2,5
5,14,14,2,5
5,15,0,2,5
5,15,1,2,5
5,15,2,2,5
5,15,3,2,5
5,15,4,2,5
5,15,5,2,5
5,15,6,2,5
5,15,7,2,5
5,15,8,2,5
5,15,9,2,5
5,15,10,2,5
5,15,11,2,5
5,15,12,2,5
5,15,13,2,5
5,15,14,2,5
5,16,0,2,5
5,16,1,2,5
5,16,2,2,5
5,16,3,2,5
5,16,4,2,5
5,16,5,2,5
5,16,6,2,5
5,16,7,2,5
5,16,8,2,5
5,16,9,2,5
5,16,10,2,5
5,16,11,2,5
5,16,12,2,5
5,16,13,2,5
5,16,14,2,5
5,17,0,2,5
5,17,1,2,5
5,17,2,2,5
5,17,3,2,5
5,17,4,2,5
5,17,5,2,5
5,17,6,2,5
5,17,7,2,5
5,17,8,2,5
5,17,9,2,5
5,17,10,2,5
5,17,11,2,5
5,17,12,2,5
5,17,13,2,5
5,17,14,2,5
5,18,0,2,5
5,18,1,2,5
5,18,2,2,5
5,18,3,2,5
5,18,4,2,5
5,18,5,2,5
5,18,6,2,5
5,18,7,2,5
5,18,8,2,5
5,18,9,2,5
5,18,10,2,5
5,18,11,2,5
5,18,12,2,5
5,18,13,2,5
5,18,14,2,5
5,19,0,2,5
5,19,1,2,5
5,19,2,2,5
5,19,3,2,5
5,19,4,2,5
5,19,5,2,5
5,19,6,2,5
5,19,7,2,5
5,19,8,2,5
5,19,9,2,5
5,19,10,2,5
5,19,11,2,5
5,19,12,2,5
5,19,13,2,5
5,19,14,2,5
5,20,0,2,5
5,20,1,2,5
5,20,2,2,5
5,20,3,2,5
5,20,4,2,5
5,20,5,2,5
5,20,6,2,5
5,20,7,2,5
5,20,8,2,5
5,20,9,2,5
5,20,10,2,5
5,20,11,2,5
5,20,12,2,5
5,20,13,2,5
5,20,14,2,5
5,0,0,3,5
5,0,1,3,5
5,0,2,3,5
5,0,3,3,5
5,0,4,3,5
5,0,5,3,5
5,0,6,3,5
5,0,7,3,5
5,0,8,3,5
5,0,9,3,5
5,0,10,3,5
5,0,11,3,5
5,0,12,3,5
5,0,13,3,5
5,0,14,3,5
5,1,0,3,5
5,1,1,3,5
5,1,2,3,5
5,1,3,3,5
5,1,4,3,5
5,1,5,3,5
5,1,6,3,5
5,1,7,3,5
5,1,8,3,5
5,1,9,3,5
5,1,10,3,5
5,1,11,3,5
5,1,12,3,5
5,1,13,3,5
5,1,14,3,5
5,2,0,3,5
5,2,1,3,5
5,2,2,3,5
5,2,3,3,5
5,2,4,3,5
5,2,5,3,5
5,2,6,3,5
5,2,7,3,5
5,2,8,3,5
5,2,9,3,5
5,2,10,3,5
5,2,11,3,5
5,2,12,3,5
5,2,13,3,5
5,2,14,3,5
5,3,0,3,5
5,3,1,3,5
5,3,2,3,5
5,3,3,3,5
5,3,4,3,5
5,3,5,3,5
5,3,6,3,5
5,3,7,3,5
5,3,8,3,5
5,3,9,3,5
5,3,10,3,5
5,3,11,3,5
5,3,12,3,5
5,3,13,3,5
5,3,14,3,5
5,4,0,3,5
5,4,1,3,5
5,4,2,3,5
5,4,3,3,5
5,4,4,3,5
5,4,5,3,5
5,4,6,3,5
5,4,7,3,5
5,4,8,3,5
5,4,9,3,5
5,4,10,3,5
5,4,11,3,5
5,4,12,3,5
5,4,13,3,5
5,4,14,3,5
5,5,0,3,5
5,5,1,3,5
5,5,2,3,5
5,5,3,3,5
5,5,4,3,5
5,5,5,3,5
5,5,6,3,5
5,5,7,3,5
5,5,8,3,5
5,5,9,3,5
5,5,10,3,5
5,5,11,3,5
5,5,12,3,5
5,5,13,3,5
5,5,14,3,5
5,6,0,3,5
5,6,1,3,5
5,6,2,3,5
5,6,3,3,5
5,6,4,3,5
5,6,5,3,5
5,6,6,3,5
5,6,7,3,5
5,6,8,3,5
5,6,9,3,5
5,6,10,3,5
5,6,11,3,5
5,6,12,3,5
5,6,13,3,5
5,6,14,3,5
5,7,0,3,5
5,7,1,3,5
5,7,2,3,5
5,7,3,3,5
5,7,4,3,5
5,7,5,3,5
5,7,6,3,5
5,7,7,3,5
5,7,8,3,5
5,7,9,3,5
5,7,10,3,5
5,7,11,3,5
5,7,12,3,5
5,7,13,3,5
5,7,14,3,5
5,8,0,3,5
5,8,1,3,5
5,8,2,3,5
5,8,3,3,5
5,8,4,3,5
5,8,5,3,5
5,8,6,3,5
5,8,7,3,5
5,8,8,3,5
5,8,9,3,5
5,8,10,3,5
5,8,11,3,5
5,8,12,3,5
5,8,13,3,5
5,8,14,3,5
5,9,0,3,5
5,9,1,3,5
5,9,2,3,5
5,9,3,3,5
5,9,4,3,5
5,9,5,3,5
5,9,6,3,5
5,9,7,3,5
5,9,8,3,5
5,9,9,3,5
5,9,10,3,5
5,9,11,3,5
5,9,12,3,5
5,9,13,3,5
5,9,14,3,5
5,10,0,3,5
5,10,1,3,5
5,10,2,3,5
5,10,3,3,5
5,10,4,3,5
5,10,5,3,5
5,10,6,3,5
5,10,7,3,5
5,10,8,3,5
5,10,9,3,5
5,10,10,3,5
5,10,11,3,5
5,10,12,3,5
5,10,13,3,5
5,10,14,3,5
5,11,0,3,5
5,11,1,3,5
5,11,2,3,5
5,11,3,3,5
5,11,4,3,5
5,11,5,3,5
5,11,6,3,5
5,11,7,3,5
5,11,8,3,5
5,11,9,3,5
5,11,10,3,5
5,11,11,3,5
5,11,12,3,5
5,11,13,3,5
5,11,14,3,5
5,12,0,3,5
5,12,1,3,5
5,12,2,3,5
5,12,3,3,5
5,12,4,3,5
5,12,5,3,5
5,12,6,3,5
5,12,7,3,5
5,12,8,3,5
5,12,9,3,5
5,12,10,3,5
5,12,11,3,5
5,12,12,3,5
5,12,13,3,5
5,12,14,3,5
5,13,0,3,5
5,13,1,3,5
5,13,2,3,5
5,13,3,3,5
5,13,4,3,5
5,13,5,3,5
5,13,6,3,5
5,13,7,3,5
5,13,8,3,5
5,13,9,3,5
5,13,10,3,5
5,13,11,3,5
5,13,12,3,5
5,13,13,3,5
5,13,14,3,5
5,14,0,3,5
5,14,1,3,5
5,14,2,3,5
5,14,3,3,5
5,14,4,3,5
5,14,5,3,5
5,14,6,3,5
5,14,7,3,5
5,14,8,3,5
5,14,9,3,5
5,14,10,3,5
5,14,11,3,5
5,14,12,3,5
5,14,13,3,5
5,14,14,3,5
5,15,0,3,5
5,15,1,3,5
5,15,2,3,5
5,15,3,3,5
5,15,4,3,5
5,15,5,3,5
5,15,6,3,5
5,15,7,3,5
5,15,8,3,5
5,15,9,3,5
5,15,10,3,5
5,15,11,3,5
5,15,12,3,5
5,15,13,3,5
5,15,14,3,5
5,16,0,3,5
5,16,1,3,5
5,16,2,3,5
5,16,3,3,5
5,16,4,3,5
5,16,5,3,5
5,16,6,3,5
5,16,7,3,5
5,16,8,3,5
5,16,9,3,5
5,16,10,3,5
5,16,11,3,5
5,16,12,3,5
5,16,13,3,5
5,16,14,3,5
5,17,0,3,5
5,17,1,3,5
5,17,2,3,5
5,17,3,3,5
5,17,4,3,5
5,17,5,3,5
5,17,6,3,5
5,17,7,3,5
5,17,8,3,5
5,17,9,3,5
5,17,10,3,5
5,17,11,3,5
5,17,12,3,5
5,17,13,3,5
5,17,14,3,5
5,18,0,3,5
5,18,1,3,5
5,18,2,3,5
5,18,3,3,5
5,18,4,3,5
5,18,5,3,5
5,18,6,3,5
5,18,7,3,5
5,18,8,3,5
5,18,9,3,5
5,18,10,3,5
5,18,11,3,5
5,18,12,3,5
5,18,13,3,5
5,18,14,3,5
5,0,0,4,5
5,0,1,4,5
5,0,2,4,5
5,0,3,4,5
5,0,4,4,5
5,0,5,4,5
5,0,6,4,5
5,0,7,4,5
5,0,8,4,5
5,0,9,4,5
5,0,10,4,5
5,0,11,4,5
5,0,12,4,5
5,0,13,4,5
5,0,14,4,5
5,1,0,4,5
5,1,1,4,5
5,1,2,4,5
5,1,3,4,5
5,1,4,4,5
5,1,5,4,5
5,1,6,4,5
5,1,7,4,5
5,1,8,4,5
5,1,9,4,5
5,1,10,4,5
5,1,11,4,5
5,1,12,4,5
5,1,13,4,5
5,1,14,4,5
5,2,0,4,5
5,2,1,4,5
5,2,2,4,5
5,2,3,4,5
5,2,4,4,5
5,2,5,4,5
5,2,6,4,5
5,2,7,4,5
5,2,8,4,5
5,2,9,4,5
5,2,10,4,5
5,2,11,4,5
5,2,12,4,5
5,2,13,4,5
5,2,14,4,5
5,3,0,4,5
5,3,1,4,5
5,3,2,4,5
5,3,3,4,5
5,3,4,4,5
5,3,5,4,5
5,3,6,4,5
5,3,7,4,5
5,3,8,4,5
5,3,9,4,5
5,3,10,4,5
5,3,11,4,5
5,3,12,4,5
5,3,13,4,5
5,3,14,4,5
5,4,0,4,5
5,4,1,4,5
5,4,2,4,5
5,4,3,4,5
5,4,4,4,5
5,4,5,4,5
5,4,6,4,5
5,4,7,4,5
5,4,8,4,5
5,4,9,4,5
5,4,10,4,5
5,4,11,4,5
5,4,12,4,5
5,4,13,4,5
5,4,14,4,5
5,5,0,4,5
5,5,1,4,5
5,5,2,4,5
5,5,3,4,5
5,5,4,4,5
5,5,5,4,5
5,5,6,4,5
5,5,7,4,5
5,5,8,4,5
5,5,9,4,5
5,5,10,4,5
5,5,11,4,5
5,5,12,4,5
5,5,13,4,5
5,5,14,4,5
5,6,0,4,5
5,6,1,4,5
5,6,2,4,5
5,6,3,4,5
5,6,4,4,5
5,6,5,4,5
5,6,6,4,5
5,6,7,4,5
5,6,8,4,5
5,6,9,4,5
5,6,10,4,5
5,6,11,4,5
5,6,12,4,5
5,6,13,4,5
5,6,14,4,5
5,7,0,4,5
5,7,1,4,5
5,7,2,4,5
5,7,3,4,5
5,7,4,4,5
5,7,5,4,5
5,7,6,4,5
5,7,7,4,5
5,7,8,4,5
5,7,9,4,5
5,7,10,4,5
5,7,11,4,5
5,7,12,4,5
5,7,13,4,5
5,7,14,4,5
5,8,0,4,5
5,8,1,4,5
5,8,2,4,5
5,8,3,4,5
5,8,4,4,5
5,8,5,4,5
5,8,6,4,5
5,8,7,4,5
5,8,8,4,5
5,8,9,4,5
5,8,10,4,5
5,8,11,4,5
5,8,12,4,5
5,8,13,4,5
5,8,14,4,5
5,9,0,4,5
5,9,1,4,5
5,9,2,4,5
5,9,3,4,5
5,9,4,4,5
5,9,5,4,5
5,9,6,4,5
5,9,7,4,5
5,9,8,4,5
5,9,9,4,5
5,9,10,4,5
5,9,11,4,5
5,9,12,4,5
5,9,13,4,5
5,9,14,4,5
5,10,0,4,5
5,10,1,4,5
5,10,2,4,5
5,10,3,4,5
5,10,4,4,5
5,10,5,4,5
5,10,6,4,5
5,10,7,4,5
5,10,8,4,5
5,10,9,4,5
5,10,10,4,5
5,10,11,4,5
5,10,12,4,5
5,10,13,4,5
5,10,14,4,5
5,11,0,4,5
5,11,1,4,5
5,11,2,4,5
5,11,3,4,5
5,11,4,4,5
5,11,5,4,5
5,11,6,4,5
5,11,7,4,5
5,11,8,4,5
5,11,9,4,5
5,11,10,4,5
5,11,11,4,5
5,11,12,4,5
5,11,13,4,5
5,11,14,4,5
5,12,0,4,5
5,12,1,4,5
5,12,2,4,5
5,12,3,4,5
5,12,4,4,5
5,12,5,4,5
5,12,6,4,5
5,12,7,4,5
5,12,8,4,5
5,12,9,4,5
5,12,10,4,5
5,12,11,4,5
5,12,12,4,5
5,12,13,4,5
5,12,14,4,5
5,13,0,4,5
5,13,1,4,5
5,13,2,4,5
5,13,3,4,5
5,13,4,4,5
5,13,5,4,5
5,13,6,4,5
5,13,7,4,5
5,13,8,4,5
5,13,9,4,5
5,13,10,4,5
5,13,11,4,5
5,13,12,4,5
5,13,13,4,5
5,13,14,4,5
5,14,0,4,5
5,14,1,4,5
5,14,2,4,5
5,14,3,4,5
5,14,4,4,5
5,14,5,4,5
5,14,6,4,5
5,14,7,4,5
5,14,8,4,5
5,14,9,4,5
5,14,10,4,5
5,14,11,4,5
5,14,12,4,5
5,14,13,4,5
5,14,14,4,5
5,15,0,4,5
5,15,1,4,5
5,15,2,4,5
5,15,3,4,5
5,15,4,4,5
5,15,5,4,5
5,15,6,4,5
5,15,7,4,5
5,15,8,4,5
5,15,9,4,5
5,15,10,4,5
5,15,11,4,5
5,15,12,4,5
5,15,13,4,5
5,15,14,4,5
5,16,0,4,5
5,16,1,4,5
5,16,2,4,5
5,16,3,4,5
5,16,4,4,5
5,16,5,4,5
5,16,6,4,5
5,16,7,4,5
5,16,8,4,5
5,16,9,4,5
5,16,10,4,5
5,16,11,4,5
5,16,12,4,5
5,16,13,4,5
5,16,14,4,5
5,0,0,5,5
5,0,1,5,5
5,0,2,5,5
5,0,3,5,5
5,0,4,5,5
5,0,5,5,5
5,0,6,5,5
5,0,7,5,5
5,0,8,5,5
5,0,9,5,5
5,0,10,5,5
5,0,11,5,5
5,0,12,5,5
5,0,13,5,5
5,0,14,5,5
5,1,0,5,5
5,1,1,5,5
5,1,2,5,5
5,1,3,5,5
5,1,4,5,5
5,1,5,5,5
5,1,6,5,5
5,1,7,5,5
5,1,8,5,5
5,1,9,5,5
5,1,10,5,5
5,1,11,5,5
5,1,12,5,5
5,1,13,5,5
5,1,14,5,5
5,2,0,5,5
5,2,1,5,5
5,2,2,5,5
5,2,3,5,5
5,2,4,5,5
5,2,5,5,5
5,2,6,5,5
5,2,7,5,5
5,2,8,5,5
5,2,9,5,5
5,2,10,5,5
5,2,11,5,5
5,2,12,5,5
5,2,13,5,5
5,2,14,5,5
5,3,0,5,5
5,3,1,5,5
5,3,2,5,5
5,3,3,5,5
5,3,4,5,5
5,3,5,5,5
5,3,6,5,5
5,3,7,5,5
5,3,8,5,5
5,3,9,5,5
5,3,10,5,5
5,3,11,5,5
5,3,12,5,5
5,3,13,5,5
5,3,14,5,5
5,4,0,5,5
5,4,1,5,5
5,4,2,5,5
5,4,3,5,5
5,4,4,5,5
5,4,5,5,5
5,4,6,5,5
5,4,7,5,5
5,4,8,5,5
5,4,9,5,5
5,4,10,5,5
5,4,11,5,5
5,4,12,5,5
5,4,13,5,5
5,4,14,5,5
5,5,0,5,5
5,5,1,5,5
5,5,2,5,5
5,5,3,5,5
5,5,4,5,5
5,5,5,5,5
5,5,6,5,5
5,5,7,5,5
5,5,8,5,5
5,5,9,5,5
5,5,10,5,5
5,5,11,5,5
5,5,12,5,5
5,5,13,5,5
5,5,14,5,5
5,6,0,5,5
5,6,1,5,5
5,6,2,5,5
5,6,3,5,5
5,6,4,5,5
5,6,5,5,5
5,6,6,5,5
5,6,7,5,5
5,6,8,5,5
5,6,9,5,5
5,6,10,5,5
5,6,11,5,5
5,6,12,5,5
5,6,13,5,5
5,6,14,5,5
5,7,0,5,5
5,7,1,5,5
5,7,2,5,5
5,7,3,5,5
5,7,4,5,5
5,7,5,5,5
5,7,6,5,5
5,7,7,5,5
5,7,8,5,5
5,7,9,5,5
5,7,10,5,5
5,7,11,5,5
5,7,12,5,5
5,7,13,5,5
5,7,14,5,5
5,8,0,5,5
5,8,1,5,5
5,8,2,5,5
5,8,3,5,5
5,8,4,5,5
5,8,5,5,5
5,8,6,5,5
5,8,7,5,5
5,8,8,5,5
5,8,9,5,5
5,8,10,5,5
5,8,11,5,5
5,8,12,5,5
5,8,13,5,5
5,8,14,5,5
5,9,0,5,5
5,9,1,5,5
5,9,2,5,5
5,9,3,5,5
5,9,4,5,5
5,9,5,5,5
5,9,6,5,5
5,9,7,5,5
5,9,8,5,5
5,9,9,5,5
5,9,10,5,5
5,9,11,5,5
5,9,12,5,5
5,9,13,5,5
5,9,14,5,5
5,10,0,5,5
5,10,1,5,5
5,10,2,5,5
5,10,3,5,5
5,10,4,5,5
5,10,5,5,5
5,10,6,5,5
5,10,7,5,5
5,10,8,5,5
5,10,9,5,5
5,10,10,5,5
5,10,11,5,5
5,10,12,5,5
5,10,13,5,5
5,10,14,5,5
5,11,0,5,5
5,11,1,5,5
5,11,2,5,5
5,11,3,5,5
5,11,4,5,5
5,11,5,5,5
5,11,6,5,5
5,11,7,5,5
5,11,8,5,5
5,11,9,5,5
5,11,10,5,5
5,11,11,5,5
5,11,12,5,5
5,11,13,5,5
5,11,14,5,5
5,12,0,5,5
5,12,1,5,5
5,12,2,5,5
5,12,3,5,5
5,12,4,5,5
5,12,5,5,5
5,12,6,5,5
5,12,7,5,5
5,12,8,5,5
5,12,9,5,5
5,12,10,5,5
5,12,11,5,5
5,12,12,5,5
5,12,13,5,5
5,12,14,5,5
5,13,0,5,5
5,13,1,5,5
5,13,2,5,5
5,13,3,5,5
5,13,4,5,5
5,13,5,5,5
5,13,6,5,5
5,13,7,5,5
5,13,8,5,5
5,13,9,5,5
5,13,10,5,5
5,13,11,5,5
5,13,12,5,5
5,13,13,5,5
5,13,14,5,5
5,14,0,5,5
5,14,1,5,5
5,14,2,5,5
5,14,3,5,5
5,14,4,5,5
5,14,5,5,5
5,14,6,5,5
5,14,7,5,5
5,14,8,5,5
5,14,9,5,5
5,14,10,5,5
5,14,11,5,5
5,14,12,5,5
5,14,13,5,5
5,14,14,5,5
5,0,0,6,5
5,0,1,6,5
5,0,2,6,5
5,0,3,6,5
5,0,4,6,5
5,0,5,6,5
5,0,6,6,5
5,0,7,6,5
5,0,8,6,5
5,0,9,6,5
5,0,10,6,5
5,0,11,6,5
5,0,12,6,5
5,0,13,6,5
5,0,14,6,5
5,1,0,6,5
5,1,1,6,5
5,1,2,6,5
5,1,3,6,5
5,1,4,6,5
5,1,5,6,5
5,1,6,6,5
5,1,7,6,5
5,1,8,6,5
5,1,9,6,5
5,1,10,6,5
5,1,11,6,5
5,1,12,6,5
5,1,13,6,5
5,1,14,6,5
5,2,0,6,5
5,2,1,6,5
5,2,2,6,5
5,2,3,6,5
5,2,4,6,5
5,2,5,6,5
5,2,6,6,5
5,2,7,6,5
5,2,8,6,5
5,2,9,6,5
5,2,10,6,5
5,2,11,6,5
5,2,12,6,5
5,2,13,6,5
5,2,14,6,5
5,3,0,6,5
5,3,1,6,5
5,3,2,6,5
5,3,3,6,5
5,3,4,6,5
5,3,5,6,5
5,3,6,6,5
5,3,7,6,5
5,3,8,6,5
5,3,9,6,5
5,3,10,6,5
5,3,11,6,5
5,3,12,6,5
5,3,13,6,5
5,3,14,6,5
5,4,0,6,5
5,4,1,6,5
5,4,2,6,5
5,4,3,6,5
5,4,4,6,5
5,4,5,6,5
5,4,6,6,5
5,4,7,6,5
5,4,8,6,5
5,4,9,6,5
5,4,10,6,5
5,4,11,6,5
5,4,12,6,5
5,4,13,6,5
5,4,14,6,5
5,5,0,6,5
5,5,1,6,5
5,5,2,6,5
5,5,3,6,5
5,5,4,6,5
5,5,5,6,5
5,5,6,6,5
5,5,7,6,5
5,5,8,6,5
5,5,9,6,5
5,5,10,6,5
5,5,11,6,5
5,5,12,6,5
5,5,13,6,5
5,5,14,6,5
5,6,0,6,5
5,6,1,6,5
5,6,2,6,5
5,6,3,6,5
5,6,4,6,5
5,6,5,6,5
5,6,6,6,5
5,6,7,6,5
5,6,8,6,5
5,6,9,6,5
5,6,10,6,5
5,6,11,6,5
5,6,12,6,5
5,6,13,6,5
5,6,14,6,5
5,7,0,6,5
5,7,1,6,5
5,7,2,6,5
5,7,3,6,5
5,7,4,6,5
5,7,5,6,5
5,7,6,6,5
5,7,7,6,5
5,7,8,6,5
5,7,9,6,5
5,7,10,6,5
5,7,11,6,5
5,7,12,6,5
5,7,13,6,5
5,7,14,6,5
5,8,0,6,5
5,8,1,6,5
5,8,2,6,5
5,8,3,6,5
5,8,4,6,5
5,8,5,6,5
5,8,6,6,5
5,8,7,6,5
5,8,8,6,5
5,8,9,6,5
5,8,10,6,5
5,8,11,6,5
5,8,12,6,5
5,8,13,6,5
5,8,14,6,5
5,9,0,6,5
5,9,1,6,5
5,9,2,6,5
5,9,3,6,5
5,9,4,6,5
5,9,5,6,5
5,9,6,6,5
5,9,7,6,5
5,9,8,6,5
5,9,9,6,5
5,9,10,6,5
5,9,11,6,5
5,9,12,6,5
5,9,13,6,5
5,9,14,6,5
5,10,0,6,5
5,10,1,6,5
5,10,2,6,5
5,10,3,6,5
5,10,4,6,5
5,10,5,6,5
5,10,6,6,5
5,10,7,6,5
5,10,8,6,5
5,10,9,6,5
5,10,10,6,5
5,10,11,6,5
5,10,12,6,5
5,10,13,6,5
5,10,14,6,5
5,11,0,6,5
5,11,1,6,5
5,11,2,6,5
5,11,3,6,5
5,11,4,6,5
5,11,5,6,5
5,11,6,6,5
5,11,7,6,5
5,11,8,6,5
5,11,9,6,5
5,11,10,6,5
5,11,11,6,5
5,11,12,6,5
5,11,13,6,5
5,11,14,6,5
5,12,0,6,5
5,12,1,6,5
5,12,2,6,5
5,12,3,6,5
5,12,4,6,5
5,12,5,6,5
5,12,6,6,5
5,12,7,6,5
5,12,8,6,5
5,12,9,6,5
5,12,10,6,5
5,12,11,6,5
5,12,12,6,5
5,12,13,6,5
5,12,14,6,5
5,0,0,7,5
5,0,1,7,5
5,0,2,7,5
5,0,3,7,5
5,0,4,7,5
5,0,5,7,5
5,0,6,7,5
5,0,7,7,5
5,0,8,7,5
5,0,9,7,5
5,0,10,7,5
5,0,11,7,5
5,0,12,7,5
5,0,13,7,5
5,0,14,7,5
5,1,0,7,5
5,1,1,7,5
5,1,2,7,5
5,1,3,7,5
5,1,4,7,5
5,1,5,7,5
5,1,6,7,5
5,1,7,7,5
5,1,8,7,5
5,1,9,7,5
5,1,10,7,5
5,1,11,7,5
5,1,12,7,5
5,1,13,7,5
5,1,14,7,5
5,2,0,7,5
5,2,1,7,5
5,2,2,7,5
5,2,3,7,5
5,2,4,7,5
5,2,5,7,5
5,2,6,7,5
5,2,7,7,5
5,2,8,7,5
5,2,9,7,5
5,2,10,7,5
5,2,11,7,5
5,2,12,7,5
5,2,13,7,5
5,2,14,7,5
5,3,0,7,5
5,3,1,7,5
5,3,2,7,5
5,3,3,7,5
5,3,4,7,5
5,3,5,7,5
5,3,6,7,5
5,3,7,7,5
5,3,8,7,5
5,3,9,7,5
5,3,10,7,5
5,3,11,7,5
5,3,12,7,5
5,3,13,7,5
5,3,14,7,5
5,4,0,7,5
5,4,1,7,5
5,4,2,7,5
5,4,3,7,5
5,4,4,7,5
5,4,5,7,5
5,4,6,7,5
5,4,7,7,5
5,4,8,7,5
5,4,9,7,5
5,4,10,7,5
5,4,11,7,5
5,4,12,7,5
5,4,13,7,5
5,4,14,7,5
5,5,0,7,5
5,5,1,7,5
5,5,2,7,5
5,5,3,7,5
5,5,4,7,5
5,5,5,7,5
5,5,6,7,5
5,5,7,7,5
5,5,8,7,5
5,5,9,7,5
5,5,10,7,5
5,5,11,7,5
5,5,12,7,5
5,5,13,7,5
5,5,14,7,5
5,6,0,7,5
5,6,1,7,5
5,6,2,7,5
5,6,3,7,5
5,6,4,7,5
5,6,5,7,5
5,6,6,7,5
5,6,7,7,5
5,6,8,7,5
5,6,9,7,5
5,6,10,7,5
5,6,11,7,5
5,6,12,7,5
5,6,13,7,5
5,6,14,7,5
5,7,0,7,5
5,7,1,7,5
5,7,2,7,5
5,7,3,7,5
5,7,4,7,5
5,7,5,7,5
5,7,6,7,5
5,7,7,7,5
5,7,8,7,5
5,7,9,7,5
5,7,10,7,5
5,7,11,7,5
5,7,12,7,5
5,7,13,7,5
5,7,14,7,5
5,8,0,7,5
5,8,1,7,5
5,8,2,7,5
5,8,3,7,5
5,8,4,7,5
5,8,5,7,5
5,8,6,7,5
5,8,7,7,5
5,8,8,7,5
5,8,9,7,5
5,8,10,7,5
5,8,11,7,5
5,8,12,7,5
5,8,13,7,5
5,8,14,7,5
5,9,0,7,5
5,9,1,7,5
5,9,2,7,5
5,9,3,7,5
5,9,4,7,5
5,9,5,7,5
5,9,6,7,5
5,9,7,7,5
5,9,8,7,5
5,9,9,7,5
5,9,10,7,5
5,9,11,7,5
5,9,12,7,5
5,9,13,7,5
5,9,14,7,5
5,10,0,7,5
5,10,1,7,5
5,10,2,7,5
5,10,3,7,5
5,10,4,7,5
5,10,5,7,5
5,10,6,7,5
5,10,7,7,5
5,10,8,7,5
5,10,9,7,5
5,10,10,7,5
5,10,11,7,5
5,10,12,7,5
5,10,13,7,5
5,10,14,7,5
5,0,0,8,5
5,0,1,8,5
5,0,2,8,5
5,0,3,8,5
5,0,4,8,5
5,0,5,8,5
5,0,6,8,5
5,0,7,8,5
5,0,8,8,5
5,0,9,8,5
5,0,10,8,5
5,0,11,8,5
5,0,12,8,5
5,0,13,8,5
5,0,14,8,5
5,1,0,8,5
5,1,1,8,5
5,1,2,8,5
5,1,3,8,5
5,1,4,8,5
5,1,5,8,5
5,1,6,8,5
5,1,7,8,5
5,1,8,8,5
5,1,9,8,5
5,1,10,8,5
5,1,11,8,5
5,1,12,8,5
5,1,13,8,5
5,1,14,8,5
5,2,0,8,5
5,2,1,8,5
5,2,2,8,5
5,2,3,8,5
5,2,4,8,5
5,2,5,8,5
5,2,6,8,5
5,2,7,8,5
5,2,8,8,5
5,2,9,8,5
5,2,10,8,5
5,2,11,8,5
5,2,12,8,5
5,2,13,8,5
5,2,14,8,5
5,3,0,8,5
5,3,1,8,5
5,3,2,8,5
5,3,3,8,5
5,3,4,8,5
5,3,5,8,5
5,3,6,8,5
5,3,7,8,5
5,3,8,8,5
5,3,9,8,5
5,3,10,8,5
5,3,11,8,5
5,3,12,8,5
5,3,13,8,5
5,3,14,8,5
5,4,0,8,5
5,4,1,8,5
5,4,2,8,5
5,4,3,8,5
5,4,4,8,5
5,4,5,8,5
5,4,6,8,5
5,4,7,8,5
5,4,8,8,5
5,4,9,8,5
5,4,10,8,5
5,4,11,8,5
5,4,12,8,5
5,4,13,8,5
5,4,14,8,5
5,5,0,8,5
5,5,1,8,5
5,5,2,8,5
5,5,3,8,5
5,5,4,8,5
5,5,5,8,5
5,5,6,8,5
5,5,7,8,5
5,5,8,8,5
5,5,9,8,5
5,5,10,8,5
5,5,11,8,5
5,5,12,8,5
5,5,13,8,5
5,5,14,8,5
5,6,0,8,5
5,6,1,8,5
5,6,2,8,5
5,6,3,8,5
5,6,4,8,5
5,6,5,8,5
5,6,6,8,5
5,6,7,8,5
5,6,8,8,5
5,6,9,8,5
5,6,10,8,5
5,6,11,8,5
5,6,12,8,5
5,6,13,8,5
5,6,14,8,5
5,7,0,8,5
5,7,1,8,5
5,7,2,8,5
5,7,3,8,5
5,7,4,8,5
5,7,5,8,5
5,7,6,8,5
5,7,7,8,5
5,7,8,8,5
5,7,9,8,5
5,7,10,8,5
5,7,11,8,5
5,7,12,8,5
5,7,13,8,5
5,7,14,8,5
5,8,0,8,5
5,8,1,8,5
5,8,2,8,5
5,8,3,8,5
5,8,4,8,5
5,8,5,8,5
5,8,6,8,5
5,8,7,8,5
5,8,8,8,5
5,8,9,8,5
5,8,10,8,5
5,8,11,8,5
5,8,12,8,5
5,8,13,8,5
5,8,14,8,5
5,0,0,9,5
5,0,1,9,5
5,0,2,9,5
5,0,3,9,5
5,0,4,9,5
5,0,5,9,5
5,0,6,9,5
5,0,7,9,5
5,0,8,9,5
5,0,9,9,5
5,0,10,9,5
5,0,11,9,5
5,0,12,9,5
5,0,13,9,5
5,0,14,9,5
5,1,0,9,5
5,1,1,9,5
5,1,2,9,5
5,1,3,9,5
5,1,4,9,5
5,1,5,9,5
5,1,6,9,5
5,1,7,9,5
5,1,8,9,5
5,1,9,9,5
5,1,10,9,5
5,1,11,9,5
5,1,12,9,5
5,1,13,9,5
5,1,14,9,5
5,2,0,9,5
5,2,1,9,5
5,2,2,9,5
5,2,3,9,5
5,2,4,9,5
5,2,5,9,5
5,2,6,9,5
5,2,7,9,5
5,2,8,9,5
5,2,9,9,5
5,2,10,9,5
5,2,11,9,5
5,2,12,9,5
5,2,13,9,5
5,2,14,9,5
5,3,0,9,5
5,3,1,9,5
5,3,2,9,5
5,3,3,9,5
5,3,4,9,5
5,3,5,9,5
5,3,6,9,5
5,3,7,9,5
5,3,8,9,5
5,3,9,9,5
5,3,10,9,5
5,3,11,9,5
5,3,12,9,5
5,3,13,9,5
5,3,14,9,5
5,4,0,9,5
5,4,1,9,5
5,4,2,9,5
5,4,3,9,5
5,4,4,9,5
5,4,5,9,5
5,4,6,9,5
5,4,7,9,5
5,4,8,9,5
5,4,9,9,5
5,4,10,9,5
5,4,11,9,5
5,4,12,9,5
5,4,13,9,5
5,4,14,9,5
5,5,0,9,5
5,5,1,9,5
5,5,2,9,5
5,5,3,9,5
5,5,4,9,5
5,5,5,9,5
5,5,6,9,5
5,5,7,9,5
5,5,8,9,5
5,5,9,9,5
5,5,10,9,5
5,5,11,9,5
5,5,12,9,5
5,5,13,9,5
5,5,14,9,5
5,6,0,9,5
5,6,1,9,5
5,6,2,9,5
5,6,3,9,5
5,6,4,9,5
5,6,5,9,5
5,6,6,9,5
5,6,7,9,5
5,6,8,9,5
5,6,9,9,5
5,6,10,9,5
5,6,11,9,5
5,6,12,9,5
5,6,13,9,5
5,6,14,9,5
5,0,0,10,5
5,0,1,10,5
5,0,2,10,5
5,0,3,10,5
5,0,4,10,5
5,0,5,10,5
5,0,6,10,5
5,0,7,10,5
5,0,8,10,5
5,0,9,10,5
5,0,10,10,5
5,0,11,10,5
5,0,12,10,5
5,0,13,10,5
5,0,14,10,5
5,1,0,10,5
5,1,1,10,5
5,1,2,10,5
5,1,3,10,5
5,1,4,10,5
5,1,5,10,5
5,1,6,10,5
5,1,7,10,5
5,1,8,10,5
5,1,9,10,5
5,1,10,10,5
5,1,11,10,5
5,1,12,10,5
5,1,13,10,5
5,1,14,10,5
5,2,0,10,5
5,2,1,10,5
5,2,2,10,5
5,2,3,10,5
5,2,4,10,5
5,2,5,10,5
5,2,6,10,5
5,2,7,10,5
5,2,8,10,5
5,2,9,10,5
5,2,10,10,5
5,2,11,10,5
5,2,12,10,5
5,2,13,10,5
5,2,14,10,5
5,3,0,10,5
5,3,1,10,5
5,3,2,10,5
5,3,3,10,5
5,3,4,10,5
5,3,5,10,5
5,3,6,10,5
5,3,7,10,5
5,3,8,10,5
5,3,9,10,5
5,3,10,10,5
5,3,11,10,5
5,3,12,10,5
5,3,13,10,5
5,3,14,10,5
5,4,0,10,5
5,4,1,10,5
5,4,2,10,5
5,4,3,10,5
5,4,4,10,5
5,4,5,10,5
5,4,6,10,5
5,4,7,10,5
5,4,8,10,5
5,4,9,10,5
5,4,10,10,5
5,4,11,10,5
5,4,12,10,5
5,4,13,10,5
5,4,14,10,5
5,0,0,11,5
5,0,1,11,5
5,0,2,11,5
5,0,3,11,5
5,0,4,11,5
5,0,5,11,5
5,0,6,11,5
5,0,7,11,5
5,0,8,11,5
5,0,9,11,5
5,0,10,11,5
5,0,11,11,5
5,0,12,11,5
5,0,13,11,5
5,0,14,11,5
5,1,0,11,5
5,1,1,11,5
5,1,2,11,5
5,1,3,11,5
5,1,4,11,5
5,1,5,11,5
5,1,6,11,5
5,1,7,11,5
5,1,8,11,5
5,1,9,11,5
5,1,10,11,5
5,1,11,11,5
5,1,12,11,5
5,1,13,11,5
5,1,14,11,5
5,2,0,11,5
5,2,1,11,5
5,2,2,11,5
5,2,3,11,5
5,2,4,11,5
5,2,5,11,5
5,2,6,11,5
5,2,7,11,5
5,2,8,11,5
5,2,9,11,5
5,2,10,11,5
5,2,11,11,5
5,2,12,11,5
5,2,13,11,5
5,2,14,11,5
5,0,0,12,5
5,0,1,12,5
5,0,2,12,5
5,0,3,12,5
5,0,4,12,5
5,0,5,12,5
5,0,6,12,5
5,0,7,12,5
5,0,8,12,5
5,0,9,12,5
5,0,10,12,5
5,0,11,12,5
5,0,12,12,5
5,0,13,12,5
5,0,14,12,5
5,0,0,1,6
5,0,1,1,6
5,0,2,1,6
5,0,3,1,6
5,0,4,1,6
5,0,5,1,6
5,0,6,1,6
5,0,7,1,6
5,0,8,1,6
5,0,9,1,6
5,0,10,1,6
5,0,11,1,6
5,0,12,1,6
5,1,0,1,6
5,1,1,1,6
5,1,2,1,6
5,1,3,1,6
5,1,4,1,6
5,1,5,1,6
5,1,6,1,6
5,1,7,1,6
5,1,8,1,6
5,1,9,1,6
5,1,10,1,6
5,1,11,1,6
5,1,12,1,6
5,2,0,1,6
5,2,1,1,6
5,2,2,1,6
5,2,3,1,6
5,2,4,1,6
5,2,5,1,6
5,2,6,1,6
5,2,7,1,6
5,2,8,1,6
5,2,9,1,6
5,2,10,1,6
5,2,11,1,6
5,2,12,1,6
5,3,0,1,6
5,3,1,1,6
5,3,2,1,6
5,3,3,1,6
5,3,4,1,6
5,3,5,1,6
5,3,6,1,6
5,3,7,1,6
5,3,8,1,6
5,3,9,1,6
5,3,10,1,6
5,3,11,1,6
5,3,12,1,6
5,4,0,1,6
5,4,1,1,6
5,4,2,1,6
5,4,3,1,6
5,4,4,1,6
5,4,5,1,6
5,4,6,1,6
5,4,7,1,6
5,4,8,1,6
5,4,9,1,6
5,4,10,1,6
5,4,11,1,6
5,4,12,1,6
5,5,0,1,6
5,5,1,1,6
5,5,2,1,6
5,5,3,1,6
5,5,4,1,6
5,5,5,1,6
5,5,6,1,6
5,5,7,1,6
5,5,8,1,6
5,5,9,1,6
5,5,10,1,6
5,5,11,1,6
5,5,12,1,6
5,6,0,1,6
5,6,1,1,6
5,6,2,1,6
5,6,3,1,6
5,6,4,1,6
5,6,5,1,6
5,6,6,1,6
5,6,7,1,6
5,6,8,1,6
5,6,9,1,6
5,6,10,1,6
5,6,11,1,6
5,6,12,1,6
5,7,0,1,6
5,7,1,1,6
5,7,2,1,6
5,7,3,1,6
5,7,4,1,6
5,7,5,1,6
5,7,6,1,6
5,7,7,1,6
5,7,8,1,6
5,7,9,1,6
5,7,10,1,6
5,7,11,1,6
5,7,12,1,6
5,8,0,1,6
5,8,1,1,6
5,8,2,1,6
5,8,3,1,6
5,8,4,1,6
5,8,5,1,6
5,8,6,1,6
5,8,7,1,6
5,8,8,1,6
5,8,9,1,6
5,8,10,1,6
5,8,11,1,6
5,8,12,1,6
5,9,0,1,6
5,9,1,1,6
5,9,2,1,6
5,9,3,1,6
5,9,4,1,6
5,9,5,1,6
5,9,6,1,6
5,9,7,1,6
5,9,8,1,6
5,9,9,1,6
5,9,10,1,6
5,9,11,1,6
5,9,12,1,6
5,10,0,1,6
5,10,1,1,6
5,10,2,1,6
5,10,3,1,6
5,10,4,1,6
5,10,5,1,6
5,10,6,1,6
5,10,7,1,6
5,10,8,1,6
5,10,9,1,6
5,10,10,1,6
5,10,11,1,6
5,10,12,1,6
5,11,0,1,6
5,11,1,1,6
5,11,2,1,6
5,11,3,1,6
5,11,4,1,6
5,11,5,1,6
5,11,6,1,6
5,11,7,1,6
5,11,8,1,6
5,11,9,1,6
5,11,10,1,6
5,11,11,1,6
5,11,12,1,6
5,12,0,1,6
5,12,1,1,6
5,12,2,1,6
5,12,3,1,6
5,12,4,1,6
5,12,5,1,6
5,12,6,1,6
5,12,7,1,6
5,12,8,1,6
5,12,9,1,6
5,12,10,1,6
5,12,11,1,6
5,12,12,1,6
5,13,0,1,6
5,13,1,1,6
5,13,2,1,6
5,13,3,1,6
5,13,4,1,6
5,13,5,1,6
5,13,6,1,6
5,13,7,1,6
5,13,8,1,6
5,13,9,1,6
5,13,10,1,6
5,13,11,1,6
5,13,12,1,6
5,14,0,1,6
5,14,1,1,6
5,14,2,1,6
5,14,3,1,6
5,14,4,1,6
5,14,5,1,6
5,14,6,1,6
5,14,7,1,6
5,14,8,1,6
5,14,9,1,6
5,14,10,1,6
5,14,11,1,6
5,14,12,1,6
5,15,0,1,6
5,15,1,1,6
5,15,2,1,6
5,15,3,1,6
5,15,4,1,6
5,15,5,1,6
5,15,6,1,6
5,15,7,1,6
5,15,8,1,6
5,15,9,1,6
5,15,10,1,6
5,15,11,1,6
5,15,12,1,6
5,16,0,1,6
5,16,1,1,6
5,16,2,1,6
5,16,3,1,6
5,16,4,1,6
5,16,5,1,6
5,16,6,1,6
5,16,7,1,6
5,16,8,1,6
5,16,9,1,6
5,16,10,1,6
5,16,11,1,6
5,16,12,1,6
5,17,0,1,6
5,17,1,1,6
5,17,2,1,6
5,17,3,1,6
5,17,4,1,6
5,17,5,1,6
5,17,6,1,6
5,17,7,1,6
5,17,8,1,6
5,17,9,1,6
5,17,10,1,6
5,17,11,1,6
5,17,12,1,6
5,18,0,1,6
5,18,1,1,6
5,18,2,1,6
5,18,3,1,6
5,18,4,1,6
5,18,5,1,6
5,18,6,1,6
5,18,7,1,6
5,18,8,1,6
5,18,9,1,6
5,18,10,1,6
5,18,11,1,6
5,18,12,1,6
5,19,0,1,6
5,19,1,1,6
5,19,2,1,6
5,19,3,1,6
5,19,4,1,6
5,19,5,1,6
5,19,6,1,6
5,19,7,1,6
5,19,8,1,6
5,19,9,1,6
5,19,10,1,6
5,19,11,1,6
5,19,12,1,6
5,20,0,1,6
5,20,1,1,6
5,20,2,1,6
5,20,3,1,6
5,20,4,1,6
5,20,5,1,6
5,20,6,1,6
5,20,7,1,6
5,20,8,1,6
5,20,9,1,6
5,20,10,1,6
5,20,11,1,6
5,20,12,1,6
5,21,0,1,6
5,21,1,1,6
5,21,2,1,6
5,21,3,1,6
5,21,4,1,6
5,21,5,1,6
5,21,6,1,6
5,21,7,1,6
5,21,8,1,6
5,21,9,1,6
5,21,10,1,6
5,21,11,1,6
5,21,12,1,6
5,22,0,1,6
5,22,1,1,6
5,22,2,1,6
5,22,3,1,6
5,22,4,1,6
5,22,5,1,6
5,22,6,1,6
5,22,7,1,6
5,22,8,1,6
5,22,9,1,6
5,22,10,1,6
5,22,11,1,6
5,22,12,1,6
5,0,0,2,6
5,0,1,2,6
5,0,2,2,6
5,0,3,2,6
5,0,4,2,6
5,0,5,2,6
5,0,6,2,6
5,0,7,2,6
5,0,8,2,6
5,0,9,2,6
5,0,10,2,6
5,0,11,2,6
5,0,12,2,6
5,1,0,2,6
5,1,1,2,6
5,1,2,2,6
5,1,3,2,6
5,1,4,2,6
5,1,5,2,6
5,1,6,2,6
5,1,7,2,6
5,1,8,2,6
5,1,9,2,6
5,1,10,2,6
5,1,11,2,6
5,1,12,2,6
5,2,0,2,6
5,2,1,2,6
5,2,2,2,6
5,2,3,2,6
5,2,4,2,6
5,2,5,2,6
5,2,6,2,6
5,2,7,2,6
5,2,8,2,6
5,2,9,2,6
5,2,10,2,6
5,2,11,2,6
5,2,12,2,6
5,3,0,2,6
5,3,1,2,6
5,3,2,2,6
5,3,3,2,6
5,3,4,2,6
5,3,5,2,6
5,3,6,2,6
5,3,7,2,6
5,3,8,2,6
5,3,9,2,6
5,3,10,2,6
5,3,11,2,6
5,3,12,2,6
5,4,0,2,6
5,4,1,2,6
5,4,2,2,6
5,4,3,2,6
5,4,4,2,6
5,4,5,2,6
5,4,6,2,6
5,4,7,2,6
5,4,8,2,6
5,4,9,2,6
5,4,10,2,6
5,4,11,2,6
5,4,12,2,6
5,5,0,2,6
5,5,1,2,6
5,5,2,2,6
5,5,3,2,6
5,5,4,2,6
5,5,5,2,6
5,5,6,2,6
5,5,7,2,6
5,5,8,2,6
5,5,9,2,6
5,5,10,2,6
5,5,11,2,6
5,5,12,2,6
5,6,0,2,6
5,6,1,2,6
5,6,2,2,6
5,6,3,2,6
5,6,4,2,6
5,6,5,2,6
5,6,6,2,6
5,6,7,2,6
5,6,8,2,6
5,6,9,2,6
5,6,10,2,6
5,6,11,2,6
5,6,12,2,6
5,7,0,2,6
5,7,1,2,6
5,7,2,2,6
5,7,3,2,6
5,7,4,2,6
5,7,5,2,6
5,7,6,2,6
5,7,7,2,6
5,7,8,2,6
5,7,9,2,6
5,7,10,2,6
5,7,11,2,6
5,7,12,2,6
5,8,0,2,6
5,8,1,2,6
5,8,2,2,6
5,8,3,2,6
5,8,4,2,6
5,8,5,2,6
5,8,6,2,6
5,8,7,2,6
5,8,8,2,6
5,8,9,2,6
5,8,10,2,6
5,8,11,2,6
5,8,12,2,6
5,9,0,2,6
5,9,1,2,6
5,9,2,2,6
5,9,3,2,6
5,9,4,2,6
5,9,5,2,6
5,9,6,2,6
5,9,7,2,6
5,9,8,2,6
5,9,9,2,6
5,9,10,2,6
5,9,11,2,6
5,9,12,2,6
5,10,0,2,6
5,10,1,2,6
5,10,2,2,6
5,10,3,2,6
5,10,4,2,6
5,10,5,2,6
5,10,6,2,6
5,10,7,2,6
5,10,8,2,6
5,10,9,2,6
5,10,10,2,6
5,10,11,2,6
5,10,12,2,6
5,11,0,2,6
5,11,1,2,6
5,11,2,2,6
5,11,3,2,6
5,11,4,2,6
5,11,5,2,6
5,11,6,2,6
5,11,7,2,6
5,11,8,2,6
5,11,9,2,6
5,11,10,2,6
5,11,11,2,6
5,11,12,2,6
5,12,0,2,6
5,12,1,2,6
5,12,2,2,6
5,12,3,2,6
5,12,4,2,6
5,12,5,2,6
5,12,6,2,6
5,12,7,2,6
5,12,8,2,6
5,12,9,2,6
5,12,10,2,6
5,12,11,2,6
5,12,12,2,6
5,13,0,2,6
5,13,1,2,6
5,13,2,2,6
5,13,3,2,6
5,13,4,2,6
5,13,5,2,6
5,13,6,2,6
5,13,7,2,6
5,13,8,2,6
5,13,9,2,6
5,13,10,2,6
5,13,11,2,6
5,13,12,2,6
5,14,0,2,6
5,14,1,2,6
5,14,2,2,6
5,14,3,2,6
5,14,4,2,6
5,14,5,2,6
5,14,6,2,6
5,14,7,2,6
5,14,8,2,6
5,14,9,2,6
5,14,10,2,6
5,14,11,2,6
5,14,12,2,6
5,15,0,2,6
5,15,1,2,6
5,15,2,2,6
5,15,3,2,6
5,15,4,2,6
5,15,5,2,6
5,15,6,2,6
5,15,7,2,6
5,15,8,2,6
5,15,9,2,6
5,15,10,2,6
5,15,11,2,6
5,15,12,2,6
5,16,0,2,6
5,16,1,2,6
5,16,2,2,6
5,16,3,2,6
5,16,4,2,6
5,16,5,2,6
5,16,6,2,6
5,16,7,2,6
5,16,8,2,6
5,16,9,2,6
5,16,10,2,6
5,16,11,2,6
5,16,12,2,6
5,17,0,2,6
5,17,1,2,6
5,17,2,2,6
5,17,3,2,6
5,17,4,2,6
5,17,5,2,6
5,17,6,2,6
5,17,7,2,6
5,17,8,2,6
5,17,9,2,6
5,17,10,2,6
5,17,11,2,6
5,17,12,2,6
5,18,0,2,6
5,18,1,2,6
5,18,2,2,6
5,18,3,2,6
5,18,4,2,6
5,18,5,2,6
5,18,6,2,6
5,18,7,2,6
5,18,8,2,6
5,18,9,2,6
5,18,10,2,6
5,18,11,2,6
5,18,12,2,6
5,19,0,2,6
5,19,1,2,6
5,19,2,2,6
5,19,3,2,6
5,19,4,2,6
5,19,5,2,6
5,19,6,2,6
5,19,7,2,6
5,19,8,2,6
5,19,9,2,6
5,19,10,2,6
5,19,11,2,6
5,19,12,2,6
5,20,0,2,6
5,20,1,2,6
5,20,2,2,6
5,20,3,2,6
5,20,4,2,6
5,20,5,2,6
5,20,6,2,6
5,20,7,2,6
5,20,8,2,6
5,20,9,2,6
5,20,10,2,6
5,20,11,2,6
5,20,12,2,6
5,0,0,3,6
5,0,1,3,6
5,0,2,3,6
5,0,3,3,6
5,0,4,3,6
5,0,5,3,6
5,0,6,3,6
5,0,7,3,6
5,0,8,3,6
5,0,9,3,6
5,0,10,3,6
5,0,11,3,6
5,0,12,3,6
5,1,0,3,6
5,1,1,3,6
5,1,2,3,6
5,1,3,3,6
5,1,4,3,6
5,1,5,3,6
5,1,6,3,6
5,1,7,3,6
5,1,8,3,6
5,1,9,3,6
5,1,10,3,6
5,1,11,3,6
5,1,12,3,6
5,2,0,3,6
5,2,1,3,6
5,2,2,3,6
5,2,3,3,6
5,2,4,3,6
5,2,5,3,6
5,2,6,3,6
5,2,7,3,6
5,2,8,3,6
5,2,9,3,6
5,2,10,3,6
5,2,11,3,6
5,2,12,3,6
5,3,0,3,6
5,3,1,3,6
5,3,2,3,6
5,3,3,3,6
5,3,4,3,6
5,3,5,3,6
5,3,6,3,6
5,3,7,3,6
5,3,8,3,6
5,3,9,3,6
5,3,10,3,6
5,3,11,3,6
5,3,12,3,6
5,4,0,3,6
5,4,1,3,6
5,4,2,3,6
5,4,3,3,6
5,4,4,3,6
5,4,5,3,6
5,4,6,3,6
5,4,7,3,6
5,4,8,3,6
5,4,9,3,6
5,4,10,3,6
5,4,11,3,6
5,4,12,3,6
5,5,0,3,6
5,5,1,3,6
5,5,2,3,6
5,5,3,3,6
5,5,4,3,6
5,5,5,3,6
5,5,6,3,6
5,5,7,3,6
5,5,8,3,6
5,5,9,3,6
5,5,10,3,6
5,5,11,3,6
5,5,12,3,6
5,6,0,3,6
5,6,1,3,6
5,6,2,3,6
5,6,3,3,6
5,6,4,3,6
5,6,5,3,6
5,6,6,3,6
5,6,7,3,6
5,6,8,3,6
5,6,9,3,6
5,6,10,3,6
5,6,11,3,6
5,6,12,3,6
5,7,0,3,6
5,7,1,3,6
5,7,2,3,6
5,7,3,3,6
5,7,4,3,6
5,7,5,3,6
5,7,6,3,6
5,7,7,3,6
5,7,8,3,6
5,7,9,3,6
5,7,10,3,6
5,7,11,3,6
5,7,12,3,6
5,8,0,3,6
5,8,1,3,6
5,8,2,3,6
5,8,3,3,6
5,8,4,3,6
5,8,5,3,6
5,8,6,3,6
5,8,7,3,6
5,8,8,3,6
5,8,9,3,6
5,8,10,3,6
5,8,11,3,6
5,8,12,3,6
5,9,0,3,6
5,9,1,3,6
5,9,2,3,6
5,9,3,3,6
5,9,4,3,6
5,9,5,3,6
5,9,6,3,6
5,9,7,3,6
5,9,8,3,6
5,9,9,3,6
5,9,10,3,6
5,9,11,3,6
5,9,12,3,6
5,10,0,3,6
5,10,1,3,6
5,10,2,3,6
5,10,3,3,6
5,10,4,3,6
5,10,5,3,6
5,10,6,3,6
5,10,7,3,6
5,10,8,3,6
5,10,9,3,6
5,10,10,3,6
5,10,11,3,6
5,10,12,3,6
5,11,0,3,6
5,11,1,3,6
5,11,2,3,6
5,11,3,3,6
5,11,4,3,6
5,11,5,3,6
5,11,6,3,6
5,11,7,3,6
5,11,8,3,6
5,11,9,3,6
5,11,10,3,6
5,11,11,3,6
5,11,12,3,6
5,12,0,3,6
5,12,1,3,6
5,12,2,3,6
5,12,3,3,6
5,12,4,3,6
5,12,5,3,6
5,12,6,3,6
5,12,7,3,6
5,12,8,3,6
5,12,9,3,6
5,12,10,3,6
5,12,11,3,6
5,12,12,3,6
5,13,0,3,6
5,13,1,3,6
5,13,2,3,6
5,13,3,3,6
5,13,4,3,6
5,13,5,3,6
5,13,6,3,6
5,13,7,3,6
5,13,8,3,6
5,13,9,3,6
5,13,10,3,6
5,13,11,3,6
5,13,12,3,6
5,14,0,3,6
5,14,1,3,6
5,14,2,3,6
5,14,3,3,6
5,14,4,3,6
5,14,5,3,6
5,14,6,3,6
5,14,7,3,6
5,14,8,3,6
5,14,9,3,6
5,14,10,3,6
5,14,11,3,6
5,14,12,3,6
5,15,0,3,6
5,15,1,3,6
5,15,2,3,6
5,15,3,3,6
5,15,4,3,6
5,15,5,3,6
5,15,6,3,6
5,15,7,3,6
5,15,8,3,6
5,15,9,3,6
5,15,10,3,6
5,15,11,3,6
5,15,12,3,6
5,16,0,3,6
5,16,1,3,6
5,16,2,3,6
5,16,3,3,6
5,16,4,3,6
5,16,5,3,6
5,16,6,3,6
5,16,7,3,6
5,16,8,3,6
5,16,9,3,6
5,16,10,3,6
5,16,11,3,6
5,16,12,3,6
5,17,0,3,6
5,17,1,3,6
5,17,2,3,6
5,17,3,3,6
5,17,4,3,6
5,17,5,3,6
5,17,6,3,6
5,17,7,3,6
5,17,8,3,6
5,17,9,3,6
5,17,10,3,6
5,17,11,3,6
5,17,12,3,6
5,18,0,3,6
5,18,1,3,6
5,18,2,3,6
5,18,3,3,6
5,18,4,3,6
5,18,5,3,6
5,18,6,3,6
5,18,7,3,6
5,18,8,3,6
5,18,9,3,6
5,18,10,3,6
5,18,11,3,6
5,18,12,3,6
5,0,0,4,6
5,0,1,4,6
5,0,2,4,6
5,0,3,4,6
5,0,4,4,6
5,0,5,4,6
5,0,6,4,6
5,0,7,4,6
5,0,8,4,6
5,0,9,4,6
5,0,10,4,6
5,0,11,4,6
5,0,12,4,6
5,1,0,4,6
5,1,1,4,6
5,1,2,4,6
5,1,3,4,6
5,1,4,4,6
5,1,5,4,6
5,1,6,4,6
5,1,7,4,6
5,1,8,4,6
5,1,9,4,6
5,1,10,4,6
5,1,11,4,6
5,1,12,4,6
5,2,0,4,6
5,2,1,4,6
5,2,2,4,6
5,2,3,4,6
5,2,4,4,6
5,2,5,4,6
5,2,6,4,6
5,2,7,4,6
5,2,8,4,6
5,2,9,4,6
5,2,10,4,6
5,2,11,4,6
5,2,12,4,6
5,3,0,4,6
5,3,1,4,6
5,3,2,4,6
5,3,3,4,6
5,3,4,4,6
5,3,5,4,6
5,3,6,4,6
5,3,7,4,6
5,3,8,4,6
5,3,9,4,6
5,3,10,4,6
5,3,11,4,6
5,3,12,4,6
5,4,0,4,6
5,4,1,4,6
5,4,2,4,6
5,4,3,4,6
5,4,4,4,6
5,4,5,4,6
5,4,6,4,6
5,4,7,4,6
5,4,8,4,6
5,4,9,4,6
5,4,10,4,6
5,4,11,4,6
5,4,12,4,6
5,5,0,4,6
5,5,1,4,6
5,5,2,4,6
5,5,3,4,6
5,5,4,4,6
5,5,5,4,6
5,5,6,4,6
5,5,7,4,6
5,5,8,4,6
5,5,9,4,6
5,5,10,4,6
5,5,11,4,6
5,5,12,4,6
5,6,0,4,6
5,6,1,4,6
5,6,2,4,6
5,6,3,4,6
5,6,4,4,6
5,6,5,4,6
5,6,6,4,6
5,6,7,4,6
5,6,8,4,6
5,6,9,4,6
5,6,10,4,6
5,6,11,4,6
5,6,12,4,6
5,7,0,4,6
5,7,1,4,6
5,7,2,4,6
5,7,3,4,6
5,7,4,4,6
5,7,5,4,6
5,7,6,4,6
5,7,7,4,6
5,7,8,4,6
5,7,9,4,6
5,7,10,4,6
5,7,11,4,6
5,7,12,4,6
5,8,0,4,6
5,8,1,4,6
5,8,2,4,6
5,8,3,4,6
5,8,4,4,6
5,8,5,4,6
5,8,6,4,6
5,8,7,4,6
5,8,8,4,6
5,8,9,4,6
5,8,10,4,6
5,8,11,4,6
5,8,12,4,6
5,9,0,4,6
5,9,1,4,6
5,9,2,4,6
5,9,3,4,6
5,9,4,4,6
5,9,5,4,6
5,9,6,4,6
5,9,7,4,6
5,9,8,4,6
5,9,9,4,6
5,9,10,4,6
5,9,11,4,6
5,9,12,4,6
5,10,0,4,6
5,10,1,4,6
5,10,2,4,6
5,10,3,4,6
5,10,4,4,6
5,10,5,4,6
5,10,6,4,6
5,10,7,4,6
5,10,8,4,6
5,10,9,4,6
5,10,10,4,6
5,10,11,4,6
5,10,12,4,6
5,11,0,4,6
5,11,1,4,6
5,11,2,4,6
5,11,3,4,6
5,11,4,4,6
5,11,5,4,6
5,11,6,4,6
5,11,7,4,6
5,11,8,4,6
5,11,9,4,6
5,11,10,4,6
5,11,11,4,6
5,11,12,4,6
5,12,0,4,6
5,12,1,4,6
5,12,2,4,6
5,12,3,4,6
5,12,4,4,6
5,12,5,4,6
5,12,6,4,6
5,12,7,4,6
5,12,8,4,6
5,12,9,4,6
5,12,10,4,6
5,12,11,4,6
5,12,12,4,6
5,13,0,4,6
5,13,1,4,6
5,13,2,4,6
5,13,3,4,6
5,13,4,4,6
5,13,5,4,6
5,13,6,4,6
5,13,7,4,6
5,13,8,4,6
5,13,9,4,6
5,13,10,4,6
5,13,11,4,6
5,13,12,4,6
5,14,0,4,6
5,14,1,4,6
5,14,2,4,6
5,14,3,4,6
5,14,4,4,6
5,14,5,4,6
5,14,6,4,6
5,14,7,4,6
5,14,8,4,6
5,14,9,4,6
5,14,10,4,6
5,14,11,4,6
5,14,12,4,6
5,15,0,4,6
5,15,1,4,6
5,15,2,4,6
5,15,3,4,6
5,15,4,4,6
5,15,5,4,6
5,15,6,4,6
5,15,7,4,6
5,15,8,4,6
5,15,9,4,6
5,15,10,4,6
5,15,11,4,6
5,15,12,4,6
5,16,0,4,6
5,16,1,4,6
5,16,2,4,6
5,16,3,4,6
5,16,4,4,6
5,16,5,4,6
5,16,6,4,6
5,16,7,4,6
5,16,8,4,6
5,16,9,4,6
5,16,10,4,6
5,16,11,4,6
5,16,12,4,6
5,0,0,5,6
5,0,1,5,6
5,0,2,5,6
5,0,3,5,6
5,0,4,5,6
5,0,5,5,6
5,0,6,5,6
5,0,7,5,6
5,0,8,5,6
5,0,9,5,6
5,0,10,5,6
5,0,11,5,6
5,0,12,5,6
5,1,0,5,6
5,1,1,5,6
5,1,2,5,6
5,1,3,5,6
5,1,4,5,6
5,1,5,5,6
5,1,6,5,6
5,1,7,5,6
5,1,8,5,6
5,1,9,5,6
5,1,10,5,6
5,1,11,5,6
5,1,12,5,6
5,2,0,5,6
5,2,1,5,6
5,2,2,5,6
5,2,3,5,6
5,2,4,5,6
5,2,5,5,6
5,2,6,5,6
5,2,7,5,6
5,2,8,5,6
5,2,9,5,6
5,2,10,5,6
5,2,11,5,6
5,2,12,5,6
5,3,0,5,6
5,3,1,5,6
5,3,2,5,6
5,3,3,5,6
5,3,4,5,6
5,3,5,5,6
5,3,6,5,6
5,3,7,5,6
5,3,8,5,6
5,3,9,5,6
5,3,10,5,6
5,3,11,5,6
5,3,12,5,6
5,4,0,5,6
5,4,1,5,6
5,4,2,5,6
5,4,3,5,6
5,4,4,5,6
5,4,5,5,6
5,4,6,5,6
5,4,7,5,6
5,4,8,5,6
5,4,9,5,6
5,4,10,5,6
5,4,11,5,6
5,4,12,5,6
5,5,0,5,6
5,5,1,5,6
5,5,2,5,6
5,5,3,5,6
5,5,4,5,6
5,5,5,5,6
5,5,6,5,6
5,5,7,5,6
5,5,8,5,6
5,5,9,5,6
5,5,10,5,6
5,5,11,5,6
5,5,12,5,6
5,6,0,5,6
5,6,1,5,6
5,6,2,5,6
5,6,3,5,6
5,6,4,5,6
5,6,5,5,6
5,6,6,5,6
5,6,7,5,6
5,6,8,5,6
5,6,9,5,6
5,6,10,5,6
5,6,11,5,6
5,6,12,5,6
5,7,0,5,6
5,7,1,5,6
5,7,2,5,6
5,7,3,5,6
5,7,4,5,6
5,7,5,5,6
5,7,6,5,6
5,7,7,5,6
5,7,8,5,6
5,7,9,5,6
5,7,10,5,6
5,7,11,5,6
5,7,12,5,6
5,8,0,5,6
5,8,1,5,6
5,8,2,5,6
5,8,3,5,6
5,8,4,5,6
5,8,5,5,6
5,8,6,5,6
5,8,7,5,6
5,8,8,5,6
5,8,9,5,6
5,8,10,5,6
5,8,11,5,6
5,8,12,5,6
5,9,0,5,6
5,9,1,5,6
5,9,2,5,6
5,9,3,5,6
5,9,4,5,6
5,9,5,5,6
5,9,6,5,6
5,9,7,5,6
5,9,8,5,6
5,9,9,5,6
5,9,10,5,6
5,9,11,5,6
5,9,12,5,6
5,10,0,5,6
5,10,1,5,6
5,10,2,5,6
5,10,3,5,6
5,10,4,5,6
5,10,5,5,6
5,10,6,5,6
5,10,7,5,6
5,10,8,5,6
5,10,9,5,6
5,10,10,5,6
5,10,11,5,6
5,10,12,5,6
5,11,0,5,6
5,11,1,5,6
5,11,2,5,6
5,11,3,5,6
5,11,4,5,6
5,11,5,5,6
5,11,6,5,6
5,11,7,5,6
5,11,8,5,6
5,11,9,5,6
5,11,10,5,6
5,11,11,5,6
5,11,12,5,6
5,12,0,5,6
5,12,1,5,6
5,12,2,5,6
5,12,3,5,6
5,12,4,5,6
5,12,5,5,6
5,12,6,5,6
5,12,7,5,6
5,12,8,5,6
5,12,9,5,6
5,12,10,5,6
5,12,11,5,6
5,12,12,5,6
5,13,0,5,6
5,13,1,5,6
5,13,2,5,6
5,13,3,5,6
5,13,4,5,6
5,13,5,5,6
5,13,6,5,6
5,13,7,5,6
5,13,8,5,6
5,13,9,5,6
5,13,10,5,6
5,13,11,5,6
5,13,12,5,6
5,14,0,5,6
5,14,1,5,6
5,14,2,5,6
5,14,3,5,6
5,14,4,5,6
5,14,5,5,6
5,14,6,5,6
5,14,7,5,6
5,14,8,5,6
5,14,9,5,6
5,14,10,5,6
5,14,11,5,6
5,14,12,5,6
5,0,0,6,6
5,0,1,6,6
5,0,2,6,6
5,0,3,6,6
5,0,4,6,6
5,0,5,6,6
5,0,6,6,6
5,0,7,6,6
5,0,8,6,6
5,0,9,6,6
5,0,10,6,6
5,0,11,6,6
5,0,12,6,6
5,1,0,6,6
5,1,1,6,6
5,1,2,6,6
5,1,3,6,6
5,1,4,6,6
5,1,5,6,6
5,1,6,6,6
5,1,7,6,6
5,1,8,6,6
5,1,9,6,6
5,1,10,6,6
5,1,11,6,6
5,1,12,6,6
5,2,0,6,6
5,2,1,6,6
5,2,2,6,6
5,2,3,6,6
5,2,4,6,6
5,2,5,6,6
5,2,6,6,6
5,2,7,6,6
5,2,8,6,6
5,2,9,6,6
5,2,10,6,6
5,2,11,6,6
5,2,12,6,6
5,3,0,6,6
5,3,1,6,6
5,3,2,6,6
5,3,3,6,6
5,3,4,6,6
5,3,5,6,6
5,3,6,6,6
5,3,7,6,6
5,3,8,6,6
5,3,9,6,6
5,3,10,6,6
5,3,11,6,6
5,3,12,6,6
5,4,0,6,6
5,4,1,6,6
5,4,2,6,6
5,4,3,6,6
5,4,4,6,6
5,4,5,6,6
5,4,6,6,6
5,4,7,6,6
5,4,8,6,6
5,4,9,6,6
5,4,10,6,6
5,4,11,6,6
5,4,12,6,6
5,5,0,6,6
5,5,1,6,6
5,5,2,6,6
5,5,3,6,6
5,5,4,6,6
5,5,5,6,6
5,5,6,6,6
5,5,7,6,6
5,5,8,6,6
5,5,9,6,6
5,5,10,6,6
5,5,11,6,6
5,5,12,6,6
5,6,0,6,6
5,6,1,6,6
5,6,2,6,6
5,6,3,6,6
5,6,4,6,6
5,6,5,6,6
5,6,6,6,6
5,6,7,6,6
5,6,8,6,6
5,6,9,6,6
5,6,10,6,6
5,6,11,6,6
5,6,12,6,6
5,7,0,6,6
5,7,1,6,6
5,7,2,6,6
5,7,3,6,6
5,7,4,6,6
5,7,5,6,6
5,7,6,6,6
5,7,7,6,6
5,7,8,6,6
5,7,9,6,6
5,7,10,6,6
5,7,11,6,6
5,7,12,6,6
5,8,0,6,6
5,8,1,6,6
5,8,2,6,6
5,8,3,6,6
5,8,4,6,6
5,8,5,6,6
5,8,6,6,6
5,8,7,6,6
5,8,8,6,6
5,8,9,6,6
5,8,10,6,6
5,8,11,6,6
5,8,12,6,6
5,9,0,6,6
5,9,1,6,6
5,9,2,6,6
5,9,3,6,6
5,9,4,6,6
5,9,5,6,6
5,9,6,6,6
5,9,7,6,6
5,9,8,6,6
5,9,9,6,6
5,9,10,6,6
5,9,11,6,6
5,9,12,6,6
5,10,0,6,6
5,10,1,6,6
5,10,2,6,6
5,10,3,6,6
5,10,4,6,6
5,10,5,6,6
5,10,6,6,6
5,10,7,6,6
5,10,8,6,6
5,10,9,6,6
5,10,10,6,6
5,10,11,6,6
5,10,12,6,6
5,11,0,6,6
5,11,1,6,6
5,11,2,6,6
5,11,3,6,6
5,11,4,6,6
5,11,5,6,6
5,11,6,6,6
5,11,7,6,6
5,11,8,6,6
5,11,9,6,6
5,11,10,6,6
5,11,11,6,6
5,11,12,6,6
5,12,0,6,6
5,12,1,6,6
5,12,2,6,6
5,12,3,6,6
5,12,4,6,6
5,12,5,6,6
5,12,6,6,6
5,12,7,6,6
5,12,8,6,6
5,12,9,6,6
5,12,10,6,6
5,12,11,6,6
5,12,12,6,6
5,0,0,7,6
5,0,1,7,6
5,0,2,7,6
5,0,3,7,6
5,0,4,7,6
5,0,5,7,6
5,0,6,7,6
5,0,7,7,6
5,0,8,7,6
5,0,9,7,6
5,0,10,7,6
5,0,11,7,6
5,0,12,7,6
5,1,0,7,6
5,1,1,7,6
5,1,2,7,6
5,1,3,7,6
5,1,4,7,6
5,1,5,7,6
5,1,6,7,6
5,1,7,7,6
5,1,8,7,6
5,1,9,7,6
5,1,10,7,6
5,1,11,7,6
5,1,12,7,6
5,2,0,7,6
5,2,1,7,6
5,2,2,7,6
5,2,3,7,6
5,2,4,7,6
5,2,5,7,6
5,2,6,7,6
5,2,7,7,6
5,2,8,7,6
5,2,9,7,6
5,2,10,7,6
5,2,11,7,6
5,2,12,7,6
5,3,0,7,6
5,3,1,7,6
5,3,2,7,6
5,3,3,7,6
5,3,4,7,6
5,3,5,7,6
5,3,6,7,6
5,3,7,7,6
5,3,8,7,6
5,3,9,7,6
5,3,10,7,6
5,3,11,7,6
5,3,12,7,6
5,4,0,7,6
5,4,1,7,6
5,4,2,7,6
5,4,3,7,6
5,4,4,7,6
5,4,5,7,6
5,4,6,7,6
5,4,7,7,6
5,4,8,7,6
5,4,9,7,6
5,4,10,7,6
5,4,11,7,6
5,4,12,7,6
5,5,0,7,6
5,5,1,7,6
5,5,2,7,6
5,5,3,7,6
5,5,4,7,6
5,5,5,7,6
5,5,6,7,6
5,5,7,7,6
5,5,8,7,6
5,5,9,7,6
5,5,10,7,6
5,5,11,7,6
5,5,12,7,6
5,6,0,7,6
5,6,1,7,6
5,6,2,7,6
5,6,3,7,6
5,6,4,7,6
5,6,5,7,6
5,6,6,7,6
5,6,7,7,6
5,6,8,7,6
5,6,9,7,6
5,6,10,7,6
5,6,11,7,6
5,6,12,7,6
5,7,0,7,6
5,7,1,7,6
5,7,2,7,6
5,7,3,7,6
5,7,4,7,6
5,7,5,7,6
5,7,6,7,6
5,7,7,7,6
5,7,8,7,6
5,7,9,7,6
5,7,10,7,6
5,7,11,7,6
5,7,12,7,6
5,8,0,7,6
5,8,1,7,6
5,8,2,7,6
5,8,3,7,6
5,8,4,7,6
5,8,5,7,6
5,8,6,7,6
5,8,7,7,6
5,8,8,7,6
5,8,9,7,6
5,8,10,7,6
5,8,11,7,6
5,8,12,7,6
5,9,0,7,6
5,9,1,7,6
5,9,2,7,6
5,9,3,7,6
5,9,4,7,6
5,9,5,7,6
5,9,6,7,6
5,9,7,7,6
5,9,8,7,6
5,9,9,7,6
5,9,10,7,6
5,9,11,7,6
5,9,12,7,6
5,10,0,7,6
5,10,1,7,6
5,10,2,7,6
5,10,3,7,6
5,10,4,7,6
5,10,5,7,6
5,10,6,7,6
5,10,7,7,6
5,10,8,7,6
5,10,9,7,6
5,10,10,7,6
5,10,11,7,6
5,10,12,7,6
5,0,0,8,6
5,0,1,8,6
5,0,2,8,6
5,0,3,8,6
5,0,4,8,6
5,0,5,8,6
5,0,6,8,6
5,0,7,8,6
5,0,8,8,6
5,0,9,8,6
5,0,10,8,6
5,0,11,8,6
5,0,12,8,6
5,1,0,8,6
5,1,1,8,6
5,1,2,8,6
5,1,3,8,6
5,1,4,8,6
5,1,5,8,6
5,1,6,8,6
5,1,7,8,6
5,1,8,8,6
5,1,9,8,6
5,1,10,8,6
5,1,11,8,6
5,1,12,8,6
5,2,0,8,6
5,2,1,8,6
5,2,2,8,6
5,2,3,8,6
5,2,4,8,6
5,2,5,8,6
5,2,6,8,6
5,2,7,8,6
5,2,8,8,6
5,2,9,8,6
5,2,10,8,6
5,2,11,8,6
5,2,12,8,6
5,3,0,8,6
5,3,1,8,6
5,3,2,8,6
5,3,3,8,6
5,3,4,8,6
5,3,5,8,6
5,3,6,8,6
5,3,7,8,6
5,3,8,8,6
5,3,9,8,6
5,3,10,8,6
5,3,11,8,6
5,3,12,8,6
5,4,0,8,6
5,4,1,8,6
5,4,2,8,6
5,4,3,8,6
5,4,4,8,6
5,4,5,8,6
5,4,6,8,6
5,4,7,8,6
5,4,8,8,6
5,4,9,8,6
5,4,10,8,6
5,4,11,8,6
5,4,12,8,6
5,5,0,8,6
5,5,1,8,6
5,5,2,8,6
5,5,3,8,6
5,5,4,8,6
5,5,5,8,6
5,5,6,8,6
5,5,7,8,6
5,5,8,8,6
5,5,9,8,6
5,5,10,8,6
5,5,11,8,6
5,5,12,8,6
5,6,0,8,6
5,6,1,8,6
5,6,2,8,6
5,6,3,8,6
5,6,4,8,6
5,6,5,8,6
5,6,6,8,6
5,6,7,8,6
5,6,8,8,6
5,6,9,8,6
5,6,10,8,6
5,6,11,8,6
5,6,12,8,6
5,7,0,8,6
5,7,1,8,6
5,7,2,8,6
5,7,3,8,6
5,7,4,8,6
5,7,5,8,6
5,7,6,8,6
5,7,7,8,6
5,7,8,8,6
5,7,9,8,6
5,7,10,8,6
5,7,11,8,6
5,7,12,8,6
5,8,0,8,6
5,8,1,8,6
5,8,2,8,6
5,8,3,8,6
5,8,4,8,6
5,8,5,8,6
5,8,6,8,6
5,8,7,8,6
5,8,8,8,6
5,8,9,8,6
5,8,10,8,6
5,8,11,8,6
5,8,12,8,6
5,0,0,9,6
5,0,1,9,6
5,0,2,9,6
5,0,3,9,6
5,0,4,9,6
5,0,5,9,6
5,0,6,9,6
5,0,7,9,6
5,0,8,9,6
5,0,9,9,6
5,0,10,9,6
5,0,11,9,6
5,0,12,9,6
5,1,0,9,6
5,1,1,9,6
5,1,2,9,6
5,1,3,9,6
5,1,4,9,6
5,1,5,9,6
5,1,6,9,6
5,1,7,9,6
5,1,8,9,6
5,1,9,9,6
5,1,10,9,6
5,1,11,9,6
5,1,12,9,6
5,2,0,9,6
5,2,1,9,6
5,2,2,9,6
5,2,3,9,6
5,2,4,9,6
5,2,5,9,6
5,2,6,9,6
5,2,7,9,6
5,2,8,9,6
5,2,9,9,6
5,2,10,9,6
5,2,11,9,6
5,2,12,9,6
5,3,0,9,6
5,3,1,9,6
5,3,2,9,6
5,3,3,9,6
5,3,4,9,6
5,3,5,9,6
5,3,6,9,6
5,3,7,9,6
5,3,8,9,6
5,3,9,9,6
5,3,10,9,6
5,3,11,9,6
5,3,12,9,6
5,4,0,9,6
5,4,1,9,6
5,4,2,9,6
5,4,3,9,6
5,4,4,9,6
5,4,5,9,6
5,4,6,9,6
5,4,7,9,6
5,4,8,9,6
5,4,9,9,6
5,4,10,9,6
5,4,11,9,6
5,4,12,9,6
5,5,0,9,6
5,5,1,9,6
5,5,2,9,6
5,5,3,9,6
5,5,4,9,6
5,5,5,9,6
5,5,6,9,6
5,5,7,9,6
5,5,8,9,6
5,5,9,9,6
5,5,10,9,6
5,5,11,9,6
5,5,12,9,6
5,6,0,9,6
5,6,1,9,6
5,6,2,9,6
5,6,3,9,6
5,6,4,9,6
5,6,5,9,6
5,6,6,9,6
5,6,7,9,6
5,6,8,9,6
5,6,9,9,6
5,6,10,9,6
5,6,11,9,6
5,6,12,9,6
5,0,0,10,6
5,0,1,10,6
5,0,2,10,6
5,0,3,10,6
5,0,4,10,6
5,0,5,10,6
5,0,6,10,6
5,0,7,10,6
5,0,8,10,6
5,0,9,10,6
5,0,10,10,6
5,0,11,10,6
5,0,12,10,6
5,1,0,10,6
5,1,1,10,6
5,1,2,10,6
5,1,3,10,6
5,1,4,10,6
5,1,5,10,6
5,1,6,10,6
5,1,7,10,6
5,1,8,10,6
5,1,9,10,6
5,1,10,10,6
5,1,11,10,6
5,1,12,10,6
5,2,0,10,6
5,2,1,10,6
5,2,2,10,6
5,2,3,10,6
5,2,4,10,6
5,2,5,10,6
5,2,6,10,6
5,2,7,10,6
5,2,8,10,6
5,2,9,10,6
5,2,10,10,6
5,2,11,10,6
5,2,12,10,6
5,3,0,10,6
5,3,1,10,6
5,3,2,10,6
5,3,3,10,6
5,3,4,10,6
5,3,5,10,6
5,3,6,10,6
5,3,7,10,6
5,3,8,10,6
5,3,9,10,6
5,3,10,10,6
5,3,11,10,6
5,3,12,10,6
5,4,0,10,6
5,4,1,10,6
5,4,2,10,6
5,4,3,10,6
5,4,4,10,6
5,4,5,10,6
5,4,6,10,6
5,4,7,10,6
5,4,8,10,6
5,4,9,10,6
5,4,10,10,6
5,4,11,10,6
5,4,12,10,6
5,0,0,11,6
5,0,1,11,6
5,0,2,11,6
5,0,3,11,6
5,0,4,11,6
5,0,5,11,6
5,0,6,11,6
5,0,7,11,6
5,0,8,11,6
5,0,9,11,6
5,0,10,11,6
5,0,11,11,6
5,0,12,11,6
5,1,0,11,6
5,1,1,11,6
5,1,2,11,6
5,1,3,11,6
5,1,4,11,6
5,1,5,11,6
5,1,6,11,6
5,1,7,11,6
5,1,8,11,6
5,1,9,11,6
5,1,10,11,6
5,1,11,11,6
5,1,12,11,6
5,2,0,11,6
5,2,1,11,6
5,2,2,11,6
5,2,3,11,6
5,2,4,11,6
5,2,5,11,6
5,2,6,11,6
5,2,7,11,6
5,2,8,11,6
5,2,9,11,6
5,2,10,11,6
5,2,11,11,6
5,2,12,11,6
5,0,0,12,6
5,0,1,12,6
5,0,2,12,6
5,0,3,12,6
5,0,4,12,6
5,0,5,12,6
5,0,6,12,6
5,0,7,12,6
5,0,8,12,6
5,0,9,12,6
5,0,10,12,6
5,0,11,12,6
5,0,12,12,6
5,0,0,1,7
5,0,1,1,7
5,0,2,1,7
5,0,3,1,7
5,0,4,1,7
5,0,5,1,7
5,0,6,1,7
5,0,7,1,7
5,0,8,1,7
5,0,9,1,7
5,0,10,1,7
5,1,0,1,7
5,1,1,1,7
5,1,2,1,7
5,1,3,1,7
5,1,4,1,7
5,1,5,1,7
5,1,6,1,7
5,1,7,1,7
5,1,8,1,7
5,1,9,1,7
5,1,10,1,7
5,2,0,1,7
5,2,1,1,7
5,2,2,1,7
5,2,3,1,7
5,2,4,1,7
5,2,5,1,7
5,2,6,1,7
5,2,7,1,7
5,2,8,1,7
5,2,9,1,7
5,2,10,1,7
5,3,0,1,7
5,3,1,1,7
5,3,2,1,7
5,3,3,1,7
5,3,4,1,7
5,3,5,1,7
5,3,6,1,7
5,3,7,1,7
5,3,8,1,7
5,3,9,1,7
5,3,10,1,7
5,4,0,1,7
5,4,1,1,7
5,4,2,1,7
5,4,3,1,7
5,4,4,1,7
5,4,5,1,7
5,4,6,1,7
5,4,7,1,7
5,4,8,1,7
5,4,9,1,7
5,4,10,1,7
5,5,0,1,7
5,5,1,1,7
5,5,2,1,7
5,5,3,1,7
5,5,4,1,7
5,5,5,1,7
5,5,6,1,7
5,5,7,1,7
5,5,8,1,7
5,5,9,1,7
5,5,10,1,7
5,6,0,1,7
5,6,1,1,7
5,6,2,1,7
5,6,3,1,7
5,6,4,1,7
5,6,5,1,7
5,6,6,1,7
5,6,7,1,7
5,6,8,1,7
5,6,9,1,7
5,6,10,1,7
5,7,0,1,7
5,7,1,1,7
5,7,2,1,7
5,7,3,1,7
5,7,4,1,7
5,7,5,1,7
5,7,6,1,7
5,7,7,1,7
5,7,8,1,7
5,7,9,1,7
5,7,10,1,7
5,8,0,1,7
5,8,1,1,7
5,8,2,1,7
5,8,3,1,7
5,8,4,1,7
5,8,5,1,7
5,8,6,1,7
5,8,7,1,7
5,8,8,1,7
5,8,9,1,7
5,8,10,1,7
5,9,0,1,7
5,9,1,1,7
5,9,2,1,7
5,9,3,1,7
5,9,4,1,7
5,9,5,1,7
5,9,6,1,7
5,9,7,1,7
5,9,8,1,7
5,9,9,1,7
5,9,10,1,7
5,10,0,1,7
5,10,1,1,7
5,10,2,1,7
5,10,3,1,7
5,10,4,1,7
5,10,5,1,7
5,10,6,1,7
5,10,7,1,7
5,10,8,1,7
5,10,9,1,7
5,10,10,1,7
5,11,0,1,7
5,11,1,1,7
5,11,2,1,7
5,11,3,1,7
5,11,4,1,7
5,11,5,1,7
5,11,6,1,7
5,11,7,1,7
5,11,8,1,7
5,11,9,1,7
5,11,10,1,7
5,12,0,1,7
5,12,1,1,7
5,12,2,1,7
5,12,3,1,7
5,12,4,1,7
5,12,5,1,7
5,12,6,1,7
5,12,7,1,7
5,12,8,1,7
5,12,9,1,7
5,12,10,1,7
5,13,0,1,7
5,13,1,1,7
5,13,2,1,7
5,13,3,1,7
5,13,4,1,7
5,13,5,1,7
5,13,6,1,7
5,13,7,1,7
5,13,8,1,7
5,13,9,1,7
5,13,10,1,7
5,14,0,1,7
5,14,1,1,7
5,14,2,1,7
5,14,3,1,7
5,14,4,1,7
5,14,5,1,7
5,14,6,1,7
5,14,7,1,7
5,14,8,1,7
5,14,9,1,7
5,14,10,1,7
5,15,0,1,7
5,15,1,1,7
5,15,2,1,7
5,15,3,1,7
5,15,4,1,7
5,15,5,1,7
5,15,6,1,7
5,15,7,1,7
5,15,8,1,7
5,15,9,1,7
5,15,10,1,7
5,16,0,1,7
5,16,1,1,7
5,16,2,1,7
5,16,3,1,7
5,16,4,1,7
5,16,5,1,7
5,16,6,1,7
5,16,7,1,7
5,16,8,1,7
5,16,9,1,7
5,16,10,1,7
5,17,0,1,7
5,17,1,1,7
5,17,2,1,7
5,17,3,1,7
5,17,4,1,7
5,17,5,1,7
5,17,6,1,7
5,17,7,1,7
5,17,8,1,7
5,17,9,1,7
5,17,10,1,7
5,18,0,1,7
5,18,1,1,7
5,18,2,1,7
5,18,3,1,7
5,18,4,1,7
5,18,5,1,7
5,18,6,1,7
5,18,7,1,7
5,18,8,1,7
5,18,9,1,7
5,18,10,1,7
5,19,0,1,7
5,19,1,1,7
5,19,2,1,7
5,19,3,1,7
5,19,4,1,7
5,19,5,1,7
5,19,6,1,7
5,19,7,1,7
5,19,8,1,7
5,19,9,1,7
5,19,10,1,7
5,20,0,1,7
5,20,1,1,7
5,20,2,1,7
5,20,3,1,7
5,20,4,1,7
5,20,5,1,7
5,20,6,1,7
5,20,7,1,7
5,20,8,1,7
5,20,9,1,7
5,20,10,1,7
5,21,0,1,7
5,21,1,1,7
5,21,2,1,7
5,21,3,1,7
5,21,4,1,7
5,21,5,1,7
5,21,6,1,7
5,21,7,1,7
5,21,8,1,7
5,21,9,1,7
5,21,10,1,7
5,22,0,1,7
5,22,1,1,7
5,22,2,1,7
5,22,3,1,7
5,22,4,1,7
5,22,5,1,7
5,22,6,1,7
5,22,7,1,7
5,22,8,1,7
5,22,9,1,7
5,22,10,1,7
5,0,0,2,7
5,0,1,2,7
5,0,2,2,7
5,0,3,2,7
5,0,4,2,7
5,0,5,2,7
5,0,6,2,7
5,0,7,2,7
5,0,8,2,7
5,0,9,2,7
5,0,10,2,7
5,1,0,2,7
5,1,1,2,7
5,1,2,2,7
5,1,3,2,7
5,1,4,2,7
5,1,5,2,7
5,1,6,2,7
5,1,7,2,7
5,1,8,2,7
5,1,9,2,7
5,1,10,2,7
5,2,0,2,7
5,2,1,2,7
5,2,2,2,7
5,2,3,2,7
5,2,4,2,7
5,2,5,2,7
5,2,6,2,7
5,2,7,2,7
5,2,8,2,7
5,2,9,2,7
5,2,10,2,7
5,3,0,2,7
5,3,1,2,7
5,3,2,2,7
5,3,3,2,7
5,3,4,2,7
5,3,5,2,7
5,3,6,2,7
5,3,7,2,7
5,3,8,2,7
5,3,9,2,7
5,3,10,2,7
5,4,0,2,7
5,4,1,2,7
5,4,2,2,7
5,4,3,2,7
5,4,4,2,7
5,4,5,2,7
5,4,6,2,7
5,4,7,2,7
5,4,8,2,7
5,4,9,2,7
5,4,10,2,7
5,5,0,2,7
5,5,1,2,7
5,5,2,2,7
5,5,3,2,7
5,5,4,2,7
5,5,5,2,7
5,5,6,2,7
5,5,7,2,7
5,5,8,2,7
5,5,9,2,7
5,5,10,2,7
5,6,0,2,7
5,6,1,2,7
5,6,2,2,7
5,6,3,2,7
5,6,4,2,7
5,6,5,2,7
5,6,6,2,7
5,6,7,2,7
5,6,8,2,7
5,6,9,2,7
5,6,10,2,7
5,7,0,2,7
5,7,1,2,7
5,7,2,2,7
5,7,3,2,7
5,7,4,2,7
5,7,5,2,7
5,7,6,2,7
5,7,7,2,7
5,7,8,2,7
5,7,9,2,7
5,7,10,2,7
5,8,0,2,7
5,8,1,2,7
5,8,2,2,7
5,8,3,2,7
5,8,4,2,7
5,8,5,2,7
5,8,6,2,7
5,8,7,2,7
5,8,8,2,7
5,8,9,2,7
5,8,10,2,7
5,9,0,2,7
5,9,1,2,7
5,9,2,2,7
5,9,3,2,7
5,9,4,2,7
5,9,5,2,7
5,9,6,2,7
5,9,7,2,7
5,9,8,2,7
5,9,9,2,7
5,9,10,2,7
5,10,0,2,7
5,10,1,2,7
5,10,2,2,7
5,10,3,2,7
5,10,4,2,7
5,10,5,2,7
5,10,6,2,7
5,10,7,2,7
5,10,8,2,7
5,10,9,2,7
5,10,10,2,7
5,11,0,2,7
5,11,1,2,7
5,11,2,2,7
5,11,3,2,7
5,11,4,2,7
5,11,5,2,7
5,11,6,2,7
5,11,7,2,7
5,11,8,2,7
5,11,9,2,7
5,11,10,2,7
5,12,0,2,7
5,12,1,2,7
5,12,2,2,7
5,12,3,2,7
5,12,4,2,7
5,12,5,2,7
5,12,6,2,7
5,12,7,2,7
5,12,8,2,7
5,12,9,2,7
5,12,10,2,7
5,13,0,2,7
5,13,1,2,7
5,13,2,2,7
5,13,3,2,7
5,13,4,2,7
5,13,5,2,7
5,13,6,2,7
5,13,7,2,7
5,13,8,2,7
5,13,9,2,7
5,13,10,2,7
5,14,0,2,7
5,14,1,2,7
5,14,2,2,7
5,14,3,2,7
5,14,4,2,7
5,14,5,2,7
5,14,6,2,7
5,14,7,2,7
5,14,8,2,7
5,14,9,2,7
5,14,10,2,7
5,15,0,2,7
5,15,1,2,7
5,15,2,2,7
5,15,3,2,7
5,15,4,2,7
5,15,5,2,7
5,15,6,2,7
5,15,7,2,7
5,15,8,2,7
5,15,9,2,7
5,15,10,2,7
5,16,0,2,7
5,16,1,2,7
5,16,2,2,7
5,16,3,2,7
5,16,4,2,7
5,16,5,2,7
5,16,6,2,7
5,16,7,2,7
5,16,8,2,7
5,16,9,2,7
5,16,10,2,7
5,17,0,2,7
5,17,1,2,7
5,17,2,2,7
5,17,3,2,7
5,17,4,2,7
5,17,5,2,7
5,17,6,2,7
5,17,7,2,7
5,17,8,2,7
5,17,9,2,7
5,17,10,2,7
5,18,0,2,7
5,18,1,2,7
5,18,2,2,7
5,18,3,2,7
5,18,4,2,7
5,18,5,2,7
5,18,6,2,7
5,18,7,2,7
5,18,8,2,7
5,18,9,2,7
5,18,10,2,7
5,19,0,2,7
5,19,1,2,7
5,19,2,2,7
5,19,3,2,7
5,19,4,2,7
5,19,5,2,7
5,19,6,2,7
5,19,7,2,7
5,19,8,2,7
5,19,9,2,7
5,19,10,2,7
5,20,0,2,7
5,20,1,2,7
5,20,2,2,7
5,20,3,2,7
5,20,4,2,7
5,20,5,2,7
5,20,6,2,7
5,20,7,2,7
5,20,8,2,7
5,20,9,2,7
5,20,10,2,7
5,0,0,3,7
5,0,1,3,7
5,0,2,3,7
5,0,3,3,7
5,0,4,3,7
5,0,5,3,7
5,0,6,3,7
5,0,7,3,7
5,0,8,3,7
5,0,9,3,7
5,0,10,3,7
5,1,0,3,7
5,1,1,3,7
5,1,2,3,7
5,1,3,3,7
5,1,4,3,7
5,1,5,3,7
5,1,6,3,7
5,1,7,3,7
5,1,8,3,7
5,1,9,3,7
5,1,10,3,7
5,2,0,3,7
5,2,1,3,7
5,2,2,3,7
5,2,3,3,7
5,2,4,3,7
5,2,5,3,7
5,2,6,3,7
5,2,7,3,7
5,2,8,3,7
5,2,9,3,7
5,2,10,3,7
5,3,0,3,7
5,3,1,3,7
5,3,2,3,7
5,3,3,3,7
5,3,4,3,7
5,3,5,3,7
5,3,6,3,7
5,3,7,3,7
5,3,8,3,7
5,3,9,3,7
5,3,10,3,7
5,4,0,3,7
5,4,1,3,7
5,4,2,3,7
5,4,3,3,7
5,4,4,3,7
5,4,5,3,7
5,4,6,3,7
5,4,7,3,7
5,4,8,3,7
5,4,9,3,7
5,4,10,3,7
5,5,0,3,7
5,5,1,3,7
5,5,2,3,7
5,5,3,3,7
5,5,4,3,7
5,5,5,3,7
5,5,6,3,7
5,5,7,3,7
5,5,8,3,7
5,5,9,3,7
5,5,10,3,7
5,6,0,3,7
5,6,1,3,7
5,6,2,3,7
5,6,3,3,7
5,6,4,3,7
5,6,5,3,7
5,6,6,3,7
5,6,7,3,7
5,6,8,3,7
5,6,9,3,7
5,6,10,3,7
5,7,0,3,7
5,7,1,3,7
5,7,2,3,7
5,7,3,3,7
5,7,4,3,7
5,7,5,3,7
5,7,6,3,7
5,7,7,3,7
5,7,8,3,7
5,7,9,3,7
5,7,10,3,7
5,8,0,3,7
5,8,1,3,7
5,8,2,3,7
5,8,3,3,7
5,8,4,3,7
5,8,5,3,7
5,8,6,3,7
5,8,7,3,7
5,8,8,3,7
5,8,9,3,7
5,8,10,3,7
5,9,0,3,7
5,9,1,3,7
5,9,2,3,7
5,9,3,3,7
5,9,4,3,7
5,9,5,3,7
5,9,6,3,7
5,9,7,3,7
5,9,8,3,7
5,9,9,3,7
5,9,10,3,7
5,10,0,3,7
5,10,1,3,7
5,10,2,3,7
5,10,3,3,7
5,10,4,3,7
5,10,5,3,7
5,10,6,3,7
5,10,7,3,7
5,10,8,3,7
5,10,9,3,7
5,10,10,3,7
5,11,0,3,7
5,11,1,3,7
5,11,2,3,7
5,11,3,3,7
5,11,4,3,7
5,11,5,3,7
5,11,6,3,7
5,11,7,3,7
5,11,8,3,7
5,11,9,3,7
5,11,10,3,7
5,12,0,3,7
5,12,1,3,7
5,12,2,3,7
5,12,3,3,7
5,12,4,3,7
5,12,5,3,7
5,12,6,3,7
5,12,7,3,7
5,12,8,3,7
5,12,9,3,7
5,12,10,3,7
5,13,0,3,7
5,13,1,3,7
5,13,2,3,7
5,13,3,3,7
5,13,4,3,7
5,13,5,3,7
5,13,6,3,7
5,13,7,3,7
5,13,8,3,7
5,13,9,3,7
5,13,10,3,7
5,14,0,3,7
5,14,1,3,7
5,14,2,3,7
5,14,3,3,7
5,14,4,3,7
5,14,5,3,7
5,14,6,3,7
5,14,7,3,7
5,14,8,3,7
5,14,9,3,7
5,14,10,3,7
5,15,0,3,7
5,15,1,3,7
5,15,2,3,7
5,15,3,3,7
5,15,4,3,7
5,15,5,3,7
5,15,6,3,7
5,15,7,3,7
5,15,8,3,7
5,15,9,3,7
5,15,10,3,7
5,16,0,3,7
5,16,1,3,7
5,16,2,3,7
5,16,3,3,7
5,16,4,3,7
5,16,5,3,7
5,16,6,3,7
5,16,7,3,7
5,16,8,3,7
5,16,9,3,7
5,16,10,3,7
5,17,0,3,7
5,17,1,3,7
5,17,2,3,7
5,17,3,3,7
5,17,4,3,7
5,17,5,3,7
5,17,6,3,7
5,17,7,3,7
5,17,8,3,7
5,17,9,3,7
5,17,10,3,7
5,18,0,3,7
5,18,1,3,7
5,18,2,3,7
5,18,3,3,7
5,18,4,3,7
5,18,5,3,7
5,18,6,3,7
5,18,7,3,7
5,18,8,3,7
5,18,9,3,7
5,18,10,3,7
5,0,0,4,7
5,0,1,4,7
5,0,2,4,7
5,0,3,4,7
5,0,4,4,7
5,0,5,4,7
5,0,6,4,7
5,0,7,4,7
5,0,8,4,7
5,0,9,4,7
5,0,10,4,7
5,1,0,4,7
5,1,1,4,7
5,1,2,4,7
5,1,3,4,7
5,1,4,4,7
5,1,5,4,7
5,1,6,4,7
5,1,7,4,7
5,1,8,4,7
5,1,9,4,7
5,1,10,4,7
5,2,0,4,7
5,2,1,4,7
5,2,2,4,7
5,2,3,4,7
5,2,4,4,7
5,2,5,4,7
5,2,6,4,7
5,2,7,4,7
5,2,8,4,7
5,2,9,4,7
5,2,10,4,7
5,3,0,4,7
5,3,1,4,7
5,3,2,4,7
5,3,3,4,7
5,3,4,4,7
5,3,5,4,7
5,3,6,4,7
5,3,7,4,7
5,3,8,4,7
5,3,9,4,7
5,3,10,4,7
5,4,0,4,7
5,4,1,4,7
5,4,2,4,7
5,4,3,4,7
5,4,4,4,7
5,4,5,4,7
5,4,6,4,7
5,4,7,4,7
5,4,8,4,7
5,4,9,4,7
5,4,10,4,7
5,5,0,4,7
5,5,1,4,7
5,5,2,4,7
5,5,3,4,7
5,5,4,4,7
5,5,5,4,7
5,5,6,4,7
5,5,7,4,7
5,5,8,4,7
5,5,9,4,7
5,5,10,4,7
5,6,0,4,7
5,6,1,4,7
5,6,2,4,7
5,6,3,4,7
5,6,4,4,7
5,6,5,4,7
5,6,6,4,7
5,6,7,4,7
5,6,8,4,7
5,6,9,4,7
5,6,10,4,7
5,7,0,4,7
5,7,1,4,7
5,7,2,4,7
5,7,3,4,7
5,7,4,4,7
5,7,5,4,7
5,7,6,4,7
5,7,7,4,7
5,7,8,4,7
5,7,9,4,7
5,7,10,4,7
5,8,0,4,7
5,8,1,4,7
5,8,2,4,7
5,8,3,4,7
5,8,4,4,7
5,8,5,4,7
5,8,6,4,7
5,8,7,4,7
5,8,8,4,7
5,8,9,4,7
5,8,10,4,7
5,9,0,4,7
5,9,1,4,7
5,9,2,4,7
5,9,3,4,7
5,9,4,4,7
5,9,5,4,7
5,9,6,4,7
5,9,7,4,7
5,9,8,4,7
5,9,9,4,7
5,9,10,4,7
5,10,0,4,7
5,10,1,4,7
5,10,2,4,7
5,10,3,4,7
5,10,4,4,7
5,10,5,4,7
5,10,6,4,7
5,10,7,4,7
5,10,8,4,7
5,10,9,4,7
5,10,10,4,7
5,11,0,4,7
5,11,1,4,7
5,11,2,4,7
5,11,3,4,7
5,11,4,4,7
5,11,5,4,7
5,11,6,4,7
5,11,7,4,7
5,11,8,4,7
5,11,9,4,7
5,11,10,4,7
5,12,0,4,7
5,12,1,4,7
5,12,2,4,7
5,12,3,4,7
5,12,4,4,7
5,12,5,4,7
5,12,6,4,7
5,12,7,4,7
5,12,8,4,7
5,12,9,4,7
5,12,10,4,7
5,13,0,4,7
5,13,1,4,7
5,13,2,4,7
5,13,3,4,7
5,13,4,4,7
5,13,5,4,7
5,13,6,4,7
5,13,7,4,7
5,13,8,4,7
5,13,9,4,7
5,13,10,4,7
5,14,0,4,7
5,14,1,4,7
5,14,2,4,7
5,14,3,4,7
5,14,4,4,7
5,14,5,4,7
5,14,6,4,7
5,14,7,4,7
5,14,8,4,7
5,14,9,4,7
5,14,10,4,7
5,15,0,4,7
5,15,1,4,7
5,15,2,4,7
5,15,3,4,7
5,15,4,4,7
5,15,5,4,7
5,15,6,4,7
5,15,7,4,7
5,15,8,4,7
5,15,9,4,7
5,15,10,4,7
5,16,0,4,7
5,16,1,4,7
5,16,2,4,7
5,16,3,4,7
5,16,4,4,7
5,16,5,4,7
5,16,6,4,7
5,16,7,4,7
5,16,8,4,7
5,16,9,4,7
5,16,10,4,7
5,0,0,5,7
5,0,1,5,7
5,0,2,5,7
5,0,3,5,7
5,0,4,5,7
5,0,5,5,7
5,0,6,5,7
5,0,7,5,7
5,0,8,5,7
5,0,9,5,7
5,0,10,5,7
5,1,0,5,7
5,1,1,5,7
5,1,2,5,7
5,1,3,5,7
5,1,4,5,7
5,1,5,5,7
5,1,6,5,7
5,1,7,5,7
5,1,8,5,7
5,1,9,5,7
5,1,10,5,7
5,2,0,5,7
5,2,1,5,7
5,2,2,5,7
5,2,3,5,7
5,2,4,5,7
5,2,5,5,7
5,2,6,5,7
5,2,7,5,7
5,2,8,5,7
5,2,9,5,7
5,2,10,5,7
5,3,0,5,7
5,3,1,5,7
5,3,2,5,7
5,3,3,5,7
5,3,4,5,7
5,3,5,5,7
5,3,6,5,7
5,3,7,5,7
5,3,8,5,7
5,3,9,5,7
5,3,10,5,7
5,4,0,5,7
5,4,1,5,7
5,4,2,5,7
5,4,3,5,7
5,4,4,5,7
5,4,5,5,7
5,4,6,5,7
5,4,7,5,7
5,4,8,5,7
5,4,9,5,7
5,4,10,5,7
5,5,0,5,7
5,5,1,5,7
5,5,2,5,7
5,5,3,5,7
5,5,4,5,7
5,5,5,5,7
5,5,6,5,7
5,5,7,5,7
5,5,8,5,7
5,5,9,5,7
5,5,10,5,7
5,6,0,5,7
5,6,1,5,7
5,6,2,5,7
5,6,3,5,7
5,6,4,5,7
5,6,5,5,7
5,6,6,5,7
5,6,7,5,7
5,6,8,5,7
5,6,9,5,7
5,6,10,5,7
5,7,0,5,7
5,7,1,5,7
5,7,2,5,7
5,7,3,5,7
5,7,4,5,7
5,7,5,5,7
5,7,6,5,7
5,7,7,5,7
5,7,8,5,7
5,7,9,5,7
5,7,10,5,7
5,8,0,5,7
5,8,1,5,7
5,8,2,5,7
5,8,3,5,7
5,8,4,5,7
5,8,5,5,7
5,8,6,5,7
5,8,7,5,7
5,8,8,5,7
5,8,9,5,7
5,8,10,5,7
5,9,0,5,7
5,9,1,5,7
5,9,2,5,7
5,9,3,5,7
5,9,4,5,7
5,9,5,5,7
5,9,6,5,7
5,9,7,5,7
5,9,8,5,7
5,9,9,5,7
5,9,10,5,7
5,10,0,5,7
5,10,1,5,7
5,10,2,5,7
5,10,3,5,7
5,10,4,5,7
5,10,5,5,7
5,10,6,5,7
5,10,7,5,7
5,10,8,5,7
5,10,9,5,7
5,10,10,5,7
5,11,0,5,7
5,11,1,5,7
5,11,2,5,7
5,11,3,5,7
5,11,4,5,7
5,11,5,5,7
5,11,6,5,7
5,11,7,5,7
5,11,8,5,7
5,11,9,5,7
5,11,10,5,7
5,12,0,5,7
5,12,1,5,7
5,12,2,5,7
5,12,3,5,7
5,12,4,5,7
5,12,5,5,7
5,12,6,5,7
5,12,7,5,7
5,12,8,5,7
5,12,9,5,7
5,12,10,5,7
5,13,0,5,7
5,13,1,5,7
5,13,2,5,7
5,13,3,5,7
5,13,4,5,7
5,13,5,5,7
5,13,6,5,7
5,13,7,5,7
5,13,8,5,7
5,13,9,5,7
5,13,10,5,7
5,14,0,5,7
5,14,1,5,7
5,14,2,5,7
5,14,3,5,7
5,14,4,5,7
5,14,5,5,7
5,14,6,5,7
5,14,7,5,7
5,14,8,5,7
5,14,9,5,7
5,14,10,5,7
5,0,0,6,7
5,0,1,6,7
5,0,2,6,7
5,0,3,6,7
5,0,4,6,7
5,0,5,6,7
5,0,6,6,7
5,0,7,6,7
5,0,8,6,7
5,0,9,6,7
5,0,10,6,7
5,1,0,6,7
5,1,1,6,7
5,1,2,6,7
5,1,3,6,7
5,1,4,6,7
5,1,5,6,7
5,1,6,6,7
5,1,7,6,7
5,1,8,6,7
5,1,9,6,7
5,1,10,6,7
5,2,0,6,7
5,2,1,6,7
5,2,2,6,7
5,2,3,6,7
5,2,4,6,7
5,2,5,6,7
5,2,6,6,7
5,2,7,6,7
5,2,8,6,7
5,2,9,6,7
5,2,10,6,7
5,3,0,6,7
5,3,1,6,7
5,3,2,6,7
5,3,3,6,7
5,3,4,6,7
5,3,5,6,7
5,3,6,6,7
5,3,7,6,7
5,3,8,6,7
5,3,9,6,7
5,3,10,6,7
5,4,0,6,7
5,4,1,6,7
5,4,2,6,7
5,4,3,6,7
5,4,4,6,7
5,4,5,6,7
5,4,6,6,7
5,4,7,6,7
5,4,8,6,7
5,4,9,6,7
5,4,10,6,7
5,5,0,6,7
5,5,1,6,7
5,5,2,6,7
5,5,3,6,7
5,5,4,6,7
5,5,5,6,7
5,5,6,6,7
5,5,7,6,7
5,5,8,6,7
5,5,9,6,7
5,5,10,6,7
5,6,0,6,7
5,6,1,6,7
5,6,2,6,7
5,6,3,6,7
5,6,4,6,7
5,6,5,6,7
5,6,6,6,7
5,6,7,6,7
5,6,8,6,7
5,6,9,6,7
5,6,10,6,7
5,7,0,6,7
5,7,1,6,7
5,7,2,6,7
5,7,3,6,7
5,7,4,6,7
5,7,5,6,7
5,7,6,6,7
5,7,7,6,7
5,7,8,6,7
5,7,9,6,7
5,7,10,6,7
5,8,0,6,7
5,8,1,6,7
5,8,2,6,7
5,8,3,6,7
5,8,4,6,7
5,8,5,6,7
5,8,6,6,7
5,8,7,6,7
5,8,8,6,7
5,8,9,6,7
5,8,10,6,7
5,9,0,6,7
5,9,1,6,7
5,9,2,6,7
5,9,3,6,7
5,9,4,6,7
5,9,5,6,7
5,9,6,6,7
5,9,7,6,7
5,9,8,6,7
5,9,9,6,7
5,9,10,6,7
5,10,0,6,7
5,10,1,6,7
5,10,2,6,7
5,10,3,6,7
5,10,4,6,7
5,10,5,6,7
5,10,6,6,7
5,10,7,6,7
5,10,8,6,7
5,10,9,6,7
5,10,10,6,7
5,11,0,6,7
5,11,1,6,7
5,11,2,6,7
5,11,3,6,7
5,11,4,6,7
5,11,5,6,7
5,11,6,6,7
5,11,7,6,7
5,11,8,6,7
5,11,9,6,7
5,11,10,6,7
5,12,0,6,7
5,12,1,6,7
5,12,2,6,7
5,12,3,6,7
5,12,4,6,7
5,12,5,6,7
5,12,6,6,7
5,12,7,6,7
5,12,8,6,7
5,12,9,6,7
5,12,10,6,7
5,0,0,7,7
5,0,1,7,7
5,0,2,7,7
5,0,3,7,7
5,0,4,7,7
5,0,5,7,7
5,0,6,7,7
5,0,7,7,7
5,0,8,7,7
5,0,9,7,7
5,0,10,7,7
5,1,0,7,7
5,1,1,7,7
5,1,2,7,7
5,1,3,7,7
5,1,4,7,7
5,1,5,7,7
5,1,6,7,7
5,1,7,7,7
5,1,8,7,7
5,1,9,7,7
5,1,10,7,7
5,2,0,7,7
5,2,1,7,7
5,2,2,7,7
5,2,3,7,7
5,2,4,7,7
5,2,5,7,7
5,2,6,7,7
5,2,7,7,7
5,2,8,7,7
5,2,9,7,7
5,2,10,7,7
5,3,0,7,7
5,3,1,7,7
5,3,2,7,7
5,3,3,7,7
5,3,4,7,7
5,3,5,7,7
5,3,6,7,7
5,3,7,7,7
5,3,8,7,7
5,3,9,7,7
5,3,10,7,7
5,4,0,7,7
5,4,1,7,7
5,4,2,7,7
5,4,3,7,7
5,4,4,7,7
5,4,5,7,7
5,4,6,7,7
5,4,7,7,7
5,4,8,7,7
5,4,9,7,7
5,4,10,7,7
5,5,0,7,7
5,5,1,7,7
5,5,2,7,7
5,5,3,7,7
5,5,4,7,7
5,5,5,7,7
5,5,6,7,7
5,5,7,7,7
5,5,8,7,7
5,5,9,7,7
5,5,10,7,7
5,6,0,7,7
5,6,1,7,7
5,6,2,7,7
5,6,3,7,7
5,6,4,7,7
5,6,5,7,7
5,6,6,7,7
5,6,7,7,7
5,6,8,7,7
5,6,9,7,7
5,6,10,7,7
5,7,0,7,7
5,7,1,7,7
5,7,2,7,7
5,7,3,7,7
5,7,4,7,7
5,7,5,7,7
5,7,6,7,7
5,7,7,7,7
5,7,8,7,7
5,7,9,7,7
5,7,10,7,7
5,8,0,7,7
5,8,1,7,7
5,8,2,7,7
5,8,3,7,7
5,8,4,7,7
5,8,5,7,7
5,8,6,7,7
5,8,7,7,7
5,8,8,7,7
5,8,9,7,7
5,8,10,7,7
5,9,0,7,7
5,9,1,7,7
5,9,2,7,7
5,9,3,7,7
5,9,4,7,7
5,9,5,7,7
5,9,6,7,7
5,9,7,7,7
5,9,8,7,7
5,9,9,7,7
5,9,10,7,7
5,10,0,7,7
5,10,1,7,7
5,10,2,7,7
5,10,3,7,7
5,10,4,7,7
5,10,5,7,7
5,10,6,7,7
5,10,7,7,7
5,10,8,7,7
5,10,9,7,7
5,10,10,7,7
5,0,0,8,7
5,0,1,8,7
5,0,2,8,7
5,0,3,8,7
5,0,4,8,7
5,0,5,8,7
5,0,6,8,7
5,0,7,8,7
5,0,8,8,7
5,0,9,8,7
5,0,10,8,7
5,1,0,8,7
5,1,1,8,7
5,1,2,8,7
5,1,3,8,7
5,1,4,8,7
5,1,5,8,7
5,1,6,8,7
5,1,7,8,7
5,1,8,8,7
5,1,9,8,7
5,1,10,8,7
5,2,0,8,7
5,2,1,8,7
5,2,2,8,7
5,2,3,8,7
5,2,4,8,7
5,2,5,8,7
5,2,6,8,7
5,2,7,8,7
5,2,8,8,7
5,2,9,8,7
5,2,10,8,7
5,3,0,8,7
5,3,1,8,7
5,3,2,8,7
5,3,3,8,7
5,3,4,8,7
5,3,5,8,7
5,3,6,8,7
5,3,7,8,7
5,3,8,8,7
5,3,9,8,7
5,3,10,8,7
5,4,0,8,7
5,4,1,8,7
5,4,2,8,7
5,4,3,8,7
5,4,4,8,7
5,4,5,8,7
5,4,6,8,7
5,4,7,8,7
5,4,8,8,7
5,4,9,8,7
5,4,10,8,7
5,5,0,8,7
5,5,1,8,7
5,5,2,8,7
5,5,3,8,7
5,5,4,8,7
5,5,5,8,7
5,5,6,8,7
5,5,7,8,7
5,5,8,8,7
5,5,9,8,7
5,5,10,8,7
5,6,0,8,7
5,6,1,8,7
5,6,2,8,7
5,6,3,8,7
5,6,4,8,7
5,6,5,8,7
5,6,6,8,7
5,6,7,8,7
5,6,8,8,7
5,6,9,8,7
5,6,10,8,7
5,7,0,8,7
5,7,1,8,7
5,7,2,8,7
5,7,3,8,7
5,7,4,8,7
5,7,5,8,7
5,7,6,8,7
5,7,7,8,7
5,7,8,8,7
5,7,9,8,7
5,7,10,8,7
5,8,0,8,7
5,8,1,8,7
5,8,2,8,7
5,8,3,8,7
5,8,4,8,7
5,8,5,8,7
5,8,6,8,7
5,8,7,8,7
5,8,8,8,7
5,8,9,8,7
5,8,10,8,7
5,0,0,9,7
5,0,1,9,7
5,0,2,9,7
5,0,3,9,7
5,0,4,9,7
5,0,5,9,7
5,0,6,9,7
5,0,7,9,7
5,0,8,9,7
5,0,9,9,7
5,0,10,9,7
5,1,0,9,7
5,1,1,9,7
5,1,2,9,7
5,1,3,9,7
5,1,4,9,7
5,1,5,9,7
5,1,6,9,7
5,1,7,9,7
5,1,8,9,7
5,1,9,9,7
5,1,10,9,7
5,2,0,9,7
5,2,1,9,7
5,2,2,9,7
5,2,3,9,7
5,2,4,9,7
5,2,5,9,7
5,2,6,9,7
5,2,7,9,7
5,2,8,9,7
5,2,9,9,7
5,2,10,9,7
5,3,0,9,7
5,3,1,9,7
5,3,2,9,7
5,3,3,9,7
5,3,4,9,7
5,3,5,9,7
5,3,6,9,7
5,3,7,9,7
5,3,8,9,7
5,3,9,9,7
5,3,10,9,7
5,4,0,9,7
5,4,1,9,7
5,4,2,9,7
5,4,3,9,7
5,4,4,9,7
5,4,5,9,7
5,4,6,9,7
5,4,7,9,7
5,4,8,9,7
5,4,9,9,7
5,4,10,9,7
5,5,0,9,7
5,5,1,9,7
5,5,2,9,7
5,5,3,9,7
5,5,4,9,7
5,5,5,9,7
5,5,6,9,7
5,5,7,9,7
5,5,8,9,7
5,5,9,9,7
5,5,10,9,7
5,6,0,9,7
5,6,1,9,7
5,6,2,9,7
5,6,3,9,7
5,6,4,9,7
5,6,5,9,7
5,6,6,9,7
5,6,7,9,7
5,6,8,9,7
5,6,9,9,7
5,6,10,9,7
5,0,0,10,7
5,0,1,10,7
5,0,2,10,7
5,0,3,10,7
5,0,4,10,7
5,0,5,10,7
5,0,6,10,7
5,0,7,10,7
5,0,8,10,7
5,0,9,10,7
5,0,10,10,7
5,1,0,10,7
5,1,1,10,7
5,1,2,10,7
5,1,3,10,7
5,1,4,10,7
5,1,5,10,7
5,1,6,10,7
5,1,7,10,7
5,1,8,10,7
5,1,9,10,7
5,1,10,10,7
5,2,0,10,7
5,2,1,10,7
5,2,2,10,7
5,2,3,10,7
5,2,4,10,7
5,2,5,10,7
5,2,6,10,7
5,2,7,10,7
5,2,8,10,7
5,2,9,10,7
5,2,10,10,7
5,3,0,10,7
5,3,1,10,7
5,3,2,10,7
5,3,3,10,7
5,3,4,10,7
5,3,5,10,7
5,3,6,10,7
5,3,7,10,7
5,3,8,10,7
5,3,9,10,7
5,3,10,10,7
5,4,0,10,7
5,4,1,10,7
5,4,2,10,7
5,4,3,10,7
5,4,4,10,7
5,4,5,10,7
5,4,6,10,7
5,4,7,10,7
5,4,8,10,7
5,4,9,10,7
5,4,10,10,7
5,0,0,11,7
5,0,1,11,7
5,0,2,11,7
5,0,3,11,7
5,0,4,11,7
5,0,5,11,7
5,0,6,11,7
5,0,7,11,7
5,0,8,11,7
5,0,9,11,7
5,0,10,11,7
5,1,0,11,7
5,1,1,11,7
5,1,2,11,7
5,1,3,11,7
5,1,4,11,7
5,1,5,11,7
5,1,6,11,7
5,1,7,11,7
5,1,8,11,7
5,1,9,11,7
5,1,10,11,7
5,2,0,11,7
5,2,1,11,7
5,2,2,11,7
5,2,3,11,7
5,2,4,11,7
5,2,5,11,7
5,2,6,11,7
5,2,7,11,7
5,2,8,11,7
5,2,9,11,7
5,2,10,11,7
5,0,0,12,7
5,0,1,12,7
5,0,2,12,7
5,0,3,12,7
5,0,4,12,7
5,0,5,12,7
5,0,6,12,7
5,0,7,12,7
5,0,8,12,7
5,0,9,12,7
5,0,10,12,7
5,0,0,1,8
5,0,1,1,8
5,0,2,1,8
5,0,3,1,8
5,0,4,1,8
5,0,5,1,8
5,0,6,1,8
5,0,7,1,8
5,0,8,1,8
5,1,0,1,8
5,1,1,1,8
5,1,2,1,8
5,1,3,1,8
5,1,4,1,8
5,1,5,1,8
5,1,6,1,8
5,1,7,1,8
5,1,8,1,8
5,2,0,1,8
5,2,1,1,8
5,2,2,1,8
5,2,3,1,8
5,2,4,1,8
5,2,5,1,8
5,2,6,1,8
5,2,7,1,8
5,2,8,1,8
5,3,0,1,8
5,3,1,1,8
5,3,2,1,8
5,3,3,1,8
5,3,4,1,8
5,3,5,1,8
5,3,6,1,8
5,3,7,1,8
5,3,8,1,8
5,4,0,1,8
5,4,1,1,8
5,4,2,1,8
5,4,3,1,8
5,4,4,1,8
5,4,5,1,8
5,4,6,1,8
5,4,7,1,8
5,4,8,1,8
5,5,0,1,8
5,5,1,1,8
5,5,2,1,8
5,5,3,1,8
5,5,4,1,8
5,5,5,1,8
5,5,6,1,8
5,5,7,1,8
5,5,8,1,8
5,6,0,1,8
5,6,1,1,8
5,6,2,1,8
5,6,3,1,8
5,6,4,1,8
5,6,5,1,8
5,6,6,1,8
5,6,7,1,8
5,6,8,1,8
5,7,0,1,8
5,7,1,1,8
5,7,2,1,8
5,7,3,1,8
5,7,4,1,8
5,7,5,1,8
5,7,6,1,8
5,7,7,1,8
5,7,8,1,8
5,8,0,1,8
5,8,1,1,8
5,8,2,1,8
5,8,3,1,8
5,8,4,1,8
5,8,5,1,8
5,8,6,1,8
5,8,7,1,8
5,8,8,1,8
5,9,0,1,8
5,9,1,1,8
5,9,2,1,8
5,9,3,1,8
5,9,4,1,8
5,9,5,1,8
5,9,6,1,8
5,9,7,1,8
5,9,8,1,8
5,10,0,1,8
5,10,1,1,8
5,10,2,1,8
5,10,3,1,8
5,10,4,1,8
5,10,5,1,8
5,10,6,1,8
5,10,7,1,8
5,10,8,1,8
5,11,0,1,8
5,11,1,1,8
5,11,2,1,8
5,11,3,1,8
5,11,4,1,8
5,11,5,1,8
5,11,6,1,8
5,11,7,1,8
5,11,8,1,8
5,12,0,1,8
5,12,1,1,8
5,12,2,1,8
5,12,3,1,8
5,12,4,1,8
5,12,5,1,8
5,12,6,1,8
5,12,7,1,8
5,12,8,1,8
5,13,0,1,8
5,13,1,1,8
5,13,2,1,8
5,13,3,1,8
5,13,4,1,8
5,13,5,1,8
5,13,6,1,8
5,13,7,1,8
5,13,8,1,8
5,14,0,1,8
5,14,1,1,8
5,14,2,1,8
5,14,3,1,8
5,14,4,1,8
5,14,5,1,8
5,14,6,1,8
5,14,7,1,8
5,14,8,1,8
5,15,0,1,8
5,15,1,1,8
5,15,2,1,8
5,15,3,1,8
5,15,4,1,8
5,15,5,1,8
5,15,6,1,8
5,15,7,1,8
5,15,8,1,8
5,16,0,1,8
5,16,1,1,8
5,16,2,1,8
5,16,3,1,8
5,16,4,1,8
5,16,5,1,8
5,16,6,1,8
5,16,7,1,8
5,16,8,1,8
5,17,0,1,8
5,17,1,1,8
5,17,2,1,8
5,17,3,1,8
5,17,4,1,8
5,17,5,1,8
5,17,6,1,8
5,17,7,1,8
5,17,8,1,8
5,18,0,1,8
5,18,1,1,8
5,18,2,1,8
5,18,3,1,8
5,18,4,1,8
5,18,5,1,8
5,18,6,1,8
5,18,7,1,8
5,18,8,1,8
5,19,0,1,8
5,19,1,1,8
5,19,2,1,8
5,19,3,1,8
5,19,4,1,8
5,19,5,1,8
5,19,6,1,8
5,19,7,1,8
5,19,8,1,8
5,20,0,1,8
5,20,1,1,8
5,20,2,1,8
5,20,3,1,8
5,20,4,1,8
5,20,5,1,8
5,20,6,1,8
5,20,7,1,8
5,20,8,1,8
5,21,0,1,8
5,21,1,1,8
5,21,2,1,8
5,21,3,1,8
5,21,4,1,8
5,21,5,1,8
5,21,6,1,8
5,21,7,1,8
5,21,8,1,8
5,22,0,1,8
5,22,1,1,8
5,22,2,1,8
5,22,3,1,8
5,22,4,1,8
5,22,5,1,8
5,22,6,1,8
5,22,7,1,8
5,22,8,1,8
5,0,0,2,8
5,0,1,2,8
5,0,2,2,8
5,0,3,2,8
5,0,4,2,8
5,0,5,2,8
5,0,6,2,8
5,0,7,2,8
5,0,8,2,8
5,1,0,2,8
5,1,1,2,8
5,1,2,2,8
5,1,3,2,8
5,1,4,2,8
5,1,5,2,8
5,1,6,2,8
5,1,7,2,8
5,1,8,2,8
5,2,0,2,8
5,2,1,2,8
5,2,2,2,8
5,2,3,2,8
5,2,4,2,8
5,2,5,2,8
5,2,6,2,8
5,2,7,2,8
5,2,8,2,8
5,3,0,2,8
5,3,1,2,8
5,3,2,2,8
5,3,3,2,8
5,3,4,2,8
5,3,5,2,8
5,3,6,2,8
5,3,7,2,8
5,3,8,2,8
5,4,0,2,8
5,4,1,2,8
5,4,2,2,8
5,4,3,2,8
5,4,4,2,8
5,4,5,2,8
5,4,6,2,8
5,4,7,2,8
5,4,8,2,8
5,5,0,2,8
5,5,1,2,8
5,5,2,2,8
5,5,3,2,8
5,5,4,2,8
5,5,5,2,8
5,5,6,2,8
5,5,7,2,8
5,5,8,2,8
5,6,0,2,8
5,6,1,2,8
5,6,2,2,8
5,6,3,2,8
5,6,4,2,8
5,6,5,2,8
5,6,6,2,8
5,6,7,2,8
5,6,8,2,8
5,7,0,2,8
5,7,1,2,8
5,7,2,2,8
5,7,3,2,8
5,7,4,2,8
5,7,5,2,8
5,7,6,2,8
5,7,7,2,8
5,7,8,2,8
5,8,0,2,8
5,8,1,2,8
5,8,2,2,8
5,8,3,2,8
5,8,4,2,8
5,8,5,2,8
5,8,6,2,8
5,8,7,2,8
5,8,8,2,8
5,9,0,2,8
5,9,1,2,8
5,9,2,2,8
5,9,3,2,8
5,9,4,2,8
5,9,5,2,8
5,9,6,2,8
5,9,7,2,8
5,9,8,2,8
5,10,0,2,8
5,10,1,2,8
5,10,2,2,8
5,10,3,2,8
5,10,4,2,8
5,10,5,2,8
5,10,6,2,8
5,10,7,2,8
5,10,8,2,8
5,11,0,2,8
5,11,1,2,8
5,11,2,2,8
5,11,3,2,8
5,11,4,2,8
5,11,5,2,8
5,11,6,2,8
5,11,7,2,8
5,11,8,2,8
5,12,0,2,8
5,12,1,2,8
5,12,2,2,8
5,12,3,2,8
5,12,4,2,8
5,12,5,2,8
5,12,6,2,8
5,12,7,2,8
5,12,8,2,8
5,13,0,2,8
5,13,1,2,8
5,13,2,2,8
5,13,3,2,8
5,13,4,2,8
5,13,5,2,8
5,13,6,2,8
5,13,7,2,8
5,13,8,2,8
5,14,0,2,8
5,14,1,2,8
5,14,2,2,8
5,14,3,2,8
5,14,4,2,8
5,14,5,2,8
5,14,6,2,8
5,14,7,2,8
5,14,8,2,8
5,15,0,2,8
5,15,1,2,8
5,15,2,2,8
5,15,3,2,8
5,15,4,2,8
5,15,5,2,8
5,15,6,2,8
5,15,7,2,8
5,15,8,2,8
5,16,0,2,8
5,16,1,2,8
5,16,2,2,8
5,16,3,2,8
5,16,4,2,8
5,16,5,2,8
5,16,6,2,8
5,16,7,2,8
5,16,8,2,8
5,17,0,2,8
5,17,1,2,8
5,17,2,2,8
5,17,3,2,8
5,17,4,2,8
5,17,5,2,8
5,17,6,2,8
5,17,7,2,8
5,17,8,2,8
5,18,0,2,8
5,18,1,2,8
5,18,2,2,8
5,18,3,2,8
5,18,4,2,8
5,18,5,2,8
5,18,6,2,8
5,18,7,2,8
5,18,8,2,8
5,19,0,2,8
5,19,1,2,8
5,19,2,2,8
5,19,3,2,8
5,19,4,2,8
5,19,5,2,8
5,19,6,2,8
5,19,7,2,8
5,19,8,2,8
5,20,0,2,8
5,20,1,2,8
5,20,2,2,8
5,20,3,2,8
5,20,4,2,8
5,20,5,2,8
5,20,6,2,8
5,20,7,2,8
5,20,8,2,8
5,0,0,3,8
5,0,1,3,8
5,0,2,3,8
5,0,3,3,8
5,0,4,3,8
5,0,5,3,8
5,0,6,3,8
5,0,7,3,8
5,0,8,3,8
5,1,0,3,8
5,1,1,3,8
5,1,2,3,8
5,1,3,3,8
5,1,4,3,8
5,1,5,3,8
5,1,6,3,8
5,1,7,3,8
5,1,8,3,8
5,2,0,3,8
5,2,1,3,8
5,2,2,3,8
5,2,3,3,8
5,2,4,3,8
5,2,5,3,8
5,2,6,3,8
5,2,7,3,8
5,2,8,3,8
5,3,0,3,8
5,3,1,3,8
5,3,2,3,8
5,3,3,3,8
5,3,4,3,8
5,3,5,3,8
5,3,6,3,8
5,3,7,3,8
5,3,8,3,8
5,4,0,3,8
5,4,1,3,8
5,4,2,3,8
5,4,3,3,8
5,4,4,3,8
5,4,5,3,8
5,4,6,3,8
5,4,7,3,8
5,4,8,3,8
5,5,0,3,8
5,5,1,3,8
5,5,2,3,8
5,5,3,3,8
5,5,4,3,8
5,5,5,3,8
5,5,6,3,8
5,5,7,3,8
5,5,8,3,8
5,6,0,3,8
5,6,1,3,8
5,6,2,3,8
5,6,3,3,8
5,6,4,3,8
5,6,5,3,8
5,6,6,3,8
5,6,7,3,8
5,6,8,3,8
5,7,0,3,8
5,7,1,3,8
5,7,2,3,8
5,7,3,3,8
5,7,4,3,8
5,7,5,3,8
5,7,6,3,8
5,7,7,3,8
5,7,8,3,8
5,8,0,3,8
5,8,1,3,8
5,8,2,3,8
5,8,3,3,8
5,8,4,3,8
5,8,5,3,8
5,8,6,3,8
5,8,7,3,8
5,8,8,3,8
5,9,0,3,8
5,9,1,3,8
5,9,2,3,8
5,9,3,3,8
5,9,4,3,8
5,9,5,3,8
5,9,6,3,8
5,9,7,3,8
5,9,8,3,8
5,10,0,3,8
5,10,1,3,8
5,10,2,3,8
5,10,3,3,8
5,10,4,3,8
5,10,5,3,8
5,10,6,3,8
5,10,7,3,8
5,10,8,3,8
5,11,0,3,8
5,11,1,3,8
5,11,2,3,8
5,11,3,3,8
5,11,4,3,8
5,11,5,3,8
5,11,6,3,8
5,11,7,3,8
5,11,8,3,8
5,12,0,3,8
5,12,1,3,8
5,12,2,3,8
5,12,3,3,8
5,12,4,3,8
5,12,5,3,8
5,12,6,3,8
5,12,7,3,8
5,12,8,3,8
5,13,0,3,8
5,13,1,3,8
5,13,2,3,8
5,13,3,3,8
5,13,4,3,8
5,13,5,3,8
5,13,6,3,8
5,13,7,3,8
5,13,8,3,8
5,14,0,3,8
5,14,1,3,8
5,14,2,3,8
5,14,3,3,8
5,14,4,3,8
5,14,5,3,8
5,14,6,3,8
5,14,7,3,8
5,14,8,3,8
5,15,0,3,8
5,15,1,3,8
5,15,2,3,8
5,15,3,3,8
5,15,4,3,8
5,15,5,3,8
5,15,6,3,8
5,15,7,3,8
5,15,8,3,8
5,16,0,3,8
5,16,1,3,8
5,16,2,3,8
5,16,3,3,8
5,16,4,3,8
5,16,5,3,8
5,16,6,3,8
5,16,7,3,8
5,16,8,3,8
5,17,0,3,8
5,17,1,3,8
5,17,2,3,8
5,17,3,3,8
5,17,4,3,8
5,17,5,3,8
5,17,6,3,8
5,17,7,3,8
5,17,8,3,8
5,18,0,3,8
5,18,1,3,8
5,18,2,3,8
5,18,3,3,8
5,18,4,3,8
5,18,5,3,8
5,18,6,3,8
5,18,7,3,8
5,18,8,3,8
5,0,0,4,8
5,0,1,4,8
5,0,2,4,8
5,0,3,4,8
5,0,4,4,8
5,0,5,4,8
5,0,6,4,8
5,0,7,4,8
5,0,8,4,8
5,1,0,4,8
5,1,1,4,8
5,1,2,4,8
5,1,3,4,8
5,1,4,4,8
5,1,5,4,8
5,1,6,4,8
5,1,7,4,8
5,1,8,4,8
5,2,0,4,8
5,2,1,4,8
5,2,2,4,8
5,2,3,4,8
5,2,4,4,8
5,2,5,4,8
5,2,6,4,8
5,2,7,4,8
5,2,8,4,8
5,3,0,4,8
5,3,1,4,8
5,3,2,4,8
5,3,3,4,8
5,3,4,4,8
5,3,5,4,8
5,3,6,4,8
5,3,7,4,8
5,3,8,4,8
5,4,0,4,8
5,4,1,4,8
5,4,2,4,8
5,4,3,4,8
5,4,4,4,8
5,4,5,4,8
5,4,6,4,8
5,4,7,4,8
5,4,8,4,8
5,5,0,4,8
5,5,1,4,8
5,5,2,4,8
5,5,3,4,8
5,5,4,4,8
5,5,5,4,8
5,5,6,4,8
5,5,7,4,8
5,5,8,4,8
5,6,0,4,8
5,6,1,4,8
5,6,2,4,8
5,6,3,4,8
5,6,4,4,8
5,6,5,4,8
5,6,6,4,8
5,6,7,4,8
5,6,8,4,8
5,7,0,4,8
5,7,1,4,8
5,7,2,4,8
5,7,3,4,8
5,7,4,4,8
5,7,5,4,8
5,7,6,4,8
5,7,7,4,8
5,7,8,4,8
5,8,0,4,8
5,8,1,4,8
5,8,2,4,8
5,8,3,4,8
5,8,4,4,8
5,8,5,4,8
5,8,6,4,8
5,8,7,4,8
5,8,8,4,8
5,9,0,4,8
5,9,1,4,8
5,9,2,4,8
5,9,3,4,8
5,9,4,4,8
5,9,5,4,8
5,9,6,4,8
5,9,7,4,8
5,9,8,4,8
5,10,0,4,8
5,10,1,4,8
5,10,2,4,8
5,10,3,4,8
5,10,4,4,8
5,10,5,4,8
5,10,6,4,8
5,10,7,4,8
5,10,8,4,8
5,11,0,4,8
5,11,1,4,8
5,11,2,4,8
5,11,3,4,8
5,11,4,4,8
5,11,5,4,8
5,11,6,4,8
5,11,7,4,8
5,11,8,4,8
5,12,0,4,8
5,12,1,4,8
5,12,2,4,8
5,12,3,4,8
5,12,4,4,8
5,12,5,4,8
5,12,6,4,8
5,12,7,4,8
5,12,8,4,8
5,13,0,4,8
5,13,1,4,8
5,13,2,4,8
5,13,3,4,8
5,13,4,4,8
5,13,5,4,8
5,13,6,4,8
5,13,7,4,8
5,13,8,4,8
5,14,0,4,8
5,14,1,4,8
5,14,2,4,8
5,14,3,4,8
5,14,4,4,8
5,14,5,4,8
5,14,6,4,8
5,14,7,4,8
5,14,8,4,8
5,15,0,4,8
5,15,1,4,8
5,15,2,4,8
5,15,3,4,8
5,15,4,4,8
5,15,5,4,8
5,15,6,4,8
5,15,7,4,8
5,15,8,4,8
5,16,0,4,8
5,16,1,4,8
5,16,2,4,8
5,16,3,4,8
5,16,4,4,8
5,16,5,4,8
5,16,6,4,8
5,16,7,4,8
5,16,8,4,8
5,0,0,5,8
5,0,1,5,8
5,0,2,5,8
5,0,3,5,8
5,0,4,5,8
5,0,5,5,8
5,0,6,5,8
5,0,7,5,8
5,0,8,5,8
5,1,0,5,8
5,1,1,5,8
5,1,2,5,8
5,1,3,5,8
5,1,4,5,8
5,1,5,5,8
5,1,6,5,8
5,1,7,5,8
5,1,8,5,8
5,2,0,5,8
5,2,1,5,8
5,2,2,5,8
5,2,3,5,8
5,2,4,5,8
5,2,5,5,8
5,2,6,5,8
5,2,7,5,8
5,2,8,5,8
5,3,0,5,8
5,3,1,5,8
5,3,2,5,8
5,3,3,5,8
5,3,4,5,8
5,3,5,5,8
5,3,6,5,8
5,3,7,5,8
5,3,8,5,8
5,4,0,5,8
5,4,1,5,8
5,4,2,5,8
5,4,3,5,8
5,4,4,5,8
5,4,5,5,8
5,4,6,5,8
5,4,7,5,8
5,4,8,5,8
5,5,0,5,8
5,5,1,5,8
5,5,2,5,8
5,5,3,5,8
5,5,4,5,8
5,5,5,5,8
5,5,6,5,8
5,5,7,5,8
5,5,8,5,8
5,6,0,5,8
5,6,1,5,8
5,6,2,5,8
5,6,3,5,8
5,6,4,5,8
5,6,5,5,8
5,6,6,5,8
5,6,7,5,8
5,6,8,5,8
5,7,0,5,8
5,7,1,5,8
5,7,2,5,8
5,7,3,5,8
5,7,4,5,8
5,7,5,5,8
5,7,6,5,8
5,7,7,5,8
5,7,8,5,8
5,8,0,5,8
5,8,1,5,8
5,8,2,5,8
5,8,3,5,8
5,8,4,5,8
5,8,5,5,8
5,8,6,5,8
5,8,7,5,8
5,8,8,5,8
5,9,0,5,8
5,9,1,5,8
5,9,2,5,8
5,9,3,5,8
5,9,4,5,8
5,9,5,5,8
5,9,6,5,8
5,9,7,5,8
5,9,8,5,8
5,10,0,5,8
5,10,1,5,8
5,10,2,5,8
5,10,3,5,8
5,10,4,5,8
5,10,5,5,8
5,10,6,5,8
5,10,7,5,8
5,10,8,5,8
5,11,0,5,8
5,11,1,5,8
5,11,2,5,8
5,11,3,5,8
5,11,4,5,8
5,11,5,5,8
5,11,6,5,8
5,11,7,5,8
5,11,8,5,8
5,12,0,5,8
5,12,1,5,8
5,12,2,5,8
5,12,3,5,8
5,12,4,5,8
5,12,5,5,8
5,12,6,5,8
5,12,7,5,8
5,12,8,5,8
5,13,0,5,8
5,13,1,5,8
5,13,2,5,8
5,13,3,5,8
5,13,4,5,8
5,13,5,5,8
5,13,6,5,8
5,13,7,5,8
5,13,8,5,8
5,14,0,5,8
5,14,1,5,8
5,14,2,5,8
5,14,3,5,8
5,14,4,5,8
5,14,5,5,8
5,14,6,5,8
5,14,7,5,8
5,14,8,5,8
5,0,0,6,8
5,0,1,6,8
5,0,2,6,8
5,0,3,6,8
5,0,4,6,8
5,0,5,6,8
5,0,6,6,8
5,0,7,6,8
5,0,8,6,8
5,1,0,6,8
5,1,1,6,8
5,1,2,6,8
5,1,3,6,8
5,1,4,6,8
5,1,5,6,8
5,1,6,6,8
5,1,7,6,8
5,1,8,6,8
5,2,0,6,8
5,2,1,6,8
5,2,2,6,8
5,2,3,6,8
5,2,4,6,8
5,2,5,6,8
5,2,6,6,8
5,2,7,6,8
5,2,8,6,8
5,3,0,6,8
5,3,1,6,8
5,3,2,6,8
5,3,3,6,8
5,3,4,6,8
5,3,5,6,8
5,3,6,6,8
5,3,7,6,8
5,3,8,6,8
5,4,0,6,8
5,4,1,6,8
5,4,2,6,8
5,4,3,6,8
5,4,4,6,8
5,4,5,6,8
5,4,6,6,8
5,4,7,6,8
5,4,8,6,8
5,5,0,6,8
5,5,1,6,8
5,5,2,6,8
5,5,3,6,8
5,5,4,6,8
5,5,5,6,8
5,5,6,6,8
5,5,7,6,8
5,5,8,6,8
5,6,0,6,8
5,6,1,6,8
5,6,2,6,8
5,6,3,6,8
5,6,4,6,8
5,6,5,6,8
5,6,6,6,8
5,6,7,6,8
5,6,8,6,8
5,7,0,6,8
5,7,1,6,8
5,7,2,6,8
5,7,3,6,8
5,7,4,6,8
5,7,5,6,8
5,7,6,6,8
5,7,7,6,8
5,7,8,6,8
5,8,0,6,8
5,8,1,6,8
5,8,2,6,8
5,8,3,6,8
5,8,4,6,8
5,8,5,6,8
5,8,6,6,8
5,8,7,6,8
5,8,8,6,8
5,9,0,6,8
5,9,1,6,8
5,9,2,6,8
5,9,3,6,8
5,9,4,6,8
5,9,5,6,8
5,9,6,6,8
5,9,7,6,8
5,9,8,6,8
5,10,0,6,8
5,10,1,6,8
5,10,2,6,8
5,10,3,6,8
5,10,4,6,8
5,10,5,6,8
5,10,6,6,8
5,10,7,6,8
5,10,8,6,8
5,11,0,6,8
5,11,1,6,8
5,11,2,6,8
5,11,3,6,8
5,11,4,6,8
5,11,5,6,8
5,11,6,6,8
5,11,7,6,8
5,11,8,6,8
5,12,0,6,8
5,12,1,6,8
5,12,2,6,8
5,12,3,6,8
5,12,4,6,8
5,12,5,6,8
5,12,6,6,8
5,12,7,6,8
5,12,8,6,8
5,0,0,7,8
5,0,1,7,8
5,0,2,7,8
5,0,3,7,8
5,0,4,7,8
5,0,5,7,8
5,0,6,7,8
5,0,7,7,8
5,0,8,7,8
5,1,0,7,8
5,1,1,7,8
5,1,2,7,8
5,1,3,7,8
5,1,4,7,8
5,1,5,7,8
5,1,6,7,8
5,1,7,7,8
5,1,8,7,8
5,2,0,7,8
5,2,1,7,8
5,2,2,7,8
5,2,3,7,8
5,2,4,7,8
5,2,5,7,8
5,2,6,7,8
5,2,7,7,8
5,2,8,7,8
5,3,0,7,8
5,3,1,7,8
5,3,2,7,8
5,3,3,7,8
5,3,4,7,8
5,3,5,7,8
5,3,6,7,8
5,3,7,7,8
5,3,8,7,8
5,4,0,7,8
5,4,1,7,8
5,4,2,7,8
5,4,3,7,8
5,4,4,7,8
5,4,5,7,8
5,4,6,7,8
5,4,7,7,8
5,4,8,7,8
5,5,0,7,8
5,5,1,7,8
5,5,2,7,8
5,5,3,7,8
5,5,4,7,8
5,5,5,7,8
5,5,6,7,8
5,5,7,7,8
5,5,8,7,8
5,6,0,7,8
5,6,1,7,8
5,6,2,7,8
5,6,3,7,8
5,6,4,7,8
5,6,5,7,8
5,6,6,7,8
5,6,7,7,8
5,6,8,7,8
5,7,0,7,8
5,7,1,7,8
5,7,2,7,8
5,7,3,7,8
5,7,4,7,8
5,7,5,7,8
5,7,6,7,8
5,7,7,7,8
5,7,8,7,8
5,8,0,7,8
5,8,1,7,8
5,8,2,7,8
5,8,3,7,8
5,8,4,7,8
5,8,5,7,8
5,8,6,7,8
5,8,7,7,8
5,8,8,7,8
5,9,0,7,8
5,9,1,7,8
5,9,2,7,8
5,9,3,7,8
5,9,4,7,8
5,9,5,7,8
5,9,6,7,8
5,9,7,7,8
5,9,8,7,8
5,10,0,7,8
5,10,1,7,8
5,10,2,7,8
5,10,3,7,8
5,10,4,7,8
5,10,5,7,8
5,10,6,7,8
5,10,7,7,8
5,10,8,7,8
5,0,0,8,8
5,0,1,8,8
5,0,2,8,8
5,0,3,8,8
5,0,4,8,8
5,0,5,8,8
5,0,6,8,8
5,0,7,8,8
5,0,8,8,8
5,1,0,8,8
5,1,1,8,8
5,1,2,8,8
5,1,3,8,8
5,1,4,8,8
5,1,5,8,8
5,1,6,8,8
5,1,7,8,8
5,1,8,8,8
5,2,0,8,8
5,2,1,8,8
5,2,2,8,8
5,2,3,8,8
5,2,4,8,8
5,2,5,8,8
5,2,6,8,8
5,2,7,8,8
5,2,8,8,8
5,3,0,8,8
5,3,1,8,8
5,3,2,8,8
5,3,3,8,8
5,3,4,8,8
5,3,5,8,8
5,3,6,8,8
5,3,7,8,8
5,3,8,8,8
5,4,0,8,8
5,4,1,8,8
5,4,2,8,8
5,4,3,8,8
5,4,4,8,8
5,4,5,8,8
5,4,6,8,8
5,4,7,8,8
5,4,8,8,8
5,5,0,8,8
5,5,1,8,8
5,5,2,8,8
5,5,3,8,8
5,5,4,8,8
5,5,5,8,8
5,5,6,8,8
5,5,7,8,8
5,5,8,8,8
5,6,0,8,8
5,6,1,8,8
5,6,2,8,8
5,6,3,8,8
5,6,4,8,8
5,6,5,8,8
5,6,6,8,8
5,6,7,8,8
5,6,8,8,8
5,7,0,8,8
5,7,1,8,8
5,7,2,8,8
5,7,3,8,8
5,7,4,8,8
5,7,5,8,8
5,7,6,8,8
5,7,7,8,8
5,7,8,8,8
5,8,0,8,8
5,8,1,8,8
5,8,2,8,8
5,8,3,8,8
5,8,4,8,8
5,8,5,8,8
5,8,6,8,8
5,8,7,8,8
5,8,8,8,8
5,0,0,9,8
5,0,1,9,8
5,0,2,9,8
5,0,3,9,8
5,0,4,9,8
5,0,5,9,8
5,0,6,9,8
5,0,7,9,8
5,0,8,9,8
5,1,0,9,8
5,1,1,9,8
5,1,2,9,8
5,1,3,9,8
5,1,4,9,8
5,1,5,9,8
5,1,6,9,8
5,1,7,9,8
5,1,8,9,8
5,2,0,9,8
5,2,1,9,8
5,2,2,9,8
5,2,3,9,8
5,2,4,9,8
5,2,5,9,8
5,2,6,9,8
5,2,7,9,8
5,2,8,9,8
5,3,0,9,8
5,3,1,9,8
5,3,2,9,8
5,3,3,9,8
5,3,4,9,8
5,3,5,9,8
5,3,6,9,8
5,3,7,9,8
5,3,8,9,8
5,4,0,9,8
5,4,1,9,8
5,4,2,9,8
5,4,3,9,8
5,4,4,9,8
5,4,5,9,8
5,4,6,9,8
5,4,7,9,8
5,4,8,9,8
5,5,0,9,8
5,5,1,9,8
5,5,2,9,8
5,5,3,9,8
5,5,4,9,8
5,5,5,9,8
5,5,6,9,8
5,5,7,9,8
5,5,8,9,8
5,6,0,9,8
5,6,1,9,8
5,6,2,9,8
5,6,3,9,8
5,6,4,9,8
5,6,5,9,8
5,6,6,9,8
5,6,7,9,8
5,6,8,9,8
5,0,0,10,8
5,0,1,10,8
5,0,2,10,8
5,0,3,10,8
5,0,4,10,8
5,0,5,10,8
5,0,6,10,8
5,0,7,10,8
5,0,8,10,8
5,1,0,10,8
5,1,1,10,8
5,1,2,10,8
5,1,3,10,8
5,1,4,10,8
5,1,5,10,8
5,1,6,10,8
5,1,7,10,8
5,1,8,10,8
5,2,0,10,8
5,2,1,10,8
5,2,2,10,8
5,2,3,10,8
5,2,4,10,8
5,2,5,10,8
5,2,6,10,8
5,2,7,10,8
5,2,8,10,8
5,3,0,10,8
5,3,1,10,8
5,3,2,10,8
5,3,3,10,8
5,3,4,10,8
5,3,5,10,8
5,3,6,10,8
5,3,7,10,8
5,3,8,10,8
5,4,0,10,8
5,4,1,10,8
5,4,2,10,8
5,4,3,10,8
5,4,4,10,8
5,4,5,10,8
5,4,6,10,8
5,4,7,10,8
5,4,8,10,8
5,0,0,11,8
5,0,1,11,8
5,0,2,11,8
5,0,3,11,8
5,0,4,11,8
5,0,5,11,8
5,0,6,11,8
5,0,7,11,8
5,0,8,11,8
5,1,0,11,8
5,1,1,11,8
5,1,2,11,8
5,1,3,11,8
5,1,4,11,8
5,1,5,11,8
5,1,6,11,8
5,1,7,11,8
5,1,8,11,8
5,2,0,11,8
5,2,1,11,8
5,2,2,11,8
5,2,3,11,8
5,2,4,11,8
5,2,5,11,8
5,2,6,11,8
5,2,7,11,8
5,2,8,11,8
5,0,0,12,8
5,0,1,12,8
5,0,2,12,8
5,0,3,12,8
5,0,4,12,8
5,0,5,12,8
5,0,6,12,8
5,0,7,12,8
5,0,8,12,8
5,0,0,1,9
5,0,1,1,9
5,0,2,1,9
5,0,3,1,9
5,0,4,1,9
5,0,5,1,9
5,0,6,1,9
5,1,0,1,9
5,1,1,1,9
5,1,2,1,9
5,1,3,1,9
5,1,4,1,9
5,1,5,1,9
5,1,6,1,9
5,2,0,1,9
5,2,1,1,9
5,2,2,1,9
5,2,3,1,9
5,2,4,1,9
5,2,5,1,9
5,2,6,1,9
5,3,0,1,9
5,3,1,1,9
5,3,2,1,9
5,3,3,1,9
5,3,4,1,9
5,3,5,1,9
5,3,6,1,9
5,4,0,1,9
5,4,1,1,9
5,4,2,1,9
5,4,3,1,9
5,4,4,1,9
5,4,5,1,9
5,4,6,1,9
5,5,0,1,9
5,5,1,1,9
5,5,2,1,9
5,5,3,1,9
5,5,4,1,9
5,5,5,1,9
5,5,6,1,9
5,6,0,1,9
5,6,1,1,9
5,6,2,1,9
5,6,3,1,9
5,6,4,1,9
5,6,5,1,9
5,6,6,1,9
5,7,0,1,9
5,7,1,1,9
5,7,2,1,9
5,7,3,1,9
5,7,4,1,9
5,7,5,1,9
5,7,6,1,9
5,8,0,1,9
5,8,1,1,9
5,8,2,1,9
5,8,3,1,9
5,8,4,1,9
5,8,5,1,9
5,8,6,1,9
5,9,0,1,9
5,9,1,1,9
5,9,2,1,9
5,9,3,1,9
5,9,4,1,9
5,9,5,1,9
5,9,6,1,9
5,10,0,1,9
5,10,1,1,9
5,10,2,1,9
5,10,3,1,9
5,10,4,1,9
5,10,5,1,9
5,10,6,1,9
5,11,0,1,9
5,11,1,1,9
5,11,2,1,9
5,11,3,1,9
5,11,4,1,9
5,11,5,1,9
5,11,6,1,9
5,12,0,1,9
5,12,1,1,9
5,12,2,1,9
5,12,3,1,9
5,12,4,1,9
5,12,5,1,9
5,12,6,1,9
5,13,0,1,9
5,13,1,1,9
5,13,2,1,9
5,13,3,1,9
5,13,4,1,9
5,13,5,1,9
5,13,6,1,9
5,14,0,1,9
5,14,1,1,9
5,14,2,1,9
5,14,3,1,9
5,14,4,1,9
5,14,5,1,9
5,14,6,1,9
5,15,0,1,9
5,15,1,1,9
5,15,2,1,9
5,15,3,1,9
5,15,4,1,9
5,15,5,1,9
5,15,6,1,9
5,16,0,1,9
5,16,1,1,9
5,16,2,1,9
5,16,3,1,9
5,16,4,1,9
5,16,5,1,9
5,16,6,1,9
5,17,0,1,9
5,17,1,1,9
5,17,2,1,9
5,17,3,1,9
5,17,4,1,9
5,17,5,1,9
5,17,6,1,9
5,18,0,1,9
5,18,1,1,9
5,18,2,1,9
5,18,3,1,9
5,18,4,1,9
5,18,5,1,9
5,18,6,1,9
5,19,0,1,9
5,19,1,1,9
5,19,2,1,9
5,19,3,1,9
5,19,4,1,9
5,19,5,1,9
5,19,6,1,9
5,20,0,1,9
5,20,1,1,9
5,20,2,1,9
5,20,3,1,9
5,20,4,1,9
5,20,5,1,9
5,20,6,1,9
5,21,0,1,9
5,21,1,1,9
5,21,2,1,9
5,21,3,1,9
5,21,4,1,9
5,21,5,1,9
5,21,6,1,9
5,22,0,1,9
5,22,1,1,9
5,22,2,1,9
5,22,3,1,9
5,22,4,1,9
5,22,5,1,9
5,22,6,1,9
5,0,0,2,9
5,0,1,2,9
5,0,2,2,9
5,0,3,2,9
5,0,4,2,9
5,0,5,2,9
5,0,6,2,9
5,1,0,2,9
5,1,1,2,9
5,1,2,2,9
5,1,3,2,9
5,1,4,2,9
5,1,5,2,9
5,1,6,2,9
5,2,0,2,9
5,2,1,2,9
5,2,2,2,9
5,2,3,2,9
5,2,4,2,9
5,2,5,2,9
5,2,6,2,9
5,3,0,2,9
5,3,1,2,9
5,3,2,2,9
5,3,3,2,9
5,3,4,2,9
5,3,5,2,9
5,3,6,2,9
5,4,0,2,9
5,4,1,2,9
5,4,2,2,9
5,4,3,2,9
5,4,4,2,9
5,4,5,2,9
5,4,6,2,9
5,5,0,2,9
5,5,1,2,9
5,5,2,2,9
5,5,3,2,9
5,5,4,2,9
5,5,5,2,9
5,5,6,2,9
5,6,0,2,9
5,6,1,2,9
5,6,2,2,9
5,6,3,2,9
5,6,4,2,9
5,6,5,2,9
5,6,6,2,9
5,7,0,2,9
5,7,1,2,9
5,7,2,2,9
5,7,3,2,9
5,7,4,2,9
5,7,5,2,9
5,7,6,2,9
5,8,0,2,9
5,8,1,2,9
5,8,2,2,9
5,8,3,2,9
5,8,4,2,9
5,8,5,2,9
5,8,6,2,9
5,9,0,2,9
5,9,1,2,9
5,9,2,2,9
5,9,3,2,9
5,9,4,2,9
5,9,5,2,9
5,9,6,2,9
5,10,0,2,9
5,10,1,2,9
5,10,2,2,9
5,10,3,2,9
5,10,4,2,9
5,10,5,2,9
5,10,6,2,9
5,11,0,2,9
5,11,1,2,9
5,11,2,2,9
5,11,3,2,9
5,11,4,2,9
5,11,5,2,9
5,11,6,2,9
5,12,0,2,9
5,12,1,2,9
5,12,2,2,9
5,12,3,2,9
5,12,4,2,9
5,12,5,2,9
5,12,6,2,9
5,13,0,2,9
5,13,1,2,9
5,13,2,2,9
5,13,3,2,9
5,13,4,2,9
5,13,5,2,9
5,13,6,2,9
5,14,0,2,9
5,14,1,2,9
5,14,2,2,9
5,14,3,2,9
5,14,4,2,9
5,14,5,2,9
5,14,6,2,9
5,15,0,2,9
5,15,1,2,9
5,15,2,2,9
5,15,3,2,9
5,15,4,2,9
5,15,5,2,9
5,15,6,2,9
5,16,0,2,9
5,16,1,2,9
5,16,2,2,9
5,16,3,2,9
5,16,4,2,9
5,16,5,2,9
5,16,6,2,9
5,17,0,2,9
5,17,1,2,9
5,17,2,2,9
5,17,3,2,9
5,17,4,2,9
5,17,5,2,9
5,17,6,2,9
5,18,0,2,9
5,18,1,2,9
5,18,2,2,9
5,18,3,2,9
5,18,4,2,9
5,18,5,2,9
5,18,6,2,9
5,19,0,2,9
5,19,1,2,9
5,19,2,2,9
5,19,3,2,9
5,19,4,2,9
5,19,5,2,9
5,19,6,2,9
5,20,0,2,9
5,20,1,2,9
5,20,2,2,9
5,20,3,2,9
5,20,4,2,9
5,20,5,2,9
5,20,6,2,9
5,0,0,3,9
5,0,1,3,9
5,0,2,3,9
5,0,3,3,9
5,0,4,3,9
5,0,5,3,9
5,0,6,3,9
5,1,0,3,9
5,1,1,3,9
5,1,2,3,9
5,1,3,3,9
5,1,4,3,9
5,1,5,3,9
5,1,6,3,9
5,2,0,3,9
5,2,1,3,9
5,2,2,3,9
5,2,3,3,9
5,2,4,3,9
5,2,5,3,9
5,2,6,3,9
5,3,0,3,9
5,3,1,3,9
5,3,2,3,9
5,3,3,3,9
5,3,4,3,9
5,3,5,3,9
5,3,6,3,9
5,4,0,3,9
5,4,1,3,9
5,4,2,3,9
5,4,3,3,9
5,4,4,3,9
5,4,5,3,9
5,4,6,3,9
5,5,0,3,9
5,5,1,3,9
5,5,2,3,9
5,5,3,3,9
5,5,4,3,9
5,5,5,3,9
5,5,6,3,9
5,6,0,3,9
5,6,1,3,9
5,6,2,3,9
5,6,3,3,9
5,6,4,3,9
5,6,5,3,9
5,6,6,3,9
5,7,0,3,9
5,7,1,3,9
5,7,2,3,9
5,7,3,3,9
5,7,4,3,9
5,7,5,3,9
5,7,6,3,9
5,8,0,3,9
5,8,1,3,9
5,8,2,3,9
5,8,3,3,9
5,8,4,3,9
5,8,5,3,9
5,8,6,3,9
5,9,0,3,9
5,9,1,3,9
5,9,2,3,9
5,9,3,3,9
5,9,4,3,9
5,9,5,3,9
5,9,6,3,9
5,10,0,3,9
5,10,1,3,9
5,10,2,3,9
5,10,3,3,9
5,10,4,3,9
5,10,5,3,9
5,10,6,3,9
5,11,0,3,9
5,11,1,3,9
5,11,2,3,9
5,11,3,3,9
5,11,4,3,9
5,11,5,3,9
5,11,6,3,9
5,12,0,3,9
5,12,1,3,9
5,12,2,3,9
5,12,3,3,9
5,12,4,3,9
5,12,5,3,9
5,12,6,3,9
5,13,0,3,9
5,13,1,3,9
5,13,2,3,9
5,13,3,3,9
5,13,4,3,9
5,13,5,3,9
5,13,6,3,9
5,14,0,3,9
5,14,1,3,9
5,14,2,3,9
5,14,3,3,9
5,14,4,3,9
5,14,5,3,9
5,14,6,3,9
5,15,0,3,9
5,15,1,3,9
5,15,2,3,9
5,15,3,3,9
5,15,4,3,9
5,15,5,3,9
5,15,6,3,9
5,16,0,3,9
5,16,1,3,9
5,16,2,3,9
5,16,3,3,9
5,16,4,3,9
5,16,5,3,9
5,16,6,3,9
5,17,0,3,9
5,17,1,3,9
5,17,2,3,9
5,17,3,3,9
5,17,4,3,9
5,17,5,3,9
5,17,6,3,9
5,18,0,3,9
5,18,1,3,9
5,18,2,3,9
5,18,3,3,9
5,18,4,3,9
5,18,5,3,9
5,18,6,3,9
5,0,0,4,9
5,0,1,4,9
5,0,2,4,9
5,0,3,4,9
5,0,4,4,9
5,0,5,4,9
5,0,6,4,9
5,1,0,4,9
5,1,1,4,9
5,1,2,4,9
5,1,3,4,9
5,1,4,4,9
5,1,5,4,9
5,1,6,4,9
5,2,0,4,9
5,2,1,4,9
5,2,2,4,9
5,2,3,4,9
5,2,4,4,9
5,2,5,4,9
5,2,6,4,9
5,3,0,4,9
5,3,1,4,9
5,3,2,4,9
5,3,3,4,9
5,3,4,4,9
5,3,5,4,9
5,3,6,4,9
5,4,0,4,9
5,4,1,4,9
5,4,2,4,9
5,4,3,4,9
5,4,4,4,9
5,4,5,4,9
5,4,6,4,9
5,5,0,4,9
5,5,1,4,9
5,5,2,4,9
5,5,3,4,9
5,5,4,4,9
5,5,5,4,9
5,5,6,4,9
5,6,0,4,9
5,6,1,4,9
5,6,2,4,9
5,6,3,4,9
5,6,4,4,9
5,6,5,4,9
5,6,6,4,9
5,7,0,4,9
5,7,1,4,9
5,7,2,4,9
5,7,3,4,9
5,7,4,4,9
5,7,5,4,9
5,7,6,4,9
5,8,0,4,9
5,8,1,4,9
5,8,2,4,9
5,8,3,4,9
5,8,4,4,9
5,8,5,4,9
5,8,6,4,9
5,9,0,4,9
5,9,1,4,9
5,9,2,4,9
5,9,3,4,9
5,9,4,4,9
5,9,5,4,9
5,9,6,4,9
5,10,0,4,9
5,10,1,4,9
5,10,2,4,9
5,10,3,4,9
5,10,4,4,9
5,10,5,4,9
5,10,6,4,9
5,11,0,4,9
5,11,1,4,9
5,11,2,4,9
5,11,3,4,9
5,11,4,4,9
5,11,5,4,9
5,11,6,4,9
5,12,0,4,9
5,12,1,4,9
5,12,2,4,9
5,12,3,4,9
5,12,4,4,9
5,12,5,4,9
5,12,6,4,9
5,13,0,4,9
5,13,1,4,9
5,13,2,4,9
5,13,3,4,9
5,13,4,4,9
5,13,5,4,9
5,13,6,4,9
5,14,0,4,9
5,14,1,4,9
5,14,2,4,9
5,14,3,4,9
5,14,4,4,9
5,14,5,4,9
5,14,6,4,9
5,15,0,4,9
5,15,1,4,9
5,15,2,4,9
5,15,3,4,9
5,15,4,4,9
5,15,5,4,9
5,15,6,4,9
5,16,0,4,9
5,16,1,4,9
5,16,2,4,9
5,16,3,4,9
5,16,4,4,9
5,16,5,4,9
5,16,6,4,9
5,0,0,5,9
5,0,1,5,9
5,0,2,5,9
5,0,3,5,9
5,0,4,5,9
5,0,5,5,9
5,0,6,5,9
5,1,0,5,9
5,1,1,5,9
5,1,2,5,9
5,1,3,5,9
5,1,4,5,9
5,1,5,5,9
5,1,6,5,9
5,2,0,5,9
5,2,1,5,9
5,2,2,5,9
5,2,3,5,9
5,2,4,5,9
5,2,5,5,9
5,2,6,5,9
5,3,0,5,9
5,3,1,5,9
5,3,2,5,9
5,3,3,5,9
5,3,4,5,9
5,3,5,5,9
5,3,6,5,9
5,4,0,5,9
5,4,1,5,9
5,4,2,5,9
5,4,3,5,9
5,4,4,5,9
5,4,5,5,9
5,4,6,5,9
5,5,0,5,9
5,5,1,5,9
5,5,2,5,9
5,5,3,5,9
5,5,4,5,9
5,5,5,5,9
5,5,6,5,9
5,6,0,5,9
5,6,1,5,9
5,6,2,5,9
5,6,3,5,9
5,6,4,5,9
5,6,5,5,9
5,6,6,5,9
5,7,0,5,9
5,7,1,5,9
5,7,2,5,9
5,7,3,5,9
5,7,4,5,9
5,7,5,5,9
5,7,6,5,9
5,8,0,5,9
5,8,1,5,9
5,8,2,5,9
5,8,3,5,9
5,8,4,5,9
5,8,5,5,9
5,8,6,5,9
5,9,0,5,9
5,9,1,5,9
5,9,2,5,9
5,9,3,5,9
5,9,4,5,9
5,9,5,5,9
5,9,6,5,9
5,10,0,5,9
5,10,1,5,9
5,10,2,5,9
5,10,3,5,9
5,10,4,5,9
5,10,5,5,9
5,10,6,5,9
5,11,0,5,9
5,11,1,5,9
5,11,2,5,9
5,11,3,5,9
5,11,4,5,9
5,11,5,5,9
5,11,6,5,9
5,12,0,5,9
5,12,1,5,9
5,12,2,5,9
5,12,3,5,9
5,12,4,5,9
5,12,5,5,9
5,12,6,5,9
5,13,0,5,9
5,13,1,5,9
5,13,2,5,9
5,13,3,5,9
5,13,4,5,9
5,13,5,5,9
5,13,6,5,9
5,14,0,5,9
5,14,1,5,9
5,14,2,5,9
5,14,3,5,9
5,14,4,5,9
5,14,5,5,9
5,14,6,5,9
5,0,0,6,9
5,0,1,6,9
5,0,2,6,9
5,0,3,6,9
5,0,4,6,9
5,0,5,6,9
5,0,6,6,9
5,1,0,6,9
5,1,1,6,9
5,1,2,6,9
5,1,3,6,9
5,1,4,6,9
5,1,5,6,9
5,1,6,6,9
5,2,0,6,9
5,2,1,6,9
5,2,2,6,9
5,2,3,6,9
5,2,4,6,9
5,2,5,6,9
5,2,6,6,9
5,3,0,6,9
5,3,1,6,9
5,3,2,6,9
5,3,3,6,9
5,3,4,6,9
5,3,5,6,9
5,3,6,6,9
5,4,0,6,9
5,4,1,6,9
5,4,2,6,9
5,4,3,6,9
5,4,4,6,9
5,4,5,6,9
5,4,6,6,9
5,5,0,6,9
5,5,1,6,9
5,5,2,6,9
5,5,3,6,9
5,5,4,6,9
5,5,5,6,9
5,5,6,6,9
5,6,0,6,9
5,6,1,6,9
5,6,2,6,9
5,6,3,6,9
5,6,4,6,9
5,6,5,6,9
5,6,6,6,9
5,7,0,6,9
5,7,1,6,9
5,7,2,6,9
5,7,3,6,9
5,7,4,6,9
5,7,5,6,9
5,7,6,6,9
5,8,0,6,9
5,8,1,6,9
5,8,2,6,9
5,8,3,6,9
5,8,4,6,9
5,8,5,6,9
5,8,6,6,9
5,9,0,6,9
5,9,1,6,9
5,9,2,6,9
5,9,3,6,9
5,9,4,6,9
5,9,5,6,9
5,9,6,6,9
5,10,0,6,9
5,10,1,6,9
5,10,2,6,9
5,10,3,6,9
5,10,4,6,9
5,10,5,6,9
5,10,6,6,9
5,11,0,6,9
5,11,1,6,9
5,11,2,6,9
5,11,3,6,9
5,11,4,6,9
5,11,5,6,9
5,11,6,6,9
5,12,0,6,9
5,12,1,6,9
5,12,2,6,9
5,12,3,6,9
5,12,4,6,9
5,12,5,6,9
5,12,6,6,9
5,0,0,7,9
5,0,1,7,9
5,0,2,7,9
5,0,3,7,9
5,0,4,7,9
5,0,5,7,9
5,0,6,7,9
5,1,0,7,9
5,1,1,7,9
5,1,2,7,9
5,1,3,7,9
5,1,4,7,9
5,1,5,7,9
5,1,6,7,9
5,2,0,7,9
5,2,1,7,9
5,2,2,7,9
5,2,3,7,9
5,2,4,7,9
5,2,5,7,9
5,2,6,7,9
5,3,0,7,9
5,3,1,7,9
5,3,2,7,9
5,3,3,7,9
5,3,4,7,9
5,3,5,7,9
5,3,6,7,9
5,4,0,7,9
5,4,1,7,9
5,4,2,7,9
5,4,3,7,9
5,4,4,7,9
5,4,5,7,9
5,4,6,7,9
5,5,0,7,9
5,5,1,7,9
5,5,2,7,9
5,5,3,7,9
5,5,4,7,9
5,5,5,7,9
5,5,6,7,9
5,6,0,7,9
5,6,1,7,9
5,6,2,7,9
5,6,3,7,9
5,6,4,7,9
5,6,5,7,9
5,6,6,7,9
5,7,0,7,9
5,7,1,7,9
5,7,2,7,9
5,7,3,7,9
5,7,4,7,9
5,7,5,7,9
5,7,6,7,9
5,8,0,7,9
5,8,1,7,9
5,8,2,7,9
5,8,3,7,9
5,8,4,7,9
5,8,5,7,9
5,8,6,7,9
5,9,0,7,9
5,9,1,7,9
5,9,2,7,9
5,9,3,7,9
5,9,4,7,9
5,9,5,7,9
5,9,6,7,9
5,10,0,7,9
5,10,1,7,9
5,10,2,7,9
5,10,3,7,9
5,10,4,7,9
5,10,5,7,9
5,10,6,7,9
5,0,0,8,9
5,0,1,8,9
5,0,2,8,9
5,0,3,8,9
5,0,4,8,9
5,0,5,8,9
5,0,6,8,9
5,1,0,8,9
5,1,1,8,9
5,1,2,8,9
5,1,3,8,9
5,1,4,8,9
5,1,5,8,9
5,1,6,8,9
5,2,0,8,9
5,2,1,8,9
5,2,2,8,9
5,2,3,8,9
5,2,4,8,9
5,2,5,8,9
5,2,6,8,9
5,3,0,8,9
5,3,1,8,9
5,3,2,8,9
5,3,3,8,9
5,3,4,8,9
5,3,5,8,9
5,3,6,8,9
5,4,0,8,9
5,4,1,8,9
5,4,2,8,9
5,4,3,8,9
5,4,4,8,9
5,4,5,8,9
5,4,6,8,9
5,5,0,8,9
5,5,1,8,9
5,5,2,8,9
5,5,3,8,9
5,5,4,8,9
5,5,5,8,9
5,5,6,8,9
5,6,0,8,9
5,6,1,8,9
5,6,2,8,9
5,6,3,8,9
5,6,4,8,9
5,6,5,8,9
5,6,6,8,9
5,7,0,8,9
5,7,1,8,9
5,7,2,8,9
5,7,3,8,9
5,7,4,8,9
5,7,5,8,9
5,7,6,8,9
5,8,0,8,9
5,8,1,8,9
5,8,2,8,9
5,8,3,8,9
5,8,4,8,9
5,8,5,8,9
5,8,6,8,9
5,0,0,9,9
5,0,1,9,9
5,0,2,9,9
5,0,3,9,9
5,0,4,9,9
5,0,5,9,9
5,0,6,9,9
5,1,0,9,9
5,1,1,9,9
5,1,2,9,9
5,1,3,9,9
5,1,4,9,9
5,1,5,9,9
5,1,6,9,9
5,2,0,9,9
5,2,1,9,9
5,2,2,9,9
5,2,3,9,9
5,2,4,9,9
5,2,5,9,9
5,2,6,9,9
5,3,0,9,9
5,3,1,9,9
5,3,2,9,9
5,3,3,9,9
5,3,4,9,9
5,3,5,9,9
5,3,6,9,9
5,4,0,9,9
5,4,1,9,9
5,4,2,9,9
5,4,3,9,9
5,4,4,9,9
5,4,5,9,9
5,4,6,9,9
5,5,0,9,9
5,5,1,9,9
5,5,2,9,9
5,5,3,9,9
5,5,4,9,9
5,5,5,9,9
5,5,6,9,9
5,6,0,9,9
5,6,1,9,9
5,6,2,9,9
5,6,3,9,9
5,6,4,9,9
5,6,5,9,9
5,6,6,9,9
5,0,0,10,9
5,0,1,10,9
5,0,2,10,9
5,0,3,10,9
5,0,4,10,9
5,0,5,10,9
5,0,6,10,9
5,1,0,10,9
5,1,1,10,9
5,1,2,10,9
5,1,3,10,9
5,1,4,10,9
5,1,5,10,9
5,1,6,10,9
5,2,0,10,9
5,2,1,10,9
5,2,2,10,9
5,2,3,10,9
5,2,4,10,9
5,2,5,10,9
5,2,6,10,9
5,3,0,10,9
5,3,1,10,9
5,3,2,10,9
5,3,3,10,9
5,3,4,10,9
5,3,5,10,9
5,3,6,10,9
5,4,0,10,9
5,4,1,10,9
5,4,2,10,9
5,4,3,10,9
5,4,4,10,9
5,4,5,10,9
5,4,6,10,9
5,0,0,11,9
5,0,1,11,9
5,0,2,11,9
5,0,3,11,9
5,0,4,11,9
5,0,5,11,9
5,0,6,11,9
5,1,0,11,9
5,1,1,11,9
5,1,2,11,9
5,1,3,11,9
5,1,4,11,9
5,1,5,11,9
5,1,6,11,9
5,2,0,11,9
5,2,1,11,9
5,2,2,11,9
5,2,3,11,9
5,2,4,11,9
5,2,5,11,9
5,2,6,11,9
5,0,0,12,9
5,0,1,12,9
5,0,2,12,9
5,0,3,12,9
5,0,4,12,9
5,0,5,12,9
5,0,6,12,9
5,0,0,1,10
5,0,1,1,10
5,0,2,1,10
5,0,3,1,10
5,0,4,1,10
5,1,0,1,10
5,1,1,1,10
5,1,2,1,10
5,1,3,1,10
5,1,4,1,10
5,2,0,1,10
5,2,1,1,10
5,2,2,1,10
5,2,3,1,10
5,2,4,1,10
5,3,0,1,10
5,3,1,1,10
5,3,2,1,10
5,3,3,1,10
5,3,4,1,10
5,4,0,1,10
5,4,1,1,10
5,4,2,1,10
5,4,3,1,10
5,4,4,1,10
5,5,0,1,10
5,5,1,1,10
5,5,2,1,10
5,5,3,1,10
5,5,4,1,10
5,6,0,1,10
5,6,1,1,10
5,6,2,1,10
5,6,3,1,10
5,6,4,1,10
5,7,0,1,10
5,7,1,1,10
5,7,2,1,10
5,7,3,1,10
5,7,4,1,10
5,8,0,1,10
5,8,1,1,10
5,8,2,1,10
5,8,3,1,10
5,8,4,1,10
5,9,0,1,10
5,9,1,1,10
5,9,2,1,10
5,9,3,1,10
5,9,4,1,10
5,10,0,1,10
5,10,1,1,10
5,10,2,1,10
5,10,3,1,10
5,10,4,1,10
5,11,0,1,10
5,11,1,1,10
5,11,2,1,10
5,11,3,1,10
5,11,4,1,10
5,12,0,1,10
5,12,1,1,10
5,12,2,1,10
5,12,3,1,10
5,12,4,1,10
5,13,0,1,10
5,13,1,1,10
5,13,2,1,10
5,13,3,1,10
5,13,4,1,10
5,14,0,1,10
5,14,1,1,10
5,14,2,1,10
5,14,3,1,10
5,14,4,1,10
5,15,0,1,10
5,15,1,1,10
5,15,2,1,10
5,15,3,1,10
5,15,4,1,10
5,16,0,1,10
5,16,1,1,10
5,16,2,1,10
5,16,3,1,10
5,16,4,1,10
5,17,0,1,10
5,17,1,1,10
5,17,2,1,10
5,17,3,1,10
5,17,4,1,10
5,18,0,1,10
5,18,1,1,10
5,18,2,1,10
5,18,3,1,10
5,18,4,1,10
5,19,0,1,10
5,19,1,1,10
5,19,2,1,10
5,19,3,1,10
5,19,4,1,10
5,20,0,1,10
5,20,1,1,10
5,20,2,1,10
5,20,3,1,10
5,20,4,1,10
5,21,0,1,10
5,21,1,1,10
5,21,2,1,10
5,21,3,1,10
5,21,4,1,10
5,22,0,1,10
5,22,1,1,10
5,22,2,1,10
5,22,3,1,10
5,22,4,1,10
5,0,0,2,10
5,0,1,2,10
5,0,2,2,10
5,0,3,2,10
5,0,4,2,10
5,1,0,2,10
5,1,1,2,10
5,1,2,2,10
5,1,3,2,10
5,1,4,2,10
5,2,0,2,10
5,2,1,2,10
5,2,2,2,10
5,2,3,2,10
5,2,4,2,10
5,3,0,2,10
5,3,1,2,10
5,3,2,2,10
5,3,3,2,10
5,3,4,2,10
5,4,0,2,10
5,4,1,2,10
5,4,2,2,10
5,4,3,2,10
5,4,4,2,10
5,5,0,2,10
5,5,1,2,10
5,5,2,2,10
5,5,3,2,10
5,5,4,2,10
5,6,0,2,10
5,6,1,2,10
5,6,2,2,10
5,6,3,2,10
5,6,4,2,10
5,7,0,2,10
5,7,1,2,10
5,7,2,2,10
5,7,3,2,10
5,7,4,2,10
5,8,0,2,10
5,8,1,2,10
5,8,2,2,10
5,8,3,2,10
5,8,4,2,10
5,9,0,2,10
5,9,1,2,10
5,9,2,2,10
5,9,3,2,10
5,9,4,2,10
5,10,0,2,10
5,10,1,2,10
5,10,2,2,10
5,10,3,2,10
5,10,4,2,10
5,11,0,2,10
5,11,1,2,10
5,11,2,2,10
5,11,3,2,10
5,11,4,2,10
5,12,0,2,10
5,12,1,2,10
5,12,2,2,10
5,12,3,2,10
5,12,4,2,10
5,13,0,2,10
5,13,1,2,10
5,13,2,2,10
5,13,3,2,10
5,13,4,2,10
5,14,0,2,10
5,14,1,2,10
5,14,2,2,10
5,14,3,2,10
5,14,4,2,10
5,15,0,2,10
5,15,1,2,10
5,15,2,2,10
5,15,3,2,10
5,15,4,2,10
5,16,0,2,10
5,16,1,2,10
5,16,2,2,10
5,16,3,2,10
5,16,4,2,10
5,17,0,2,10
5,17,1,2,10
5,17,2,2,10
5,17,3,2,10
5,17,4,2,10
5,18,0,2,10
5,18,1,2,10
5,18,2,2,10
5,18,3,2,10
5,18,4,2,10
5,19,0,2,10
5,19,1,2,10
5,19,2,2,10
5,19,3,2,10
5,19,4,2,10
5,20,0,2,10
5,20,1,2,10
5,20,2,2,10
5,20,3,2,10
5,20,4,2,10
5,0,0,3,10
5,0,1,3,10
5,0,2,3,10
5,0,3,3,10
5,0,4,3,10
5,1,0,3,10
5,1,1,3,10
5,1,2,3,10
5,1,3,3,10
5,1,4,3,10
5,2,0,3,10
5,2,1,3,10
5,2,2,3,10
5,2,3,3,10
5,2,4,3,10
5,3,0,3,10
5,3,1,3,10
5,3,2,3,10
5,3,3,3,10
5,3,4,3,10
5,4,0,3,10
5,4,1,3,10
5,4,2,3,10
5,4,3,3,10
5,4,4,3,10
5,5,0,3,10
5,5,1,3,10
5,5,2,3,10
5,5,3,3,10
5,5,4,3,10
5,6,0,3,10
5,6,1,3,10
5,6,2,3,10
5,6,3,3,10
5,6,4,3,10
5,7,0,3,10
5,7,1,3,10
5,7,2,3,10
5,7,3,3,10
5,7,4,3,10
5,8,0,3,10
5,8,1,3,10
5,8,2,3,10
5,8,3,3,10
5,8,4,3,10
5,9,0,3,10
5,9,1,3,10
5,9,2,3,10
5,9,3,3,10
5,9,4,3,10
5,10,0,3,10
5,10,1,3,10
5,10,2,3,10
5,10,3,3,10
5,10,4,3,10
5,11,0,3,10
5,11,1,3,10
5,11,2,3,10
5,11,3,3,10
5,11,4,3,10
5,12,0,3,10
5,12,1,3,10
5,12,2,3,10
5,12,3,3,10
5,12,4,3,10
5,13,0,3,10
5,13,1,3,10
5,13,2,3,10
5,13,3,3,10
5,13,4,3,10
5,14,0,3,10
5,14,1,3,10
5,14,2,3,10
5,14,3,3,10
5,14,4,3,10
5,15,0,3,10
5,15,1,3,10
5,15,2,3,10
5,15,3,3,10
5,15,4,3,10
5,16,0,3,10
5,16,1,3,10
5,16,2,3,10
5,16,3,3,10
5,16,4,3,10
5,17,0,3,10
5,17,1,3,10
5,17,2,3,10
5,17,3,3,10
5,17,4,3,10
5,18,0,3,10
5,18,1,3,10
5,18,2,3,10
5,18,3,3,10
5,18,4,3,10
5,0,0,4,10
5,0,1,4,10
5,0,2,4,10
5,0,3,4,10
5,0,4,4,10
5,1,0,4,10
5,1,1,4,10
5,1,2,4,10
5,1,3,4,10
5,1,4,4,10
5,2,0,4,10
5,2,1,4,10
5,2,2,4,10
5,2,3,4,10
5,2,4,4,10
5,3,0,4,10
5,3,1,4,10
5,3,2,4,10
5,3,3,4,10
5,3,4,4,10
5,4,0,4,10
5,4,1,4,10
5,4,2,4,10
5,4,3,4,10
5,4,4,4,10
5,5,0,4,10
5,5,1,4,10
5,5,2,4,10
5,5,3,4,10
5,5,4,4,10
5,6,0,4,10
5,6,1,4,10
5,6,2,4,10
5,6,3,4,10
5,6,4,4,10
5,7,0,4,10
5,7,1,4,10
5,7,2,4,10
5,7,3,4,10
5,7,4,4,10
5,8,0,4,10
5,8,1,4,10
5,8,2,4,10
5,8,3,4,10
5,8,4,4,10
5,9,0,4,10
5,9,1,4,10
5,9,2,4,10
5,9,3,4,10
5,9,4,4,10
5,10,0,4,10
5,10,1,4,10
5,10,2,4,10
5,10,3,4,10
5,10,4,4,10
5,11,0,4,10
5,11,1,4,10
5,11,2,4,10
5,11,3,4,10
5,11,4,4,10
5,12,0,4,10
5,12,1,4,10
5,12,2,4,10
5,12,3,4,10
5,12,4,4,10
5,13,0,4,10
5,13,1,4,10
5,13,2,4,10
5,13,3,4,10
5,13,4,4,10
5,14,0,4,10
5,14,1,4,10
5,14,2,4,10
5,14,3,4,10
5,14,4,4,10
5,15,0,4,10
5,15,1,4,10
5,15,2,4,10
5,15,3,4,10
5,15,4,4,10
5,16,0,4,10
5,16,1,4,10
5,16,2,4,10
5,16,3,4,10
5,16,4,4,10
5,0,0,5,10
5,0,1,5,10
5,0,2,5,10
5,0,3,5,10
5,0,4,5,10
5,1,0,5,10
5,1,1,5,10
5,1,2,5,10
5,1,3,5,10
5,1,4,5,10
5,2,0,5,10
5,2,1,5,10
5,2,2,5,10
5,2,3,5,10
5,2,4,5,10
5,3,0,5,10
5,3,1,5,10
5,3,2,5,10
5,3,3,5,10
5,3,4,5,10
5,4,0,5,10
5,4,1,5,10
5,4,2,5,10
5,4,3,5,10
5,4,4,5,10
5,5,0,5,10
5,5,1,5,10
5,5,2,5,10
5,5,3,5,10
5,5,4,5,10
5,6,0,5,10
5,6,1,5,10
5,6,2,5,10
5,6,3,5,10
5,6,4,5,10
5,7,0,5,10
5,7,1,5,10
5,7,2,5,10
5,7,3,5,10
5,7,4,5,10
5,8,0,5,10
5,8,1,5,10
5,8,2,5,10
5,8,3,5,10
5,8,4,5,10
5,9,0,5,10
5,9,1,5,10
5,9,2,5,10
5,9,3,5,10
5,9,4,5,10
5,10,0,5,10
5,10,1,5,10
5,10,2,5,10
5,10,3,5,10
5,10,4,5,10
5,11,0,5,10
5,11,1,5,10
5,11,2,5,10
5,11,3,5,10
5,11,4,5,10
5,12,0,5,10
5,12,1,5,10
5,12,2,5,10
5,12,3,5,10
5,12,4,5,10
5,13,0,5,10
5,13,1,5,10
5,13,2,5,10
5,13,3,5,10
5,13,4,5,10
5,14,0,5,10
5,14,1,5,10
5,14,2,5,10
5,14,3,5,10
5,14,4,5,10
5,0,0,6,10
5,0,1,6,10
5,0,2,6,10
5,0,3,6,10
5,0,4,6,10
5,1,0,6,10
5,1,1,6,10
5,1,2,6,10
5,1,3,6,10
5,1,4,6,10
5,2,0,6,10
5,2,1,6,10
5,2,2,6,10
5,2,3,6,10
5,2,4,6,10
5,3,0,6,10
5,3,1,6,10
5,3,2,6,10
5,3,3,6,10
5,3,4,6,10
5,4,0,6,10
5,4,1,6,10
5,4,2,6,10
5,4,3,6,10
5,4,4,6,10
5,5,0,6,10
5,5,1,6,10
5,5,2,6,10
5,5,3,6,10
5,5,4,6,10
5,6,0,6,10
5,6,1,6,10
5,6,2,6,10
5,6,3,6,10
5,6,4,6,10
5,7,0,6,10
5,7,1,6,10
5,7,2,6,10
5,7,3,6,10
5,7,4,6,10
5,8,0,6,10
5,8,1,6,10
5,8,2,6,10
5,8,3,6,10
5,8,4,6,10
5,9,0,6,10
5,9,1,6,10
5,9,2,6,10
5,9,3,6,10
5,9,4,6,10
5,10,0,6,10
5,10,1,6,10
5,10,2,6,10
5,10,3,6,10
5,10,4,6,10
5,11,0,6,10
5,11,1,6,10
5,11,2,6,10
5,11,3,6,10
5,11,4,6,10
5,12,0,6,10
5,12,1,6,10
5,12,2,6,10
5,12,3,6,10
5,12,4,6,10
5,0,0,7,10
5,0,1,7,10
5,0,2,7,10
5,0,3,7,10
5,0,4,7,10
5,1,0,7,10
5,1,1,7,10
5,1,2,7,10
5,1,3,7,10
5,1,4,7,10
5,2,0,7,10
5,2,1,7,10
5,2,2,7,10
5,2,3,7,10
5,2,4,7,10
5,3,0,7,10
5,3,1,7,10
5,3,2,7,10
5,3,3,7,10
5,3,4,7,10
5,4,0,7,10
5,4,1,7,10
5,4,2,7,10
5,4,3,7,10
5,4,4,7,10
5,5,0,7,10
5,5,1,7,10
5,5,2,7,10
5,5,3,7,10
5,5,4,7,10
5,6,0,7,10
5,6,1,7,10
5,6,2,7,10
5,6,3,7,10
5,6,4,7,10
5,7,0,7,10
5,7,1,7,10
5,7,2,7,10
5,7,3,7,10
5,7,4,7,10
5,8,0,7,10
5,8,1,7,10
5,8,2,7,10
5,8,3,7,10
5,8,4,7,10
5,9,0,7,10
5,9,1,7,10
5,9,2,7,10
5,9,3,7,10
5,9,4,7,10
5,10,0,7,10
5,10,1,7,10
5,10,2,7,10
5,10,3,7,10
5,10,4,7,10
5,0,0,8,10
5,0,1,8,10
5,0,2,8,10
5,0,3,8,10
5,0,4,8,10
5,1,0,8,10
5,1,1,8,10
5,1,2,8,10
5,1,3,8,10
5,1,4,8,10
5,2,0,8,10
5,2,1,8,10
5,2,2,8,10
5,2,3,8,10
5,2,4,8,10
5,3,0,8,10
5,3,1,8,10
5,3,2,8,10
5,3,3,8,10
5,3,4,8,10
5,4,0,8,10
5,4,1,8,10
5,4,2,8,10
5,4,3,8,10
5,4,4,8,10
5,5,0,8,10
5,5,1,8,10
5,5,2,8,10
5,5,3,8,10
5,5,4,8,10
5,6,0,8,10
5,6,1,8,10
5,6,2,8,10
5,6,3,8,10
5,6,4,8,10
5,7,0,8,10
5,7,1,8,10
5,7,2,8,10
5,7,3,8,10
5,7,4,8,10
5,8,0,8,10
5,8,1,8,10
5,8,2,8,10
5,8,3,8,10
5,8,4,8,10
5,0,0,9,10
5,0,1,9,10
5,0,2,9,10
5,0,3,9,10
5,0,4,9,10
5,1,0,9,10
5,1,1,9,10
5,1,2,9,10
5,1,3,9,10
5,1,4,9,10
5,2,0,9,10
5,2,1,9,10
5,2,2,9,10
5,2,3,9,10
5,2,4,9,10
5,3,0,9,10
5,3,1,9,10
5,3,2,9,10
5,3,3,9,10
5,3,4,9,10
5,4,0,9,10
5,4,1,9,10
5,4,2,9,10
5,4,3,9,10
5,4,4,9,10
5,5,0,9,10
5,5,1,9,10
5,5,2,9,10
5,5,3,9,10
5,5,4,9,10
5,6,0,9,10
5,6,1,9,10
5,6,2,9,10
5,6,3,9,10
5,6,4,9,10
5,0,0,10,10
5,0,1,10,10
5,0,2,10,10
5,0,3,10,10
5,0,4,10,10
5,1,0,10,10
5,1,1,10,10
5,1,2,10,10
5,1,3,10,10
5,1,4,10,10
5,2,0,10,10
5,2,1,10,10
5,2,2,10,10
5,2,3,10,10
5,2,4,10,10
5,3,0,10,10
5,3,1,10,10
5,3,2,10,10
5,3,3,10,10
5,3,4,10,10
5,4,0,10,10
5,4,1,10,10
5,4,2,10,10
5,4,3,10,10
5,4,4,10,10
5,0,0,11,10
5,0,1,11,10
5,0,2,11,10
5,0,3,11,10
5,0,4,11,10
5,1,0,11,10
5,1,1,11,10
5,1,2,11,10
5,1,3,11,10
5,1,4,11,10
5,2,0,11,10
5,2,1,11,10
5,2,2,11,10
5,2,3,11,10
5,2,4,11,10
5,0,0,12,10
5,0,1,12,10
5,0,2,12,10
5,0,3,12,10
5,0,4,12,10
5,0,0,1,11
5,0,1,1,11
5,0,2,1,11
5,1,0,1,11
5,1,1,1,11
5,1,2,1,11
5,2,0,1,11
5,2,1,1,11
5,2,2,1,11
5,3,0,1,11
5,3,1,1,11
5,3,2,1,11
5,4,0,1,11
5,4,1,1,11
5,4,2,1,11
5,5,0,1,11
5,5,1,1,11
5,5,2,1,11
5,6,0,1,11
5,6,1,1,11
5,6,2,1,11
5,7,0,1,11
5,7,1,1,11
5,7,2,1,11
5,8,0,1,11
5,8,1,1,11
5,8,2,1,11
5,9,0,1,11
5,9,1,1,11
5,9,2,1,11
5,10,0,1,11
5,10,1,1,11
5,10,2,1,11
5,11,0,1,11
5,11,1,1,11
5,11,2,1,11
5,12,0,1,11
5,12,1,1,11
5,12,2,1,11
5,13,0,1,11
5,13,1,1,11
5,13,2,1,11
5,14,0,1,11
5,14,1,1,11
5,14,2,1,11
5,15,0,1,11
5,15,1,1,11
5,15,2,1,11
5,16,0,1,11
5,16,1,1,11
5,16,2,1,11
5,17,0,1,11
5,17,1,1,11
5,17,2,1,11
5,18,0,1,11
5,18,1,1,11
5,18,2,1,11
5,19,0,1,11
5,19,1,1,11
5,19,2,1,11
5,20,0,1,11
5,20,1,1,11
5,20,2,1,11
5,21,0,1,11
5,21,1,1,11
5,21,2,1,11
5,22,0,1,11
5,22,1,1,11
5,22,2,1,11
5,0,0,2,11
5,0,1,2,11
5,0,2,2,11
5,1,0,2,11
5,1,1,2,11
5,1,2,2,11
5,2,0,2,11
5,2,1,2,11
5,2,2,2,11
5,3,0,2,11
5,3,1,2,11
5,3,2,2,11
5,4,0,2,11
5,4,1,2,11
5,4,2,2,11
5,5,0,2,11
5,5,1,2,11
5,5,2,2,11
5,6,0,2,11
5,6,1,2,11
5,6,2,2,11
5,7,0,2,11
5,7,1,2,11
5,7,2,2,11
5,8,0,2,11
5,8,1,2,11
5,8,2,2,11
5,9,0,2,11
5,9,1,2,11
5,9,2,2,11
5,10,0,2,11
5,10,1,2,11
5,10,2,2,11
5,11,0,2,11
5,11,1,2,11
5,11,2,2,11
5,12,0,2,11
5,12,1,2,11
5,12,2,2,11
5,13,0,2,11
5,13,1,2,11
5,13,2,2,11
5,14,0,2,11
5,14,1,2,11
5,14,2,2,11
5,15,0,2,11
5,15,1,2,11
5,15,2,2,11
5,16,0,2,11
5,16,1,2,11
5,16,2,2,11
5,17,0,2,11
5,17,1,2,11
5,17,2,2,11
5,18,0,2,11
5,18,1,2,11
5,18,2,2,11
5,19,0,2,11
5,19,1,2,11
5,19,2,2,11
5,20,0,2,11
5,20,1,2,11
5,20,2,2,11
5,0,0,3,11
5,0,1,3,11
5,0,2,3,11
5,1,0,3,11
5,1,1,3,11
5,1,2,3,11
5,2,0,3,11
5,2,1,3,11
5,2,2,3,11
5,3,0,3,11
5,3,1,3,11
5,3,2,3,11
5,4,0,3,11
5,4,1,3,11
5,4,2,3,11
5,5,0,3,11
5,5,1,3,11
5,5,2,3,11
5,6,0,3,11
5,6,1,3,11
5,6,2,3,11
5,7,0,3,11
5,7,1,3,11
5,7,2,3,11
5,8,0,3,11
5,8,1,3,11
5,8,2,3,11
5,9,0,3,11
5,9,1,3,11
5,9,2,3,11
5,10,0,3,11
5,10,1,3,11
5,10,2,3,11
5,11,0,3,11
5,11,1,3,11
5,11,2,3,11
5,12,0,3,11
5,12,1,3,11
5,12,2,3,11
5,13,0,3,11
5,13,1,3,11
5,13,2,3,11
5,14,0,3,11
5,14,1,3,11
5,14,2,3,11
5,15,0,3,11
5,15,1,3,11
5,15,2,3,11
5,16,0,3,11
5,16,1,3,11
5,16,2,3,11
5,17,0,3,11
5,17,1,3,11
5,17,2,3,11
5,18,0,3,11
5,18,1,3,11
5,18,2,3,11
5,0,0,4,11
5,0,1,4,11
5,0,2,4,11
5,1,0,4,11
5,1,1,4,11
5,1,2,4,11
5,2,0,4,11
5,2,1,4,11
5,2,2,4,11
5,3,0,4,11
5,3,1,4,11
5,3,2,4,11
5,4,0,4,11
5,4,1,4,11
5,4,2,4,11
5,5,0,4,11
5,5,1,4,11
5,5,2,4,11
5,6,0,4,11
5,6,1,4,11
5,6,2,4,11
5,7,0,4,11
5,7,1,4,11
5,7,2,4,11
5,8,0,4,11
5,8,1,4,11
5,8,2,4,11
5,9,0,4,11
5,9,1,4,11
5,9,2,4,11
5,10,0,4,11
5,10,1,4,11
5,10,2,4,11
5,11,0,4,11
5,11,1,4,11
5,11,2,4,11
5,12,0,4,11
5,12,1,4,11
5,12,2,4,11
5,13,0,4,11
5,13,1,4,11
5,13,2,4,11
5,14,0,4,11
5,14,1,4,11
5,14,2,4,11
5,15,0,4,11
5,15,1,4,11
5,15,2,4,11
5,16,0,4,11
5,16,1,4,11
5,16,2,4,11
5,0,0,5,11
5,0,1,5,11
5,0,2,5,11
5,1,0,5,11
5,1,1,5,11
5,1,2,5,11
5,2,0,5,11
5,2,1,5,11
5,2,2,5,11
5,3,0,5,11
5,3,1,5,11
5,3,2,5,11
5,4,0,5,11
5,4,1,5,11
5,4,2,5,11
5,5,0,5,11
5,5,1,5,11
5,5,2,5,11
5,6,0,5,11
5,6,1,5,11
5,6,2,5,11
5,7,0,5,11
5,7,1,5,11
5,7,2,5,11
5,8,0,5,11
5,8,1,5,11
5,8,2,5,11
5,9,0,5,11
5,9,1,5,11
5,9,2,5,11
5,10,0,5,11
5,10,1,5,11
5,10,2,5,11
5,11,0,5,11
5,11,1,5,11
5,11,2,5,11
5,12,0,5,11
5,12,1,5,11
5,12,2,5,11
5,13,0,5,11
5,13,1,5,11
5,13,2,5,11
5,14,0,5,11
5,14,1,5,11
5,14,2,5,11
5,0,0,6,11
5,0,1,6,11
5,0,2,6,11
5,1,0,6,11
5,1,1,6,11
5,1,2,6,11
5,2,0,6,11
5,2,1,6,11
5,2,2,6,11
5,3,0,6,11
5,3,1,6,11
5,3,2,6,11
5,4,0,6,11
5,4,1,6,11
5,4,2,6,11
5,5,0,6,11
5,5,1,6,11
5,5,2,6,11
5,6,0,6,11
5,6,1,6,11
5,6,2,6,11
5,7,0,6,11
5,7,1,6,11
5,7,2,6,11
5,8,0,6,11
5,8,1,6,11
5,8,2,6,11
5,9,0,6,11
5,9,1,6,11
5,9,2,6,11
5,10,0,6,11
5,10,1,6,11
5,10,2,6,11
5,11,0,6,11
5,11,1,6,11
5,11,2,6,11
5,12,0,6,11
5,12,1,6,11
5,12,2,6,11
5,0,0,7,11
5,0,1,7,11
5,0,2,7,11
5,1,0,7,11
5,1,1,7,11
5,1,2,7,11
5,2,0,7,11
5,2,1,7,11
5,2,2,7,11
5,3,0,7,11
5,3,1,7,11
5,3,2,7,11
5,4,0,7,11
5,4,1,7,11
5,4,2,7,11
5,5,0,7,11
5,5,1,7,11
5,5,2,7,11
5,6,0,7,11
5,6,1,7,11
5,6,2,7,11
5,7,0,7,11
5,7,1,7,11
5,7,2,7,11
5,8,0,7,11
5,8,1,7,11
5,8,2,7,11
5,9,0,7,11
5,9,1,7,11
5,9,2,7,11
5,10,0,7,11
5,10,1,7,11
5,10,2,7,11
5,0,0,8,11
5,0,1,8,11
5,0,2,8,11
5,1,0,8,11
5,1,1,8,11
5,1,2,8,11
5,2,0,8,11
5,2,1,8,11
5,2,2,8,11
5,3,0,8,11
5,3,1,8,11
5,3,2,8,11
5,4,0,8,11
5,4,1,8,11
5,4,2,8,11
5,5,0,8,11
5,5,1,8,11
5,5,2,8,11
5,6,0,8,11
5,6,1,8,11
5,6,2,8,11
5,7,0,8,11
5,7,1,8,11
5,7,2,8,11
5,8,0,8,11
5,8,1,8,11
5,8,2,8,11
5,0,0,9,11
5,0,1,9,11
5,0,2,9,11
5,1,0,9,11
5,1,1,9,11
5,1,2,9,11
5,2,0,9,11
5,2,1,9,11
5,2,2,9,11
5,3,0,9,11
5,3,1,9,11
5,3,2,9,11
5,4,0,9,11
5,4,1,9,11
5,4,2,9,11
5,5,0,9,11
5,5,1,9,11
5,5,2,9,11
5,6,0,9,11
5,6,1,9,11
5,6,2,9,11
5,0,0,10,11
5,0,1,10,11
5,0,2,10,11
5,1,0,10,11
5,1,1,10,11
5,1,2,10,11
5,2,0,10,11
5,2,1,10,11
5,2,2,10,11
5,3,0,10,11
5,3,1,10,11
5,3,2,10,11
5,4,0,10,11
5,4,1,10,11
5,4,2,10,11
5,0,0,11,11
5,0,1,11,11
5,0,2,11,11
5,1,0,11,11
5,1,1,11,11
5,1,2,11,11
5,2,0,11,11
5,2,1,11,11
5,2,2,11,11
5,0,0,12,11
5,0,1,12,11
5,0,2,12,11
5,0,0,1,12
5,1,0,1,12
5,2,0,1,12
5,3,0,1,12
5,4,0,1,12
5,5,0,1,12
5,6,0,1,12
5,7,0,1,12
5,8,0,1,12
5,9,0,1,12
5,10,0,1,12
5,11,0,1,12
5,12,0,1,12
5,13,0,1,12
5,14,0,1,12
5,15,0,1,12
5,16,0,1,12
5,17,0,1,12
5,18,0,1,12
5,19,0,1,12
5,20,0,1,12
5,21,0,1,12
5,22,0,1,12
5,0,0,2,12
5,1,0,2,12
5,2,0,2,12
5,3,0,2,12
5,4,0,2,12
5,5,0,2,12
5,6,0,2,12
5,7,0,2,12
5,8,0,2,12
5,9,0,2,12
5,10,0,2,12
5,11,0,2,12
5,12,0,2,12
5,13,0,2,12
5,14,0,2,12
5,15,0,2,12
5,16,0,2,12
5,17,0,2,12
5,18,0,2,12
5,19,0,2,12
5,20,0,2,12
5,0,0,3,12
5,1,0,3,12
5,2,0,3,12
5,3,0,3,12
5,4,0,3,12
5,5,0,3,12
5,6,0,3,12
5,7,0,3,12
5,8,0,3,12
5,9,0,3,12
5,10,0,3,12
5,11,0,3,12
5,12,0,3,12
5,13,0,3,12
5,14,0,3,12
5,15,0,3,12
5,16,0,3,12
5,17,0,3,12
5,18,0,3,12
5,0,0,4,12
5,1,0,4,12
5,2,0,4,12
5,3,0,4,12
5,4,0,4,12
5,5,0,4,12
5,6,0,4,12
5,7,0,4,12
5,8,0,4,12
5,9,0,4,12
5,10,0,4,12
5,11,0,4,12
5,12,0,4,12
5,13,0,4,12
5,14,0,4,12
5,15,0,4,12
5,16,0,4,12
5,0,0,5,12
5,1,0,5,12
5,2,0,5,12
5,3,0,5,12
5,4,0,5,12
5,5,0,5,12
5,6,0,5,12
5,7,0,5,12
5,8,0,5,12
5,9,0,5,12
5,10,0,5,12
5,11,0,5,12
5,12,0,5,12
5,13,0,5,12
5,14,0,5,12
5,0,0,6,12
5,1,0,6,12
5,2,0,6,12
5,3,0,6,12
5,4,0,6,12
5,5,0,6,12
5,6,0,6,12
5,7,0,6,12
5,8,0,6,12
5,9,0,6,12
5,10,0,6,12
5,11,0,6,12
5,12,0,6,12
5,0,0,7,12
5,1,0,7,12
5,2,0,7,12
5,3,0,7,12
5,4,0,7,12
5,5,0,7,12
5,6,0,7,12
5,7,0,7,12
5,8,0,7,12
5,9,0,7,12
5,10,0,7,12
5,0,0,8,12
5,1,0,8,12
5,2,0,8,12
5,3,0,8,12
5,4,0,8,12
5,5,0,8,12
5,6,0,8,12
5,7,0,8,12
5,8,0,8,12
5,0,0,9,12
5,1,0,9,12
5,2,0,9,12
5,3,0,9,12
5,4,0,9,12
5,5,0,9,12
5,6,0,9,12
5,0,0,10,12
5,1,0,10,12
5,2,0,10,12
5,3,0,10,12
5,4,0,10,12
5,0,0,11,12
5,1,0,11,12
5,2,0,11,12
5,0,0,12,12
